"gene"	"mRNA len"	"genomic span"	"DC_normal"	"DC_treated"	"DC0904"	"DC0907"	"DCLPS0910"	"DCLPS0913"	"A_DC"	"A_DC_LPS"	"B_DC"	"B_DC_LPS"	"C_DC"	"C_DC_LPS"	"C2DC"	"C2DCLPS"	"C3DC"	"C3DCLPS"
"Total"			34421746	35651172	18993731	15428015	19295809	16355363	15815593	18359702	15914475	29579632	20682552	26654329	24954250	26797323	30197188	23025806
"10a.872B9 (locus 10a)"	361	472	0	0	0	0	0	0	0	0	0	0	0	0	0	0	0	0
"16G2"	1444	12549	0	0	0	0	0	0	0	0	0	0	0	0	0	0	0	0
"214K23.2"	2522	31972	119	137	83	36	76	61	93	83	9	68	275	355	302	303	414	312
"2B4"	949	24007	0	0	0	0	0	0	13	0	0	0	29	58	61	106	56	37
"2E4"	1787	9122	0	0	0	0	0	0	94	73	0	0	101	107	145	85	153	92
44050	2315	19035	0	0	0	0	0	0	14	0	0	0	0	0	0	0	0	0
"5-OPase"	1020	1284	70	34	37	33	6	28	77	34	4	41	146	269	155	171	323	188
"5H9"	970	35347	268	51	163	105	19	32	367	200	0	250	1516	1406	1953	1857	1425	1399
"6M1-18"	478	29431	0	0	0	0	0	0	0	0	0	0	0	0	0	0	0	0
"6a8b"	1551	8982	1881	1313	1303	578	529	784	663	1033	2186	1956	751	880	1847	1932	3307	1950
"7M1-2"	69	907	0	0	0	0	0	0	0	0	0	0	0	0	0	0	0	0
"A-328A3.5"	1570	1958	63	0	57	6	0	0	64	0	0	0	260	164	336	120	399	88
"A1"	1751	37974	0	0	0	0	0	0	132	25	0	0	17	8	0	0	30	0
"A121/SUI1"	1164	2772	873	1210	477	396	631	579	299	565	411	948	7634	14397	10090	17750	12150	14826
"A1BG"	1772	6693	256	46	113	143	46	0	183	57	192	149	134	174	254	186	450	278
"A1CF"	2386	79110	0	0	0	0	0	0	0	0	0	0	0	0	0	0	0	0
"A2BP1"	4791	1694210	0	0	0	0	0	0	22	0	0	0	0	0	0	0	0	0
"A2LD1"	1273	57237	0	0	0	0	0	0	126	32	0	0	77	17	170	90	87	16
"A2LG"	3277	11467	2363	1883	1220	1143	1026	857	843	1071	1574	2838	1471	2489	3565	3633	4665	3915
"A2M"	4689	48256	6156	2420	3340	2816	1326	1094	2549	709	2338	1904	24801	17865	58886	55413	54742	51275
"A2ML1"	5222	54227	0	0	0	0	0	0	17	8	0	0	0	0	0	0	0	0
"A3GALT2"	1028	14334	0	0	0	0	0	0	47	0	0	0	0	0	0	0	0	0
"A4GALT"	2136	29160	11	0	11	0	0	0	112	56	0	0	45	40	0	9	0	0
"A4GNT"	1774	8671	39	10	22	17	0	10	0	9	0	0	50	12	0	0	0	0
"AA02"	610	3950	0	0	0	0	0	0	0	0	0	0	0	0	0	0	0	0
"AAA1"	1536	115467	0	0	0	0	0	0	0	0	0	0	41	46	0	0	0	0
"AAAS"	1852	14173	95	22	39	56	11	11	110	68	0	45	465	362	580	382	663	462
"AACS"	3340	77949	399	38	244	155	11	27	622	190	19	47	499	434	355	292	629	356
"AACSL"	2832	53572	0	0	0	0	0	0	46	34	0	0	0	0	0	0	0	0
"AADAC"	1612	14418	0	0	0	0	0	0	0	0	0	0	0	0	0	0	0	0
"AADACL2"	1503	23852	0	0	0	0	0	0	0	0	0	0	0	0	0	0	0	0
"AADACL3"	4053	12610	0	0	0	0	0	0	0	0	0	0	0	0	0	0	0	0
"AADACL4"	1578	22532	0	0	0	0	0	0	14	0	0	0	0	0	0	0	0	0
"AADAT"	2338	29811	0	0	0	0	0	0	0	0	0	0	0	0	0	0	0	0
"AAGAB"	2853	53707	1365	335	765	600	202	133	917	672	135	528	470	559	510	1073	637	1061
"AAK1"	21287	185852	18818	6083	10571	8247	3274	2809	8818	2940	10024	4856	3208	3555	2850	2333	2686	1718
"AAMP"	1807	6042	185	117	81	104	45	72	149	164	0	23	1372	959	1751	1568	2681	1161
"AANAT"	1008	2549	0	0	0	0	0	0	0	31	0	0	0	0	0	0	0	0
"AARS"	3365	37117	615	252	305	310	128	124	242	94	228	144	1233	1508	1592	1607	3019	1746
"AARS2"	4804	14602	361	63	194	167	29	34	235	55	51	84	313	427	474	371	610	415
"AARSD1"	2189	30002	38	0	28	10	0	0	41	26	0	0	154	188	311	271	271	238
"AASDH"	4491	44306	250	26	157	93	14	12	136	0	0	0	448	360	406	249	359	221
"AASDHPPT"	2867	21129	287	6	152	135	0	6	275	13	9	0	1233	962	881	682	1053	737
"AASS"	5893	70746	0	0	0	0	0	0	0	0	0	0	0	0	0	0	0	0
"AAT1"	1048	7341	0	0	0	0	0	0	0	0	0	0	0	0	0	0	0	0
"AATF"	2156	107997	2408	1163	1428	980	724	439	1537	1249	475	1462	605	947	1132	1018	1076	800
"AATK"	5321	48774	297	567	173	124	280	287	556	1346	0	2214	58	144	44	269	280	228
"AB000466"	3004	6320	400	436	221	179	226	210	235	285	154	437	682	974	535	672	301	386
"AB004851"	745	14913	65	0	37	28	0	0	143	37	0	0	322	251	215	174	549	265
"AB007962"	5060	23800	0	9	0	0	9	0	0	0	0	0	0	42	0	40	0	0
"AB055772"	933	933	0	0	0	0	0	0	0	0	0	0	2356	2074	5500	5601	8897	6699
"AB062081"	409	775	0	0	0	0	0	0	0	0	0	0	0	0	0	0	0	0
"AB073649"	2905	2905	0	0	0	0	0	0	0	0	0	0	0	0	0	0	0	0
"AB073667"	3562	3562	358	34	240	118	34	0	131	0	253	20	600	632	578	367	764	294
"AB074160"	4333	4333	0	0	0	0	0	0	0	0	0	0	0	0	0	0	0	0
"AB074162"	2238	2238	0	18	0	0	18	0	56	24	0	0	0	0	0	0	0	0
"AB074166"	4849	4849	0	0	0	0	0	0	0	0	0	0	0	0	0	0	0	5
"AB074188"	2092	2092	0	0	0	0	0	0	0	0	0	0	0	0	0	0	0	0
"AB1"	1161	1161	60	0	24	36	0	0	100	0	0	0	0	0	0	0	0	549
"AB209061"	4068	4068	574	13	337	237	0	13	255	135	338	55	4485	3523	5764	3975	6792	4281
"AB209077"	451	4711	0	0	0	0	0	0	0	0	0	0	0	0	0	0	0	0
"AB209185"	1914	2565	0	0	0	0	0	0	41	0	0	0	102	38	91	109	98	106
"AB209575"	3589	3935	479	122	302	177	70	52	89	57	190	106	1308	1385	1302	1015	1673	1226
"AB209692"	7580	10347	0	0	0	0	0	0	32	14	0	0	0	0	0	0	0	0
"AB231702"	884	27258	0	0	0	0	0	0	0	0	0	0	0	0	0	0	0	0
"AB231703"	219	1125	0	0	0	0	0	0	0	0	0	0	0	0	0	0	0	0
"AB231705"	713	5268	0	0	0	0	0	0	0	0	0	0	0	0	0	0	0	0
"AB231710"	248	1323	0	0	0	0	0	0	0	0	0	0	0	0	199	195	250	198
"AB231711"	153	1323	0	0	0	0	0	0	0	0	0	0	0	0	199	195	250	198
"AB231721"	208	7844	0	0	0	0	0	0	0	0	0	0	0	0	0	0	0	0
"AB231722"	160	513	0	0	0	0	0	0	0	0	0	0	0	0	0	0	0	0
"AB231723"	176	4533	0	0	0	0	0	0	0	0	0	0	0	0	0	0	0	0
"AB231724"	157	1329	0	0	0	0	0	0	0	0	0	0	0	0	0	0	0	0
"AB231729"	416	16984	513	67	316	197	35	32	814	226	135	101	114	259	66	53	61	5
"AB231731"	535	16984	513	67	316	197	35	32	814	226	135	101	114	259	66	53	61	5
"AB231737"	1009	4531	0	0	0	0	0	0	0	0	0	0	0	0	0	0	0	0
"AB231740"	653	17565	0	0	0	0	0	0	0	0	0	0	0	0	0	0	0	0
"AB231742"	165	17573	0	0	0	0	0	0	0	0	0	0	0	0	0	0	0	0
"AB231754"	308	71023	0	0	0	0	0	0	93	32	0	0	0	0	0	0	0	0
"AB231755"	233	71023	0	0	0	0	0	0	93	32	0	0	0	0	0	0	0	0
"AB231756"	386	71023	0	0	0	0	0	0	93	32	0	0	0	0	0	0	0	0
"AB231757"	236	71023	0	0	0	0	0	0	93	32	0	0	0	0	0	0	0	0
"AB231758"	83	71023	0	0	0	0	0	0	93	32	0	0	0	0	0	0	0	0
"AB231759"	294	1942	0	0	0	0	0	0	0	0	0	0	0	0	0	0	0	0
"AB231760"	213	1942	0	0	0	0	0	0	0	0	0	0	0	0	0	0	0	0
"AB231761"	146	5341	0	0	0	0	0	0	0	0	0	0	0	0	0	0	0	0
"AB231779"	891	9289	0	0	0	0	0	0	0	0	0	0	0	0	0	0	3	0
"AB231784"	168	6188	0	0	0	0	0	0	0	0	0	0	0	0	0	0	0	0
"AB240015"	591	591	0	0	0	0	0	0	0	0	0	0	0	0	0	0	0	0
"AB330770"	23	23	284	12558	158	126	9014	3544	56	3129	0	3866	225	1384	0	602	0	536
"AB429224"	1157	4988	0	0	0	0	0	0	0	22	0	0	0	1	0	0	0	0
"ABAT"	5601	71607	4725	476	2590	2135	335	141	2371	607	3313	1142	1856	1992	2608	2452	2527	1688
"ABCA1"	10460	147153	118	1452	81	37	837	615	1589	2796	61	334	863	1258	1276	1656	1380	1229
"ABCA10"	6371	96810	66	279	12	54	168	111	17	23	2	13	51	46	10	27	20	8
"ABCA11P"	1898	48776	3118	1338	1748	1370	697	641	1429	557	946	987	763	683	683	312	817	292
"ABCA12"	9234	206886	0	0	0	0	0	0	10	0	0	0	0	0	0	0	0	0
"ABCA13"	17246	476036	0	0	0	0	0	0	0	0	0	0	0	0	0	0	0	0
"ABCA17"	4205	85779	0	0	0	0	0	0	10	0	0	0	0	1	0	1	0	1
"ABCA2"	8203	21056	1090	689	558	532	348	341	798	601	1296	587	1646	1952	2069	2060	2757	1974
"ABCA3"	6656	64870	15	0	4	11	0	0	315	101	0	0	187	229	150	87	332	142
"ABCA4"	7373	128311	0	0	0	0	0	0	10	0	0	0	0	0	0	0	0	0
"ABCA4 variant protein"	1163	8297	0	0	0	0	0	0	10	0	0	0	0	0	0	0	0	0
"ABCA5"	9287	71200	2168	2491	1185	983	1372	1119	529	666	133	723	448	874	363	292	422	235
"ABCA6"	5335	63170	6508	4486	4040	2468	2463	2023	2064	1498	1174	3190	4759	7145	9957	7478	2257	943
"ABCA7"	6863	25468	994	330	472	522	185	145	756	494	574	176	778	810	1161	1072	2508	1463
"ABCA7/ABCA-SSN"	1959	8664	382	72	207	175	50	22	280	165	88	63	162	209	369	378	859	477
"ABCA8"	6039	88102	2	0	0	2	0	0	0	0	0	0	0	0	0	0	0	0
"ABCA9"	6339	86364	901	2192	474	427	1250	942	134	735	26	1441	509	1287	698	959	115	27
"ABCB1"	4901	209618	0	0	0	0	0	0	0	0	0	0	42	57	69	52	67	46
"ABCB10"	3869	42114	1215	116	673	542	66	50	529	126	233	226	619	650	770	687	847	615
"ABCB11"	4803	108386	0	0	0	0	0	0	0	0	0	0	0	0	0	0	0	0
"ABCB4"	4016	73660	242	7	119	123	4	3	55	4	20	0	268	293	280	133	272	146
"ABCB5"	5428	141393	0	0	0	0	0	0	0	0	0	0	0	0	0	0	0	0
"ABCB6"	4493	10682	153	47	52	101	22	25	251	71	41	0	1387	915	1396	843	370	246
"ABCB7"	2401	103027	744	55	459	285	43	12	698	96	41	73	376	685	787	635	698	640
"ABCB8"	4749	19359	525	47	274	251	30	17	639	254	289	117	472	472	718	647	800	625
"ABCB9"	3809	46214	79	0	35	44	0	0	604	165	53	0	341	227	330	223	540	431
"ABCC1"	6592	193496	21096	12251	11765	9331	6510	5741	8532	7716	12082	13539	3786	4584	4692	4485	5631	4280
"ABCC10"	5108	18676	2036	531	1121	915	288	243	797	281	1006	416	768	852	1096	916	1629	714
"ABCC11"	4891	65362	81	0	58	23	0	0	55	15	0	0	0	62	0	0	0	0
"ABCC12"	5217	73047	0	0	0	0	0	0	15	11	0	0	0	0	0	0	0	0
"ABCC13"	3375	64217	0	0	0	0	0	0	0	0	0	0	0	0	0	0	0	0
"ABCC2"	5083	69201	0	0	0	0	0	0	11	0	0	0	3	25	26	19	12	12
"ABCC3"	5196	56846	10751	3354	5959	4792	1803	1551	4751	1701	13396	4172	2357	2049	7170	5411	8044	4869
"ABCC4"	5873	281605	1023	738	607	416	433	305	940	1126	120	409	802	1050	597	525	894	588
"ABCC5"	5871	98003	1639	412	936	703	197	215	1034	295	657	467	862	1092	1733	1720	1853	1037
"ABCC6"	5147	73907	99	33	42	57	33	0	145	95	0	0	156	40	0	0	0	0
"ABCC6P1"	2849	27037	0	0	0	0	0	0	0	0	0	0	0	0	0	0	0	0
"ABCC8"	5016	84018	0	0	0	0	0	0	255	91	0	0	0	0	0	0	0	0
"ABCC9"	8360	139304	0	0	0	0	0	0	0	0	0	0	0	0	0	0	0	0
"ABCD1"	3674	19895	1836	307	1004	832	204	103	1011	350	1235	464	1169	1274	2331	1610	2731	1778
"ABCD2"	5351	68823	0	0	0	0	0	0	0	0	0	0	0	0	0	0	0	0
"ABCD3"	4377	37171	658	50	391	267	33	17	654	58	25	39	1038	1136	1019	865	1171	760
"ABCD4"	3176	17789	768	5	443	325	0	5	394	63	569	102	571	474	961	598	1090	565
"ABCE1"	4422	31521	645	2886	371	274	1627	1259	234	1253	0	833	1260	2471	2343	2603	2179	1638
"ABCF1"	3488	20135	670	1281	360	310	642	639	310	729	110	1625	2212	3429	1631	2941	2117	2541
"ABCF2"	3561	14742	79	50	21	58	50	0	131	313	25	263	936	1094	1248	985	1906	1076
"ABCF3"	2593	7934	648	160	341	307	72	88	298	150	0	221	1369	795	1473	749	2064	1063
"ABCG1"	3175	97555	5255	309	2853	2402	154	155	4010	1231	342	0	2011	1414	1720	1123	3155	1689
"ABCG2"	4446	68596	0	0	0	0	0	0	8	0	0	1	150	127	783	782	347	475
"ABCG4"	3848	13624	0	0	0	0	0	0	20	49	0	0	0	0	0	0	0	0
"ABCG5"	3106	26394	0	0	0	0	0	0	7	0	0	0	0	0	0	0	0	0
"ABCG8"	2677	39503	0	0	0	0	0	0	29	0	0	0	0	0	0	0	0	0
"ABH8"	3801	54277	69	0	49	20	0	0	69	15	0	0	244	228	236	152	240	85
"ABHD1"	1453	7023	47	0	22	25	0	0	59	12	0	0	0	1	0	0	0	0
"ABHD10"	2647	14382	477	35	273	204	18	17	360	32	99	0	1918	1057	1194	540	1646	726
"ABHD11"	1479	2765	17	0	0	17	0	0	91	0	35	0	179	284	287	179	377	164
"ABHD12"	1979	90629	13220	1642	7310	5910	821	821	5206	1102	5848	686	4475	3985	5727	4245	7026	4986
"ABHD12B"	1720	32811	1	0	0	1	0	0	87	0	0	0	0	0	1	0	0	0
"ABHD13"	5303	15841	1345	466	736	609	245	221	739	317	233	205	836	1467	827	790	934	804
"ABHD14A"	1143	3983	0	0	0	0	0	0	26	0	0	0	134	82	129	139	82	113
"ABHD14B"	2440	6121	62	0	47	15	0	0	103	25	0	0	1014	777	991	872	1286	893
"ABHD15"	2741	5739	395	75	270	125	55	20	240	36	576	0	1704	1230	1755	236	1972	958
"ABHD2"	9148	114212	11180	1388	6233	4947	765	623	4465	496	5381	683	10045	9148	14386	12718	11251	8442
"ABHD3"	2073	53910	2847	709	1577	1270	413	296	1660	571	1424	766	1529	1570	1466	1409	1596	632
"ABHD4"	2508	14112	137	0	69	68	0	0	100	12	12	0	1410	954	1318	1128	1541	1417
"ABHD5"	5359	31843	44	40	44	0	16	24	124	23	24	42	498	534	670	587	681	520
"ABHD6"	2466	57202	1314	19	679	635	6	13	903	0	327	0	577	543	1062	934	902	777
"ABHD8"	2094	11343	91	4	48	43	2	2	22	1	35	5	390	304	677	424	553	505
"ABI1"	3678	114434	12131	20588	6801	5330	10894	9694	4751	18233	3240	54283	1925	2544	4573	2483	5240	4174
"ABI2"	6604	103890	1069	94	601	468	74	20	959	131	124	30	810	707	930	551	1152	715
"ABI2B"	6599	103890	1069	94	601	468	74	20	959	131	124	30	810	707	930	551	1152	715
"ABI3"	2117	13000	537	199	271	266	37	162	92	108	129	2226	77	813	660	950	142	106
"ABI3BP"	4616	97111	174	147	112	62	75	72	186	523	42	65	0	0	0	0	0	0
"ABIN-3"	2420	85218	0	1392	0	0	757	635	0	493	0	475	0	1304	0	384	0	116
"ABL1"	5890	173794	6288	1514	3561	2727	849	665	3749	1811	2262	2498	1564	1266	1932	1671	2502	1558
"ABL2"	12238	130358	43396	49981	24379	19017	32165	17816	15332	14822	30068	66559	8936	25812	7853	32098	9508	14913
"ABLIM1"	7715	253546	12	0	2	10	0	0	15	0	0	0	123	180	107	178	38	6
"ABLIM2"	3781	193523	0	1	0	0	0	1	801	394	0	5	0	0	0	0	0	0
"ABLIM3"	4589	118824	0	0	0	0	0	0	38	10	0	0	0	0	0	3	0	0
"ABO"	1585	20069	25	0	16	9	0	0	196	77	70	0	6	87	24	0	41	20
"ABP1"	6562	32312	0	0	0	0	0	0	12	11	0	0	53	21	110	81	160	135
"ABR"	5625	183858	63285	65980	33670	29615	35124	30856	19265	48828	56667	90418	10754	5518	6554	12299	8195	4740
"ABRA"	2755	10762	0	0	0	0	0	0	0	0	0	0	0	0	0	0	0	0
"ABT1"	2255	3097	48	16	35	13	16	0	55	25	0	0	517	443	693	437	851	535
"ABTB1"	2082	6811	433	13	261	172	7	6	173	105	476	257	562	522	829	722	1045	715
"ABTB2"	4166	206269	543	16316	295	248	8848	7468	268	9508	0	19234	36	287	49	21	74	13
"ACAA1"	1830	14533	860	144	490	370	57	87	390	142	273	77	1387	945	1381	1137	2162	1073
"ACAA2"	1943	30378	96	0	43	53	0	0	52	20	0	0	1328	836	2085	1910	2182	1403
"ACACA"	10722	324976	3809	1851	2096	1713	1051	800	2627	1542	461	924	1718	1269	1795	1771	2106	1514
"ACACB"	9410	151630	611	220	281	330	124	96	685	217	322	539	647	825	648	701	824	657
"ACAD10"	4128	71055	581	149	312	269	55	94	765	244	720	193	563	505	700	565	969	554
"ACAD11"	3574	101993	277	170	175	102	85	85	458	84	197	121	380	491	384	267	643	387
"ACAD8"	2210	12312	219	4	146	73	0	4	124	9	0	0	303	327	515	285	700	334
"ACAD9"	2635	33492	1085	229	683	402	108	121	788	341	331	325	728	677	847	827	1025	761
"ACADL"	2499	37499	0	0	0	0	0	0	0	0	0	0	0	0	0	0	0	0
"ACADM"	2713	39312	477	30	231	246	16	14	336	36	44	31	1852	1747	1982	1729	1551	1195
"ACADS"	1926	14241	2	0	0	2	0	0	51	10	0	0	357	242	536	406	497	333
"ACADSB"	5951	49378	0	0	0	0	0	0	84	0	0	0	395	441	219	208	319	194
"ACADVL"	2307	5433	1663	832	934	729	405	427	637	440	1111	697	3254	3447	6027	5027	6066	3389
"ACAN"	8858	71913	0	0	0	0	0	0	87	51	0	0	0	0	0	0	0	0
"ACAP1"	2530	14947	1159	686	648	511	371	315	446	307	450	617	1402	1381	776	668	1402	879
"ACAP2"	7183	168344	15509	3939	8659	6850	2285	1654	7031	1562	5435	2586	4474	5026	4093	3136	2242	2763
"ACAP3"	5347	13547	1632	642	950	682	264	378	695	536	1381	1062	745	856	1779	1452	2359	1353
"ACAT1"	2308	22406	256	75	164	92	45	30	264	27	68	34	394	290	530	888	564	756
"ACAT2"	2040	21050	551	5546	328	223	2958	2588	166	2702	0	24966	1641	3790	1589	2656	1632	1890
"ACBD3"	3571	42043	965	566	570	395	336	230	638	315	91	949	1004	973	1253	1070	1285	849
"ACBD4"	2249	8529	103	26	51	52	11	15	114	81	39	0	85	56	98	69	230	91
"ACBD5"	3997	45666	432	0	245	187	0	0	228	0	0	26	831	812	1087	872	1065	768
"ACBD6"	1623	214671	1093	510	705	388	295	215	899	462	0	124	222	326	346	341	436	322
"ACBD7"	3373	13302	4	0	3	1	0	0	0	11	0	0	0	0	0	0	0	0
"ACCN1"	3450	279900	225	209	134	91	103	106	309	90	0	128	454	478	238	258	288	153
"ACCN2"	3927	25908	1	0	0	1	0	0	85	74	0	0	0	0	0	0	0	0
"ACCN3"	2099	4240	0	0	0	0	0	0	111	66	0	0	5	1	19	17	45	22
"ACCN4"	3157	19704	1	0	1	0	0	0	212	114	0	0	0	0	0	0	0	0
"ACCN5"	1702	36546	0	0	0	0	0	0	0	0	0	0	0	0	0	0	0	0
"ACCS"	2188	17759	923	323	511	412	207	116	507	302	151	39	188	141	422	243	585	245
"ACCSL"	1881	11998	0	0	0	0	0	0	0	0	0	0	0	0	0	0	0	0
"ACD"	2077	3304	7	0	0	7	0	0	44	63	0	124	272	296	315	351	396	345
"ACE"	4894	37028	9010	2791	4869	4141	1513	1278	3833	918	6371	1325	12259	9890	19001	13675	23262	10931
"ACE2"	3526	41038	0	0	0	0	0	0	0	0	0	0	0	0	0	0	0	0
"ACER1"	1094	27132	0	0	0	0	0	0	29	25	0	0	0	0	0	0	0	0
"ACER2"	2995	43577	18	0	9	9	0	0	99	10	0	0	67	79	62	15	27	6
"ACER3"	4398	162935	6760	2781	3775	2985	1557	1224	3486	1792	733	1367	2110	2484	1477	1357	2034	1222
"ACHE"	2964	5927	0	4	0	0	4	0	77	109	0	18	0	54	0	141	0	30
"ACID2"	1474	9988	933	1643	843	90	706	937	591	621	252	542	638	84	1581	1491	1926	1448
"ACIN1"	4954	37049	8844	3580	4801	4043	1896	1684	3311	1288	6577	2903	6268	8418	8192	5564	10720	5650
"ACLY"	4384	52093	2505	937	1336	1169	552	385	1263	684	877	1250	2729	2664	3752	3197	4915	3087
"ACMSD"	1315	63416	10	0	10	0	0	0	22	0	0	1	2	34	8	11	0	2
"ACN9"	2057	65170	18	0	10	8	0	0	51	0	0	0	143	143	113	101	168	100
"ACO1"	3813	66231	1587	3793	919	668	1984	1809	759	5515	53	650	849	1956	1003	1442	1128	838
"ACO2"	2833	59865	4171	3307	2398	1773	1948	1359	1791	2151	2805	6210	1024	3866	5528	5683	7461	5500
"ACOT1"	1607	38431	42	0	15	27	0	0	36	0	0	0	291	328	972	666	1021	730
"ACOT11"	3098	62101	221	13	117	104	6	7	826	137	27	0	153	106	152	135	206	164
"ACOT12"	2003	64042	0	0	0	0	0	0	0	0	0	0	0	0	0	0	0	0
"ACOT13"	4395	38032	2529	982	1461	1068	132	850	1262	559	949	280	291	8388	584	590	6340	4608
"ACOT2"	1768	6587	42	0	15	27	0	0	27	0	0	0	291	328	904	626	904	632
"ACOT4"	1633	4060	0	0	0	0	0	0	0	0	0	0	0	0	46	24	0	8
"ACOT6"	1004	3044	0	0	0	0	0	0	0	0	0	0	0	0	0	0	0	0
"ACOT7"	1813	129495	3186	357	1749	1437	195	162	2817	1054	1917	902	1477	1382	2047	1645	2767	2881
"ACOT7L"	1616	14284	8	0	5	3	0	0	87	0	0	0	279	269	10	16	4	6
"ACOT8"	1163	15676	386	22	213	173	10	12	251	11	104	0	249	101	395	326	528	305
"ACOT9"	1742	39631	1873	1953	996	877	1124	829	529	906	640	3350	1380	2505	1374	1325	1411	981
"ACOX1"	7689	37857	1392	1128	754	638	639	489	587	699	300	1996	1574	2353	1725	1951	1990	1458
"ACOX2"	2323	32067	41	0	29	12	0	0	371	9	20	0	5	1	49	44	27	23
"ACOX3"	2944	62200	5081	23183	2807	2274	12129	11054	1337	11613	648	17109	688	1433	616	1143	761	440
"ACOXL"	2733	361773	0	0	0	0	0	0	54	10	0	0	0	0	0	0	0	3
"ACP1"	1585	13413	386	118	211	175	80	38	275	178	0	215	1024	1053	1263	972	1552	899
"ACP2"	2522	9605	553	194	307	246	96	98	291	235	66	218	1368	1592	1061	2519	2186	663
"ACP5"	1636	4326	1323	569	721	602	300	269	348	194	663	0	19042	13130	27619	36607	36414	30636
"ACP6"	3626	20690	19	0	7	12	0	0	64	0	9	0	86	65	28	19	51	24
"ACPL2"	3188	62805	524	144	385	139	110	34	614	601	133	425	466	558	351	307	705	433
"ACPP"	3229	41481	631	33	304	327	30	3	433	8	63	18	553	825	540	342	529	287
"ACPT"	1358	4811	0	0	0	0	0	0	54	37	0	0	0	0	0	0	0	0
"ACR"	1374	7076	0	0	0	0	0	0	69	42	0	0	0	0	0	0	0	0
"ACR1"	742	3122	1	0	0	1	0	0	68	59	0	0	597	574	982	648	871	656
"ACRBP"	1896	9340	0	0	0	0	0	0	59	11	0	0	18	40	25	13	51	4
"ACRC"	3191	35561	54	105	45	9	74	31	59	134	0	67	4	57	11	25	10	8
"ACRV1"	1327	8714	0	0	0	0	0	0	0	0	0	0	0	0	0	0	0	0
"ACSBG1"	2842	63712	10	0	9	1	0	0	144	59	0	0	1	0	0	0	0	0
"ACSBG2"	2761	57429	0	0	0	0	0	0	57	0	0	0	0	0	0	0	0	0
"ACSF2"	2331	48683	3864	296	2217	1647	179	117	2102	242	4838	178	1881	1364	2070	1098	3226	1883
"ACSF3"	3636	61917	2307	463	1299	1008	222	241	1636	625	1127	781	738	679	656	584	831	561
"ACSL1"	3976	52858	4433	35325	2435	1998	22148	13177	1160	23741	550	45407	2932	8104	3596	15978	3476	7301
"ACSL3"	4377	82388	16659	36833	9264	7395	19781	17052	6844	16644	2908	9510	8585	9678	7068	5143	11263	7055
"ACSL4"	5352	92059	5527	7363	3106	2421	4004	3359	2646	4419	384	2655	5637	6747	5306	4721	5369	3561
"ACSL5"	3401	53116	1423	5046	734	689	2806	2240	719	2717	307	8141	1752	2477	1897	2474	2436	2154
"ACSL6"	3153	187133	178	85	142	36	40	45	161	19	33	40	58	48	57	38	22	20
"ACSM1"	2157	74509	3172	5951	1915	1257	3191	2760	377	1000	568	5905	146	344	3	6	15	4
"ACSM2A"	3273	36132	0	0	0	0	0	0	0	0	0	0	0	0	0	0	0	0
"ACSM2B"	2455	39613	0	0	0	0	0	0	0	0	0	0	0	0	0	0	0	0
"ACSM3"	2146	33168	125	282	67	58	143	139	31	14	0	154	337	458	312	102	398	159
"ACSM4"	1756	24043	0	0	0	0	0	0	0	0	0	0	0	0	0	0	0	0
"ACSM5"	2430	31424	25	0	7	18	0	0	5	8	0	0	93	36	418	330	123	88
"ACSS1"	4889	26436	611	44	358	253	24	20	727	150	132	37	612	579	871	795	1125	857
"ACSS2"	3037	51443	5204	1419	2945	2259	842	577	2399	1135	3530	1710	2433	2369	2344	1737	3308	2137
"ACSS3"	3049	177775	0	0	0	0	0	0	0	0	0	0	0	0	0	0	0	0
"ACTA1"	1497	2850	0	0	0	0	0	0	0	12	0	0	0	0	0	0	0	0
"ACTA2"	1766	56317	161	41	95	66	41	0	309	37	0	0	251	155	483	401	320	274
"ACTB"	1856	3451	14610	13547	8138	6472	7184	6363	3236	7321	7491	21408	421	447	26052	29997	316643	38937
"ACTBL2"	2794	2794	0	0	0	0	0	0	0	0	0	0	0	0	0	0	0	0
"ACTBL3"	3413	46494	0	0	0	0	0	0	0	0	0	0	0	0	0	0	0	0
"ACTC1"	3700	7632	0	0	0	0	0	0	0	0	0	0	0	0	0	0	0	0
"ACTG1"	2045	2250	15803	16127	8143	7660	8558	7569	3939	8877	8775	23868	75395	79560	30185	106961	322561	43324
"ACTG2"	1903	26688	8	0	8	0	0	0	0	0	0	0	0	0	0	0	0	0
"ACTL6A"	1915	25482	301	14	207	94	14	0	173	0	0	0	954	967	967	766	669	711
"ACTL6B"	1543	13358	0	0	0	0	0	0	206	0	0	0	0	0	0	0	0	0
"ACTL7A"	1434	1434	0	13	0	0	13	0	23	14	0	0	0	0	0	0	0	0
"ACTL7B"	1406	1406	0	0	0	0	0	0	0	0	0	0	0	0	0	0	0	0
"ACTL8"	1862	71750	0	0	0	0	0	0	126	9	0	0	0	0	0	0	0	0
"ACTL9"	1423	1423	0	0	0	0	0	0	0	0	0	0	0	0	0	0	0	0
"ACTN1"	4878	14141	27075	39955	14687	12388	21416	18539	9531	23099	21793	43691	10669	12312	13445	15704	20930	14738
"ACTN2"	4748	77790	0	0	0	0	0	0	42	0	0	0	0	0	0	0	0	0
"ACTN3"	3105	16933	0	0	0	0	0	0	132	24	0	0	1	0	0	0	0	0
"ACTN4"	3914	82845	7239	1730	3927	3312	994	736	3013	2032	4877	4148	5793	5501	5426	4827	8983	5672
"ACTR10"	2453	35520	512	174	297	215	132	42	305	129	203	150	876	1058	1094	930	1190	918
"ACTR1A"	2883	23527	1153	680	622	531	381	299	688	655	226	995	2677	763	1667	1417	4680	1262
"ACTR1B"	2269	8161	931	469	494	437	250	219	434	301	918	614	2171	1069	2302	1583	3550	1678
"ACTR2"	3942	43558	9576	8950	5416	4160	4911	4039	3281	3596	3492	7349	26347	29829	28048	26113	33236	20708
"ACTR3"	2724	68632	27477	64939	15241	12236	35279	29660	7691	23662	7458	37714	12827	19870	13006	16229	16118	14597
"ACTR3B"	2598	68632	28917	65060	16090	12827	35321	29739	8876	23837	8059	38036	13018	19997	13214	16367	16415	14774
"ACTR5"	2488	23994	194	0	129	65	0	0	129	21	0	0	286	195	166	94	318	128
"ACTR6"	1887	23609	71	0	50	21	0	0	62	0	10	0	318	484	367	302	437	332
"ACTR8"	3537	15033	402	80	232	170	48	32	155	116	24	214	258	510	973	416	962	694
"ACTRT1"	1441	1441	0	0	0	0	0	0	0	0	0	0	0	0	0	0	0	0
"ACTRT2"	1421	1421	0	0	0	0	0	0	14	0	0	0	0	0	0	0	0	0
"ACVR1"	3056	138667	2551	633	1361	1190	391	242	1810	446	367	356	533	718	585	898	916	920
"ACVR1B"	4658	45375	179	0	138	41	0	0	197	23	0	25	495	348	530	244	581	270
"ACVR1C"	8884	102121	0	0	0	0	0	0	0	0	0	0	0	0	0	0	0	0
"ACVR2A"	5372	86308	9981	59995	5573	4408	32457	27538	2535	25085	955	38124	615	4606	366	2900	454	1864
"ACVR2B"	11463	38843	328	64	188	140	30	34	352	40	83	22	434	328	528	66	442	94
"ACVRL1"	4272	15944	0	0	0	0	0	0	85	22	0	0	4	0	89	76	30	33
"ACY1"	1895	14177	0	0	0	0	0	0	136	20	7	20	497	348	610	567	577	495
"ACY3"	1307	8105	0	0	0	0	0	0	10	12	0	0	6	2	0	0	0	0
"ACYP1"	688	10808	130	0	74	56	0	0	123	0	0	0	185	96	153	81	212	90
"ACYP2"	1224	190025	598	432	394	204	207	225	429	246	53	182	10	82	15	61	73	8
"ADA"	1543	32214	8	215	8	0	123	92	54	815	0	69	77	268	53	700	75	106
"ADAD1"	2028	50827	0	0	0	0	0	0	0	0	0	0	0	0	0	0	0	0
"ADAD2"	2315	6051	1	13	0	1	13	0	0	48	0	0	1	0	0	0	0	0
"ADAL"	3524	23224	0	0	0	0	0	0	14	0	0	0	37	182	40	33	44	20
"ADAM10"	3943	153669	5987	829	3446	2541	429	400	3509	361	972	512	3948	4563	5998	3265	6156	4408
"ADAM11"	4427	22646	0	0	0	0	0	0	105	84	0	0	24	19	0	0	0	0
"ADAM12"	6112	374227	2652	1055	1521	1131	570	485	1094	206	1146	300	281	285	754	528	319	217
"ADAM15"	4531	11832	3067	796	1598	1469	430	366	1504	582	4346	1595	7389	6378	5601	3805	14506	8557
"ADAM17"	3570	66506	6809	13722	3873	2936	7522	6200	2675	4984	2226	11065	2533	3919	3304	4692	3250	2728
"ADAM18"	2266	145345	0	0	0	0	0	0	0	0	0	0	0	0	0	0	0	0
"ADAM19"	6488	98457	8643	14761	4972	3671	8063	6698	3212	7052	1065	14854	4369	11950	3809	3497	5521	2346
"ADAM2"	2662	94525	0	0	0	0	0	0	0	0	0	0	0	0	0	0	0	0
"ADAM20"	2793	12655	0	0	0	0	0	0	49	0	0	0	0	0	0	0	0	0
"ADAM21"	2406	2406	0	0	0	0	0	0	0	0	0	0	0	0	0	0	0	0
"ADAM21P"	2049	2049	0	0	0	0	0	0	0	0	0	0	0	0	0	0	0	0
"ADAM22"	3472	262747	0	0	0	0	0	0	9	8	0	0	1	0	0	0	0	0
"ADAM23"	3074	174311	239	310	162	77	178	132	159	85	20	41	485	666	257	292	64	8
"ADAM28"	3308	61147	9	1367	0	9	765	602	0	868	0	264	14	45	11	32	4	4
"ADAM29"	3329	59823	0	0	0	0	0	0	0	0	0	0	0	0	0	0	0	0
"ADAM30"	2958	2958	0	0	0	0	0	0	0	0	0	0	0	0	0	0	0	0
"ADAM32"	2751	177387	0	0	0	0	0	0	7	0	0	0	0	0	0	1	0	0
"ADAM33"	3540	14122	0	3	0	0	3	0	103	57	0	0	0	0	0	0	0	0
"ADAM6"	1844	2541	0	0	0	0	0	0	0	0	0	0	0	0	0	0	0	0
"ADAM7"	2614	67766	0	0	0	0	0	0	0	0	0	0	0	0	0	0	0	0
"ADAM8"	3288	14453	771	1489	403	368	736	753	343	1051	406	3296	641	1100	859	1352	969	1409
"ADAM9"	4118	108274	4456	3899	2596	1860	2137	1762	2341	2358	861	1688	6322	7212	6994	7865	7066	4831
"ADAMDEC1"	2453	21730	0	273	0	0	141	132	0	133	0	46	0	84	0	48	0	0
"ADAMTS1"	4658	9122	0	0	0	0	0	0	0	0	0	0	0	0	0	0	0	0
"ADAMTS10"	4263	30464	3	0	0	3	0	0	128	66	1	0	2	2	0	17	9	3
"ADAMTS12"	4978	364839	0	0	0	0	0	0	51	0	2	0	0	0	0	0	0	0
"ADAMTS13"	4962	37389	1	0	1	0	0	0	141	182	0	0	1	0	0	0	0	0
"ADAMTS14"	5287	89636	31	44	31	0	29	15	513	366	0	171	0	145	4	47	19	4
"ADAMTS15"	2860	24848	0	0	0	0	0	0	27	0	0	0	0	0	29	4	0	0
"ADAMTS16"	4996	179970	0	0	0	0	0	0	65	39	0	0	0	0	0	0	0	0
"ADAMTS17"	6353	370542	0	0	0	0	0	0	270	65	0	0	0	0	0	0	0	0
"ADAMTS18"	5935	152987	1	0	1	0	0	0	0	0	0	0	0	0	0	0	0	0
"ADAMTS19"	5112	278275	0	0	0	0	0	0	0	0	0	0	0	0	0	0	0	0
"ADAMTS2"	3675	231480	0	0	0	0	0	0	748	344	0	0	0	0	0	0	0	0
"ADAMTS20"	5771	197713	0	0	0	0	0	0	0	0	0	0	0	0	0	0	0	0
"ADAMTS3"	5843	287831	0	0	0	0	0	0	0	0	0	0	0	0	0	0	0	0
"ADAMTS4"	4340	9308	0	0	0	0	0	0	62	29	0	0	1	1	0	0	0	0
"ADAMTS5"	9670	49209	0	0	0	0	0	0	0	10	0	0	22	41	8	103	10	0
"ADAMTS6"	7444	333142	0	0	0	0	0	0	0	0	0	0	0	0	0	0	0	0
"ADAMTS7"	5513	52229	0	0	0	0	0	0	279	98	0	0	0	0	0	0	0	0
"ADAMTS8"	3670	23721	0	0	0	0	0	0	28	11	0	0	0	0	0	0	0	0
"ADAMTS9"	7350	172034	0	0	0	0	0	0	0	0	0	0	0	0	0	0	0	0
"ADAMTSL1"	7844	436843	0	0	0	0	0	0	0	0	0	0	0	0	0	0	0	0
"ADAMTSL2"	4086	43356	0	0	0	0	0	0	240	236	0	0	0	0	0	0	0	0
"ADAMTSL3"	7363	385755	0	0	0	0	0	0	0	0	0	0	0	0	0	0	0	0
"ADAMTSL4"	4218	11514	9217	13374	5134	4083	9846	3528	3646	8900	9867	15163	8150	8760	13021	10783	20495	11898
"ADAMTSL5"	2869	8173	0	0	0	0	0	0	36	39	0	0	0	0	0	0	0	0
"ADAP1"	2359	77699	5364	7681	2851	2513	3962	3719	2179	7416	3014	8976	2243	2631	2506	2133	1788	1244
"ADAP2"	2776	37457	1975	330	1105	870	135	195	981	166	881	261	1685	1641	1331	951	1826	1020
"ADAR"	6642	26148	6454	7181	3540	2914	3799	3382	2511	4018	2151	6085	12220	15792	15550	11861	15673	4339
"ADAR2g"	4014	151987	21	6	11	10	6	0	361	104	9	33	168	157	201	258	209	196
"ADARB1"	7039	151987	21	6	11	10	6	0	361	104	9	33	168	157	201	258	209	196
"ADARB2"	3663	551646	16	0	0	16	0	0	1061	198	0	0	8	0	0	0	0	0
"ADAT1"	2796	24158	451	90	280	171	31	59	224	49	27	35	320	320	513	430	631	355
"ADAT2"	6258	27873	18	7	14	4	0	7	85	90	0	30	181	219	164	119	247	169
"ADAT3"	1623	8072	224	39	109	115	25	14	109	67	109	117	76	46	132	90	164	103
"ADC"	5855	38873	0	0	0	0	0	0	100	33	0	0	0	0	0	9	11	0
"ADCK1"	2505	10723	1543	636	842	701	320	316	1229	598	251	448	383	415	484	413	876	556
"ADCK2"	2372	21957	163	28	88	75	18	10	78	37	122	0	805	831	1437	1039	1467	965
"ADCK4"	2458	25358	409	15	213	196	0	15	438	150	130	0	182	309	344	258	487	294
"ADCK5"	1974	20722	317	51	146	171	18	33	330	144	269	45	173	466	143	202	209	178
"ADCY1"	12516	148589	0	0	0	0	0	0	246	49	0	0	0	0	117	68	8	0
"ADCY10"	5278	104617	0	0	0	0	0	0	0	0	0	0	0	0	0	0	0	0
"ADCY2"	6578	433853	0	2	0	0	0	2	31	0	0	0	0	0	0	0	0	0
"ADCY3"	4418	100016	921	333	529	392	163	170	926	280	426	271	1398	1567	2160	1185	2347	1811
"ADCY4"	3437	16384	23	8	23	0	0	8	237	57	0	0	19	12	79	68	99	84
"ADCY5"	3863	163995	0	0	0	0	0	0	407	117	0	0	0	0	0	0	0	0
"ADCY6"	6586	17903	4	0	0	4	0	0	102	33	0	0	0	7	21	16	42	13
"ADCY7"	6163	30222	33722	29030	18504	15218	15769	13261	10131	14458	29525	12810	18819	22647	25115	18607	33290	16616
"ADCY8"	4118	260289	0	0	0	0	0	0	36	0	0	0	0	0	0	0	0	0
"ADCY9"	7735	153535	3209	1219	1767	1442	576	643	1866	657	1051	743	983	1688	1081	1622	1306	1269
"ADCYAP1"	3190	7229	0	0	0	0	0	0	0	0	0	0	0	0	0	0	0	0
"ADCYAP1R1"	1659	54171	0	0	0	0	0	0	184	134	0	0	0	0	0	0	0	0
"ADD1"	5294	15523	6377	5501	3658	2719	2947	2554	2956	1946	3490	21542	4852	4721	5388	4286	6759	4451
"ADD2"	4041	106066	162	20	71	91	10	10	85	11	0	0	189	195	290	148	347	182
"ADD3"	4456	127611	4233	420	2521	1712	234	186	3048	285	1386	349	1660	2364	2752	2247	3535	2037
"ADFP"	832	7927	0	0	0	0	0	0	10	10	0	0	225	190	911	1263	815	989
"ADH1A"	1478	45050	0	0	0	0	0	0	0	0	0	0	0	0	0	0	0	0
"ADH1B"	4718	15046	0	0	0	0	0	0	0	0	0	0	0	0	0	0	0	0
"ADH1C"	1478	16268	0	0	0	0	0	0	0	0	0	0	0	0	0	0	0	0
"ADH4"	2134	20615	0	0	0	0	0	0	0	0	0	0	0	0	0	0	0	0
"ADH5"	2650	17801	59	34	26	33	16	18	162	0	0	0	431	278	1134	945	1098	979
"ADH6"	2812	16610	0	0	0	0	0	0	0	0	0	0	0	0	0	0	0	0
"ADH7"	2156	23109	0	0	0	0	0	0	0	0	0	0	0	0	0	0	0	0
"ADHFE1"	1907	36326	572	161	283	289	111	50	499	172	24	41	201	280	352	253	278	178
"ADI1"	1679	21661	349	221	214	135	114	107	341	298	64	172	1842	685	1838	1225	676	2265
"ADIG"	773	7268	0	0	0	0	0	0	0	0	0	0	0	0	0	0	0	0
"ADIPOQ"	4631	15789	0	0	0	0	0	0	0	0	0	0	0	0	0	0	0	0
"ADIPOR1"	2141	17524	611	139	338	273	90	49	405	95	210	199	4347	3566	4139	3392	4861	1993
"ADIPOR2"	3980	97585	5572	11529	3277	2295	6295	5234	2097	5824	1081	10017	3059	3700	2818	2745	3449	2456
"ADIR"	1859	14017	1143	2710	348	795	672	2038	304	77	970	29402	1607	3277	2003	3929	2828	4270
"ADK"	2092	532617	37598	31244	21256	16342	17067	14177	16398	12457	15122	27422	1325	1960	2200	1633	1326	1317
"ADM"	1913	2294	0	0	0	0	0	0	41	53	0	34	31	219	78	959	64	489
"ADM2"	4246	4854	0	0	0	0	0	0	0	30	0	0	25	38	0	0	4	3
"ADNP"	4718	40646	7593	6005	4245	3348	3184	2821	3631	2712	4471	4835	129	203	120	97	114	75
"ADNP2"	5389	31313	657	961	411	246	553	408	366	980	163	1044	823	1183	921	1154	1004	746
"ADO"	3724	3724	30931	7267	21342	9589	3894	3373	3417	2621	17021	22285	4860	3904	4456	3102	4635	2722
"ADORA1"	2923	39699	0	0	0	0	0	0	150	25	0	0	17	8	0	0	30	0
"ADORA2A"	2874	24617	41	223	17	24	175	48	99	634	0	318	29	398	45	844	45	34
"ADORA2B"	1887	30981	44	132	33	11	95	37	326	494	0	93	219	206	186	360	337	234
"ADORA3"	2245	4692	86	0	29	57	0	0	115	0	0	0	1755	871	1189	303	1722	542
"ADPGK"	2777	32418	8824	3185	2895	5929	1739	1446	5500	3175	9766	7126	951	1048	5080	4471	5627	7941
"ADPRH"	3443	10270	171	712	99	72	359	353	79	489	0	392	1262	2041	1280	1554	1319	944
"ADPRHL1"	2036	31581	6	0	0	6	0	0	94	67	0	0	10	15	5	3	0	11
"ADPRHL2"	1696	5081	259	64	146	113	20	44	113	93	6	54	1002	784	950	744	1618	777
"ADRA1A"	2307	117257	0	0	0	0	0	0	0	0	0	0	0	0	0	0	0	0
"ADRA1B"	2256	56279	0	0	0	0	0	0	26	19	0	0	0	0	0	0	0	0
"ADRA1D"	2668	28383	0	0	0	0	0	0	50	10	0	0	0	0	0	0	0	0
"ADRA2A"	3872	3872	0	0	0	0	0	0	0	0	0	0	0	0	0	0	0	0
"ADRA2B"	3262	3264	0	310	0	0	144	166	0	185	0	37	11	54	56	54	69	75
"ADRA2C"	1957	1957	0	0	0	0	0	0	0	0	0	0	0	0	0	0	0	0
"ADRB1"	2861	2861	0	0	0	0	0	0	0	0	0	0	0	0	0	0	0	0
"ADRB2"	2034	2034	43	0	14	29	0	0	25	0	0	103	52	27	73	0	42	0
"ADRB3"	2646	3670	0	0	0	0	0	0	11	0	0	0	11	0	0	0	0	0
"ADRBK1"	3465	20126	5377	933	2909	2468	525	408	2272	554	6625	1287	6200	5849	8845	6979	11251	6697
"ADRBK2"	9225	164397	42175	62577	23458	18717	33748	28829	16461	29501	19623	46729	5741	8369	7665	7835	7795	5610
"ADRM1"	1413	5891	360	431	183	177	224	207	212	303	207	658	1980	1954	2315	2979	3079	2491
"ADSL"	1616	20071	190	44	118	72	18	26	157	56	115	190	374	732	729	832	981	774
"ADSS"	2769	43618	1364	191	719	645	85	106	1222	189	194	51	899	677	876	1017	1374	907
"ADSSL1"	1823	17419	0	0	0	0	0	0	343	99	0	28	0	5	12	16	13	0
"AEBP1"	4101	10200	0	0	0	0	0	0	77	36	0	0	1	1	0	0	0	0
"AEBP2"	5668	82567	2597	4216	1460	1137	2191	2025	1218	3156	256	4248	647	1329	593	876	783	715
"AEN"	3120	10987	135	433	51	84	254	179	143	311	15	306	344	618	497	765	433	467
"AER61"	4194	38407	176	14	90	86	0	14	232	52	22	5	526	580	662	499	634	413
"AES"	1754	9984	1580	695	868	712	325	370	723	461	882	381	8826	8006	8929	7282	16654	11378
"AF007131"	1973	25658	0	0	0	0	0	0	0	0	0	0	3	0	0	0	0	0
"AF007147"	2875	2875	519	262	321	198	162	100	494	136	69	105	0	0	0	0	0	0
"AF035281"	3109	3109	122	0	46	76	0	0	54	28	0	0	94	38	271	105	366	143
"AF047486"	993	1405	0	0	0	0	0	0	0	0	0	0	0	0	0	0	0	0
"AF055024"	1835	1868	207	180	107	100	89	91	112	88	117	151	508	791	392	566	906	328
"AF064843"	1647	1647	23	5	14	9	0	5	17	4	0	24	13	27	204	144	111	46
"AF070581"	4938	4938	0	0	0	0	0	0	0	0	0	0	0	0	0	0	0	0
"AF075052"	1481	1481	13472	130	9621	3851	32	98	2083	8042	228	188	433	453	84	0	103	32
"AF075059"	1666	1666	246	189	155	91	108	81	111	395	85	213	609	272	498	416	659	367
"AF075112"	304	1524	0	0	0	0	0	0	18	0	0	0	0	0	0	0	0	0
"AF079515"	574	574	0	0	0	0	0	0	0	0	0	0	0	0	0	0	0	0
"AF085962"	589	761	0	0	0	0	0	0	0	0	0	0	0	0	0	0	0	0
"AF085995"	478	39674	529	170	268	261	107	63	700	162	4	46	142	81	13	20	78	15
"AF086102"	651	2974	0	0	0	0	0	0	0	0	0	0	0	0	0	0	0	0
"AF086111"	2219	2219	0	0	0	0	0	0	0	0	0	0	0	0	0	0	0	0
"AF086125"	435	12016	0	0	0	0	0	0	43	23	0	0	0	0	0	0	0	0
"AF086132"	545	545	34	0	0	34	0	0	0	8	0	0	521	410	181	110	248	176
"AF086142"	1673	1673	61	25	35	26	0	25	14	0	0	18	52	86	19	13	22	0
"AF086154"	634	6565	0	0	0	0	0	0	46	0	0	0	0	0	0	0	0	0
"AF086184"	710	62428	16	0	16	0	0	0	46	26	0	31	56	44	50	59	56	45
"AF086187"	993	35386	0	0	0	0	0	0	0	0	0	0	0	0	0	0	0	0
"AF086203"	703	280482	35	0	19	16	0	0	61	0	0	0	1140	397	1458	634	1488	594
"AF086204"	448	4727	1074	1203	563	511	620	583	180	241	310	1101	284	699	599	276	1474	1278
"AF086219"	459	30109	188	85	114	74	65	20	149	94	116	22	149	130	286	305	324	211
"AF086258"	547	7438	0	0	0	0	0	0	0	0	0	0	0	0	0	0	0	0
"AF086288"	697	206511	1	0	0	1	0	0	11	0	0	0	0	0	0	0	0	0
"AF086294"	666	3408	0	0	0	0	0	0	0	0	0	0	0	0	0	0	0	0
"AF086303"	671	621276	0	0	0	0	0	0	0	0	0	0	0	0	0	0	0	0
"AF086351"	507	3031	112	0	61	51	0	0	74	9	109	1	100	484	1350	24	0	48
"AF086463"	4366	5912	62	111	30	32	65	46	127	131	0	31	0	0	0	0	0	0
"AF086476"	268	7400	14	0	14	0	0	0	3	0	0	0	2	8	3	0	5	2
"AF086487"	757	13935	0	0	0	0	0	0	0	0	0	0	0	5	0	0	0	0
"AF088005"	593	95059	0	0	0	0	0	0	0	0	0	0	0	0	0	0	0	0
"AF088011"	661	103728	0	0	0	0	0	0	0	0	0	0	0	0	0	0	0	0
"AF088041"	3547	3547	0	1543	0	0	914	629	898	0	1328	1010	4923	4984	0	0	0	0
"AF088054"	1078	2440	76	74	76	0	48	26	70	15	0	48	46	25	53	54	67	35
"AF088076"	425	15662	0	0	0	0	0	0	0	0	0	0	0	0	0	0	0	0
"AF090102"	1457	1457	0	0	0	0	0	0	0	0	0	0	0	0	0	0	0	0
"AF090939"	2039	2039	0	0	0	0	0	0	14	0	0	0	0	0	0	0	0	0
"AF10"	3620	69987	5028	2784	2841	2187	1577	1207	2557	1418	1176	1707	834	1049	913	750	1011	637
"AF10/CALM"	5227	209162	8910	3266	4955	3955	1833	1433	4806	1814	2024	2224	1365	1683	1207	952	1272	798
"AF113016"	4136	4136	807846	772182	448004	359842	417262	354920	317374	329972	339425	438091	8033	14811	12226	18488	16658	14693
"AF116693"	1619	1619	58	28	29	29	28	0	14	29	61	0	374	638	100	256	140	147
"AF119915"	1324	1324	106	0	52	54	0	0	49	21	0	0	0	0	0	2	0	0
"AF129264"	2141	2729	0	0	0	0	0	0	32	13	0	0	0	0	0	0	0	0
"AF131817"	1433	1433	0	0	0	0	0	0	0	0	0	0	0	0	0	0	0	0
"AF131837"	1733	1733	0	0	0	0	0	0	0	0	0	0	0	0	0	0	0	0
"AF143870"	651	17964	0	0	0	0	0	0	18	0	0	0	0	0	0	0	0	0
"AF143871"	1111	2785	141	37	69	72	19	18	223	92	98	181	4089	275	1349	0	2643	1701
"AF157115"	2399	2399	28	0	0	28	0	0	145	0	0	0	286	77	177	41	377	56
"AF161365"	547	20456	0	0	0	0	0	0	27	11	0	0	0	0	4	9	0	0
"AF161426"	621	22345	0	0	0	0	0	0	15	0	0	0	0	0	3603	7425	5881	2631
"AF161442"	558	11812	0	0	0	0	0	0	93	56	0	0	0	0	0	0	0	0
"AF216583"	847	847	19	70	19	0	32	38	0	20	0	0	0	0	0	0	0	0
"AF230800"	409	89889	0	0	0	0	0	0	0	0	0	0	0	0	0	0	0	0
"AF245314"	151	253	0	0	0	0	0	0	0	0	0	0	0	0	0	0	0	0
"AF258550"	1697	1697	15	0	0	15	0	0	16	13	0	0	68	134	0	0	0	0
"AF258560"	1687	1687	589	53	361	228	32	21	343	55	106	51	679	0	0	700	1246	0
"AF268386"	4463	4463	0	0	0	0	0	0	0	0	0	0	0	0	0	0	0	0
"AF277175"	810	810	203	0	100	103	0	0	309	9	0	0	1031	981	1222	719	1404	765
"AF279775"	727	5596	0	0	0	0	0	0	0	0	0	0	0	0	0	0	0	0
"AF279780"	1774	334912	0	0	0	0	0	0	0	0	0	0	0	0	0	0	0	0
"AF279782"	1693	246257	0	0	0	0	0	0	0	11	0	0	0	0	0	0	0	0
"AF283776"	1794	1794	152	72	61	91	33	39	101	28	0	0	1208	1	200	0	226	184
"AF289551"	2373	2373	32	0	1	31	0	0	12	37	0	0	47	135	0	0	21	0
"AF290475"	528	1477	59	0	37	22	0	0	0	0	0	0	0	28	20	19	41	21
"AF301223"	1693	47082	0	0	0	0	0	0	0	0	0	0	0	0	0	0	0	0
"AF315106"	86	86	0	0	0	0	0	0	0	0	0	0	0	0	0	0	0	0
"AF321617"	1727	1727	489	183	367	122	108	75	84	61	0	84	0	0	1465	865	0	796
"AF339814"	1676	226973	0	0	0	0	0	0	0	0	0	0	0	0	0	0	0	0
"AF339817"	6078	6078	0	0	0	0	0	0	0	0	0	0	0	0	0	0	0	0
"AF355799"	499	2545	0	0	0	0	0	0	0	0	0	0	0	0	0	0	0	0
"AF379632"	1219	29801	0	0	0	0	0	0	15	0	0	0	0	0	3604	7430	5880	2696
"AF379633"	2925	21851	0	0	0	0	0	0	0	0	0	0	0	0	34	0	1245	450
"AF380582"	515	2595	0	0	0	0	0	0	0	0	0	0	0	0	471	1043	499	0
"AF387615"	138	138	0	0	0	0	0	0	0	0	0	0	0	0	0	0	0	0
"AF397448"	325	413	0	0	0	0	0	0	0	0	0	0	0	0	0	0	0	0
"AF420437"	436	1149	0	0	0	0	0	0	0	0	0	0	0	0	14	3207	66	2452
"AF452719"	1102	3216	0	0	0	0	0	0	0	0	0	0	11	0	0	0	0	0
"AF462444"	1260	1477	0	0	0	0	0	0	13	10	0	0	597	0	182	165	234	163
"AF480540"	80	80	0	0	0	0	0	0	0	0	0	0	0	0	0	0	0	0
"AF480556"	97	97	0	0	0	0	0	0	0	0	0	0	0	0	0	0	0	0
"AF508905"	636	11160	0	5	0	0	0	5	0	0	0	0	0	0	0	0	0	0
"AF508907"	403	15600	0	0	0	0	0	0	0	0	0	0	0	0	0	0	0	0
"AF510427"	605	70108	0	0	0	0	0	0	0	0	0	0	0	0	0	0	0	0
"AF520419"	1959	34384	0	0	0	0	0	0	0	0	0	0	0	1	0	0	0	0
"AF520792"	1000	1000	1668	765	1038	630	521	244	829	682	0	52	3485	3343	1774	2675	3687	2386
"AF520793"	488	488	1490	318	1139	351	318	0	330	571	0	288	3473	19	1	0	23	211
"AF548120"	138	138	0	0	0	0	0	0	0	0	0	0	0	0	0	0	0	0
"AFAP1"	7788	181215	0	0	0	0	0	0	127	157	0	0	0	0	0	0	33	7
"AFAP1L1"	4229	69966	5	0	0	5	0	0	91	11	0	0	170	153	365	416	100	127
"AFAP1L2"	4154	109933	0	0	0	0	0	0	123	13	0	0	0	0	0	0	0	0
"AFARP1"	1325	1325	20	0	20	0	0	0	0	0	0	0	0	0	0	0	0	0
"AFF1"	9400	134039	39928	12664	22492	17436	6892	5772	16939	6633	20441	6719	6763	7013	8464	6105	9417	4681
"AFF2"	13766	500055	0	0	0	0	0	0	28	0	0	0	0	0	16	10	0	0
"AFF3"	8159	595321	404	590	288	116	304	286	152	101	37	254	0	8	22	0	5	5
"AFF4"	9618	88284	8684	29815	4800	3884	16122	13693	3006	10821	2573	15966	3793	7021	5002	5966	4757	3329
"AFG3L1"	3179	24042	1984	945	1064	920	500	445	877	586	1417	1311	645	851	640	489	844	446
"AFG3L2"	2980	48088	2766	1223	1836	930	648	575	1414	674	414	1799	2293	2501	2796	2348	3584	2249
"AFM"	2011	22257	0	0	0	0	0	0	0	0	0	0	0	0	0	0	0	0
"AFMID"	1756	20386	252	41	153	99	41	0	212	81	125	35	445	388	432	278	293	257
"AFP"	2047	19561	0	0	0	0	0	0	0	0	0	0	0	0	0	0	0	0
"AFTPH"	4097	68668	9444	14128	5309	4135	7602	6526	3570	6569	2671	10763	4853	8143	4956	5698	5431	4304
"AG10"	3456	95818	5260	8924	2913	2347	4949	3975	3086	6942	2630	9261	1265	1655	8026	15615	11317	9712
"AGA"	2050	11669	70	6	43	27	6	0	51	0	0	0	469	417	431	426	558	336
"AGAP1"	4535	631380	0	0	0	0	0	0	883	221	0	0	0	0	0	0	0	0
"AGAP11"	3167	39464	30	0	22	8	0	0	0	0	0	23	14	10	1361	871	2074	820
"AGAP2"	4938	13036	202	31	90	112	6	25	205	132	18	67	464	391	445	348	773	545
"AGAP3"	3250	57699	5868	4929	3240	2628	2773	2156	2627	3950	4070	8442	1502	1901	3413	3688	4017	3596
"AGAP4"	2507	21872	0	0	0	0	0	0	0	0	0	0	0	10	546	353	770	95
"AGAP5"	3890	56240	791	47	452	339	26	21	719	96	88	204	307	286	242	115	265	74
"AGAP6"	2779	22182	182	64	99	83	44	20	146	62	140	28	146	116	240	124	245	146
"AGAP7"	2425	22165	0	0	0	0	0	0	0	0	0	0	35	37	4	6	3	4
"AGAP8"	2813	146643	0	0	0	0	0	0	0	0	0	0	0	0	555	483	690	504
"AGBL1"	3517	887043	0	0	0	0	0	0	17	0	0	0	0	0	0	0	0	0
"AGBL2"	3407	55159	0	0	0	0	0	0	0	0	0	0	0	0	0	0	0	0
"AGBL3"	3546	149269	129	10	85	44	10	0	49	10	0	19	40	47	1	0	7	0
"AGBL4"	4031	461932	0	0	0	0	0	0	36	0	0	0	0	0	0	0	0	0
"AGBL5"	3299	19000	482	174	289	193	116	58	369	189	80	64	973	1075	145	743	263	102
"AGER"	1592	3265	166	96	37	129	52	44	33	152	137	127	87	167	101	137	310	120
"AGFG1"	8746	89052	7611	5748	4167	3444	3039	2709	3873	3219	2209	5232	2609	2844	2539	2453	2780	1901
"AGFG2"	4822	29010	1301	1578	745	556	829	749	581	1412	732	5420	508	726	522	765	871	918
"AGGF1"	4477	34805	480	4	283	197	0	4	289	5	19	4	1380	1079	1653	979	1862	1025
"AGK"	2941	103133	290	48	200	90	26	22	450	95	42	187	341	334	435	353	557	331
"AGL"	7483	73536	212	15	123	89	10	5	74	9	9	35	706	925	899	709	881	544
"AGMAT"	2203	12455	0	0	0	0	0	0	0	20	0	0	0	1	0	0	3	0
"AGPAT1"	2452	9131	313	11	188	125	11	0	222	71	97	20	2078	679	712	453	1295	600
"AGPAT2"	1554	14318	288	38	119	169	31	7	336	144	55	14	1116	563	1185	1181	1439	977
"AGPAT3"	7269	40665	16332	4124	9198	7134	2309	1815	6584	4160	12039	7599	6376	6049	5629	4635	8667	5376
"AGPAT4"	7888	144052	8036	31925	4480	3556	17243	14682	2327	19753	1383	26950	443	975	1412	2975	1232	895
"AGPAT5"	5525	53143	153	11	69	84	11	0	155	59	0	0	618	656	592	439	866	578
"AGPAT6"	6323	46815	3837	3124	2140	1697	1748	1376	1822	1726	2095	3011	3260	3895	3895	3877	5587	3972
"AGPAT9"	2725	69554	8680	660	5038	3642	429	231	2527	144	2636	125	3365	3188	2299	1594	3619	2221
"AGPHD1"	2016	21239	0	0	0	0	0	0	0	0	0	0	0	0	0	0	0	0
"AGPS"	7685	151095	3574	386	2076	1498	202	184	2359	192	229	138	3282	3763	3080	2602	3224	2062
"AGR2"	989	12474	0	0	0	0	0	0	0	0	0	0	0	0	0	0	0	0
"AGR3"	757	22584	0	0	0	0	0	0	0	0	0	0	73	44	0	0	0	0
"AGRN"	7355	35991	2506	4587	1353	1153	2455	2132	935	4272	1106	6982	2665	2872	3132	3971	3847	3131
"AGRP"	768	1244	20	0	20	0	0	0	44	0	0	0	0	0	0	0	0	0
"AGT"	2584	12064	0	0	0	0	0	0	17	0	0	0	0	0	0	0	0	0
"AGT2"	1119	14962	0	0	0	0	0	0	0	0	0	0	0	0	0	0	0	0
"AGTPBP1"	4444	195491	11251	7126	6315	4936	3920	3206	6103	4148	2267	5064	2151	2617	2036	1849	1886	1398
"AGTR1"	2416	45132	0	0	0	0	0	0	0	0	0	0	0	0	0	0	0	0
"AGTR2"	2900	4267	0	0	0	0	0	0	0	0	0	0	0	0	0	0	0	0
"AGTRAP"	1285	14687	0	7	0	0	0	7	261	52	27	108	282	243	287	277	531	401
"AGXT"	1608	10375	0	0	0	0	0	0	171	89	0	0	0	0	0	0	0	0
"AGXT2"	2256	49872	0	0	0	0	0	0	0	0	0	4	3	6	0	0	0	0
"AGXT2L1"	2152	21033	0	0	0	0	0	0	0	0	0	0	0	0	0	0	0	0
"AGXT2L2"	2837	24253	5926	3132	3409	2517	1655	1477	2392	1519	4818	3664	2280	2749	4213	3397	2128	2720
"AHCTF1"	8664	92323	1801	1121	1044	757	637	484	1000	1250	202	1245	824	1096	2328	2547	2190	1693
"AHCY"	2379	31537	400	42	214	186	13	29	332	94	65	20	2699	2158	1641	3561	4036	1262
"AHCYL1"	4038	39057	1352	7570	774	578	3999	3571	670	2966	329	6075	4442	6199	4075	5369	4684	4062
"AHCYL2"	5072	205189	12419	5692	7010	5409	3016	2676	5805	2651	4479	3757	1010	1323	1331	1164	1665	1135
"AHDC1"	6465	69351	725	19	420	305	19	0	1071	442	430	0	329	118	294	48	464	79
"AHI1"	5675	213793	20	0	14	6	0	0	20	12	0	9	98	159	123	147	66	71
"AHNAK"	18819	30959	116863	73467	64744	52119	39401	34066	37198	25335	60458	36112	171601	188006	219964	172612	288209	135053
"AHNAK2"	18324	41105	0	14	0	0	14	0	380	114	0	0	0	14	0	0	0	25
"AHR"	6258	47501	20365	9075	11461	8904	5002	4073	8804	2464	7128	4121	12721	15188	15095	9509	12082	7951
"AHRR"	5669	134113	51845	41973	28389	23456	21904	20069	14196	18611	26290	32875	9144	12603	7252	7143	11247	6715
"AHSA1"	1401	11436	196	355	68	128	189	166	99	456	107	502	1614	2691	859	1574	983	995
"AHSA2"	2143	9239	2456	1183	1433	1023	517	666	1420	464	1155	745	639	606	3633	2255	4674	2268
"AHSG"	1581	8257	0	0	0	0	0	0	0	0	0	0	0	0	0	0	0	0
"AIBC1"	2426	52659	0	0	0	0	0	0	0	0	0	0	0	0	0	0	0	0
"AIBP"	1121	2533	10	0	10	0	0	0	52	0	0	0	400	413	365	337	390	530
"AICDA"	2799	10682	0	0	0	0	0	0	0	0	0	0	0	0	0	0	0	0
"AID"	2322	4848	0	0	0	0	0	0	0	0	0	0	0	0	0	0	0	0
"AIDA"	3140	45171	21	11	14	7	11	0	154	81	0	0	1004	1097	910	808	1279	465
"AIEBP"	2542	14697	6	0	4	2	0	0	58	9	0	0	1	0	0	0	0	0
"AIF1"	1492	1804	15	0	15	0	0	0	53	0	0	0	1569	1128	1955	2215	1979	1292
"AIF1L"	3473	26629	0	1	0	0	0	1	24	9	0	0	0	0	0	0	0	0
"AIFM1"	2432	36470	1017	45	558	459	16	29	603	54	113	57	1203	1764	2246	1741	2834	1669
"AIFM2"	3249	20662	118	0	49	69	0	0	214	23	114	21	193	238	571	455	434	380
"AIFM3"	2449	14204	135	15	76	59	10	5	231	70	46	28	64	81	255	241	222	152
"AIG1"	3406	129707	59	0	45	14	0	0	737	99	29	10	185	256	323	348	438	240
"AIM1"	7995	59029	4838	4250	2793	2045	2268	1982	2722	2851	1611	4623	6818	8055	6353	6065	7981	4826
"AIM1L"	2409	22095	89	0	38	51	0	0	90	8	0	0	5	0	0	0	0	0
"AIM2"	1490	14374	0	24	0	0	12	12	0	38	0	0	31	164	38	23	41	19
"AIMP1"	3150	33528	741	549	439	302	292	257	406	250	93	319	1090	1226	1129	952	1174	788
"AIMP2"	1222	14584	562	83	286	276	37	46	268	102	74	155	246	1992	3	1348	2560	1542
"AIP"	1238	8075	108	29	47	61	5	24	228	67	83	29	727	694	777	820	1440	1068
"AIPL1"	2976	11461	0	0	0	0	0	0	0	0	0	0	0	0	0	0	0	0
"AIRE"	2279	12349	11	1	4	7	0	1	37	80	0	0	4	7	0	0	0	0
"AJ011378"	525	4486	0	0	0	0	0	0	0	0	0	0	0	0	0	0	0	0
"AJ011981"	617	617	0	0	0	0	0	0	7	0	0	0	106	138	138	106	105	88
"AJ276246"	375	375	80	107	0	80	64	43	74	0	0	176	0	0	0	0	0	0
"AJ276555"	365	850	0	0	0	0	0	0	0	0	0	0	0	0	0	0	0	0
"AJ420489"	2464	2765	285	20	159	126	20	0	120	58	0	22	0	0	137	147	193	163
"AJ420566"	569	82305	187	14	130	57	14	0	421	69	44	29	13	33	0	1	8	2
"AJ420595"	1068	1068	83	0	51	32	0	0	27	17	0	0	12	61	77	0	118	0
"AJ606316"	2717	371590	0	0	0	0	0	0	0	0	0	0	0	0	0	0	0	0
"AJ606328"	1989	50667	3391	8589	2009	1382	4658	3931	866	873	258	1522	92	114	212	169	180	162
"AJ606330"	1574	48296	3191	8051	1898	1293	4375	3676	801	785	181	1282	92	114	212	169	180	162
"AJ606331"	2488	84342	35	11	21	14	0	11	0	0	0	0	2	0	24	15	11	5
"AJAP1"	2928	128747	0	0	0	0	0	0	442	175	0	0	0	0	0	0	0	0
"AK000028"	791	1104	0	0	0	0	0	0	9	0	0	0	0	0	24	3	33	0
"AK000154"	5436	5436	268	29	145	123	16	13	187	22	0	11	722	560	442	146	668	162
"AK000271"	1908	15980	1889	1875	1075	814	1030	845	657	844	374	1619	1765	2294	2299	1987	2631	1752
"AK000451"	1029	30097	0	0	0	0	0	0	0	0	0	0	4	25	1	4	4	5
"AK000470"	2184	10549	0	0	0	0	0	0	5	0	0	0	0	0	111	60	23	16
"AK000477"	1702	208483	0	0	0	0	0	0	257	50	0	0	0	0	0	0	0	0
"AK000709"	2965	4189	216	19	112	104	19	0	43	29	10	33	564	547	550	278	519	335
"AK000798"	2549	2549	0	0	0	0	0	0	0	0	0	0	0	0	0	0	0	0
"AK000807"	447	447	591	339	190	401	189	150	568	149	177	822	181	261	217	197	213	131
"AK000840"	1920	19423	0	0	0	0	0	0	0	0	0	0	0	0	0	0	0	0
"AK000872"	1923	58578	0	0	0	0	0	0	0	0	0	0	0	0	0	0	0	0
"AK000879"	2734	5147	169	30	110	59	19	11	105	32	0	0	57	22	12	0	27	0
"AK001351"	1845	14261	0	0	0	0	0	0	0	23	0	0	0	0	0	0	0	0
"AK001394"	4223	4223	0	0	0	0	0	0	0	0	0	0	0	0	0	0	0	0
"AK001432"	1560	10015	0	0	0	0	0	0	0	0	0	0	0	0	0	0	0	0
"AK001558"	2189	571222	0	0	0	0	0	0	39	17	0	0	0	0	0	0	0	0
"AK001582"	3598	320879	0	0	0	0	0	0	0	0	0	0	0	0	0	0	0	0
"AK001814"	1074	6166	10	0	10	0	0	0	68	11	36	49	1244	545	463	362	360	299
"AK001875"	4376	4376	0	0	0	0	0	0	0	0	0	0	0	0	0	0	0	0
"AK001937"	1176	1317	0	0	0	0	0	0	0	0	0	0	0	0	11	0	4	0
"AK002090"	1413	118322	24649	6004	13680	10969	3265	2739	12529	1933	12457	2696	10735	10353	12910	9295	14534	9175
"AK002138"	892	9005	0	0	0	0	0	0	0	0	0	0	0	0	0	0	0	0
"AK002196"	1759	16645	2	0	2	0	0	0	12	0	0	0	9	0	3	0	2	0
"AK021537"	2106	2106	0	0	0	0	0	0	0	0	0	0	0	0	0	0	0	0
"AK021563"	839	122693	197	148	104	93	30	118	149	97	0	46	661	750	464	490	681	443
"AK021570"	2411	2411	145	84	69	76	38	46	121	14	240	134	0	0	243	195	307	240
"AK021664"	2146	2146	0	0	0	0	0	0	0	0	0	0	0	0	0	0	0	0
"AK021716"	2045	2045	74	20	51	23	0	20	50	7	53	0	1220	1456	460	453	477	354
"AK021739"	1880	25465	23	0	0	23	0	0	0	0	0	0	83	48	120	78	80	66
"AK021804"	2455	2455	0	0	0	0	0	0	0	0	0	0	0	0	0	0	0	0
"AK021876"	1858	1858	33	2	33	0	2	0	29	0	0	0	2	5	0	1	24	0
"AK021878"	547	31390	5726	1867	3137	2589	1021	846	2194	810	7639	2559	18991	17011	18363	14087	24166	17663
"AK021888"	2705	2705	0	0	0	0	0	0	0	0	0	0	189	240	287	247	352	82
"AK021977"	7542	7542	40	1624	0	40	905	719	0	189	0	966	0	0	0	0	0	0
"AK022194"	2397	2397	0	0	0	0	0	0	0	0	0	0	0	0	0	1	10	0
"AK022285"	2269	3393	1	0	0	1	0	0	95	97	0	0	41	63	32	5	61	25
"AK022382"	2091	2488	0	0	0	0	0	0	0	0	0	0	55	55	0	0	0	0
"AK022396"	2386	8677	0	0	0	0	0	0	0	0	0	0	0	0	0	0	0	0
"AK022435"	1818	2550	90	56	39	51	28	28	29	22	0	0	50	0	330	329	440	273
"AK022793"	2102	4259	0	0	0	0	0	0	0	0	0	0	0	0	0	0	0	0
"AK022898"	2788	22073	0	0	0	0	0	0	0	0	0	0	0	0	0	0	0	0
"AK022914"	4659	45126	0	0	0	0	0	0	0	0	0	0	0	2	0	0	0	0
"AK022993"	3089	3586	147	0	98	49	0	0	57	0	0	0	22	25	107	89	54	44
"AK023018"	1194	3184	0	0	0	0	0	0	13	20	0	0	68	17	10	16	53	25
"AK023033"	724	29313	0	0	0	0	0	0	0	0	0	0	0	0	0	0	0	0
"AK023040"	1850	15534	43	5	19	24	0	5	84	0	24	0	27	45	25	5	32	13
"AK023048"	2770	2770	0	0	0	0	0	0	21	0	0	0	0	0	0	0	0	0
"AK023159"	4839	4839	0	0	0	0	0	0	45	0	0	0	269	221	222	0	306	50
"AK023304"	1629	43574	108	42	67	41	42	0	142	64	0	0	5	3	3	0	0	1
"AK023371"	2459	8128	2537	890	1730	807	500	390	1151	316	780	482	1664	194	483	131	424	48
"AK023391"	3476	3476	0	0	0	0	0	0	0	0	0	0	47	7	0	0	84	0
"AK023401"	2729	2729	0	0	0	0	0	0	0	0	0	0	0	0	0	0	0	0
"AK023445"	1863	65290	0	0	0	0	0	0	0	8	0	0	0	0	0	0	0	0
"AK023457"	2482	2482	1961	32	1496	465	23	9	1076	75	459	87	4464	3974	3917	3156	4932	3575
"AK023507"	1795	1795	0	0	0	0	0	0	0	0	0	0	0	0	0	0	0	0
"AK023515"	2033	47559	0	30	0	0	12	18	13	0	0	0	666	884	516	552	665	569
"AK023548"	562	8783	0	0	0	0	0	0	0	0	0	0	0	0	0	0	0	0
"AK023629"	2293	37978	1754	715	977	777	420	295	840	217	399	275	23	10	13	5	19	12
"AK023685"	2622	2622	135	0	79	56	0	0	45	0	0	0	389	309	361	239	346	52
"AK023809"	4437	12582	0	0	0	0	0	0	0	0	0	0	0	0	0	0	0	0
"AK023856"	2348	3174	0	0	0	0	0	0	0	0	0	0	191	96	54	16	73	33
"AK024119"	1957	4956	0	0	0	0	0	0	83	33	0	0	0	0	0	0	0	0
"AK024141"	4063	4063	0	0	0	0	0	0	13	0	0	0	0	0	0	0	0	0
"AK024177"	1675	24579	2353	2089	1263	1090	1098	991	901	1238	2586	2903	2106	2043	1213	1294	1539	1152
"AK024242"	2813	50890	0	0	0	0	0	0	0	0	0	0	0	0	0	0	0	0
"AK024243"	4413	5273	0	0	0	0	0	0	34	16	0	0	250	134	187	174	88	38
"AK024248"	4402	41955	283	148	192	91	81	67	138	118	100	214	210	370	564	740	896	470
"AK024293"	1420	5431	0	0	0	0	0	0	14	74	0	0	0	77531	0	5	13	7
"AK024295"	2639	15392	299	614	246	53	19	595	23	2252	204	4119	184	100	57	146	71	84
"AK024736"	1520	78214	0	0	0	0	0	0	177	53	0	0	53	43	0	0	4	4
"AK024936"	1939	1939	0	0	0	0	0	0	0	0	0	0	0	0	0	0	0	0
"AK024998"	2513	2967	0	0	0	0	0	0	0	0	0	0	0	0	0	0	0	0
"AK025061"	2179	2692	0	0	0	0	0	0	0	0	0	0	0	0	0	0	0	0
"AK025117"	3106	3106	3073	2738	1574	1499	1827	911	1460	1435	425	957	190	3384	280	757	297	363
"AK025127"	1647	1647	0	0	0	0	0	0	0	0	0	0	23	32	24	21	25	4
"AK025140"	2332	2332	82	24	47	35	24	0	40	30	0	0	1480	1529	1324	946	1360	917
"AK025264"	2437	3155	406	110	206	200	57	53	186	92	65	117	352	411	441	418	453	331
"AK025288"	2766	2766	2382	6075	1407	975	3343	2732	1312	5677	362	4847	0	0	0	0	0	0
"AK025316"	4611	4611	228	92	127	101	57	35	157	42	0	64	1698	1613	1610	1274	1924	1063
"AK025321"	1651	1651	0	0	0	0	0	0	0	0	0	0	0	0	0	0	0	0
"AK025619"	2513	3789	0	0	0	0	0	0	0	0	0	0	1	0	4	0	0	0
"AK025726"	3779	3779	1378	103	584	794	44	59	640	15	277	69	1821	1576	2028	168	1907	210
"AK025785"	2196	2196	211	87	124	87	37	50	152	71	241	72	0	2915	195	117	292	470
"AK025786"	2528	39024	4	0	4	0	0	0	38	0	0	0	0	0	0	0	0	0
"AK025793"	3506	4169	548	98	331	217	64	34	339	20	68	0	0	0	0	0	0	0
"AK025855"	2494	2494	0	0	0	0	0	0	0	0	0	0	0	0	0	0	0	0
"AK025967"	1394	69975	0	0	0	0	0	0	0	0	0	0	0	0	0	0	0	0
"AK025975"	3566	3566	0	0	0	0	0	0	31	0	0	0	0	0	0	0	0	0
"AK025977"	595	595	0	0	0	0	0	0	0	0	0	0	0	0	0	0	0	0
"AK026026"	3021	3021	796	11738	464	332	2447	9291	289	6272	0	13456	0	7078	23	5461	25	4163
"AK026100"	1640	88138	0	0	0	0	0	0	0	0	0	0	0	0	0	0	0	0
"AK026101"	1638	1638	112	399	69	43	215	184	156	337	245	660	703	739	1365	1407	120	1201
"AK026194"	1934	1934	15	0	0	15	0	0	16	19	0	0	0	435	0	228	0	0
"AK026206"	2301	10717	914	358	514	400	192	166	365	130	414	152	4	1293	1262	672	1745	926
"AK026219"	1252	6303	2139	1516	1161	978	780	736	1035	712	1997	767	2182	2086	5079	4006	4358	3285
"AK026244"	631	631	279	216	147	132	216	0	125	736	143	235	23	71	0	87	29	52
"AK026379"	2217	2217	277	131	190	87	71	60	722	26	0	0	1320	1066	0	0	0	0
"AK026416"	1934	13390	0	0	0	0	0	0	0	0	0	0	0	0	0	0	0	0
"AK026430"	2367	2450	30	0	16	14	0	0	15	0	0	0	59	63	137	136	125	91
"AK026477"	2609	7985	0	0	0	0	0	0	0	0	0	0	0	0	0	0	0	0
"AK026502"	1838	46102	2022	774	1036	986	419	355	1093	467	253	492	95	103	34	37	174	78
"AK026512"	998	1893	0	0	0	0	0	0	0	0	0	0	0	0	0	0	0	0
"AK026668"	4231	4231	963	215	549	414	119	96	440	80	160	90	6006	7160	4207	3265	4762	2990
"AK026714"	1881	1881	1190	100946	621	569	54778	46168	85	48358	0	10934	17	17147	24	1972	31	93
"AK026736"	2076	2076	0	0	0	0	0	0	0	0	0	0	0	0	0	0	0	0
"AK026768"	1916	138227	925	354	425	500	163	191	514	175	275	234	1949	1853	2317	1245	2336	1374
"AK026805"	2087	3436	0	0	0	0	0	0	0	0	0	0	0	0	0	0	0	0
"AK026905"	3236	3236	582	215	319	263	99	116	369	144	259	295	23	60	41	30	81	31
"AK026965"	2480	311402	2137	1824	1101	1036	923	901	825	4845	5442	9705	4348	4724	3870	3624	4414	3128
"AK027091"	846	846	4005	4425	2265	1740	2324	2101	885	2416	3467	5671	1104	2504	0	0	0	0
"AK027145"	2045	2045	0	0	0	0	0	0	0	0	0	0	0	0	0	0	0	0
"AK027179"	2298	3624	227	372	2	225	213	159	0	278	362	214	1175	0	0	0	1	0
"AK027190"	1636	1636	0	0	0	0	0	0	0	0	0	0	0	0	0	0	0	0
"AK027257"	2550	14390	1945	2720	1119	826	1443	1277	916	2319	192	4189	0	23	0	0	0	0
"AK027541"	2015	3993	0	15	0	0	15	0	0	0	0	0	0	0	0	0	0	0
"AK027578"	1924	102017	0	0	0	0	0	0	0	0	0	0	10	0	5	6	3	0
"AK054607"	1660	29306	0	0	0	0	0	0	0	14	0	0	0	3	0	13	8	1
"AK054623"	2049	18034	0	0	0	0	0	0	189	0	0	0	45	51	13	0	0	0
"AK054637"	2101	104513	0	0	0	0	0	0	184	51	0	0	0	0	0	0	0	0
"AK054645"	2405	205468	0	0	0	0	0	0	0	0	0	0	0	0	0	0	0	0
"AK054655"	3074	3074	3980	1928	3973	7	1928	0	2564	1554	4088	2506	5153	0	0	0	8564	0
"AK054694"	1879	1977	60	76	17	43	42	34	46	44	26	96	83	95	112	93	129	81
"AK054708"	1956	2319	0	0	0	0	0	0	0	0	0	0	0	0	0	0	0	0
"AK054726"	1725	2484	0	0	0	0	0	0	0	0	0	0	2	15	20	0	27	4
"AK054749"	1838	19034	0	0	0	0	0	0	12	0	0	0	0	0	0	0	0	0
"AK054753"	2038	115478	0	0	0	0	0	0	9	0	0	0	2	14	26	0	0	0
"AK054836"	2210	5510	0	0	0	0	0	0	0	0	0	0	0	0	0	0	0	0
"AK054845"	2408	235545	0	337	0	0	198	139	0	559	0	39	0	0	0	0	0	0
"AK054869"	1877	5017	0	0	0	0	0	0	0	0	0	0	0	0	0	0	0	0
"AK054880"	2567	4477	0	0	0	0	0	0	17	0	0	0	0	0	0	0	0	0
"AK054921"	3295	3295	0	0	0	0	0	0	0	0	0	0	0	0	0	0	0	0
"AK054970"	3682	3682	582	347	331	251	200	147	296	120	0	146	1237	1608	567	251	890	272
"AK054988"	2090	3061	0	0	0	0	0	0	0	0	0	0	0	0	0	0	0	0
"AK054990"	2074	11233	0	0	0	0	0	0	0	0	0	0	0	0	0	0	0	0
"AK055006"	2676	11413	0	0	0	0	0	0	0	0	0	0	0	0	0	0	0	0
"AK055012"	1971	8778	0	0	0	0	0	0	0	0	0	0	0	0	4	6	0	5
"AK055016"	2613	9610	0	0	0	0	0	0	0	0	0	0	0	0	0	0	0	0
"AK055017"	5228	5228	1095	14	358	737	0	14	905	33	186	32	81	154	0	961	2068	0
"AK055055"	2503	12435	74	14	43	31	0	14	81	22	0	0	0	0	0	0	0	0
"AK055062"	2512	8568	0	0	0	0	0	0	0	0	0	0	32	58	60	102	0	8
"AK055100"	1953	11402	0	0	0	0	0	0	0	0	0	0	0	0	0	0	0	0
"AK055145"	2524	2524	0	0	0	0	0	0	0	0	0	0	0	0	0	0	0	0
"AK055150"	1127	114563	40	0	28	12	0	0	84	25	0	24	18	9	0	0	9	0
"AK055166"	2072	66867	5810	13647	3383	2427	7352	6295	1262	1405	291	2424	1138	1077	1272	989	1040	878
"AK055214"	3981	3981	3393	1566	1866	1527	844	722	1458	1099	1092	808	4156	4934	3566	2778	4948	3050
"AK055250"	1929	8611	0	0	0	0	0	0	11	15	0	0	0	0	0	0	0	0
"AK055254"	5045	8819	0	0	0	0	0	0	10	0	0	0	0	1	0	0	0	0
"AK055257"	2106	2106	69	774	69	0	446	328	0	384	0	141	0	2	0	0	1	0
"AK055260"	2175	9011	4	0	3	1	0	0	51	65	0	0	0	2	0	0	0	0
"AK055267"	816	10150	0	0	0	0	0	0	13	0	0	0	1	1	0	0	0	0
"AK055272"	2156	6795	0	0	0	0	0	0	28	0	0	0	0	0	0	0	0	0
"AK055323"	4248	4248	2210	492	1223	987	315	177	881	146	147	146	5664	6349	1453	851	2335	1134
"AK055332"	2132	102367	0	0	0	0	0	0	0	0	0	0	0	0	0	0	0	0
"AK055351"	1626	8521	0	0	0	0	0	0	0	0	0	0	0	0	0	0	0	0
"AK055364"	2942	2942	0	0	0	0	0	0	0	0	0	0	0	0	0	0	0	0
"AK055370"	3749	3749	0	0	0	0	0	0	0	0	0	0	0	0	0	0	0	0
"AK055384"	2558	2558	2326	2272	1185	1141	1175	1097	1460	1290	626	1849	2390	3395	839	908	822	478
"AK055386"	3405	3405	0	0	0	0	0	0	0	0	0	0	0	0	0	0	0	0
"AK055400"	4309	543014	0	0	0	0	0	0	0	0	0	8	0	0	0	0	0	0
"AK055408"	1110	5982	0	0	0	0	0	0	0	0	0	0	0	0	0	0	0	0
"AK055439"	2171	157580	993	4405	586	407	2338	2067	323	1558	124	2363	0	0	0	0	0	0
"AK055458"	3235	3235	363	2623	205	158	1430	1193	104	874	5	1642	203	2620	197	607	226	315
"AK055459"	2986	3229	0	0	0	0	0	0	0	0	0	0	0	0	0	0	0	0
"AK055514"	2372	192389	0	0	0	0	0	0	11	0	0	0	0	0	0	0	0	0
"AK055518"	1398	27497	0	0	0	0	0	0	10	0	0	0	0	0	0	0	0	0
"AK055533"	894	894	0	0	0	0	0	0	22	0	0	0	0	0	0	0	0	0
"AK055550"	2320	8806	0	0	0	0	0	0	0	0	0	0	0	0	0	0	0	0
"AK055570"	2284	14706	0	0	0	0	0	0	0	0	0	0	0	0	0	0	0	0
"AK055590"	2331	11773	188	7	107	81	7	0	170	17	121	38	331	261	70	51	101	64
"AK055601"	3092	3092	707	172	406	301	62	110	195	97	0	152	964	1156	1051	600	875	511
"AK055602"	2475	2475	0	18	0	0	18	0	0	0	0	0	893	0	0	0	108	101
"AK055621"	2369	41352	0	0	0	0	0	0	0	0	0	0	0	0	0	5	0	0
"AK055623"	1808	9995	211	108	106	105	58	50	377	163	386	37	407	428	78	77	101	19
"AK055631"	2205	2604	0	0	0	0	0	0	0	0	0	0	0	0	0	0	0	0
"AK055656"	725	1860	0	0	0	0	0	0	0	0	0	0	0	0	0	0	0	0
"AK055666"	2285	8478	0	0	0	0	0	0	0	0	0	0	0	0	0	0	0	0
"AK055694"	2226	84262	8	18	8	0	7	11	140	55	0	58	58	81	0	0	0	0
"AK055712"	1469	1469	0	0	0	0	0	0	0	0	0	0	0	0	0	0	0	0
"AK055746"	2597	34010	0	0	0	0	0	0	0	0	0	0	0	0	0	0	0	0
"AK055772"	2025	9337	0	0	0	0	0	0	11	0	0	0	0	0	0	0	0	0
"AK055785"	2786	2786	204	57	153	51	23	34	104	112	757	308	100	67	211	52	1375	37
"AK055803"	2291	37289	0	0	0	0	0	0	15	0	0	0	0	0	0	0	0	0
"AK055811"	861	4988	0	0	0	0	0	0	0	0	0	0	0	0	0	0	0	0
"AK055831"	2696	23077	0	0	0	0	0	0	0	0	0	0	0	0	0	0	0	0
"AK055832"	1898	2008	0	0	0	0	0	0	0	0	0	1	0	0	0	0	0	0
"AK055853"	3107	17198	0	0	0	0	0	0	26	11	0	0	1	2	0	0	10	0
"AK055854"	2860	33719	0	0	0	0	0	0	19	0	0	0	0	0	0	0	0	0
"AK055856"	3334	7152	0	0	0	0	0	0	0	0	0	0	0	0	0	0	0	0
"AK055863"	3445	10031	0	0	0	0	0	0	0	0	0	0	0	0	0	0	0	0
"AK055868"	2376	24198	7229	9038	5168	2061	4776	4262	1819	1790	3020	2026	3047	4380	76	56	130	51
"AK055876"	2696	16909	0	0	0	0	0	0	0	22	0	16	1	7	0	67	4	9
"AK055890"	2347	4559	0	0	0	0	0	0	73	85	0	0	0	0	0	2	0	0
"AK055918"	2852	10265	6106	2309	3393	2713	1215	1094	2351	1700	1504	4302	866	522	617	602	1044	470
"AK055932"	2656	20780	0	0	0	0	0	0	0	0	0	0	0	0	0	0	0	0
"AK055957"	647	2491	2	0	2	0	0	0	0	0	0	0	0	0	0	0	0	0
"AK055967"	3045	5756	0	0	0	0	0	0	0	0	0	0	0	0	0	0	0	0
"AK055974"	1769	47046	0	0	0	0	0	0	0	0	0	0	0	0	0	0	0	0
"AK055981"	2023	2023	810	382	457	353	193	189	342	65	337	188	2539	270	117	37	182	38
"AK055993"	2377	53326	5749	422	3197	2552	247	175	2851	353	2494	425	8672	8518	10797	9094	13016	8987
"AK056031"	1982	98591	5777	2261	3377	2400	1251	1010	2927	1139	2255	1944	282	357	96	130	129	84
"AK056047"	2926	10639	0	0	0	0	0	0	0	0	0	0	0	0	0	0	0	0
"AK056073"	2378	9803	0	0	0	0	0	0	82	25	0	0	0	0	0	0	0	0
"AK056077"	2002	2533	0	0	0	0	0	0	0	0	0	0	0	0	0	0	0	0
"AK056081"	2344	25571	0	0	0	0	0	0	54	0	0	0	0	0	0	0	0	0
"AK056084"	1729	7509	0	0	0	0	0	0	0	0	0	0	0	0	0	0	0	0
"AK056105"	2234	49606	0	0	0	0	0	0	0	0	0	0	0	0	0	0	0	0
"AK056135"	580	5841	0	0	0	0	0	0	0	0	0	0	0	2	0	0	0	0
"AK056182"	1914	103749	6	16	1	5	16	0	32	15	0	0	673	445	457	81	566	91
"AK056196"	2134	109982	0	0	0	0	0	0	0	0	0	0	0	0	0	0	0	0
"AK056211"	2876	4371	0	0	0	0	0	0	0	0	0	0	0	0	0	0	0	0
"AK056212"	2888	30062	0	0	0	0	0	0	0	0	0	0	0	0	0	0	0	0
"AK056228"	2305	4024	0	0	0	0	0	0	80	27	0	0	0	0	0	0	0	0
"AK056246"	2343	26385	0	0	0	0	0	0	0	0	0	0	0	0	0	0	0	0
"AK056252"	2960	82361	0	0	0	0	0	0	0	0	0	0	0	0	0	0	0	0
"AK056253"	3177	3177	0	0	0	0	0	0	3	0	7	0	18	0	345	337	568	140
"AK056267"	3040	3040	0	0	0	0	0	0	52	15	0	0	0	0	0	0	0	0
"AK056332"	2224	79478	0	0	0	0	0	0	0	10	0	0	0	0	0	72	3	0
"AK056351"	2354	40810	0	0	0	0	0	0	0	0	0	0	0	0	0	0	0	0
"AK056368"	2100	59227	0	0	0	0	0	0	0	22	0	0	9	13	0	0	0	3
"AK056375"	2184	46623	0	0	0	0	0	0	0	0	0	0	31	0	0	0	45	0
"AK056376"	2176	10654	0	0	0	0	0	0	33	18	0	0	0	0	0	0	0	0
"AK056384"	2942	4798	0	0	0	0	0	0	49	0	0	0	81	82	72	34	61	0
"AK056396"	830	44689	532	0	367	165	0	0	1013	184	1378	723	0	0	0	0	0	0
"AK056401"	3286	69667	290	14	166	124	0	14	194	8	0	0	374	367	158	156	206	181
"AK056431"	4117	53233	0	0	0	0	0	0	0	0	0	0	0	0	0	0	0	0
"AK056432"	1877	105395	0	0	0	0	0	0	0	0	0	0	0	0	0	0	0	0
"AK056485"	2962	246999	0	0	0	0	0	0	0	0	0	0	0	0	0	0	0	0
"AK056486"	3045	3515	0	0	0	0	0	0	45	25	48	0	0	0	0	0	0	0
"AK056490"	1770	1770	0	0	0	0	0	0	0	0	0	0	0	0	0	0	0	0
"AK056518"	3308	148667	1781	291	978	803	154	137	1117	285	475	410	64	4	0	3	58	0
"AK056524"	2690	33509	0	0	0	0	0	0	0	0	0	0	0	0	0	0	0	0
"AK056556"	2888	9191	25	0	15	10	0	0	36	45	0	0	4	0	0	1	21	8
"AK056558"	2792	66690	275	19	129	146	8	11	361	10	56	0	2287	2412	1354	1118	1289	1109
"AK056561"	2691	14681	0	0	0	0	0	0	0	0	0	0	0	0	0	0	0	0
"AK056584"	3106	67621	0	0	0	0	0	0	0	0	0	0	0	1	0	0	0	0
"AK056618"	2905	2905	63	0	29	34	0	0	61	31	0	0	0	6	0	0	0	0
"AK056625"	3199	7041	0	0	0	0	0	0	0	0	0	0	0	0	0	0	0	0
"AK056626"	4428	4428	0	0	0	0	0	0	0	0	0	0	0	0	0	0	0	0
"AK056657"	2429	32445	1329	57	752	577	36	21	949	116	248	0	46	20	34	296	0	11
"AK056683"	2149	3613	0	0	0	0	0	0	0	0	0	0	0	0	8	0	7	0
"AK056686"	2388	29481	798	1351	639	159	796	555	105	699	0	1557	0	1877	0	0	0	0
"AK056689"	1520	26699	0	0	0	0	0	0	0	0	0	0	0	0	0	0	0	0
"AK056703"	3147	45089	0	22	0	0	13	9	63	26	0	0	0	21	9	56	11	6
"AK056720"	2069	21444	0	12	0	0	12	0	23	0	0	0	59	63	46	41	87	18
"AK056728"	2604	8457	576	9	320	256	9	0	250	17	68	0	0	0	0	0	0	0
"AK056780"	3093	3484	0	0	0	0	0	0	0	0	0	0	0	0	0	0	0	0
"AK056784"	1808	8414	13	0	5	8	0	0	70	7	0	0	0	0	0	0	0	0
"AK056817"	2759	7934	0	0	0	0	0	0	41	14	0	0	1	15	117	58	172	109
"AK056822"	2460	56275	1486	635	858	628	322	313	697	433	319	703	131	165	18	62	54	48
"AK056885"	2362	10192	0	0	0	0	0	0	33	18	0	0	0	0	0	0	0	0
"AK056892"	2360	83155	371	1657	224	147	416	1241	106	296	314	2245	688	743	395	780	551	925
"AK056897"	2389	8762	0	0	0	0	0	0	0	0	0	0	0	0	0	0	0	0
"AK056973"	1126	2073	0	0	0	0	0	0	19	0	0	0	0	0	0	5	0	0
"AK056982"	1114	15120	0	0	0	0	0	0	0	0	0	0	3	1	5	7	0	0
"AK057000"	1627	8358	0	0	0	0	0	0	0	0	0	0	131	31	62	22	142	38
"AK057037"	1617	2463	0	0	0	0	0	0	0	0	0	0	0	0	0	0	0	0
"AK057104"	3145	9037	1	0	0	1	0	0	0	0	0	0	176	150	45	31	46	0
"AK057135"	2956	4132	0	0	0	0	0	0	0	0	0	0	0	0	0	0	0	0
"AK057177"	2232	8236	244	25	137	107	16	9	189	124	106	105	120	139	111	200	243	179
"AK057187"	1892	3153	0	0	0	0	0	0	0	0	0	0	0	0	4	0	0	0
"AK057188"	2225	22755	2339	1663	1245	1094	951	712	1518	874	603	1051	2515	2694	378	183	833	340
"AK057198"	2061	2603	0	0	0	0	0	0	0	9	0	0	0	0	0	0	0	0
"AK057213"	2615	37001	0	0	0	0	0	0	62	0	0	0	207	174	181	145	246	106
"AK057215"	2267	2267	0	0	0	0	0	0	0	0	0	0	0	0	0	0	0	0
"AK057217"	2093	12623	4606	442	2251	2355	232	210	1748	289	4903	581	0	1	3	0	0	0
"AK057218"	2202	23482	0	0	0	0	0	0	0	0	0	0	0	0	0	0	0	0
"AK057223"	1766	17518	0	0	0	0	0	0	0	8	0	0	0	0	0	0	0	0
"AK057233"	1720	12458	0	0	0	0	0	0	0	0	0	0	0	0	0	0	0	0
"AK057239"	2136	16175	0	0	0	0	0	0	0	0	0	0	0	1	0	0	0	0
"AK057259"	1954	2410	0	0	0	0	0	0	20	0	0	0	0	0	0	0	0	0
"AK057297"	2293	38672	0	0	0	0	0	0	0	0	0	0	0	0	0	0	0	0
"AK057304"	1947	43384	0	0	0	0	0	0	0	0	0	0	0	0	0	0	0	0
"AK057317"	1037	9009	0	0	0	0	0	0	13	0	0	0	0	0	0	0	0	0
"AK057321"	1769	25883	94	0	63	31	0	0	51	0	0	17	130	161	6	0	0	0
"AK057332"	1751	125451	0	0	0	0	0	0	0	10	0	0	0	0	0	0	0	0
"AK057336"	1893	54182	0	0	0	0	0	0	0	0	0	0	0	0	0	0	0	0
"AK057351"	653	2795	0	0	0	0	0	0	0	0	0	0	0	0	0	0	0	0
"AK057376"	1978	44366	0	0	0	0	0	0	90	55	0	0	0	0	0	0	0	0
"AK057379"	1874	69704	0	0	0	0	0	0	0	0	0	0	0	0	0	0	0	0
"AK057396"	2046	9710	0	0	0	0	0	0	0	0	0	0	0	0	0	0	0	0
"AK057438"	1045	23099	0	0	0	0	0	0	0	0	0	0	0	0	0	0	0	0
"AK057447"	1768	58012	0	0	0	0	0	0	0	0	0	0	0	0	0	0	0	0
"AK057448"	1978	15581	12	0	12	0	0	0	92	14	0	0	0	0	0	0	0	0
"AK057451"	1551	234105	2	80	0	2	40	40	32	92	0	0	0	0	0	0	0	0
"AK057455"	1780	58494	0	0	0	0	0	0	0	0	0	0	0	0	0	0	0	0
"AK057456"	1714	17206	0	0	0	0	0	0	0	0	0	0	0	0	0	0	0	0
"AK057471"	1884	89642	0	0	0	0	0	0	0	0	0	0	0	0	0	0	0	0
"AK057473"	2409	35477	0	0	0	0	0	0	0	0	0	0	0	0	0	0	0	0
"AK057490"	1903	71160	0	0	0	0	0	0	0	0	0	0	0	0	0	0	0	0
"AK057493"	2069	12771	0	0	0	0	0	0	0	0	0	0	0	0	0	0	0	0
"AK057515"	1636	11212	0	0	0	0	0	0	0	0	0	0	0	0	0	0	0	0
"AK057519"	2153	18189	0	0	0	0	0	0	0	0	0	0	0	0	0	0	0	0
"AK057554"	2599	20433	0	0	0	0	0	0	0	0	0	0	0	0	0	0	0	0
"AK057572"	1037	25013	0	0	0	0	0	0	0	0	0	0	0	0	0	0	0	0
"AK057596"	2953	9699	431	475	266	165	257	218	379	321	0	114	319	702	124	107	198	132
"AK057604"	956	956	112	0	45	67	0	0	64	0	0	23	1	1	43	10	47	0
"AK057610"	1671	1767	1566	588	899	667	322	266	5	446	170	477	87	110	1353	1463	1771	1542
"AK057625"	2902	3144	160	74	101	59	31	43	105	96	50	45	0	0	10	5	25	28
"AK057632"	2826	24686	0	0	0	0	0	0	0	0	0	0	0	0	0	0	0	0
"AK057657"	3758	3758	3548	1788	1992	1556	1077	711	1583	1537	2870	3075	3041	3639	1224	1208	1118	792
"AK057681"	1430	1430	966	65	369	597	0	65	953	24	1195	124	316	135	0	2	0	0
"AK057701"	2601	14228	875	487	408	467	266	221	462	354	5183	775	24	58	49	53	33	24
"AK057709"	3153	7397	0	0	0	0	0	0	0	0	0	0	0	0	0	0	0	0
"AK057719"	2061	6456	821	243	432	389	178	65	262	85	1031	365	2728	1909	3969	2061	1642	1385
"AK057834"	882	166980	0	0	0	0	0	0	7	0	0	0	0	1	0	0	0	0
"AK057873"	2001	2034	0	0	0	0	0	0	0	0	0	0	0	0	0	0	0	0
"AK057887"	3733	3733	750	174	433	317	114	60	331	136	555	433	1818	1460	1771	1134	2334	1067
"AK057909"	2352	7374	0	0	0	0	0	0	50	31	0	0	0	0	0	0	0	0
"AK057935"	905	3277	0	0	0	0	0	0	0	0	0	0	0	0	0	0	0	0
"AK057978"	2965	2965	320	350	150	170	204	146	199	123	71	265	64	46	50	43	29	49
"AK057986"	2059	10330	0	0	0	0	0	0	42	28	0	0	0	0	0	0	0	0
"AK058053"	1240	54928	0	0	0	0	0	0	0	0	0	0	0	0	0	0	0	0
"AK058104"	1265	1727	0	0	0	0	0	0	0	0	0	0	0	0	0	0	0	0
"AK058116"	842	1244	0	0	0	0	0	0	0	0	0	0	0	0	0	0	0	0
"AK058136"	1441	66937	0	0	0	0	0	0	0	0	0	0	0	0	1	0	0	0
"AK058169"	2102	54182	0	0	0	0	0	0	0	0	0	0	0	0	0	0	0	0
"AK058177"	1304	11183	0	0	0	0	0	0	0	0	0	0	0	0	0	0	0	0
"AK074198"	2058	13625	0	0	0	0	0	0	0	0	0	0	0	0	0	0	0	0
"AK074469"	1429	1429	52	336	28	24	190	146	82	37	0	95	0	0	0	0	0	0
"AK074567"	1923	2506	0	0	0	0	0	0	0	13	0	0	0	0	0	0	0	0
"AK074580"	1733	11212	1023	874	599	424	454	420	328	296	412	1102	83	199	114	684	949	67
"AK074615"	3084	3084	0	0	0	0	0	0	0	0	0	0	0	0	0	0	0	0
"AK075019"	1842	4056	115	29	89	26	16	13	40	5	55	21	4	4	6	7	9	9
"AK075337"	329	7995	0	0	0	0	0	0	0	0	0	0	0	0	0	0	0	0
"AK090553"	1049	4439	0	0	0	0	0	0	0	0	0	0	0	0	0	0	0	0
"AK090573"	2547	2547	0	12	0	0	0	12	71	29	0	0	0	0	791	0	790	464
"AK090593"	1977	5468	0	0	0	0	0	0	25	0	0	0	46	31	0	0	6	5
"AK090604"	613	2424	0	0	0	0	0	0	0	0	0	0	0	0	0	0	0	0
"AK090613"	2314	4765	55	10	19	36	10	0	32	25	0	0	11	9	14	11	13	7
"AK090620"	2101	23191	0	0	0	0	0	0	0	0	0	0	0	0	0	0	0	0
"AK090661"	2905	2995	423	85	248	175	43	42	148	170	333	442	1123	1298	789	870	843	634
"AK090674"	3159	3159	1143	164	667	476	68	96	554	107	0	150	1502	1262	1585	0	1797	0
"AK090681"	1806	60273	0	0	0	0	0	0	30	18	0	0	0	0	0	3	0	0
"AK090688"	2046	206229	0	0	0	0	0	0	45	10	0	0	0	0	0	0	0	0
"AK090700"	2451	70765	0	0	0	0	0	0	0	0	0	0	0	0	0	0	0	0
"AK090737"	1640	3638	0	0	0	0	0	0	0	0	0	0	0	0	0	0	0	0
"AK090788"	1067	28680	0	0	0	0	0	0	0	0	0	0	0	0	0	0	0	0
"AK090796"	3712	87199	0	0	0	0	0	0	22	0	0	0	2	6	0	5	9	6
"AK090817"	2091	13197	0	0	0	0	0	0	0	0	0	0	5	0	0	7	0	0
"AK090842"	3338	78391	0	0	0	0	0	0	75	29	0	0	0	0	0	0	0	0
"AK090844"	2763	2763	287	418	1	286	166	252	491	388	216	739	3	10	172	172	212	98
"AK090854"	2618	15009	0	0	0	0	0	0	0	0	0	0	0	0	0	0	0	0
"AK090895"	2206	194624	0	0	0	0	0	0	10	0	0	0	0	0	0	0	0	0
"AK090900"	2380	24823	0	0	0	0	0	0	8	0	0	0	0	0	0	0	0	0
"AK090904"	2963	2963	0	0	0	0	0	0	0	0	0	0	0	0	0	0	0	0
"AK090935"	2367	2891	42	0	31	11	0	0	0	0	0	0	15	0	11	0	9	2
"AK090973"	2295	14008	0	0	0	0	0	0	0	0	0	0	0	0	0	0	0	0
"AK091028"	2589	31618	0	0	0	0	0	0	0	0	0	0	0	1	0	0	1	0
"AK091070"	4104	4104	0	0	0	0	0	0	0	0	0	0	0	0	0	0	0	0
"AK091100"	2683	2683	0	0	0	0	0	0	13	0	0	0	26	28	46	27	0	0
"AK091102"	1918	1918	0	0	0	0	0	0	0	0	0	0	0	10	3	0	1	0
"AK091244"	3191	10955	34	0	12	22	0	0	138	53	0	0	0	0	0	0	22	0
"AK091265"	1551	1976	0	0	0	0	0	0	0	0	0	0	0	0	0	0	0	0
"AK091275"	2910	5684	0	0	0	0	0	0	0	0	0	0	19	17	25	33	16	2
"AK091355"	2234	2234	0	0	0	0	0	0	0	0	0	0	41	8	0	0	27	0
"AK091365"	1989	403215	0	0	0	0	0	0	0	0	0	0	0	0	0	0	0	0
"AK091396"	4262	337025	14669	6856	8359	6310	3727	3129	6149	2652	2990	4867	2885	2840	2386	1828	2951	1541
"AK091527"	2700	31126	25	27	16	9	27	0	22	69	0	32	0	0	3	5	0	0
"AK091594"	2938	361502	146	60	90	56	34	26	130	47	86	50	60	74	95	83	99	75
"AK091624"	2372	2372	165	40	96	69	17	23	101	173	64	104	363	417	267	299	448	309
"AK091688"	2515	10797	0	0	0	0	0	0	0	0	0	0	0	0	0	0	0	0
"AK091704"	2797	10655	0	0	0	0	0	0	0	0	0	0	0	0	0	0	0	0
"AK091729"	1987	1987	115	72	65	50	11	61	47	34	92	251	28	81	60	9	23	49
"AK091766"	3622	4079	0	0	0	0	0	0	17	0	0	0	0	0	0	0	0	0
"AK091798"	1745	20531	0	0	0	0	0	0	0	0	0	0	0	0	0	0	0	0
"AK091865"	2113	207770	0	0	0	0	0	0	77	0	0	0	3	6	64	83	9	16
"AK091866"	2675	3383	154	1975	52	102	1258	717	85	1620	0	1	37	2265	80	964	43	156
"AK091889"	2232	276051	1	0	0	1	0	0	0	0	0	0	0	0	0	0	0	0
"AK091906"	1975	12666	0	0	0	0	0	0	0	0	0	0	0	0	0	0	0	0
"AK091996"	3389	4851	0	0	0	0	0	0	0	0	0	0	0	0	0	0	0	0
"AK092048"	3219	3219	0	0	0	0	0	0	0	0	0	0	0	0	0	0	0	0
"AK092080"	1977	33245	4407	2181	2527	1880	1177	1004	1833	1036	2734	1815	188	309	90	30	108	4
"AK092087"	2730	57841	0	0	0	0	0	0	0	0	0	0	0	0	0	0	0	0
"AK092098"	3438	3438	22	0	22	0	0	0	23	0	0	0	87	37	115	96	170	81
"AK092135"	2784	29602	0	0	0	0	0	0	0	0	0	0	0	0	0	0	0	0
"AK092143"	2085	26652	0	0	0	0	0	0	0	0	0	0	0	0	0	0	0	0
"AK092150"	1647	33245	4407	2181	2527	1880	1177	1004	1833	1036	2734	1815	188	309	90	30	108	4
"AK092251"	3305	146631	0	0	0	0	0	0	14	0	0	0	0	0	0	0	0	0
"AK092331"	3885	3885	2808	2748	1082	1726	1844	904	3015	1817	995	0	2421	0	2310	2051	0	2866
"AK092333"	4276	4276	4787	92081	2763	2024	49673	42408	1659	47470	487	88285	319	7735	153	329	173	353
"AK092337"	2572	10835	0	0	0	0	0	0	0	0	0	0	0	0	0	0	0	0
"AK092380"	3495	3495	0	0	0	0	0	0	69	18	0	0	2	0	3	2	1	0
"AK092451"	2281	21315	0	0	0	0	0	0	15	0	0	0	0	0	0	0	0	0
"AK092460"	2243	63996	245	174	135	110	105	69	388	125	46	108	15	62	28	0	0	0
"AK092511"	2134	7959	0	0	0	0	0	0	14	8	0	0	0	0	0	0	0	0
"AK092540"	2250	3456	0	0	0	0	0	0	0	0	0	0	0	0	0	0	0	0
"AK092541"	1933	2588	0	0	0	0	0	0	0	0	0	0	0	0	0	0	0	0
"AK092578"	2425	20341	0	0	0	0	0	0	0	0	0	0	0	0	0	0	0	0
"AK092589"	863	18425	0	0	0	0	0	0	0	0	0	0	0	0	0	0	0	0
"AK092598"	1109	58092	0	0	0	0	0	0	0	0	0	0	0	0	0	0	0	0
"AK092619"	1960	2436	0	0	0	0	0	0	0	0	0	0	0	0	0	0	0	0
"AK092686"	1311	15152	2085	2089	1132	953	1098	991	772	1092	2462	2658	2086	1305	916	1001	1075	845
"AK092715"	2798	2798	0	0	0	0	0	0	0	0	0	0	0	0	0	0	0	0
"AK092922"	3279	3279	606	893	189	417	462	431	152	341	0	617	1638	2076	49	47	55	540
"AK092941"	2113	17962	313	65	189	124	41	24	169	0	0	0	2	0	0	0	0	0
"AK092965"	1981	1981	825	496	514	311	495	1	150	1011	179	2717	2746	3459	733	896	980	722
"AK093002"	2214	63855	0	0	0	0	0	0	0	0	0	0	0	0	0	0	0	0
"AK093026"	2203	33625	7573	656	4261	3312	340	316	2929	208	1068	227	432	122	283	43	259	25
"AK093055"	2004	29708	98	0	58	40	0	0	79	0	0	0	0	0	0	0	0	0
"AK093077"	2033	13100	1283	223	910	373	103	120	810	261	407	272	1603	1073	1044	546	1742	1047
"AK093107"	1795	223899	0	0	0	0	0	0	51	37	0	0	0	0	0	0	0	0
"AK093114"	1823	103023	0	0	0	0	0	0	21	25	0	0	0	0	0	0	0	0
"AK093124"	1983	215757	0	0	0	0	0	0	0	0	0	0	0	0	0	0	0	0
"AK093165"	2059	49769	0	0	0	0	0	0	0	0	0	0	0	0	0	0	0	0
"AK093193"	1753	17127	0	0	0	0	0	0	0	0	0	0	0	0	0	0	0	0
"AK093203"	1995	50948	945	77	495	450	56	21	659	64	78	69	0	0	0	1	0	0
"AK093205"	1982	14958	0	0	0	0	0	0	0	0	0	0	0	0	0	0	0	0
"AK093214"	1947	6883	0	0	0	0	0	0	0	0	0	0	0	0	0	0	0	0
"AK093219"	1864	41886	0	0	0	0	0	0	0	0	0	0	0	0	0	0	0	0
"AK093256"	2016	2471	0	0	0	0	0	0	0	0	0	0	0	0	0	0	0	0
"AK093257"	1811	17607	0	0	0	0	0	0	1	0	0	0	0	0	0	0	0	0
"AK093264"	2273	41121	0	0	0	0	0	0	0	0	0	0	0	0	0	0	0	0
"AK093265"	1863	3466	0	0	0	0	0	0	0	0	0	0	0	0	0	0	0	0
"AK093279"	2103	34261	13	0	0	13	0	0	193	32	0	0	140	223	93	27	5	7
"AK093299"	1583	6672	551	761	268	283	348	413	281	270	216	1339	440	527	398	798	652	414
"AK093301"	1992	2084	0	0	0	0	0	0	0	0	0	0	0	0	0	0	0	0
"AK093355"	2683	28060	0	0	0	0	0	0	0	0	0	0	0	0	0	0	0	0
"AK093356"	829	15966	32	0	20	12	0	0	43	11	0	0	0	1	0	0	0	0
"AK093362"	1699	325853	0	0	0	0	0	0	0	0	0	0	0	0	0	0	0	0
"AK093363"	2061	63742	0	0	0	0	0	0	0	0	0	0	0	0	0	0	0	0
"AK093370"	1766	33093	0	0	0	0	0	0	0	0	0	0	0	0	0	0	0	0
"AK093381"	1827	13395	0	0	0	0	0	0	0	0	0	0	0	0	0	0	0	0
"AK093382"	1801	1918	0	0	0	0	0	0	24	0	0	0	0	0	0	0	0	0
"AK093403"	1729	4760	0	0	0	0	0	0	0	0	0	0	0	0	0	0	0	0
"AK093412"	1811	17864	0	0	0	0	0	0	17	0	0	0	0	0	0	0	0	0
"AK093416"	2021	91326	0	0	0	0	0	0	0	0	0	0	0	0	0	0	4	0
"AK093430"	2143	75074	0	0	0	0	0	0	0	0	0	0	0	0	0	0	0	0
"AK093500"	1820	13729	1	0	0	1	0	0	25	0	0	0	0	0	0	0	0	0
"AK093513"	1809	72581	0	0	0	0	0	0	0	0	0	0	0	0	0	0	0	0
"AK093519"	2812	17537	0	0	0	0	0	0	0	0	0	0	0	0	0	1	3	1
"AK093525"	1877	28181	0	0	0	0	0	0	22	0	0	0	0	0	0	0	0	0
"AK093534"	489	489	1319	158	720	599	80	78	946	184	415	274	1248	1181	1655	1149	1969	1025
"AK093551"	2291	15799	126	59	69	57	59	0	281	86	0	101	155	292	0	0	0	0
"AK093552"	1954	102867	276	237	113	163	172	65	30	8	0	0	233	346	107	111	157	108
"AK093678"	1777	22408	0	0	0	0	0	0	11	0	0	0	0	0	0	0	0	0
"AK093733"	1577	92152	5876	19147	3381	2495	10355	8792	4267	19858	2035	23990	1120	4961	1631	6583	1896	2196
"AK093746"	2195	15119	0	0	0	0	0	0	29	0	0	0	3	0	0	0	0	0
"AK093758"	1013	11067	0	0	0	0	0	0	40	0	0	0	0	0	0	0	0	0
"AK093871"	3302	3302	0	0	0	0	0	0	0	0	0	0	0	0	0	0	0	0
"AK093892"	2944	32502	0	0	0	0	0	0	0	0	0	0	0	0	0	0	0	0
"AK093898"	2317	2317	28	28	16	12	19	9	36	61	0	20	79	0	120	130	123	112
"AK093940"	3070	18404	0	0	0	0	0	0	0	0	0	0	0	0	0	0	0	0
"AK093976"	2723	58994	0	0	0	0	0	0	0	0	0	0	0	0	0	0	0	0
"AK093987"	2287	2387	0	0	0	0	0	0	0	11	0	0	0	0	0	0	0	0
"AK094056"	1942	1942	112	17	40	72	8	9	45	18	0	56	30	44	458	392	260	399
"AK094108"	1901	29439	0	0	0	0	0	0	0	0	0	0	0	0	0	0	0	0
"AK094117"	1695	52418	0	0	0	0	0	0	11	0	0	0	0	0	0	0	0	0
"AK094127"	2041	2041	280	106	134	146	84	22	186	98	70	95	2507	2548	3377	3076	3407	2302
"AK094144"	3135	3135	1791	1738	999	792	919	819	2101	1561	130	312	4062	4604	3505	2360	3902	2367
"AK094154"	3089	63324	0	0	0	0	0	0	0	0	0	0	0	0	0	0	0	0
"AK094156"	4848	4848	0	0	0	0	0	0	42	13	0	0	0	0	0	0	0	0
"AK094188"	2483	15959	0	0	0	0	0	0	10	0	0	0	0	6	0	0	0	0
"AK094196"	1683	19520	0	0	0	0	0	0	0	0	0	0	0	0	0	3	0	4
"AK094208"	2494	16384	32	0	20	12	0	0	51	0	0	0	3	0	0	3	0	3
"AK094280"	1876	2230	15	0	15	0	0	0	32	0	0	0	0	464	0	0	0	0
"AK094309"	2174	3151	0	0	0	0	0	0	0	0	0	0	8	0	67	56	105	44
"AK094324"	1906	6492	0	0	0	0	0	0	52	0	0	17	2	5	6	5	12	6
"AK094325"	2022	4040	134	54	51	83	37	17	74	43	0	0	13	21	41	45	36	23
"AK094342"	1961	3592	0	0	0	0	0	0	0	0	0	0	0	0	0	0	0	0
"AK094343"	1895	131019	9	0	9	0	0	0	100	16	0	0	0	0	0	0	0	0
"AK094352"	2016	242315	0	0	0	0	0	0	23	7	0	0	0	0	0	0	0	0
"AK094354"	1850	13523	0	0	0	0	0	0	0	0	0	0	11	10	0	0	0	0
"AK094392"	1845	2464	0	0	0	0	0	0	3	0	0	0	0	0	97	24	131	75
"AK094413"	1692	1692	0	0	0	0	0	0	0	0	0	0	0	0	0	0	0	0
"AK094433"	1984	5672	0	0	0	0	0	0	0	0	0	0	0	0	0	0	0	0
"AK094456"	1874	2705	38	0	28	10	0	0	10	0	21	0	151	192	201	152	241	181
"AK094462"	1829	2499	0	0	0	0	0	0	0	0	0	0	0	0	0	0	0	0
"AK094480"	1375	1375	0	0	0	0	0	0	0	0	0	0	0	0	0	0	0	0
"AK094490"	917	1041	0	0	0	0	0	0	0	0	0	0	8	0	29	17	37	12
"AK094504"	1886	82523	0	0	0	0	0	0	80	14	0	0	10	2	16	0	3	6
"AK094525"	3351	3351	0	0	0	0	0	0	0	0	0	0	0	0	0	0	0	0
"AK094546"	1937	2553	0	0	0	0	0	0	0	0	0	0	11	0	0	0	0	0
"AK094561"	877	185225	0	0	0	0	0	0	0	0	0	0	0	0	0	0	0	0
"AK094562"	2640	3025	0	0	0	0	0	0	0	0	0	0	0	0	0	0	0	0
"AK094577"	2627	3364	164	106	76	88	60	46	177	92	254	42	258	278	392	305	642	327
"AK094599"	2795	17952	114	0	95	19	0	0	12	0	15	12	0	0	0	0	0	0
"AK094607"	2386	61607	2	0	0	2	0	0	0	0	0	0	0	0	0	0	0	0
"AK094621"	3827	3827	104	0	74	30	0	0	36	0	0	0	738	857	380	0	0	405
"AK094634"	2567	57107	0	0	0	0	0	0	0	0	0	0	0	0	0	0	0	0
"AK094644"	2253	6290	40	0	28	12	0	0	56	0	0	0	0	32	449	326	280	73
"AK094649"	2503	89369	0	0	0	0	0	0	22	0	0	0	0	0	4	0	0	0
"AK094674"	2378	3933	0	0	0	0	0	0	12	0	0	0	0	0	0	0	0	0
"AK094692"	1051	7349	46	0	46	0	0	0	49	0	0	0	11	0	77	0	75	0
"AK094705"	5754	5754	0	0	0	0	0	0	0	0	0	0	0	0	0	0	0	0
"AK094715"	1982	33905	0	0	0	0	0	0	0	0	0	0	0	0	0	0	0	0
"AK094729"	2130	14479	0	0	0	0	0	0	0	0	0	0	0	0	0	0	0	0
"AK094733"	1929	209553	0	0	0	0	0	0	0	0	0	0	0	0	0	0	0	0
"AK094748"	2415	5147	169	30	110	59	19	11	105	32	0	0	57	22	12	0	27	0
"AK094793"	2592	238743	0	0	0	0	0	0	281	63	0	0	0	0	0	0	0	0
"AK094818"	3121	3121	39	0	23	16	0	0	0	0	0	0	323	220	336	174	424	211
"AK094824"	905	15906	0	0	0	0	0	0	0	0	0	0	0	0	0	0	0	0
"AK094825"	2177	5934	0	0	0	0	0	0	0	0	0	0	225	119	136	56	138	0
"AK094828"	2096	7966	0	0	0	0	0	0	30	31	0	0	41	0	11	10	25	0
"AK094845"	2154	24276	0	0	0	0	0	0	13	7	0	0	0	0	0	0	0	3
"AK094859"	2744	2744	0	0	0	0	0	0	20	0	0	0	0	0	0	0	0	0
"AK094908"	942	942	27	0	27	0	0	0	0	17	0	227	8	36	0	0	0	0
"AK094909"	2058	7165	0	0	0	0	0	0	0	0	0	0	0	0	0	0	4	0
"AK094914"	998	998	121	60	64	57	26	34	42	0	101	0	1	0	238	140	256	217
"AK094915"	1837	8363	0	0	0	0	0	0	0	0	0	0	0	0	0	0	0	0
"AK094916"	3318	46209	253	56	143	110	32	24	79	51	26	50	1799	1939	1763	1269	1787	1130
"AK094934"	3166	236681	1642	931	925	717	468	463	1707	1812	89	1323	315	303	226	209	484	334
"AK094945"	2167	232149	22	0	13	9	0	0	98	0	0	0	3	0	0	0	0	0
"AK094960"	2511	35646	0	0	0	0	0	0	0	0	0	0	0	0	0	0	0	0
"AK094963"	3039	44975	0	0	0	0	0	0	0	0	0	0	0	0	0	0	0	0
"AK094985"	2249	121784	584	50	318	266	24	26	585	37	46	26	1792	1969	1544	1230	4043	2620
"AK095045"	2469	2469	0	0	0	0	0	0	0	0	0	0	0	0	0	0	0	0
"AK095053"	3816	10969	0	0	0	0	0	0	0	0	0	0	0	0	0	0	0	0
"AK095077"	3897	8827	0	0	0	0	0	0	73	0	0	0	29	30	0	0	0	0
"AK095112"	4058	4439	2268	252	631	1637	154	98	447	283	218	242	323	314	504	85	706	124
"AK095115"	2310	24434	0	0	0	0	0	0	17	0	0	0	0	0	0	0	3	0
"AK095117"	2448	6680	0	0	0	0	0	0	0	0	0	0	61	79	7	4	0	0
"AK095119"	3221	48501	0	0	0	0	0	0	72	0	0	0	1	3	0	0	0	0
"AK095123"	2664	122129	8699	9480	4754	3945	5166	4314	2988	6043	1533	5015	3185	2958	2599	1967	3830	1947
"AK095132"	2747	5809	108	13	65	43	13	0	95	0	61	40	6	0	17	13	8	1
"AK095133"	2147	2147	0	0	0	0	0	0	0	0	0	0	0	0	0	0	0	0
"AK095151"	2050	9726	253	0	50	203	0	0	332	30	0	31	20	19	29	0	0	1
"AK095154"	3276	3860	849	373	538	311	162	211	298	239	180	196	7970	7141	7424	6164	13696	9647
"AK095178"	2523	163929	22	0	14	8	0	0	56	23	0	0	126	22	87	115	138	69
"AK095179"	3928	3928	1772	3031	1128	644	1786	1245	732	1690	984	2897	721	1873	823	1612	1022	1366
"AK095187"	2326	34306	0	0	0	0	0	0	8	9	0	0	0	0	0	0	0	0
"AK095188"	2165	28474	0	0	0	0	0	0	0	14	54	43	22	14	38	1	176	0
"AK095199"	1794	14089	0	0	0	0	0	0	11	0	0	0	0	0	0	1	0	0
"AK095210"	2083	37776	4703	1884	2523	2180	1045	839	3383	1043	2329	1704	951	1060	1079	637	1057	434
"AK095242"	4039	4039	1798	1512	707	1091	843	669	503	612	76	1207	2322	5491	2256	2310	3042	1777
"AK095255"	3126	49666	0	0	0	0	0	0	0	0	0	0	0	0	0	0	0	0
"AK095281"	2904	9088	0	0	0	0	0	0	160	75	0	0	0	1	10	4	10	4
"AK095285"	2847	331089	0	0	0	0	0	0	0	0	0	0	0	0	0	0	0	0
"AK095310"	2351	230980	0	0	0	0	0	0	172	28	0	0	0	0	0	0	0	0
"AK095330"	3795	5917	0	0	0	0	0	0	0	0	0	0	0	0	0	0	0	0
"AK095335"	2849	10225	0	0	0	0	0	0	96	47	0	0	0	16	0	0	3	0
"AK095347"	2326	3076	0	0	0	0	0	0	0	0	0	0	0	0	0	0	0	0
"AK095365"	3006	6627	0	0	0	0	0	0	39	26	0	0	0	0	0	0	0	0
"AK095366"	1484	1576	141	500	64	77	293	207	130	197	0	118	126	0	22	21	94	22
"AK095439"	3310	214191	1588	1722	1014	574	952	770	806	1344	24	665	964	1248	935	1021	916	660
"AK095450"	3444	40157	1583	320	931	652	176	144	878	136	569	170	0	0	0	4	0	0
"AK095458"	1922	3205	0	0	0	0	0	0	0	0	0	0	517	421	595	613	812	849
"AK095498"	3035	6887	0	0	0	0	0	0	10	0	0	0	0	0	0	0	0	0
"AK095544"	2547	144578	0	0	0	0	0	0	0	0	0	0	0	0	0	0	0	0
"AK095546"	2676	2676	1290	7860	733	557	7107	753	400	1133	605	2011	18466	24066	16234	15916	20449	14294
"AK095549"	2231	32319	9869	20110	5422	4447	10993	9117	1476	5372	3318	7999	0	71	0	41	0	0
"AK095554"	1990	89636	0	0	0	0	0	0	9	0	0	0	4	3	3	1	7	4
"AK095583"	5004	5323	0	0	0	0	0	0	0	0	0	0	0	0	0	1	0	0
"AK095585"	3100	3100	117	0	81	36	0	0	52	12	0	0	167	234	168	108	193	118
"AK095618"	1644	104538	0	0	0	0	0	0	0	0	0	0	0	0	0	0	0	0
"AK095621"	2059	2288	0	0	0	0	0	0	0	0	0	0	0	5	3	3	0	4
"AK095633"	2759	12968	0	0	0	0	0	0	47	22	0	0	0	0	0	0	0	0
"AK095652"	3032	3719	69	0	0	69	0	0	63	37	0	38	171	144	356	169	446	271
"AK095699"	2392	26368	0	0	0	0	0	0	0	0	0	0	0	0	0	0	0	0
"AK095700"	2563	2563	1980	1129	1091	889	607	522	822	671	3192	1988	710	66	1326	557	2088	327
"AK095721"	2902	2902	57	76	49	8	38	38	83	53	0	0	256	285	289	235	330	227
"AK095764"	2078	2078	0	0	0	0	0	0	0	0	0	0	0	0	0	0	0	0
"AK095778"	1977	52650	566	207	332	234	95	112	344	190	0	209	710	612	1026	980	1057	925
"AK095779"	2424	562472	15	25	0	15	13	12	43	14	0	0	550	350	541	225	583	280
"AK095785"	1346	2442	1251	969	674	577	543	426	516	468	1639	1648	829	886	1075	1016	1460	907
"AK095850"	2089	2089	0	0	0	0	0	0	42	0	0	0	85	39	152	101	51	53
"AK095968"	2438	82973	0	0	0	0	0	0	0	0	0	0	0	0	0	0	0	0
"AK095981"	2198	129730	2106	1111	1164	942	628	483	1347	707	782	1124	0	78	13	11	14	4
"AK095988"	5830	5830	0	0	0	0	0	0	0	0	0	0	0	0	0	0	0	0
"AK096014"	2733	63996	245	174	135	110	105	69	388	125	46	108	15	62	28	0	0	0
"AK096023"	1885	8852	0	0	0	0	0	0	10	10	0	0	0	0	0	0	0	0
"AK096056"	3169	13771	10094	4623	5732	4362	2511	2112	5295	1984	5520	2413	1915	2583	739	664	1213	473
"AK096066"	2247	14493	1502	850	831	671	557	293	747	461	1747	1045	3720	3172	1812	1248	4839	2546
"AK096077"	2914	11757	0	0	0	0	0	0	35	32	0	0	0	0	0	0	0	0
"AK096081"	2073	370686	0	0	0	0	0	0	11	8	0	0	9	12	28	36	3	15
"AK096134"	3161	6463	0	3	0	0	1	2	0	1	0	1	0	0	0	0	0	0
"AK096143"	1830	15861	0	0	0	0	0	0	0	0	0	0	0	0	0	0	0	0
"AK096159"	2052	26340	128	0	83	45	0	0	97	0	0	29	48	48	219	49	223	64
"AK096219"	2110	59890	392	0	193	199	0	0	498	28	193	0	149	64	111	75	168	67
"AK096230"	3681	3681	2718	878	1382	1336	491	387	1002	849	2076	1314	60	62	80	119	225	0
"AK096233"	2205	2205	0	0	0	0	0	0	0	0	0	0	0	0	0	0	0	0
"AK096249"	877	9555	12	0	0	12	0	0	38	0	0	0	0	0	12	4	1	3
"AK096250"	4203	6561	239	97	132	107	64	33	111	94	0	28	44	107	186	81	222	0
"AK096279"	1878	3735	622	256	332	290	173	83	333	121	320	123	241	138	444	247	447	145
"AK096286"	1757	6311	997	929	543	454	477	452	154	699	260	727	356	475	277	312	714	407
"AK096291"	2191	65974	39	327	8	31	193	134	86	161	0	480	36	82	84	142	42	56
"AK096314"	2834	34739	179	81	112	67	60	21	54	0	0	76	180	244	45	35	98	79
"AK096319"	3519	3519	1169	8868	645	524	1148	7720	714	0	107	6622	1012	0	1006	0	0	0
"AK096329"	2130	60295	0	0	0	0	0	0	0	0	0	0	0	0	0	0	0	0
"AK096334"	3454	3454	0	0	0	0	0	0	0	29	0	0	0	0	0	0	0	0
"AK096335"	2792	14416	435	6	198	237	0	6	279	55	180	0	868	386	542	166	921	279
"AK096360"	1947	52999	1	0	1	0	0	0	11	16	0	0	0	0	0	0	0	0
"AK096368"	2126	5100	0	0	0	0	0	0	22	0	0	0	0	0	0	0	0	0
"AK096370"	2292	5417	0	0	0	0	0	0	31	10	0	43	0	0	0	0	0	1
"AK096379"	2412	3438	0	0	0	0	0	0	0	0	0	0	0	0	0	0	0	0
"AK096380"	2308	36536	0	0	0	0	0	0	0	0	0	0	0	0	0	0	0	0
"AK096387"	2606	5062	0	0	0	0	0	0	0	0	0	0	0	0	0	0	0	0
"AK096395"	2198	6119	264	488	166	98	280	208	120	302	45	503	1010	1528	1260	1585	1853	1345
"AK096399"	2131	158488	141	89	74	67	43	46	24	56	0	45	2205	2268	343	340	439	390
"AK096461"	2487	2487	0	0	0	0	0	0	0	0	0	0	0	0	0	0	0	0
"AK096469"	2953	171293	2445	1045	1402	1043	569	476	1327	457	196	261	766	408	795	382	869	272
"AK096472"	2867	11251	0	0	0	0	0	0	64	68	0	0	0	3	0	0	0	0
"AK096475"	3259	17934	0	4	0	0	3	1	0	0	0	1	8	0	0	4	0	0
"AK096498"	2766	45941	0	0	0	0	0	0	0	10	0	0	0	0	0	0	0	0
"AK096499"	2530	75188	0	0	0	0	0	0	0	0	0	0	0	0	0	0	0	0
"AK096549"	2583	5097	0	0	0	0	0	0	0	0	0	0	0	0	0	0	0	0
"AK096592"	3328	3328	757	130	406	351	101	29	428	14	142	102	41	3	1	0	1	1
"AK096621"	2440	11083	373	70	190	183	38	32	153	16	0	12	607	182	186	72	410	129
"AK096622"	3232	19957	1	0	1	0	0	0	0	0	0	0	0	0	0	0	0	0
"AK096625"	2935	2935	3246	659	1856	1390	151	508	1448	518	1242	1	2761	0	2205	1398	2412	1197
"AK096649"	2601	2601	0	0	0	0	0	0	0	0	0	0	0	0	0	21	0	0
"AK096668"	1948	25423	33	0	28	5	0	0	188	0	0	0	128	188	6	107	135	6
"AK096680"	2066	63996	245	174	135	110	105	69	388	125	46	108	15	62	28	0	0	0
"AK096687"	2832	28401	8072	3866	4558	3514	2104	1762	3928	1033	3801	2135	235	2326	493	496	599	299
"AK096766"	1280	2031	0	0	0	0	0	0	0	0	0	0	0	0	0	2	0	0
"AK096792"	1557	29991	471	18	274	197	18	0	999	55	0	27	153	131	171	165	135	48
"AK096803"	2089	4534	0	0	0	0	0	0	20	0	0	0	0	0	0	0	0	0
"AK096834"	2556	5738	0	0	0	0	0	0	0	0	0	0	0	0	0	0	0	0
"AK096849"	2385	228266	56	65	30	26	42	23	186	39	0	24	491	812	12	0	159	1
"AK096853"	2360	79561	18	0	8	10	0	0	137	0	0	18	24	6	0	5	6	5
"AK096898"	789	2212	0	0	0	0	0	0	0	0	0	0	0	0	0	0	0	0
"AK096932"	2090	29108	0	0	0	0	0	0	47	10	0	0	0	0	0	0	0	0
"AK096987"	2905	29602	0	0	0	0	0	0	0	0	0	0	0	0	0	0	0	0
"AK096995"	2211	2458	26	0	13	13	0	0	51	0	0	0	0	0	0	0	0	0
"AK097101"	2829	38111	0	0	0	0	0	0	12	0	0	0	0	0	0	0	0	0
"AK097119"	3278	3278	9682	3416	4641	5041	1845	1571	4591	2903	5075	7554	3456	3469	812	558	1187	253
"AK097143"	2115	448750	0	0	0	0	0	0	0	0	0	0	0	0	0	0	0	0
"AK097158"	2047	14488	0	0	0	0	0	0	0	9	0	0	0	0	0	0	0	0
"AK097161"	2435	293692	0	0	0	0	0	0	13	0	0	0	322	334	125	94	116	69
"AK097190"	2294	64910	0	0	0	0	0	0	35	36	0	0	44	56	8	0	14	5
"AK097193"	2350	165955	0	0	0	0	0	0	0	9	0	0	0	0	0	0	0	0
"AK097240"	1560	3153	6030	690	3395	2635	396	294	3270	5	746	118	21	35	57	88	358	102
"AK097242"	2688	8237	0	0	0	0	0	0	15	0	0	0	0	0	0	0	0	0
"AK097283"	6136	6136	33	0	14	19	0	0	99	63	0	0	348	112	165	107	371	115
"AK097288"	3852	3852	0	0	0	0	0	0	0	0	0	0	0	0	0	0	0	0
"AK097289"	3744	3744	189	42	108	81	28	14	45	65	0	32	289	217	278	137	319	162
"AK097351"	687	8757	64	31	43	21	16	15	114	81	45	6	442	394	504	481	770	710
"AK097370"	2239	2327	3556	1434	1904	1652	187	1247	524	730	303	650	22	1022	0	0	0	1180
"AK097381"	3638	16521	0	0	0	0	0	0	0	0	0	0	0	0	0	0	0	0
"AK097428"	1959	11058	0	0	0	0	0	0	0	0	0	0	0	0	0	0	0	0
"AK097432"	2461	4009	0	0	0	0	0	0	0	0	0	0	0	0	13206	15022	17939	14910
"AK097446"	2255	4398	0	0	0	0	0	0	33	0	0	0	0	0	0	0	0	0
"AK097447"	2213	46865	0	0	0	0	0	0	0	0	0	0	0	0	0	0	0	0
"AK097453"	2696	8732	0	0	0	0	0	0	0	17	0	0	3	2	3	0	0	0
"AK097457"	1801	8725	0	0	0	0	0	0	146	57	0	0	0	0	0	0	0	0
"AK097470"	1542	265570	0	0	0	0	0	0	0	0	0	0	0	0	0	0	0	0
"AK097472"	2442	3342	407	13	251	156	0	13	196	107	338	55	3397	2743	4357	2974	5052	3155
"AK097474"	2100	8877	0	0	0	0	0	0	0	0	0	0	0	0	0	0	0	0
"AK097493"	621	14539	0	0	0	0	0	0	0	0	0	0	0	0	0	0	0	0
"AK097499"	1731	3076	960	349	621	339	207	142	465	62	269	243	131	45	2	2	6	2
"AK097500"	2282	240741	0	0	0	0	0	0	11	0	0	0	0	0	0	0	0	0
"AK097508"	2240	2913	0	0	0	0	0	0	0	0	0	0	0	0	0	0	0	0
"AK097510"	2380	89643	0	0	0	0	0	0	0	0	0	0	0	0	0	0	0	0
"AK097513"	2321	8212	0	0	0	0	0	0	0	0	0	0	0	0	0	0	0	0
"AK097516"	1801	43958	706	154	387	319	109	45	517	342	270	292	1351	1207	1114	1051	1564	966
"AK097527"	1802	3867	0	0	0	0	0	0	14	0	0	0	0	0	0	0	0	0
"AK097539"	2907	10566	0	0	0	0	0	0	10	0	0	0	0	0	0	0	2	0
"AK097541"	1912	11636	53	0	44	9	0	0	128	0	0	0	0	28	91	74	118	78
"AK097548"	1585	31318	0	280	0	0	141	139	16	494	0	221	0	0	0	9	0	0
"AK097571"	1278	8986	0	0	0	0	0	0	34	0	0	0	1	0	0	0	0	0
"AK097585"	2143	111939	0	0	0	0	0	0	0	0	0	0	0	0	0	0	0	0
"AK097590"	2051	3432	0	0	0	0	0	0	10	0	0	0	0	3	0	0	0	0
"AK097607"	2003	79977	0	0	0	0	0	0	20	0	0	0	0	0	0	0	0	0
"AK097613"	1908	10311	0	0	0	0	0	0	0	0	0	0	0	0	0	0	0	0
"AK097622"	1757	3890	0	0	0	0	0	0	73	12	0	0	0	0	0	0	0	0
"AK097624"	2051	5519	0	0	0	0	0	0	0	0	0	0	0	0	0	0	0	0
"AK097625"	2267	44047	1224	5367	885	339	2856	2511	147	1852	195	1364	18963	25088	13918	18448	4564	24792
"AK097649"	2113	5680	0	0	0	0	0	0	0	0	0	0	0	0	0	0	0	0
"AK097654"	1442	10453	28	22	13	15	22	0	44	63	0	18	811	1060	621	626	606	425
"AK097655"	2103	29484	0	0	0	0	0	0	0	0	0	0	0	0	0	0	0	0
"AK097658"	1607	31878	0	0	0	0	0	0	0	0	0	0	8	11	123	75	156	90
"AK097685"	1674	13218	96	0	56	40	0	0	181	0	0	0	62	40	0	0	0	0
"AK097686"	1364	301170	0	0	0	0	0	0	0	0	0	0	0	0	0	0	0	0
"AK097694"	1771	23529	3111	1488	1765	1346	783	705	1308	1060	2685	2931	0	1	7	0	5	0
"AK097701"	1823	27485	0	0	0	0	0	0	0	0	0	0	0	0	4	0	82	21
"AK097702"	2286	19685	0	0	0	0	0	0	35	33	0	0	0	0	0	0	0	0
"AK097705"	2546	14638	1	1	1	0	1	0	203	80	0	0	6	0	0	0	0	0
"AK097706"	2282	128157	0	0	0	0	0	0	0	0	0	0	0	0	0	0	0	0
"AK097709"	2365	4873	0	0	0	0	0	0	0	0	0	0	0	0	0	0	0	0
"AK097713"	2779	4149	0	0	0	0	0	0	17	0	0	0	0	0	0	0	0	0
"AK097722"	1750	58788	0	0	0	0	0	0	0	0	0	0	0	0	0	0	0	0
"AK097759"	1912	44538	0	0	0	0	0	0	24	9	0	0	301	259	54	54	29	13
"AK097779"	1994	13629	46	0	32	14	0	0	0	0	0	0	2	25	3	0	15	12
"AK097791"	1951	16547	1725	336	908	817	180	156	682	236	1665	173	2519	1938	3279	1750	4212	1970
"AK097794"	1645	25848	0	0	0	0	0	0	31	0	0	13	562	476	267	226	257	219
"AK097800"	507	59216	0	0	0	0	0	0	0	0	0	0	0	0	0	0	0	0
"AK097803"	1684	17447	0	0	0	0	0	0	0	0	0	0	0	0	88	88	72	44
"AK097805"	2650	53092	1	0	0	1	0	0	0	0	0	0	0	0	0	0	0	0
"AK097814"	1810	7291	262	28	151	111	21	7	209	92	295	74	428	192	1694	1028	2274	1226
"AK097816"	1602	24769	0	0	0	0	0	0	0	0	0	0	0	0	0	0	0	0
"AK097820"	1793	144856	0	0	0	0	0	0	262	77	0	0	2	2	0	0	0	0
"AK097829"	2286	5728	0	0	0	0	0	0	0	0	0	0	0	0	0	0	0	0
"AK097836"	1936	8056	0	0	0	0	0	0	0	0	0	0	0	0	0	0	0	0
"AK097853"	1378	7448	0	0	0	0	0	0	0	0	0	0	0	0	0	0	0	0
"AK097866"	2002	2244	0	0	0	0	0	0	0	0	0	0	0	0	0	0	0	0
"AK097891"	1030	1030	0	0	0	0	0	0	0	0	0	0	11	0	0	0	0	0
"AK097893"	2355	5268	0	0	0	0	0	0	0	0	0	0	0	0	0	3	0	0
"AK097902"	2123	20763	0	0	0	0	0	0	0	0	0	0	0	0	0	0	0	0
"AK097910"	2129	2199	0	0	0	0	0	0	0	0	0	0	0	0	0	0	0	0
"AK097921"	542	4498	38	0	38	0	0	0	12	11	0	60	2910	76	4	4	5	2
"AK097922"	1864	2898	0	0	0	0	0	0	0	0	0	0	20	9	0	0	16	0
"AK097927"	2509	8677	0	0	0	0	0	0	0	0	0	0	0	0	0	0	0	0
"AK097934"	2176	6595	0	0	0	0	0	0	38	9	0	0	0	0	0	0	0	0
"AK097952"	1982	17498	21	0	9	12	0	0	0	0	0	0	3	2	0	0	4	0
"AK097957"	2437	3949	0	0	0	0	0	0	8	0	0	0	0	0	1	0	0	0
"AK097964"	2238	2395	1138	162	602	536	78	84	162	48	284	89	691	2149	2603	1998	4371	1952
"AK098017"	2221	4452	0	0	0	0	0	0	136	78	0	0	0	0	0	0	0	0
"AK098067"	2885	2885	266	0	141	125	0	0	180	10	0	15	0	0	0	0	0	0
"AK098095"	2751	2751	109	9	74	35	0	9	97	40	0	30	0	0	486	233	622	244
"AK098126"	2101	19741	0	0	0	0	0	0	0	0	0	0	0	1	0	0	0	0
"AK098198"	1046	13782	0	0	0	0	0	0	16	0	0	0	0	0	0	0	0	0
"AK098200"	1648	2029	0	0	0	0	0	0	0	0	0	0	0	0	0	6	0	0
"AK098230"	2187	37442	1139	566	655	484	300	266	468	351	319	652	31	57	18	36	53	20
"AK098241"	2502	12189	0	0	0	0	0	0	83	10	0	0	0	0	0	0	0	0
"AK098263"	2098	11521	20	0	13	7	0	0	76	18	0	10	2	57	82	70	0	1
"AK098264"	1387	78450	35	36	2	33	18	18	112	0	0	19	514	544	622	441	668	461
"AK098304"	3327	29306	0	0	0	0	0	0	0	14	0	0	0	3	0	13	8	1
"AK098333"	3052	3052	20	0	20	0	0	0	0	0	0	0	0	0	0	0	0	0
"AK098403"	2292	2479	500	121	298	202	63	58	125	206	511	266	311	282	305	290	502	545
"AK098438"	2062	4701	0	0	0	0	0	0	0	0	0	0	0	0	0	0	0	0
"AK098491"	2537	2537	268	108	204	64	67	41	184	103	89	58	386	1703	196	44	306	77
"AK098548"	953	26832	0	0	0	0	0	0	0	0	0	0	0	0	0	0	0	0
"AK098560"	1531	15280	0	0	0	0	0	0	0	0	0	0	0	0	0	0	0	0
"AK098570"	737	9944	0	0	0	0	0	0	0	0	0	0	0	0	0	0	0	0
"AK098638"	1555	5446	6936	3709	449	6487	1249	2460	7201	897	13455	4128	10198	11010	8653	7426	15092	9385
"AK098641"	1648	40188	0	0	0	0	0	0	0	0	0	0	0	0	0	0	0	0
"AK098656"	1341	2895	0	0	0	0	0	0	0	0	0	0	0	0	0	0	0	0
"AK098660"	1696	37137	19	22	0	19	22	0	147	140	0	5	0	1	0	3	0	0
"AK098665"	1754	200153	0	0	0	0	0	0	0	0	0	0	0	0	0	0	0	0
"AK098676"	1661	2046	0	0	0	0	0	0	0	0	0	0	0	0	0	0	0	0
"AK098705"	1493	11725	0	0	0	0	0	0	0	0	0	0	0	0	0	0	0	0
"AK098715"	843	2261	122	29	58	64	10	19	83	23	64	46	340	315	385	298	390	358
"AK098727"	2397	2397	0	0	0	0	0	0	0	10	0	0	0	0	0	0	0	0
"AK098763"	2570	3011	0	0	0	0	0	0	0	0	0	0	0	0	0	0	0	0
"AK098783"	1963	3122	0	0	0	0	0	0	0	0	0	0	0	0	0	0	0	0
"AK098818"	1937	1937	61	0	39	22	0	0	80	17	43	22	3689	0	1444	1170	1687	1300
"AK1"	2271	11263	71	37	31	40	25	12	169	71	0	0	86	57	240	213	163	248
"AK122718"	3034	51243	9	0	4	5	0	0	6	29	10	0	236	261	86	123	129	128
"AK122764"	788	788	0	0	0	0	0	0	0	0	0	0	0	0	0	0	0	0
"AK122786"	1708	33556	0	1	0	0	0	1	0	0	0	1	0	33	0	0	15	0
"AK123067"	1303	18201	0	0	0	0	0	0	0	0	0	0	0	0	0	0	0	0
"AK123100"	1947	40168	152	32	97	55	21	11	140	29	0	0	147	63	9	6	51	3
"AK123120"	1945	40227	0	0	0	0	0	0	0	0	0	0	0	0	0	0	0	0
"AK123141"	3644	3644	1266	473	889	377	259	214	432	210	504	356	1752	1576	274	124	375	219
"AK123177"	1950	2953	514	0	296	218	0	0	163	49	397	0	0	0	0	0	0	0
"AK123181"	2560	6738	901	3276	490	411	1674	1602	262	4420	426	13657	1880	9471	1076	7397	2339	7471
"AK123194"	2248	24868	0	0	0	0	0	0	0	0	0	0	0	0	0	0	0	0
"AK123199"	1739	44604	150	38	72	78	38	0	130	0	0	33	490	351	490	320	627	210
"AK123261"	2470	20846	2	0	0	2	0	0	75	30	0	0	126	121	132	124	105	91
"AK123263"	2802	15720	416	206	202	214	85	121	323	92	0	0	70	176	24	11	134	42
"AK123272"	3165	93746	0	0	0	0	0	0	0	0	0	0	0	0	0	0	0	0
"AK123292"	2817	68642	148	4925	81	67	2629	2296	24	2119	0	1556	717	1563	308	585	528	500
"AK123298"	1957	3038	0	0	0	0	0	0	0	0	0	0	0	0	0	0	0	0
"AK123300"	1413	10507	0	0	0	0	0	0	0	0	0	0	2	1	1	6	11	5
"AK123388"	3430	3430	229	0	104	125	0	0	174	0	49	0	800	164	210	66	332	53
"AK123440"	1643	81225	0	0	0	0	0	0	35	0	0	0	0	0	0	0	0	0
"AK123450"	1705	1705	0	0	0	0	0	0	0	0	0	0	0	0	0	0	0	0
"AK123453"	1657	2000	90	0	44	46	0	0	17	13	0	0	0	0	4	0	0	0
"AK123459"	2040	2040	0	0	0	0	0	0	0	0	0	0	0	4	0	12	0	0
"AK123483"	1967	2762	0	0	0	0	0	0	0	12	0	0	1	2	0	0	0	0
"AK123487"	2264	16036	136	42	45	91	23	19	128	8	0	0	47	50	46	43	59	36
"AK123543"	2667	16798	0	0	0	0	0	0	0	13	0	0	0	0	0	0	0	0
"AK123582"	2556	4497	1	0	0	1	0	0	0	37	0	0	1	0	0	0	0	0
"AK123584"	2800	5265	0	0	0	0	0	0	0	0	0	0	66	33	0	0	0	0
"AK123617"	3472	3472	0	0	0	0	0	0	0	0	0	0	0	0	0	0	0	0
"AK123630"	2217	45767	389	268	217	172	163	105	329	302	183	285	562	1119	394	312	637	341
"AK123632"	611	17533	0	0	0	0	0	0	20	0	0	0	0	0	0	0	0	0
"AK123660"	3181	4133	93	251	5	88	152	99	285	164	57	178	864	158	229	835	276	146
"AK123700"	1916	4186	71	67	71	0	33	34	50	20	0	20	129	250	36	108	82	29
"AK123703"	2074	9373	0	0	0	0	0	0	0	0	0	0	0	0	0	0	0	0
"AK123722"	2230	2389	561	248	316	245	147	101	255	80	275	45	1591	1369	1763	1218	1471	902
"AK123758"	2693	2908	0	0	0	0	0	0	0	0	0	0	0	0	0	0	0	0
"AK123766"	2108	91964	0	0	0	0	0	0	0	0	0	0	0	0	0	0	0	0
"AK123771"	1578	1578	40	0	16	24	0	0	18	12	72	0	862	825	117	67	173	101
"AK123801"	1694	5603	0	0	0	0	0	0	0	0	0	0	0	0	0	0	0	0
"AK123816"	2182	353386	0	0	0	0	0	0	0	0	0	0	0	0	0	0	0	0
"AK123826"	2795	3665	0	0	0	0	0	0	0	0	0	0	1	0	1	0	0	0
"AK123838"	3689	10094	0	0	0	0	0	0	0	0	0	0	0	0	0	0	0	0
"AK123843"	3901	22635	0	0	0	0	0	0	34	0	0	0	0	0	0	0	0	0
"AK123852"	3469	8460	0	0	0	0	0	0	23	27	0	0	0	0	0	0	0	0
"AK123868"	2769	94489	0	0	0	0	0	0	0	0	0	0	0	0	0	0	0	0
"AK123872"	2590	2590	328	19	213	115	19	0	125	41	57	0	93	63	50	0	138	0
"AK123889"	3460	10129	0	0	0	0	0	0	0	0	0	0	0	0	0	0	0	0
"AK123890"	2648	4173	0	0	0	0	0	0	0	0	0	0	7	5	3	9	10	2
"AK123891"	1884	1884	15	0	15	0	0	0	9	12	0	0	0	0	0	0	0	0
"AK123913"	2056	83867	0	0	0	0	0	0	0	0	0	0	0	0	0	0	0	0
"AK123934"	1513	1513	0	0	0	0	0	0	0	0	0	0	0	0	0	0	0	0
"AK123947"	3336	13062	0	0	0	0	0	0	0	0	0	0	0	0	0	0	0	0
"AK123961"	2429	10654	0	0	0	0	0	0	0	0	0	0	0	0	0	0	0	0
"AK123976"	2107	110561	0	0	0	0	0	0	26	0	0	0	0	0	0	0	0	0
"AK124028"	2242	370686	0	0	0	0	0	0	11	8	0	0	9	12	28	36	3	15
"AK124052"	3488	4021	0	0	0	0	0	0	0	0	0	0	10	0	0	12	4	0
"AK124056"	1533	51641	0	0	0	0	0	0	13	10	0	0	0	0	0	0	0	0
"AK124062"	2710	37001	0	0	0	0	0	0	62	0	0	0	207	174	181	145	246	106
"AK124066"	1795	31884	0	0	0	0	0	0	0	0	0	0	0	0	0	0	0	0
"AK124069"	2426	5567	0	0	0	0	0	0	0	12	0	0	0	0	8	12	0	0
"AK124079"	2741	12199	0	0	0	0	0	0	0	28	0	0	0	2	0	0	0	0
"AK124096"	2165	17610	0	0	0	0	0	0	0	0	0	0	0	0	0	0	0	0
"AK124118"	1291	5391	0	0	0	0	0	0	0	0	0	0	0	0	0	0	0	0
"AK124121"	1939	2106	0	0	0	0	0	0	0	0	0	0	0	0	0	0	0	0
"AK124126"	1927	6247	0	0	0	0	0	0	0	0	0	0	0	0	0	0	0	0
"AK124130"	2091	4185	0	0	0	0	0	0	0	0	0	0	0	0	0	53	0	0
"AK124131"	4295	5171	0	0	0	0	0	0	0	0	0	0	0	0	0	0	0	0
"AK124136"	1821	64870	0	9	0	0	9	0	11	0	0	0	0	0	0	0	0	0
"AK124173"	1963	44560	2103	61082	1582	521	32687	28395	57	29269	52	39274	74	92396	55	3728	155	2597
"AK124179"	2092	79208	0	0	0	0	0	0	11	0	0	0	0	0	0	0	0	0
"AK124194"	2914	61569	0	0	0	0	0	0	0	0	0	0	0	0	0	0	0	0
"AK124197"	4053	4053	368	0	209	159	0	0	198	0	278	0	443	191	437	121	615	200
"AK124220"	1166	47267	0	0	0	0	0	0	58	26	0	0	0	0	0	0	3	0
"AK124226"	3093	136592	0	0	0	0	0	0	75	29	0	0	0	0	0	0	0	0
"AK124233"	3597	3597	5080	7386	2875	2205	4054	3332	3091	3283	3480	4519	2657	4566	1529	751	548	276
"AK124256"	2339	9957	0	0	0	0	0	0	0	0	0	0	0	0	0	0	0	0
"AK124262"	2447	10608	0	0	0	0	0	0	0	0	0	0	0	0	0	0	0	0
"AK124272"	2652	16348	0	0	0	0	0	0	0	0	0	0	41	100	102	90	54	4
"AK124295"	1973	5707	0	0	0	0	0	0	48	0	0	0	115	46	0	0	167	22
"AK124304"	3648	3648	0	0	0	0	0	0	0	0	0	0	0	0	0	0	0	0
"AK124308"	1967	2208	0	0	0	0	0	0	0	0	0	0	0	0	0	0	0	0
"AK124326"	1867	3795	0	0	0	0	0	0	0	0	0	0	0	0	0	0	0	0
"AK124327"	1820	7013	0	0	0	0	0	0	22	0	0	0	0	0	0	0	0	0
"AK124342"	2027	3860	24	0	0	24	0	0	59	0	0	0	97	159	252	9	162	6
"AK124349"	2324	34018	0	0	0	0	0	0	0	0	0	0	0	0	0	0	0	0
"AK124399"	2841	4880	0	0	0	0	0	0	0	0	0	0	0	0	0	7	0	14
"AK124400"	2238	28554	0	0	0	0	0	0	0	0	0	0	0	0	0	0	0	0
"AK124409"	2136	41143	0	0	0	0	0	0	0	13	0	0	0	0	0	0	0	0
"AK124433"	2186	2186	0	0	0	0	0	0	0	0	0	0	0	0	0	0	0	0
"AK124439"	1885	8971	0	0	0	0	0	0	13	0	0	0	0	0	0	0	0	0
"AK124484"	1510	45340	4858	3267	2772	2086	1682	1585	1877	1351	2017	2421	67	79	52	30	71	71
"AK124653"	3229	3229	0	0	0	0	0	0	0	0	0	0	0	0	0	0	0	0
"AK124673"	4439	4439	0	0	0	0	0	0	0	0	0	0	0	0	0	0	0	0
"AK124680"	2309	2309	14	0	14	0	0	0	22	7	0	0	0	64	0	0	0	0
"AK124682"	3883	10040	0	0	0	0	0	0	27	0	0	0	0	0	0	0	0	0
"AK124708"	3245	14647	0	0	0	0	0	0	51	0	0	0	0	0	0	0	0	0
"AK124757"	3529	151715	1394	61	843	551	53	8	1140	107	56	20	1208	750	1347	629	1249	455
"AK124776"	4061	4061	0	0	0	0	0	0	0	0	0	0	0	0	0	0	0	0
"AK124820"	2616	4963	511	66	188	323	16	50	0	50	0	56	41	37	1	1	53	35
"AK124832"	2648	5858	0	0	0	0	0	0	0	0	0	0	0	0	0	0	0	0
"AK124857"	2687	63504	0	0	0	0	0	0	0	0	0	0	0	0	0	0	0	0
"AK124888"	3420	12329	582	1304	345	237	906	398	382	649	39	1831	0	11	0	0	0	0
"AK124893"	3725	18437	0	0	0	0	0	0	0	0	0	0	0	0	0	0	0	0
"AK124897"	3700	231975	0	0	0	0	0	0	92	0	0	0	17	17	120	112	12	16
"AK124928"	3512	48501	0	0	0	0	0	0	72	0	0	0	1	3	0	0	0	0
"AK124943"	1838	18770	0	0	0	0	0	0	0	0	0	0	0	0	0	0	4	0
"AK124950"	1864	2119	0	0	0	0	0	0	0	0	0	0	0	0	3	1	0	0
"AK124961"	2961	195693	0	0	0	0	0	0	0	0	0	0	3	4	0	5	14	0
"AK124970"	2672	8211	271	27	160	111	12	15	249	38	48	93	114	47	55	0	87	3
"AK124973"	1831	7222	74	15	46	28	15	0	117	54	0	58	1970	1505	1042	927	680	662
"AK125001"	1770	275718	0	0	0	0	0	0	0	0	0	17	0	0	0	0	0	0
"AK125018"	4499	198932	0	0	0	0	0	0	0	12	0	0	0	0	20	14	40	0
"AK125042"	4370	58143	0	0	0	0	0	0	0	0	0	0	0	0	0	0	0	0
"AK125051"	5129	6453	0	35	0	0	35	0	0	96	0	0	0	175	0	1	0	0
"AK125078"	850	106548	0	0	0	0	0	0	56	18	0	0	0	0	0	0	0	0
"AK125083"	1241	2493	0	0	0	0	0	0	64	0	0	0	4	2	0	9	0	0
"AK125128"	3743	55882	0	0	0	0	0	0	0	0	0	0	0	0	0	0	0	0
"AK125149"	2797	47839	0	0	0	0	0	0	0	0	0	0	0	0	34	32	90	65
"AK125216"	2025	73986	13	14	13	0	7	7	10	0	0	0	5	41	0	3	0	0
"AK125237"	647	30064	0	0	0	0	0	0	0	0	0	0	0	0	0	0	0	0
"AK125248"	2375	148584	0	0	0	0	0	0	17	0	7	0	9	30	1052	868	1052	683
"AK125257"	1333	125740	0	0	0	0	0	0	0	0	0	0	0	0	0	0	0	0
"AK125288"	2010	5644	0	0	0	0	0	0	0	0	0	0	0	0	0	0	0	0
"AK125301"	2526	40548	63	13421	29	34	8343	5078	13	6674	21020	13764	543	168	1862	1405	1673	626
"AK125305"	2528	44664	0	0	0	0	0	0	0	0	0	0	0	0	0	0	0	0
"AK125310"	2133	11224	0	0	0	0	0	0	0	0	0	0	0	0	0	0	0	0
"AK125311"	1950	9245	0	0	0	0	0	0	0	0	0	0	0	0	0	0	0	0
"AK125313"	2602	14788	3	0	0	3	0	0	43	0	0	0	32	40	643	385	457	364
"AK125333"	5979	9107	0	0	0	0	0	0	0	0	0	0	0	0	0	0	0	0
"AK125357"	3576	6244	0	0	0	0	0	0	0	0	0	0	63	23	28	0	0	0
"AK125393"	862	1077	0	0	0	0	0	0	18	8	0	0	0	0	18	12	16	0
"AK125397"	1469	15200	0	0	0	0	0	0	0	0	0	0	0	0	0	0	0	3
"AK125412"	2377	8278	671	312	366	305	184	128	302	238	127	442	3139	2773	4281	4068	5756	4074
"AK125429"	4372	43896	0	0	0	0	0	0	8	0	0	0	0	0	0	0	0	0
"AK125436"	1827	10041	0	0	0	0	0	0	0	0	0	0	0	0	0	4	3	0
"AK125437"	3729	3729	0	0	0	0	0	0	44	14	0	0	0	0	0	0	0	0
"AK125463"	2578	25054	465	84	318	147	53	31	319	133	9	171	427	682	764	622	849	658
"AK125489"	1932	15054	46	0	29	17	0	0	53	0	45	39	19	0	0	8	0	41
"AK125500"	2759	40065	2271	1236	1534	737	681	555	591	758	662	1764	807	1091	1150	1216	1599	1179
"AK125516"	2980	3275	1	0	1	0	0	0	13	9	0	0	14	24	21	27	24	12
"AK125532"	2430	27477	0	0	0	0	0	0	0	0	0	0	0	0	0	0	0	0
"AK125537"	1701	2456	175	0	105	70	0	0	51	3	95	177	76	29	62	43	144	46
"AK125558"	3013	18335	403	216	232	171	119	97	214	39	0	128	681	722	564	5	706	11
"AK125594"	2027	30980	0	0	0	0	0	0	0	0	0	0	0	0	6	0	0	0
"AK125599"	2311	3907	10	56	10	0	56	0	0	0	0	329	0	0	2	16	5	9
"AK125646"	3482	37024	5090	1315	2892	2198	683	632	1586	145	2419	734	846	551	440	271	670	231
"AK125672"	1799	1892	151	50	85	66	34	16	163	90	50	151	130	139	234	152	338	176
"AK125676"	1396	39218	69	0	27	42	0	0	92	0	0	0	238	183	235	118	245	98
"AK125684"	1924	2737	0	0	0	0	0	0	0	0	0	0	0	0	0	0	0	0
"AK125686"	1588	38851	164	0	0	164	0	0	0	181	0	0	4	0	0	0	4	0
"AK125699"	2684	2684	307	79	226	81	57	22	106	171	0	77	146	75	0	0	0	0
"AK125701"	1740	1740	0	0	0	0	0	0	0	21	0	0	40	41	59	34	62	41
"AK125723"	1955	123250	758	5200	491	267	2921	2279	322	1578	53	3068	13	276	0	10	4	4
"AK125726"	1575	38666	217	0	141	76	0	0	201	54	43	24	259	186	311	258	312	267
"AK125727"	1679	4986	13189	1467	7201	5988	774	693	1146	570	2604	1259	9843	8728	5979	4459	10230	6512
"AK125733"	1779	120400	0	0	0	0	0	0	0	0	0	0	0	0	0	0	0	0
"AK125748"	2127	102194	0	0	0	0	0	0	0	0	0	0	0	0	0	0	0	0
"AK125749"	1655	219202	0	0	0	0	0	0	548	161	0	0	0	0	0	0	0	0
"AK125759"	1841	135550	1792	1048	1054	738	570	478	810	305	279	348	122	136	70	26	50	8
"AK125769"	1969	2845	0	0	0	0	0	0	0	0	0	0	0	0	0	0	0	0
"AK125775"	2719	38801	0	0	0	0	0	0	45	9	0	0	203	146	228	152	213	120
"AK125792"	1418	1418	0	0	0	0	0	0	0	0	0	0	117	178	1631	2474	2097	1636
"AK125818"	3908	3908	207	76	97	110	37	39	122	62	0	32	617	490	763	493	841	559
"AK125821"	4232	33308	0	0	0	0	0	0	41	8	0	0	0	8	0	0	0	0
"AK125832"	1288	57257	1250	135	678	572	42	93	697	82	418	253	55	31	295	218	396	204
"AK125849"	5257	10822	0	0	0	0	0	0	26	12	0	0	0	0	0	0	0	0
"AK125858"	5307	16124	0	0	0	0	0	0	8	0	0	0	0	0	0	0	0	0
"AK125860"	4078	4562	3439	1491	1341	2098	965	526	2148	1133	2595	1639	215	285	153	228	349	162
"AK125871"	4289	9398	617	105	331	286	60	45	366	37	164	0	0	0	0	0	0	0
"AK125884"	4122	48245	456	1667	289	167	898	769	175	703	0	950	8572	10612	9843	14380	13638	9533
"AK125932"	4401	16244	1	0	0	1	0	0	0	0	0	0	17	14	0	0	0	0
"AK125951"	3939	21718	0	0	0	0	0	0	0	0	0	0	0	0	0	0	0	0
"AK125955"	3462	6066	0	0	0	0	0	0	0	0	0	0	0	0	0	0	0	0
"AK125960"	3664	4787	618	36	358	260	17	19	92	13	0	23	0	0	57	38	0	0
"AK125965"	2875	13874	0	0	0	0	0	0	160	90	0	0	0	1	10	4	10	4
"AK125982"	3874	6145	0	0	0	0	0	0	0	0	0	0	0	0	0	0	0	0
"AK125994"	3029	15842	0	0	0	0	0	0	0	0	0	0	0	0	0	0	0	0
"AK125996"	3964	8095	0	0	0	0	0	0	0	0	0	0	0	0	0	0	0	0
"AK126075"	3188	65640	0	0	0	0	0	0	1	0	0	0	0	0	0	0	0	0
"AK126080"	3226	6731	0	0	0	0	0	0	0	0	0	0	0	0	0	0	0	0
"AK126168"	1943	12238	0	0	0	0	0	0	0	0	0	0	0	0	0	0	0	0
"AK126180"	2372	2372	148	0	66	82	0	0	27	0	64	0	7	92	106	91	126	88
"AK126199"	2670	9316	0	5	0	0	5	0	58	9	0	3	0	0	0	0	0	0
"AK126213"	1779	1779	0	0	0	0	0	0	0	0	0	0	0	0	0	0	0	0
"AK126245"	1993	2703	12	0	0	12	0	0	39	0	32	0	127	59	0	0	0	0
"AK126248"	2069	2646	0	9	0	0	0	9	0	0	0	0	0	0	0	383	30	0
"AK126253"	2043	4685	0	0	0	0	0	0	0	0	0	0	0	0	0	0	0	0
"AK126266"	2728	24608	458	18	355	103	18	0	974	78	58	27	123	25	80	74	46	28
"AK126278"	1940	1940	587	545	363	224	205	340	256	1164	62	549	141	199	147	173	234	121
"AK126286"	2809	25545	349	10	209	140	0	10	363	125	0	0	62	26	33	0	140	7
"AK126307"	3953	309786	0	0	0	0	0	0	0	0	0	0	0	0	0	0	0	0
"AK126318"	4724	5808	2268	641	631	1637	433	208	447	283	218	242	439	314	504	112	706	147
"AK126334"	3820	55882	0	0	0	0	0	0	0	0	0	0	0	0	0	0	0	0
"AK126351"	4071	76667	0	0	0	0	0	0	53	18	0	0	92	106	154	134	190	128
"AK126380"	4687	4687	2	0	0	2	0	0	71	50	0	0	0	0	0	0	0	0
"AK126420"	2497	2497	230	153	124	106	82	71	143	75	162	177	411	465	987	818	1249	118
"AK126429"	2321	7497	0	0	0	0	0	0	45	16	0	0	0	0	0	0	0	0
"AK126491"	3845	132405	0	0	0	0	0	0	175	69	0	0	2	0	0	0	0	0
"AK126511"	3908	4826	12	0	12	0	0	0	26	0	0	0	21	12	25	0	0	0
"AK126532"	2951	3193	311	194	173	138	79	115	107	85	72	239	0	1805	1984	2066	2364	1743
"AK126539"	3575	49566	41	6871	33	8	3723	3148	246	2381	0	1484	0	0	0	8	3	5
"AK126569"	2983	28123	0	0	0	0	0	0	0	11	0	0	0	0	0	0	0	0
"AK126616"	1033	6697	0	0	0	0	0	0	13	0	0	0	0	0	0	0	0	0
"AK126635"	1829	1829	83	0	61	22	0	0	162	53	0	0	0	14	0	0	51	0
"AK126656"	3230	3897	243	196	121	122	101	95	151	173	191	343	266	269	205	181	384	130
"AK126693"	3574	4299	237	14	136	101	0	14	116	19	292	83	425	251	380	208	736	478
"AK126717"	966	966	0	0	0	0	0	0	0	0	0	0	0	0	0	0	0	0
"AK126744"	3213	4341	0	0	0	0	0	0	41	12	0	0	0	0	0	0	0	0
"AK126798"	2495	7256	0	0	0	0	0	0	0	1	147	110	0	0	198	226	263	199
"AK126814"	1884	7867	0	0	0	0	0	0	0	0	0	0	0	0	0	0	0	0
"AK126817"	1829	18313	0	0	0	0	0	0	0	0	0	0	0	4	0	5	4	0
"AK126833"	2297	6191	2102	5891	880	1222	3623	2268	360	902	891	3328	184	1106	292	726	268	306
"AK126852"	3470	12920	0	0	0	0	0	0	126	21	0	0	0	0	0	0	0	0
"AK127026"	3409	3836	0	0	0	0	0	0	0	0	0	0	0	0	0	751	1006	665
"AK127048"	4483	4633	541	302	295	246	154	148	315	455	439	406	0	0	0	0	0	0
"AK127065"	1273	5663	112	0	54	58	0	0	84	20	116	51	120	70	126	83	189	108
"AK127087"	3741	3741	18	17	0	18	6	11	17	17	0	0	0	0	484	457	0	0
"AK127120"	4521	12381	0	0	0	0	0	0	0	0	0	0	0	0	0	0	0	0
"AK127124"	1462	77745	0	0	0	0	0	0	132	18	0	0	0	0	0	0	0	0
"AK127151"	2513	9681	0	0	0	0	0	0	0	0	0	0	0	0	0	0	0	0
"AK127155"	1886	3223	41	0	17	24	0	0	19	0	0	0	0	16	30	0	36	32
"AK127179"	2333	2452	0	0	0	0	0	0	0	0	0	0	0	0	0	0	10	0
"AK127190"	3449	4026	0	0	0	0	0	0	17	0	0	0	7	0	4	0	0	0
"AK127191"	2910	9642	0	0	0	0	0	0	0	0	0	0	0	0	0	0	0	0
"AK127207"	3888	6900	78	0	44	34	0	0	13	0	0	0	190	192	199	197	239	178
"AK127224"	4489	4489	5	11	5	0	11	0	0	56	0	2	1	27	0	50	1	9
"AK127238"	5622	242097	1060	15	622	438	15	0	1306	125	0	131	0	5	0	1	1	5
"AK127260"	5282	5792	0	0	0	0	0	0	0	0	0	0	29	41	0	0	4	0
"AK127270"	4066	153967	0	0	0	0	0	0	0	0	0	0	0	0	0	0	0	0
"AK127292"	4919	41851	0	0	0	0	0	0	11	0	0	0	0	0	0	0	0	0
"AK127309"	3068	3068	0	0	0	0	0	0	0	0	0	0	0	0	0	0	0	0
"AK127318"	4413	89865	0	0	0	0	0	0	0	12	0	0	0	0	20	14	40	0
"AK127339"	4818	4818	306	66	181	125	54	12	318	279	365	349	28	16	79	50	145	25
"AK127347"	3333	3333	0	0	0	0	0	0	17	16	0	0	0	0	0	0	0	0
"AK127352"	5332	11496	8205	2082	4468	3737	961	1121	1081	5086	4597	12214	283	23673	18766	408	1582	267
"AK127378"	1004	1004	0	0	0	0	0	0	0	0	0	0	0	0	0	0	0	0
"AK127380"	1759	44563	0	0	0	0	0	0	0	0	0	0	0	0	0	0	0	0
"AK127400"	2194	54997	0	0	0	0	0	0	0	0	0	0	0	0	0	0	0	0
"AK127443"	3036	3036	5823	3357	3277	2546	1465	1892	2186	468	1332	1076	8776	10136	11367	8805	11328	8258
"AK127460"	4599	6405	0	0	0	0	0	0	52	15	0	0	0	0	0	0	0	0
"AK127472"	3584	742195	0	0	0	0	0	0	21	0	0	0	0	0	0	0	0	1
"AK127555"	3130	3130	597	201	433	164	118	83	229	92	58	73	1429	1404	559	884	1339	1051
"AK127557"	3127	3872	0	0	0	0	0	0	0	4	0	0	0	0	0	0	0	0
"AK127578"	2352	121278	44	67	26	18	41	26	101	98	0	70	7	5	0	0	4	0
"AK127609"	2098	3183	392	279	389	3	151	128	317	191	117	0	72	59	142	100	157	81
"AK127627"	2310	42155	0	0	0	0	0	0	0	0	0	0	0	0	0	0	0	0
"AK127673"	2376	2510	18	184	10	8	96	88	275	52	649	233	119	97	113	135	233	155
"AK127696"	2320	27981	53	23	15	38	12	11	340	72	75	0	36	29	10	8	88	0
"AK127697"	2928	21853	0	0	0	0	0	0	0	0	0	0	0	0	0	0	0	0
"AK127787"	4073	4996	0	0	0	0	0	0	0	0	0	0	0	0	0	0	0	0
"AK127846"	4045	5653	0	0	0	0	0	0	0	0	0	0	0	0	0	0	0	0
"AK127877"	2733	15366	1184	102	50	1134	74	28	260	440	2666	396	118	453	709	846	744	553
"AK127888"	1357	258787	0	0	0	0	0	0	0	0	0	0	0	0	0	0	0	0
"AK127889"	2166	15500	141	31	89	52	16	15	128	26	0	24	151	19	159	11	193	83
"AK127910"	2561	2561	1249	413	828	421	140	273	691	341	246	108	17795	15800	9713	12128	6749	6564
"AK127919"	3135	4976	15	0	14	1	0	0	79	71	62	0	328	0	356	0	436	404
"AK127963"	1954	159101	0	0	0	0	0	0	0	0	0	0	199	253	0	0	0	0
"AK127966"	2472	3978	0	0	0	0	0	0	0	0	0	0	0	0	0	0	0	0
"AK127969"	3228	15280	0	0	0	0	0	0	0	0	0	0	0	0	0	0	0	0
"AK127974"	2341	9377	0	0	0	0	0	0	0	0	0	0	0	0	0	0	0	0
"AK127982"	1830	23697	18	0	9	9	0	0	99	0	0	0	3	4	10	13	7	1
"AK127989"	3640	3640	0	0	0	0	0	0	25	0	0	0	202	207	0	0	0	0
"AK128013"	1967	17297	34	0	16	18	0	0	19	0	0	0	0	0	36	3	19	0
"AK128037"	4948	143848	0	0	0	0	0	0	0	0	0	0	0	0	0	0	0	0
"AK128059"	4343	7012	0	0	0	0	0	0	0	0	0	0	0	0	0	0	0	0
"AK128099"	3317	11235	0	0	0	0	0	0	0	0	0	0	0	0	0	0	0	0
"AK128136"	2524	8861	0	0	0	0	0	0	26	0	0	0	0	0	0	0	0	0
"AK128153"	2909	3700	11	19	11	0	0	19	57	72	0	30	0	0	0	0	14	0
"AK128161"	3425	164677	0	0	0	0	0	0	11	0	0	0	0	0	0	0	0	0
"AK128202"	3541	8833	0	0	0	0	0	0	0	10	0	0	0	0	0	0	0	0
"AK128216"	3267	45557	10	0	4	6	0	0	20	0	0	0	157	222	173	172	173	145
"AK128245"	1897	6454	40	0	40	0	0	0	88	0	0	0	30	0	12	10	30	16
"AK128252"	3756	3756	312	23	179	133	23	0	164	63	394	104	518	388	560	423	0	0
"AK128266"	3389	4317	0	0	0	0	0	0	93	43	0	0	0	0	0	0	0	0
"AK128329"	3371	75690	0	4	0	0	1	3	264	161	0	2	1	0	0	0	0	0
"AK128346"	2735	11925	5350	4376	2721	2629	2745	1631	3929	1679	5182	2891	1173	1621	148	72	420	166
"AK128353"	2848	5894	0	87	0	0	58	29	35	111	0	197	0	9	0	0	0	0
"AK128382"	3470	3470	230	0	106	124	0	0	226	18	0	37	29	115	353	336	351	316
"AK128390"	2142	58092	0	0	0	0	0	0	0	0	0	0	0	0	0	0	0	0
"AK128396"	3674	3674	222	102	110	112	59	43	109	73	0	57	720	245	235	109	304	74
"AK128400"	3994	3994	2473	16631	999	1474	11768	4863	1130	6	1086	8092	53	2	116	640	173	1548
"AK128414"	3226	24647	0	0	0	0	0	0	224	157	0	0	0	0	0	0	0	0
"AK128439"	3610	3610	1179	7	5	1174	3	4	3	875	1026	1	1	1426	0	61	0	1
"AK128486"	1629	61386	1	0	1	0	0	0	0	0	0	0	0	0	0	0	0	0
"AK128525"	3600	3600	0	0	0	0	0	0	0	9	0	0	139	152	86	102	193	183
"AK128532"	3327	5238	1010	1098	579	431	568	530	436	1701	852	7259	912	1061	1398	1462	2187	1505
"AK128534"	1847	6249	0	0	0	0	0	0	0	0	0	0	0	0	0	0	0	0
"AK128559"	3399	11052	447	608	198	249	343	265	272	283	163	470	404	361	291	260	317	219
"AK128569"	2711	77608	12	1	0	12	1	0	48	25	0	18	19	9	47	32	0	4
"AK128619"	4470	4470	558	189	269	289	110	79	273	124	289	232	12	23	22	0	0	0
"AK128656"	2323	2323	0	0	0	0	0	0	0	5	10	5	6	2	8	8	7	11
"AK128673"	3260	3611	0	4	0	0	3	1	0	12	0	0	0	0	0	0	0	0
"AK128703"	5253	11840	0	0	0	0	0	0	17	9	0	0	0	0	0	0	0	0
"AK128707"	4620	26096	0	0	0	0	0	0	0	0	0	0	0	0	0	0	0	0
"AK128708"	5090	5090	56	329	27	29	216	113	55	174	0	142	144	476	34	172	57	23
"AK128724"	3373	4172	0	0	0	0	0	0	0	0	0	0	0	0	0	0	0	0
"AK128734"	5473	5473	873	4519	658	215	2404	2115	288	2973	112	4737	333	879	530	651	674	365
"AK128777"	4879	4879	15	0	15	0	0	0	43	0	0	0	297	165	357	177	452	255
"AK128818"	1517	2973	0	0	0	0	0	0	0	0	0	0	0	0	0	0	0	0
"AK128833"	3534	6501	0	0	0	0	0	0	61	27	0	0	0	1	0	0	0	0
"AK128837"	3283	8458	0	0	0	0	0	0	0	0	0	0	0	0	0	0	0	0
"AK128864"	2705	3752	0	0	0	0	0	0	103	38	0	0	0	0	0	0	0	0
"AK128874"	309	4287	100	0	57	43	0	0	61	0	10	0	185	78	350	83	276	131
"AK128880"	580	31903	0	0	0	0	0	0	0	0	0	0	0	1	0	0	0	0
"AK129550"	2588	3326	0	0	0	0	0	0	25	18	0	0	0	14	4	16	0	9
"AK129567"	1898	24728	0	0	0	0	0	0	0	0	0	0	0	0	0	0	0	0
"AK129672"	2376	2376	0	0	0	0	0	0	0	0	0	0	0	0	0	0	0	0
"AK129756"	1601	10074	0	0	0	0	0	0	26	0	0	0	0	0	0	0	0	0
"AK129763"	2255	189476	0	0	0	0	0	0	257	42	0	0	0	0	0	0	0	0
"AK129926"	856	930	9	0	9	0	0	0	33	0	0	0	0	0	0	0	0	0
"AK129982"	2439	129730	2106	1111	1164	942	628	483	1347	707	782	1124	0	78	13	11	14	4
"AK130076"	1771	1771	540	280	291	249	156	124	149	351	146	328	7	59	0	0	0	0
"AK130099"	2783	37001	0	0	0	0	0	0	62	0	0	0	207	174	181	145	246	106
"AK130329"	4135	4135	2264	1689	0	2264	895	794	2780	781	4329	2252	8519	7717	768	306	912	448
"AK130400"	2345	2345	0	0	0	0	0	0	0	0	0	0	0	0	0	0	0	0
"AK130481"	1854	1854	0	0	0	0	0	0	34	0	0	0	149	131	163	126	162	98
"AK130486"	2091	2091	0	0	0	0	0	0	24	21	0	0	77	45	35	0	38	0
"AK130719"	2529	19563	15	10	15	0	0	10	205	30	62	0	0	10	8	8	15	8
"AK130758"	1829	14110	0	0	0	0	0	0	0	0	0	0	0	0	0	0	0	0
"AK130765"	2004	2216	0	0	0	0	0	0	0	0	0	0	0	0	0	0	0	0
"AK130864"	792	8047	190	31	127	63	16	15	303	27	0	0	32	0	13	3	11	8
"AK130904"	3866	3866	0	0	0	0	0	0	0	0	0	0	1	0	0	0	0	0
"AK130911"	1590	30034	365	155	232	133	101	54	379	93	121	91	0	0	0	0	0	0
"AK130926"	4905	5103	0	0	0	0	0	0	18	1	0	0	0	0	0	0	0	0
"AK130974"	673	6428	0	0	0	0	0	0	0	0	0	0	0	0	0	0	0	0
"AK131017"	2034	27976	6444	3024	3626	2818	1581	1443	2563	1022	3297	1340	279	124	20	2	229	73
"AK131020"	404	16955	0	0	0	0	0	0	0	0	0	0	379	457	204	157	190	101
"AK131021"	547	1812	0	0	0	0	0	0	0	0	0	0	0	0	0	0	0	0
"AK131224"	713	6380	0	0	0	0	0	0	0	0	0	0	0	0	0	0	0	0
"AK131288"	1573	11849	32	0	20	12	0	0	98	12	0	0	7	6	5	16	11	9
"AK131325"	3045	52837	1	0	1	0	0	0	0	0	0	0	0	0	0	0	3	0
"AK131347"	2738	4099	0	0	0	0	0	0	0	0	0	0	0	0	0	0	0	0
"AK131472"	3207	32988	8	0	8	0	0	0	15	0	0	25	334	400	0	0	0	0
"AK131516"	800	1773	0	17	0	0	17	0	0	20	0	0	0	0	0	0	0	0
"AK131520"	2068	5151	0	0	0	0	0	0	0	0	0	0	0	0	0	0	0	0
"AK172755"	4716	4716	547	785	287	260	426	359	234	391	68	558	0	0	0	0	0	0
"AK2"	3613	28908	3388	1451	1936	1452	761	690	1793	624	2176	1418	4321	5282	5061	4147	1310	4457
"AK225487"	1057	2474	0	0	0	0	0	0	0	0	0	0	0	0	0	0	0	0
"AK225940"	1043	2589	0	0	0	0	0	0	0	0	0	0	0	0	0	0	0	0
"AK289390"	2436	2436	52	0	37	15	0	0	21	0	0	0	676	0	221	35	371	197
"AK289488"	532	30633	0	0	0	0	0	0	68	0	0	0	0	0	0	0	0	0
"AK291391"	2787	4054	0	0	0	0	0	0	12	0	0	0	0	0	0	0	0	0
"AK291611"	1115	5291	12	0	0	12	0	0	0	0	0	0	446	149	187	83	201	151
"AK293020"	376	376	5	0	3	2	0	0	0	3	0	7	10	209926	0	0	2422	2319
"AK293540"	1713	61437	11	61	11	0	53	8	11	98	0	22	0	20	0	0	0	0
"AK293718"	1014	4115	0	0	0	0	0	0	0	0	0	0	0	0	0	0	0	0
"AK293862"	1207	3978	419	54	221	198	25	29	184	241	153	248	0	1	0	0	0	0
"AK294004"	499	1336	0	0	0	0	0	0	0	0	0	0	127	213	97	250	327	308
"AK294034"	1315	9256	0	0	0	0	0	0	17	0	0	0	0	0	0	0	0	0
"AK294171"	779	4137	0	1	0	0	0	1	21	27	0	0	0	0	0	0	0	1
"AK294518"	1271	302616	0	0	0	0	0	0	424	146	0	0	2	0	0	0	0	0
"AK294743"	3772	10240	1587	1284	1155	432	624	660	786	363	2983	1954	2044	2066	2141	2164	2504	1888
"AK294819"	986	84124	26	0	10	16	0	0	30	0	0	0	36	52	360	241	263	259
"AK294825"	1238	3459	0	0	0	0	0	0	0	0	0	0	0	0	63	72	80	69
"AK294844"	1802	170429	0	0	0	0	0	0	0	0	0	0	0	0	0	0	0	0
"AK294973"	1598	3176	0	0	0	0	0	0	0	0	0	0	0	0	0	0	0	0
"AK295403"	1620	23238	0	0	0	0	0	0	0	0	0	0	0	0	0	7	13	10
"AK295617"	3644	11381	0	0	0	0	0	0	0	0	0	0	0	0	1	0	0	0
"AK295639"	1966	35318	0	0	0	0	0	0	0	0	0	0	0	0	3337	7646	3745	2773
"AK295707"	370	1181	0	0	0	0	0	0	0	15	0	0	5	28	8	5	14	13
"AK295837"	637	637	0	0	0	0	0	0	15	1	0	0	0	2	1	1	13	0
"AK296065"	1231	1789	67	59	33	34	37	22	135	66	38	0	895	605	606	601	1161	730
"AK296148"	1179	3767	0	0	0	0	0	0	0	0	0	0	0	0	0	0	0	0
"AK296220"	1502	18249	889	79	454	435	55	24	625	90	310	95	421	325	547	331	679	364
"AK296254"	1087	29484	0	0	0	0	0	0	9	0	0	0	0	0	0	0	0	0
"AK296276"	1134	26396	0	0	0	0	0	0	14	0	0	0	0	0	0	0	0	0
"AK296298"	997	114563	40	0	28	12	0	0	84	25	0	24	18	9	0	0	9	0
"AK296854"	646	1973	0	0	0	0	0	0	0	16	0	0	0	2	0	5	0	0
"AK296966"	4265	53250	2785	1627	1516	1269	919	708	1609	588	595	561	2220	3185	2178	1842	2742	1242
"AK297272"	1141	3407	1157	158	380	777	86	72	194	89	577	191	296	309	486	341	815	361
"AK297683"	1126	118808	0	0	0	0	0	0	10	0	0	0	0	0	0	0	0	0
"AK297837"	770	4350	0	0	0	0	0	0	0	0	0	0	0	0	0	0	0	0
"AK297919"	2117	2117	388	390	213	175	166	224	41	138	331	772	0	0	135	116	164	126
"AK298018"	1439	45334	0	0	0	0	0	0	0	29	0	0	0	0	0	0	0	0
"AK298043"	946	78277	0	0	0	0	0	0	154	26	0	0	115	198	121	106	161	87
"AK298056"	2333	2404	24	60	13	11	0	60	42	93	0	23	1784	4561	11474	44294	11319	39637
"AK298300"	433	10440	0	0	0	0	0	0	0	0	0	0	0	0	0	0	0	0
"AK298596"	1202	4727	30	0	13	17	0	0	132	36	0	0	52	62	59	49	116	68
"AK299427"	743	7313	326	331	190	136	186	145	200	174	63	311	0	0	0	0	0	0
"AK299432"	473	473	119	0	85	34	0	0	345	0	0	23	141	64	224	120	181	110
"AK299452"	938	47526	12	0	0	12	0	0	9	0	0	0	23	0	20	0	28	0
"AK299501"	1479	1479	445	192	253	192	121	71	432	54	91	90	411	423	313	0	450	335
"AK299774"	1164	2140	0	219	0	0	121	98	25	1004	17	0	4	0	8	8	5	5
"AK3"	2647	30071	236	35	114	122	17	18	114	82	34	0	1055	1102	763	666	931	696
"AK300121"	1229	7845	0	0	0	0	0	0	25	9	0	0	0	0	0	0	0	0
"AK300387"	1224	12025	0	0	0	0	0	0	10	0	0	0	0	0	0	0	0	0
"AK300656"	1015	5058	0	0	0	0	0	0	0	0	0	0	8	12	0	0	0	0
"AK300962"	1167	1167	0	0	0	0	0	0	0	0	0	0	0	0	0	0	0	0
"AK301093"	972	972	313	4049	0	313	2238	1811	352	3315	80	0	0	739	445	607	367	316
"AK301230"	2768	28763	0	0	0	0	0	0	17	0	0	0	41	10	8	0	0	0
"AK301549"	728	1804	0	0	0	0	0	0	0	15	0	0	0	0	0	0	0	0
"AK301679"	1015	1699	0	0	0	0	0	0	12	0	0	0	0	0	0	0	0	0
"AK301806"	1784	35494	4171	2251	2495	1676	1274	977	1672	730	756	590	1880	1777	265	170	265	146
"AK301885"	1627	389408	0	0	0	0	0	0	0	0	0	0	0	0	13206	15022	17939	14910
"AK301968"	453	1951	0	0	0	0	0	0	0	0	0	0	0	0	0	0	0	0
"AK302092"	1650	6716	0	0	0	0	0	0	0	0	0	0	0	0	0	3	15	5
"AK302238"	989	3543	0	0	0	0	0	0	0	0	0	0	0	0	0	0	0	0
"AK302306"	1118	6385	0	0	0	0	0	0	0	0	0	0	0	0	0	0	0	0
"AK302451"	1597	4554	0	0	0	0	0	0	0	0	0	0	0	0	0	0	0	0
"AK302471"	1439	53745	0	0	0	0	0	0	0	0	0	0	0	0	0	0	3	0
"AK302503"	1005	1554	0	0	0	0	0	0	14	9	0	0	0	0	0	0	0	0
"AK302511"	2067	9036	0	0	0	0	0	0	11	0	207	155	0	0	93	234	518	173
"AK302545"	850	16182	0	0	0	0	0	0	0	0	0	0	0	0	0	0	0	0
"AK302694"	1693	24741	0	0	0	0	0	0	0	0	0	0	0	0	0	0	7	0
"AK302734"	1034	16421	27	8	14	13	8	0	43	0	0	0	282	297	253	215	285	197
"AK302783"	3235	24064	0	0	0	0	0	0	0	0	0	0	0	0	0	0	0	0
"AK302879"	1194	7652	0	0	0	0	0	0	25	0	0	0	0	0	0	0	0	0
"AK303166"	1762	740742	38227	11822	20950	17277	6320	5502	15075	6411	31052	11299	113163	103113	78637	68485	109439	66889
"AK303289"	2882	4490	0	0	0	0	0	0	0	0	0	0	0	0	0	0	0	0
"AK303295"	980	51545	10	0	10	0	0	0	29	218	0	17	2	27	8	11	0	2
"AK303306"	925	3129	196	386	99	97	170	216	80	378	138	659	637	3249	1541	5119	4847	2272
"AK303423"	1042	5375	0	139	0	0	65	74	15	56	0	0	0	93	0	20	0	0
"AK303607"	998	1482	0	0	0	0	0	0	0	0	0	0	0	0	0	0	0	324
"AK303953"	1225	57000	16	0	16	0	0	0	25	0	0	0	1722	1410	2224	1635	2445	1595
"AK304304"	1580	2352	0	0	0	0	0	0	0	0	0	0	0	0	0	0	0	0
"AK304427"	1542	209926	49997	65294	27901	22096	35113	30181	16443	25117	19078	50863	1649	8965	907	863	1042	5076
"AK304483"	1713	3216	0	0	0	0	0	0	0	0	0	0	0	0	0	0	0	0
"AK304759"	275	275	99	1	61	38	0	1	31	0	89	1	0	0	0	0	0	0
"AK304826"	2662	7327	59	0	30	29	0	0	87	26	272	164	21	28	1200	1255	1820	1208
"AK307134"	2016	58578	0	0	0	0	0	0	0	0	0	0	0	0	0	0	0	0
"AK307154"	1128	59678	0	0	0	0	0	0	43	0	0	0	0	0	0	0	4	0
"AK307158"	1763	3312	15	8	0	15	0	8	87	75	0	0	42	57	31	55	48	58
"AK307172"	919	1137	23	126	23	0	41	85	61	137	0	128	340	339	371	490	344	210
"AK307192"	1036	11333	0	0	0	0	0	0	149	108	0	18	185	169	581	613	301	328
"AK307207"	1127	64708	300	85	147	153	46	39	316	81	0	27	25	41	13	10	0	0
"AK307208"	906	1851	17	0	0	17	0	0	72	0	0	0	87	16	116	41	77	81
"AK307209"	2664	57107	0	0	0	0	0	0	0	0	0	0	0	0	0	0	0	0
"AK307233"	2103	2103	343	757	2	341	420	337	310	639	280	730	2	4333	3766	4084	5238	3776
"AK307246"	1381	6017	4	11	3	1	11	0	74	43	4	0	20570	2545	12441	1944	3339	2462
"AK307291"	1565	8063	8981	4423	5042	3939	4363	60	3299	5900	2084	3901	57	113	80	68	97	54
"AK307308"	1008	2747	0	0	0	0	0	0	0	0	0	0	0	0	0	0	0	0
"AK307324"	2117	27444	0	0	0	0	0	0	0	0	0	0	0	0	0	0	0	0
"AK307331"	1092	69143	0	0	0	0	0	0	0	0	0	0	0	0	0	0	3	0
"AK307870"	1570	9300	34	0	23	11	0	0	18	10	9	16	12	24	589	657	950	433
"AK308309"	1243	1651	0	0	0	0	0	0	0	0	0	0	0	0	503	543	404	237
"AK308439"	664	664	0	0	0	0	0	0	0	0	0	0	0	0	0	0	0	0
"AK308497"	2573	2573	427	26	252	175	26	0	102	37	193	39	0	0	0	0	0	0
"AK308544"	561	25374	0	0	0	0	0	0	0	0	0	0	0	0	0	2	0	0
"AK308561"	1598	3438	866	158	456	410	88	70	774	379	459	24	245	251	206	67	207	51
"AK308580"	1621	4540	0	0	0	0	0	0	44	42	0	0	0	0	1	0	2	5
"AK308605"	1693	1693	0	0	0	0	0	0	0	0	0	0	0	0	0	0	0	0
"AK308634"	1540	34626	100	0	60	40	0	0	271	63	0	0	0	8	6	0	4	0
"AK308635"	1140	10017	0	0	0	0	0	0	0	0	0	0	0	10	1275	1301	1878	1339
"AK308637"	1109	1852	150	0	85	65	0	0	183	120	143	0	13	0	140	57	48	42
"AK308652"	374	374	0	0	0	0	0	0	0	0	0	0	0	0	0	0	0	0
"AK308660"	2647	57107	0	0	0	0	0	0	0	0	0	0	0	0	0	0	0	0
"AK308669"	1007	42174	0	0	0	0	0	0	375	179	0	0	0	0	0	0	0	0
"AK308704"	379	1251	0	0	0	0	0	0	0	0	0	0	8	0	41	33	57	21
"AK308867"	1220	5567	39	0	6	33	0	0	30	0	0	0	12	0	24	3	9	7
"AK308944"	1958	9270	0	0	0	0	0	0	23	0	0	0	0	0	0	0	0	0
"AK308965"	869	869	0	0	0	0	0	0	0	0	0	0	0	25	0	39	0	165
"AK309024"	1304	30212	0	0	0	0	0	0	0	0	0	0	0	0	946	500	1733	491
"AK309109"	1110	2752	0	0	0	0	0	0	0	0	0	0	0	0	0	0	0	0
"AK309218"	3689	515441	10614	4708	5972	4642	2642	2066	2803	1381	1471	4102	63	99	4	0	0	0
"AK309234"	984	3177	0	0	0	0	0	0	0	0	0	0	0	0	0	0	0	0
"AK309255"	1954	8460	34	0	23	11	0	0	18	10	9	16	12	24	589	576	950	433
"AK309286"	1344	46619	174	31	98	76	16	15	163	33	0	24	151	19	159	11	197	83
"AK309314"	1066	8508	577	214	310	267	109	105	167	113	526	156	348	467	277	258	403	70
"AK309325"	1196	15791	499	215	323	176	78	137	225	163	162	283	209	381	85	100	135	24
"AK309406"	2120	5321	45	0	26	19	0	0	43	22	0	0	75	97	40	0	30	0
"AK309441"	977	1293	0	0	0	0	0	0	0	0	0	0	0	0	0	0	0	0
"AK309452"	3684	5151	0	0	0	0	0	0	0	27	0	0	70	193	148	354	132	148
"AK309476"	1007	42610	2	0	2	0	0	0	8	0	0	0	54	19	587	158	693	233
"AK309620"	878	31327	0	0	0	0	0	0	0	0	0	0	0	0	0	0	0	0
"AK309664"	1607	5431	0	0	0	0	0	0	14	74	0	0	0	77531	0	5	13	7
"AK309685"	2669	10835	0	0	0	0	0	0	0	0	0	0	0	0	0	0	0	0
"AK309717"	899	35222	0	0	0	0	0	0	0	0	0	0	0	0	0	0	0	0
"AK309726"	1080	249471	0	0	0	0	0	0	0	0	0	0	0	0	0	0	0	0
"AK309744"	1141	26141	0	0	0	0	0	0	0	0	0	0	0	0	0	0	0	0
"AK309762"	3842	3842	204	28	93	111	21	7	209	92	231	74	428	192	1694	1025	2274	1226
"AK309867"	746	6291	102	60	63	39	32	28	50	81	0	50	34	39	33	42	45	30
"AK309874"	2102	136540	372	197	177	195	119	78	858	299	0	653	9	11	9	0	10	9
"AK309896"	1074	39853	0	0	0	0	0	0	10	16	0	0	15	15	0	0	0	0
"AK309922"	1220	60759	0	0	0	0	0	0	0	0	0	0	0	0	0	0	0	0
"AK309946"	1034	208419	12412	3181	6845	5567	1778	1403	6543	1480	5264	1420	1017	857	949	633	900	569
"AK310013"	2600	94483	0	0	0	0	0	0	0	0	0	0	0	0	0	0	0	0
"AK310030"	1129	1774	58	20	36	22	10	10	55	0	0	0	32	21	19	64	114	31
"AK310041"	1214	1394	0	0	0	0	0	0	0	0	0	0	10	0	27	5	36	11
"AK310046"	395	395	10231	40	5536	4695	0	40	3265	5265	4547	13633	35495	43848	14281	14830	13835	12783
"AK310110"	1077	7265	116	98	78	38	73	25	30	0	0	0	77	156	29	38	69	39
"AK310146"	1851	5126	0	0	0	0	0	0	34	16	0	0	202	134	126	123	88	12
"AK310226"	1847	1847	3	0	2	1	0	0	34	0	0	0	91	0	124	74	131	62
"AK310228"	2352	4701	0	0	0	0	0	0	0	0	0	0	0	0	264	94	247	212
"AK310237"	1411	1555	409	0	245	164	0	0	82	11	0	0	31	32	19	54	37	55
"AK310239"	896	1029	0	52	0	0	23	29	57	25	50	37	3	16	8	8	10	71
"AK310266"	982	2090	15	0	15	0	0	0	26	29	0	31	59	62	75	66	113	76
"AK310300"	1233	42334	0	0	0	0	0	0	0	0	0	0	2	0	0	0	0	0
"AK310313"	1029	2383	0	0	0	0	0	0	9	0	0	0	0	0	5	53	38	50
"AK310350"	678	2355	0	15	0	0	15	0	9	25	0	0	1	26	0	23	0	0
"AK310432"	1093	10489	0	0	0	0	0	0	110	37	0	0	0	0	0	0	0	0
"AK310441"	1154	26085	0	0	0	0	0	0	0	0	0	0	0	0	0	0	0	0
"AK310493"	1235	4474	0	23	0	0	23	0	31	13	0	52	0	0	0	0	0	0
"AK310497"	2475	228266	56	65	30	26	42	23	186	39	0	24	491	812	12	0	159	1
"AK310526"	1077	4355	0	0	0	0	0	0	0	0	0	0	0	0	27	9	42	25
"AK310642"	1786	33219	0	0	0	0	0	0	0	0	0	0	0	0	80	72	50	23
"AK310665"	1238	6480	20	0	11	9	0	0	31	10	0	0	14	100	60	113	125	92
"AK310745"	919	12857	1367	363	830	537	245	118	743	345	371	319	11	9	95	91	95	61
"AK310751"	688	5498	0	0	0	0	0	0	0	0	0	17	0	0	21	64	64	54
"AK310794"	814	1529	129	21	75	54	0	21	69	33	0	0	113	89	96	39	126	59
"AK310876"	1266	10906	0	0	0	0	0	0	0	0	0	0	0	0	0	0	0	0
"AK310947"	1683	18167	0	13	0	0	13	0	29	308	0	0	0	0	0	14	0	0
"AK311005"	1244	4206	1443	1766	815	628	809	957	515	3761	469	1388	1810	2836	779	1160	901	752
"AK311103"	3982	8995	0	0	0	0	0	0	0	0	0	0	0	0	3	9	0	0
"AK311108"	1129	18829	0	0	0	0	0	0	0	0	0	0	0	0	0	0	5	0
"AK311113"	2866	12238	0	0	0	0	0	0	0	0	0	0	0	0	1	0	0	0
"AK311115"	1173	1269	0	0	0	0	0	0	0	0	147	68	0	0	0	0	209	0
"AK311120"	1386	1386	0	0	0	0	0	0	0	0	0	0	0	0	0	0	0	0
"AK311131"	1193	6221	267	23	166	101	23	0	160	107	86	127	217	351	25	0	38	0
"AK311159"	1484	8765	0	0	0	0	0	0	0	0	0	0	3	0	0	0	0	0
"AK311167"	989	40818	440	19	261	179	19	0	335	19	0	29	70	70	382	190	407	200
"AK311181"	1115	254847	341	65	185	156	42	23	572	209	132	49	491	832	20	17	169	9
"AK311189"	995	6633	0	0	0	0	0	0	0	0	0	0	0	0	0	0	0	0
"AK311208"	1832	24350	3986	4427	2130	1856	2351	2076	1120	2362	1376	4111	1967	2869	2800	2711	3360	2506
"AK311212"	1250	9401	0	0	0	0	0	0	0	0	0	0	0	0	0	0	0	0
"AK311218"	2019	41336	0	0	0	0	0	0	27	0	0	0	0	0	0	0	0	0
"AK311235"	3964	71675	511	9	302	209	9	0	616	37	0	0	14	42	131	90	1	11
"AK311257"	850	30152	0	127	0	0	91	36	375	369	0	472	10	40	0	84	0	33
"AK311282"	2195	2195	326	37	163	163	15	22	182	81	196	80	0	0	0	0	0	0
"AK311291"	1089	4124	0	0	0	0	0	0	0	0	0	0	0	0	0	0	0	0
"AK311306"	1803	16085	1889	1875	1075	814	1030	845	657	844	374	1619	1765	2294	2299	1987	2631	1752
"AK311310"	1575	27497	0	0	0	0	0	0	10	0	0	0	0	0	0	0	0	0
"AK311311"	1841	24350	3986	4427	2130	1856	2351	2076	1120	2362	1376	4111	1967	2869	2800	2711	3360	2506
"AK311328"	901	1543	156	93	88	68	45	48	95	34	57	63	3519	3636	3421	3208	4668	3143
"AK311342"	1048	356761	0	0	0	0	0	0	10	0	0	0	0	0	0	0	0	0
"AK311345"	2363	265440	63198	43260	35248	27950	23355	19905	28755	18907	44075	38305	3651	4191	1912	1514	1708	653
"AK311356"	854	1503	14	37	0	14	0	37	14	45	0	15	5	94	0	9	10	0
"AK311374"	1235	1979	0	0	0	0	0	0	0	0	17	0	0	5	355	55	567	302
"AK311380"	2081	10044	211	108	106	105	58	50	377	163	386	37	407	428	78	77	101	19
"AK311383"	1225	1949	0	0	0	0	0	0	0	0	0	0	0	0	1	1	0	1
"AK311398"	991	25977	1253	111	663	590	45	66	783	110	830	117	459	243	244	34	345	35
"AK311400"	1172	2101	0	0	0	0	0	0	0	0	0	0	0	0	0	0	0	0
"AK311445"	645	2241	22	73	12	10	42	31	3	37	0	0	11	13	19	12	14	11
"AK311458"	975	93604	0	0	0	0	0	0	0	0	0	0	1	0	0	0	0	0
"AK311469"	1143	7869	0	0	0	0	0	0	0	0	0	0	0	0	0	0	0	0
"AK311558"	466	1745	0	0	0	0	0	0	0	0	0	0	0	0	0	0	0	0
"AK311573"	1601	144399	0	0	0	0	0	0	21	17	0	0	0	0	0	0	0	0
"AK311578"	1001	1099	0	0	0	0	0	0	0	87	0	0	17	3	15	21	174	5
"AK311622"	701	1235	0	0	0	0	0	0	0	0	0	0	0	0	7	106	122	0
"AK311627"	1645	1980	434	161	233	201	91	70	248	124	301	133	538	406	4325	2425	5751	2673
"AK311642"	1234	45334	0	0	0	0	0	0	0	29	0	0	0	0	0	0	0	0
"AK311646"	1525	82225	371	1657	224	147	416	1241	106	296	314	2245	688	734	395	780	551	925
"AK311660"	1025	1633	0	0	0	0	0	0	0	0	0	0	0	0	48	43	51	22
"AK313893"	742	742	145	30	98	47	30	0	97	7	0	62	0	10	63	36	0	7
"AK3L1"	2349	79662	11	288	11	0	161	127	46	798	0	902	73	123	295	450	489	321
"AK5"	3948	277367	21	0	21	0	0	0	0	0	0	0	0	0	0	0	0	0
"AK7"	2666	96666	4	0	0	4	0	0	0	0	0	0	0	0	0	0	0	0
"AKAP1"	4030	35576	1381	239	768	613	140	99	791	186	334	129	1221	767	1318	672	1616	922
"AKAP10"	2929	72379	6631	1243	3838	2793	702	541	2495	636	3158	1542	1491	595	768	487	888	479
"AKAP11"	9932	51115	6960	1263	3837	3123	722	541	3004	463	1089	458	5346	6608	4795	3143	5130	2455
"AKAP12"	8437	118560	620	2167	364	256	1165	1002	280	1024	0	1785	1920	2107	3148	2901	2226	1695
"AKAP12 variant protein"	3188	33028	487	1239	289	198	642	597	102	463	0	638	1879	2075	3055	2817	2163	1665
"AKAP13"	13339	368717	17814	12026	10065	7749	6658	5368	9149	5115	5269	9399	7738	7548	8949	6078	11647	6293
"AKAP14"	846	24743	0	3	0	0	2	1	0	0	0	0	0	0	0	0	0	0
"AKAP2"	6907	123815	605	4402	345	260	2342	2060	545	3860	0	2088	446	685	830	1658	908	648
"AKAP3"	3039	29683	0	0	0	0	0	0	0	0	0	0	0	198	0	0	0	0
"AKAP4"	2887	10255	0	0	0	0	0	0	11	0	0	0	0	0	0	0	0	0
"AKAP5"	6488	9005	724	284	380	344	140	144	414	237	316	31	3006	2700	3847	2020	3958	1786
"AKAP6"	10400	503790	0	0	0	0	0	0	0	0	0	0	0	0	0	0	0	0
"AKAP7"	2895	147804	0	13	0	0	13	0	134	231	0	0	127	146	139	126	125	120
"AKAP8"	3539	26264	2404	2882	1311	1093	1494	1388	703	1467	1166	2679	1089	1198	1133	940	1332	672
"AKAP8L"	2128	38976	2578	1504	1387	1191	897	607	1078	1273	1730	2097	923	868	1641	993	2000	1117
"AKAP9"	12512	169799	3661	1387	2026	1635	812	575	2119	720	265	818	1972	2646	2409	2477	2882	1785
"AKD1"	6367	198358	64	40	38	26	40	0	52	18	0	38	86	92	92	62	63	19
"AKIRIN1"	2729	14821	3568	2447	1971	1597	1274	1173	1083	1198	2752	4146	4201	6210	4645	5307	5301	4936
"AKIRIN2"	1936	27408	3769	3960	2162	1607	2121	1839	1520	1453	1189	3622	880	757	1087	1611	2227	1754
"AKNA"	7460	53812	9624	3641	5204	4420	1938	1703	4040	2323	5447	4186	3044	2650	3331	2654	5070	2897
"AKR1A1"	1757	17257	1558	543	880	678	323	220	663	538	715	1067	2604	2524	3659	3134	4771	2596
"AKR1B1"	1927	16783	0	14	0	0	14	0	63	53	0	15	147	101	742	766	906	698
"AKR1B10"	1605	13823	0	0	0	0	0	0	0	10	0	0	0	0	0	0	0	0
"AKR1B15"	1345	30453	0	0	0	0	0	0	11	0	0	0	0	0	0	0	0	0
"AKR1C1"	2050	85363	9	36	7	2	8	28	142	55	0	6	12	26	7	24	11	14
"AKR1C2"	1600	28243	9	35	7	2	20	15	142	58	0	6	17	38	7	52	24	20
"AKR1C3"	1345	144424	8	20	6	2	20	0	42	21	0	6	29	45	25	71	38	34
"AKR1C4"	1201	22114	7	0	0	7	0	0	0	0	0	0	0	0	0	0	0	0
"AKR1CL1"	2135	30497	1	0	0	1	0	0	0	0	0	0	0	0	0	0	0	0
"AKR1CL2"	1723	199207	94	48	65	29	20	28	701	104	0	6	102	86	44	81	114	83
"AKR1D1"	2702	41857	0	0	0	0	0	0	0	0	0	0	0	0	0	0	0	0
"AKR1E2"	1684	21849	30	0	18	12	0	0	273	22	0	0	80	46	37	29	90	63
"AKR7A2"	1369	8183	78	0	65	13	0	0	197	64	0	0	505	399	465	787	541	369
"AKR7A3"	1248	6225	0	0	0	0	0	0	0	0	0	0	0	0	14	6	8	18
"AKR7L"	2319	8094	0	0	0	0	0	0	0	10	0	0	0	0	13	25	12	0
"AKT1"	3403	24251	3813	605	2000	1813	258	347	1177	773	3893	1714	6020	3210	7849	3946	6512	3256
"AKT1S1"	2377	8281	3818	16167	2425	1393	1369	14798	563	1335	716	383	1089	6495	972	5155	846	3872
"AKT2"	5338	12986	1494	389	809	685	195	194	1168	989	833	1234	2127	2245	2988	2307	3929	2551
"AKT3"	3632	340102	2061	7602	1181	880	4182	3420	1377	4758	350	5814	615	712	432	383	590	337
"AKTIP"	2231	11979	195	126	113	82	74	52	114	9	22	0	1277	1649	1484	1247	1759	1166
"AL049219"	2448	2448	0	0	0	0	0	0	19	17	0	0	653	821	1146	960	1180	829
"AL049675"	1078	17907	297	28	151	146	0	28	246	47	0	33	641	656	856	718	908	611
"AL049935"	5929	5929	921	657	554	367	152	505	348	73	459	1184	3031	3289	1997	714	3560	2061
"AL050000"	4229	4229	365	90	213	152	55	35	501	97	143	194	387	1365	472	91	519	68
"AL050035"	1290	6458	9	0	0	9	0	0	68	0	0	0	142	130	16	11	72	14
"AL050085"	658	4775	358	83	217	141	49	34	230	112	0	138	18	0	5	1	2	0
"AL050132"	1758	77946	0	0	0	0	0	0	10	0	0	0	0	0	0	0	20	0
"AL050141"	713	2783	0	0	0	0	0	0	0	0	0	0	0	0	3072	5425	4041	2449
"AL050203"	551	1565	0	0	0	0	0	0	11	0	0	0	0	0	0	0	0	0
"AL079291"	1737	1737	0	0	0	0	0	0	0	0	0	0	0	0	23	0	0	0
"AL096727"	1683	89184	0	0	0	0	0	0	53	26	0	0	0	0	13	7	33	20
"AL109700"	2605	2605	0	0	0	0	0	0	0	0	0	0	0	0	0	0	0	0
"AL109792"	2901	2901	0	0	0	0	0	0	0	0	0	0	0	0	0	0	0	0
"AL110163"	2918	2918	1868	1099	789	1079	265	834	1138	734	0	593	4477	4749	5013	3555	5109	2641
"AL110181"	1765	1765	0	0	0	0	0	0	0	0	0	0	84	71	46	39	79	58
"AL117485"	4926	8170	0	0	0	0	0	0	10	0	0	0	0	0	5	5	15	30
"AL117630"	963	5607	0	0	0	0	0	0	0	0	0	0	0	0	0	0	0	0
"AL133111"	5572	10310	1084	523	673	411	281	242	711	250	252	185	401	770	716	534	986	659
"AL133568"	2163	45324	0	3	0	0	0	3	0	0	0	0	6	19	16	10	12	9
"AL137270"	4990	21760	0	0	0	0	0	0	0	0	0	0	0	0	0	0	0	0
"AL137366"	332	907	0	0	0	0	0	0	0	0	0	0	0	10	0	9	0	2
"AL137382"	1074	1785	0	0	0	0	0	0	0	10	0	0	0	0	0	0	0	0
"AL137445"	1424	8477	2330	600	1233	1097	331	269	3707	297	892	128	78	105	0	0	0	0
"AL137535"	1947	3390	149	0	84	65	0	0	22	0	0	0	56	81	3	0	61	0
"AL137595"	3940	11353	0	0	0	0	0	0	0	0	0	0	0	0	0	0	0	0
"AL137655"	2178	18562	0	0	0	0	0	0	0	0	0	0	0	1	983	1005	1135	672
"AL137733"	3856	45436	0	0	0	0	0	0	20	0	0	0	0	0	0	0	5	0
"AL137752"	1694	6172	0	0	0	0	0	0	98	84	0	9	455	357	194	70	756	363
"AL157440"	3535	3659	22	0	22	0	0	0	100	0	0	0	0	10	38	20	27	0
"AL162052"	1964	5924	0	0	0	0	0	0	0	0	0	0	0	0	0	0	0	0
"AL355711"	1816	1816	841	0	473	368	0	0	610	50	68	0	1377	859	739	114	2328	883
"AL357213"	3529	3529	331	63	54	277	55	8	355	0	326	0	958	660	380	181	448	193
"AL359605"	3748	3748	0	0	0	0	0	0	8	0	0	0	0	0	0	0	0	0
"AL359653"	1000	1576	1726	22	935	791	22	0	490	0	283	0	103	0	0	25	0	0
"AL360260"	2037	2037	257	66	116	141	39	27	73	64	292	50	45	39	71	31	185	44
"AL389983"	1187	1187	84	0	46	38	0	0	45	0	0	0	47	45	39	42	88	35
"AL390170"	1686	1686	0	0	0	0	0	0	0	0	0	0	0	0	0	0	0	0
"AL831889"	2672	4103	4420	4961	4420	0	0	4961	0	4659	2579	7949	64	107	167	142	178	129
"AL831948"	2969	23044	273	12	171	102	0	12	682	90	62	0	136	101	63	70	306	131
"AL831954"	4581	21169	0	0	0	0	0	0	0	0	0	0	22	0	22	7	17	15
"AL831977"	5003	5322	0	0	0	0	0	0	0	0	0	0	0	0	0	1	0	1
"AL832007"	5343	114443	0	0	0	0	0	0	11	0	0	0	0	1	0	0	0	0
"AL832096"	2412	32154	0	0	0	0	0	0	0	0	0	0	0	0	0	0	0	0
"AL832161"	2736	2736	0	0	0	0	0	0	0	0	0	0	0	0	0	0	0	0
"AL832184"	2291	293015	0	0	0	0	0	0	10	11	0	0	0	0	0	0	0	0
"AL832252"	3361	23287	0	0	0	0	0	0	20	0	0	0	0	0	0	0	0	0
"AL832262"	3425	3425	120	0	73	47	0	0	196	0	0	0	21	38	0	0	0	0
"AL832282"	1743	2147	0	70	0	0	44	26	15	77	0	31	0	54	30	32	0	28
"AL832378"	5893	13926	0	0	0	0	0	0	0	0	0	0	0	0	0	0	0	0
"AL832384"	4821	4821	0	0	0	0	0	0	0	0	0	0	0	0	0	1	0	1
"AL832412"	2954	4321	623	362	342	281	196	166	562	184	324	119	865	788	585	461	723	422
"AL832439"	3118	19918	2172	1410	1320	852	763	647	1158	1026	114	387	524	999	124	107	198	132
"AL832447"	6594	7107	0	0	0	0	0	0	33	29	0	0	0	0	0	0	0	0
"AL832481"	2487	2537	1527	771	880	647	330	441	313	578	1113	766	2453	3410	3059	3578	4426	3303
"AL832593"	4510	5278	584	156	347	237	66	90	241	157	117	168	113	101	227	177	836	173
"AL832615"	1605	1605	0	0	0	0	0	0	0	0	0	0	0	0	0	0	0	0
"AL832737"	3873	16666	0	0	0	0	0	0	34	11	0	0	0	0	0	0	0	0
"AL832786"	4048	35710	1673	343	937	736	225	118	934	270	315	211	369	318	231	137	282	99
"AL832797"	2444	2563	0	0	0	0	0	0	0	0	0	0	0	0	0	0	0	0
"AL832834"	2412	6881	0	0	0	0	0	0	0	0	0	0	0	0	0	0	3	1
"AL832909"	2235	2235	435	350	244	191	346	4	199	346	277	265	3492	4743	3604	2646	3869	2564
"AL833139"	1742	40856	0	0	0	0	0	0	0	0	0	0	0	0	0	0	0	0
"AL833146"	2089	17953	0	0	0	0	0	0	0	0	0	0	0	0	0	0	0	0
"AL833150"	1568	1568	39	11	18	21	0	11	43	36	0	0	69	54	0	0	20	0
"AL833181"	3719	3719	1987	2578	1885	102	1394	1184	0	1805	392	0	0	0	3	42	0	7
"AL833246"	4407	29949	0	0	0	0	0	0	67	11	0	20	0	0	0	0	3	0
"AL833346"	3390	3390	0	0	0	0	0	0	28	0	0	0	0	0	0	0	0	0
"AL833363"	4126	4200	161	61	92	69	27	34	142	66	75	78	35	19	59	29	44	31
"AL833455"	3940	3940	252	177	180	72	94	83	151	37	0	0	0	1883	0	1	0	957
"AL833509"	3847	7565	613	214	344	269	62	152	478	191	82	711	273	821	117	73	164	71
"AL833583"	5019	115634	48	6	35	13	4	2	399	83	0	0	0	0	61	28	19	7
"AL833634"	1886	4131	0	0	0	0	0	0	0	0	0	0	0	0	0	0	0	0
"AL953854.2-002"	2648	16796	0	0	0	0	0	0	0	0	0	0	0	0	0	0	0	0
"ALAD"	3360	15027	217	9	164	53	9	0	69	34	68	0	1363	1331	1571	1337	2054	1425
"ALAS1"	2447	16229	481	428	270	211	222	206	338	504	242	533	1630	2520	2435	3789	2790	2408
"ALAS2"	2037	22010	0	0	0	0	0	0	12	0	0	0	1040	714	0	0	0	0
"ALB"	2260	17157	0	0	0	0	0	0	0	0	0	0	0	0	0	0	0	0
"ALCAM"	4756	210032	40053	277632	22201	17852	150365	127267	10530	122638	8179	114194	5672	8185	8198	9510	6750	6336
"ALDH1"	1490	24942	0	0	0	0	0	0	0	0	0	0	112	96	293	321	315	227
"ALDH16A1"	3122	17833	444	97	225	219	65	32	392	91	255	10	1398	859	799	760	1086	753
"ALDH18A1"	3480	50882	0	0	0	0	0	0	0	0	0	0	80	84	121	115	125	93
"ALDH1A1"	2108	52383	1	0	1	0	0	0	0	0	0	0	144	121	382	499	412	316
"ALDH1A2"	3493	112280	2165	12528	1159	1006	6794	5734	1247	6837	271	10374	5978	8583	11209	19843	5379	9291
"ALDH1A3"	3506	36821	352	10	209	143	0	10	335	112	0	7	62	24	33	0	133	6
"ALDH1B1"	3024	5955	0	0	0	0	0	0	11	54	0	0	458	730	267	526	227	164
"ALDH1L1"	3148	77079	0	0	0	0	0	0	138	84	0	0	0	0	0	0	0	0
"ALDH1L2"	7560	64779	202	8	88	114	8	0	268	55	0	0	496	422	34	27	391	107
"ALDH2"	2411	43438	96	51	58	38	12	39	177	108	3	101	1314	1525	1920	1690	2431	1552
"ALDH3A1"	2393	6447	0	0	0	0	0	0	30	0	0	0	0	0	0	0	0	0
"ALDH3A2"	3838	28846	1434	63	782	652	49	14	864	91	481	4	2452	2291	3442	2990	3194	2164
"ALDH3B1"	4991	13152	967	29	508	459	0	29	706	85	689	39	2120	1666	2323	1728	2581	1550
"ALDH3B2"	2659	12470	0	0	0	0	0	0	50	25	0	0	0	0	0	0	0	0
"ALDH4A1"	3396	31369	218	53	135	83	53	0	478	270	47	50	370	273	503	411	600	500
"ALDH5A1"	5180	42239	135	0	96	39	0	0	35	4	0	0	1182	1153	925	792	810	644
"ALDH6A1"	2353	24324	0	0	0	0	0	0	43	0	0	0	138	180	379	290	382	199
"ALDH7A1"	3569	52166	0	0	0	0	0	0	0	0	0	0	6	0	17	20	54	41
"ALDH8A1"	2548	32717	0	0	0	0	0	0	0	0	0	0	0	0	0	0	0	0
"ALDH9A1"	2511	36453	378	32	212	166	18	14	248	79	100	28	1833	1764	2079	1860	2224	1386
"ALDOA"	2436	17264	1132	906	645	487	449	457	555	513	832	792	20243	18273	23197	27040	30245	24232
"ALDOB"	2435	15222	0	0	0	0	0	0	0	0	0	0	0	0	0	0	0	0
"ALDOC"	1659	3819	113	0	61	52	0	0	536	37	0	3	156	134	76	49	112	90
"ALG-2"	860	1748	382	74	274	108	35	39	40	139	253	72	86	90	136	91	160	103
"ALG1"	4930	53677	517	28	274	243	28	0	770	105	175	10	1388	716	1086	1216	1433	1309
"ALG10"	11259	12960	35	0	35	0	0	0	77	0	0	0	327	319	253	118	262	84
"ALG10B"	10076	12972	35	0	35	0	0	0	40	0	0	0	215	203	130	41	174	22
"ALG11"	6496	21186	521	29	313	208	25	4	360	54	16	37	1417	1684	1289	844	1574	966
"ALG12"	2381	15252	302	73	139	163	44	29	292	158	11	68	117	91	397	284	409	329
"ALG13"	3904	79179	5717	3989	3086	2631	2265	1724	3237	1914	2019	2758	764	1160	834	917	1228	904
"ALG14"	1061	90230	20	0	11	9	0	0	129	0	0	0	159	67	191	179	218	177
"ALG1L"	811	7766	0	0	0	0	0	0	0	0	0	0	0	0	0	0	0	0
"ALG1L2"	976	16560	0	0	0	0	0	0	0	16	0	0	0	0	0	0	0	0
"ALG2"	2991	5540	323	255	199	124	116	139	190	221	0	174	1573	2065	1489	1903	1832	1343
"ALG3"	1615	7198	36	0	21	15	0	0	55	13	0	0	428	312	703	504	715	483
"ALG5"	1358	49596	365	28	216	149	21	7	230	90	0	28	438	449	600	563	664	514
"ALG6"	3391	70973	15	24	0	15	15	9	140	8	0	16	242	316	178	172	211	137
"ALG8"	1757	38713	1021	131	561	460	89	42	481	109	268	113	587	749	669	781	823	693
"ALG9"	7053	97235	27	0	19	8	0	0	153	0	15	15	384	380	407	242	425	260
"ALK"	6248	728793	417	0	251	166	0	0	374	58	178	64	0	0	0	0	0	0
"ALKBH1"	2591	35609	352	170	170	182	93	77	273	378	0	365	282	357	317	259	344	206
"ALKBH2"	1201	5302	0	0	0	0	0	0	27	0	0	0	38	24	73	36	112	45
"ALKBH3"	1579	39470	467	59	253	214	20	39	441	14	9	0	331	428	325	267	381	278
"ALKBH4"	2061	8593	14	0	7	7	0	0	132	27	0	0	227	59	169	20	182	49
"ALKBH5"	3435	26400	1421	214	766	655	103	111	701	100	523	118	2697	1905	2556	1603	3749	2378
"ALKBH6"	1035	3951	85	4	23	62	0	4	136	40	0	8	128	152	190	116	261	156
"ALKBH7"	1114	2598	5	0	5	0	0	0	35	21	0	0	377	391	657	599	879	613
"ALKBH8"	4078	63009	69	0	49	20	0	0	69	15	0	0	244	228	236	152	240	85
"ALLC"	1871	8049	0	0	0	0	0	0	86	25	0	0	0	0	0	0	0	0
"ALMS1"	12945	224162	4528	3160	2472	2056	1708	1452	2963	1619	319	819	1240	1806	971	996	1558	823
"ALMS1P"	1597	40648	0	10	0	0	10	0	0	1	0	0	1	2	0	0	4	0
"ALOX12"	2371	14672	1272	973	636	636	554	419	460	441	797	1630	288	204	369	330	545	185
"ALOX12B"	2517	15069	0	0	0	0	0	0	90	41	0	0	0	0	0	0	0	0
"ALOX12E"	2781	46774	0	0	0	0	0	0	39	18	0	0	0	0	0	0	0	0
"ALOX15"	2844	11011	22074	15341	2049	20025	8272	7069	18700	4482	44947	15345	24482	41932	120514	117764	116648	75780
"ALOX15B"	3008	10086	0	10	0	0	5	5	74	39	0	5	42	55	117	234	98	113
"ALOX5"	2564	71934	42	17	29	13	0	17	194	69	14	0	254	274	688	693	631	319
"ALOX5AP"	1224	50943	24	185	24	0	129	56	34	78	10	437	370	534	378	393	837	566
"ALOXE3"	3376	22590	0	0	0	0	0	0	168	77	0	0	0	0	0	0	0	0
"ALPI"	2571	3840	0	0	0	0	0	0	26	30	0	0	0	0	0	0	0	0
"ALPK1"	5736	60209	8365	5391	4590	3775	3020	2371	4129	2458	2258	3861	1183	1549	1166	913	1199	870
"ALPK2"	7311	147707	0	0	0	0	0	0	72	0	0	0	0	0	0	0	0	0
"ALPK3"	10929	56802	0	0	0	0	0	0	102	45	0	15	0	0	0	0	0	1
"ALPL"	2607	69048	7	2	5	2	0	2	125	37	0	0	0	0	0	0	0	0
"ALPP"	2876	4251	0	0	0	0	0	0	14	0	0	0	0	0	0	0	0	0
"ALPPL2"	2503	3872	0	0	0	0	0	0	0	8	0	0	0	0	0	0	0	0
"ALS2"	6951	80910	254	104	125	129	74	30	388	69	66	97	478	544	808	622	841	488
"ALS2CL"	5033	24494	0	0	0	0	0	0	153	110	0	0	0	0	0	0	0	0
"ALS2CR10"	1048	17505	11471	93805	6844	4627	50514	43291	1447	50815	4045	84688	642	54903	356	5287	527	3157
"ALS2CR11"	5705	131746	0	0	0	0	0	0	12	0	0	0	0	1	0	0	0	0
"ALS2CR12"	2123	68955	138	26	85	53	22	4	104	63	0	0	0	40	14	7	4	0
"ALS2CR16"	982	47611	60	630	25	35	361	269	57	420	21	259	9	37	20	36	12	12
"ALS2CR17"	923	17742	19	15	0	19	6	9	26	12	0	0	344	476	290	213	321	50
"ALS2CR4"	5406	23319	0	0	0	0	0	0	0	0	0	0	4	34	13	86	4	31
"ALS2CR5"	4968	53821	0	0	0	0	0	0	0	0	0	0	0	0	0	0	0	0
"ALS2CR7"	675	38752	0	0	0	0	0	0	0	0	0	0	0	0	0	0	0	0
"ALS2CR8"	5946	73945	48	0	11	37	0	0	112	6	16	0	180	204	233	106	206	91
"ALX1"	1295	21525	0	0	0	0	0	0	0	0	0	0	0	0	0	0	0	0
"ALX3"	1481	10326	58	0	38	20	0	0	102	33	0	0	158	129	161	80	197	90
"ALX4"	1589	45559	0	0	0	0	0	0	79	45	0	0	0	0	0	0	1	0
"AM413008"	136	136	0	0	0	0	0	0	0	0	0	0	0	22	19	11	43	6
"AMAC1"	1875	1875	35	8	15	20	3	5	3	0	0	0	0	0	0	0	0	0
"AMAC1L2"	1202	1202	0	0	0	0	0	0	0	0	0	0	0	0	0	0	0	0
"AMAC1L3"	1197	1664	26	0	12	14	0	0	0	0	0	0	0	0	0	0	0	0
"AMACR"	2528	20302	0	0	0	0	0	0	22	0	0	0	63	129	209	131	291	142
"AMBN"	1987	15003	0	0	0	0	0	0	0	0	0	0	0	0	0	0	0	0
"AMBP"	1441	18344	0	0	0	0	0	0	72	32	0	0	0	0	0	0	0	0
"AMBRA1"	5311	194952	5770	2564	3263	2507	1463	1101	3434	2578	1412	3914	4366	4144	3150	2934	4733	3171
"AMD1"	3430	20928	2796	4439	1498	1298	2438	2001	1672	3821	638	5925	3648	6346	4101	6238	4880	3999
"AMDHD1"	2144	25300	0	0	0	0	0	0	0	0	0	0	15	8	21	19	0	0
"AMDHD2"	2087	10593	2185	750	1171	1014	388	362	856	450	2046	1265	612	432	1662	928	1985	923
"AMELX"	841	7349	0	0	0	0	0	0	0	0	0	0	0	0	0	0	0	0
"AMELY"	807	8110	0	0	0	0	0	0	0	0	0	0	0	0	0	0	0	0
"AMFR"	3607	64081	2468	195	1492	976	83	112	1231	191	974	167	3025	2675	2908	2523	3887	2652
"AMH"	2023	2961	1	0	1	0	0	0	0	14	0	0	0	1	0	0	0	0
"AMHR2"	1866	7673	0	0	0	0	0	0	48	0	0	0	0	0	0	0	0	0
"AMICA1"	2450	28361	10376	3318	5560	4816	1904	1414	4224	937	3665	1377	13839	11728	8994	6784	12631	5793
"AMIGO1"	2472	2891	0	0	0	0	0	0	0	0	0	0	63	4	42	0	50	5
"AMIGO2"	3958	4245	0	0	0	0	0	0	0	0	0	0	2	14	0	0	0	0
"AMIGO3"	2972	2972	319	0	172	147	0	0	119	20	248	75	573	555	165	81	215	139
"AML1"	542	8696	8267	5879	12	8255	2743	3136	7170	1796	5207	1800	54	68	0	11	135	2
"AML2"	437	35536	23	0	23	0	0	0	282	170	0	11	0	0	21	17	48	0
"AMMECR1"	5608	246045	575	59	353	222	27	32	813	74	0	36	248	339	239	282	280	138
"AMMECR1L"	4679	24307	426	242	260	166	120	122	158	249	0	284	516	722	794	191	249	548
"AMN"	2280	7921	2	0	0	2	0	0	40	16	3	36	0	0	0	0	0	0
"AMN1"	2115	58037	11	0	11	0	0	0	10	8	53	0	23	23	15	18	10	5
"AMOT"	6973	48268	0	0	0	0	0	0	0	0	0	0	0	0	0	0	0	0
"AMOTL1"	9011	108411	0	0	0	0	0	0	0	0	0	0	4	3	0	0	4	3
"AMOTL2"	4998	20071	0	0	0	0	0	0	12	14	0	0	0	0	0	0	0	0
"AMPD1"	2357	22456	0	0	0	0	0	0	10	10	0	0	0	1	0	0	0	0
"AMPD2"	4104	12220	2950	4434	1646	1304	2378	2056	834	2982	2216	7735	3111	4654	4342	7416	5460	5555
"AMPD3"	4488	51647	1060	518	539	521	325	193	454	342	343	395	604	606	703	701	826	585
"AMPH"	3290	247715	728	0	421	307	0	0	299	0	42	0	33	0	0	0	0	2
"AMPK beta 2"	5261	17444	297	0	176	121	0	0	180	22	0	28	558	370	549	276	667	181
"AMT"	2111	5802	304	27	167	137	17	10	204	49	83	46	38	61	90	64	316	101
"AMTN"	1005	14163	0	0	0	0	0	0	0	0	0	0	0	0	0	0	0	0
"AMY1A"	1792	9035	0	0	0	0	0	0	0	0	0	0	0	0	22	19	60	31
"AMY1B"	1872	8872	0	0	0	0	0	0	0	0	0	0	0	0	22	19	60	31
"AMY1C"	1873	8874	0	0	0	0	0	0	0	0	0	0	0	0	22	19	46	31
"AMY2A"	1635	8396	0	0	0	0	0	0	0	0	0	0	0	0	20	8	54	28
"AMY2B"	3615	26253	616	308	333	283	178	130	392	105	0	160	477	299	443	244	678	309
"AMZ1"	4422	35908	92	64	57	35	18	46	235	238	0	0	6	4	0	0	44	10
"AMZ2"	2272	7966	196	0	90	106	0	0	178	13	18	0	784	765	979	731	1223	652
"ANAPC1"	6357	115102	151	28	107	44	28	0	277	26	18	48	664	715	1068	909	1167	763
"ANAPC10"	930	103029	2068	4137	1062	1006	2344	1793	1232	1730	133	845	100	165	155	90	61	76
"ANAPC11"	1134	8766	35	0	18	17	0	0	113	65	0	137	511	489	768	679	814	657
"ANAPC13"	1210	8318	0	0	0	0	0	0	72	0	0	0	927	121	763	526	968	655
"ANAPC2"	2713	13823	1241	685	664	577	314	371	706	762	1080	1488	966	786	989	1406	1489	1499
"ANAPC4"	2700	41273	1071	8	658	413	8	0	656	115	237	56	808	680	830	583	778	485
"ANAPC5"	2836	27478	1762	587	1029	733	325	262	1103	276	1387	428	1814	1946	2368	1839	2811	1942
"ANAPC7"	3056	30832	1663	460	940	723	260	200	692	411	1504	849	1615	1501	1704	1125	2001	965
"ANG"	1222	10009	0	0	0	0	0	0	13	0	0	0	0	15	12	0	32	7
"ANG-3"	1796	43663	5	0	0	5	0	0	105	13	0	0	0	0	3	0	0	0
"ANGEL1"	4119	25697	766	135	377	389	85	50	429	134	376	129	1209	968	790	578	909	471
"ANGEL2"	4698	23297	953	165	460	493	125	40	486	137	106	161	967	779	744	468	806	442
"ANGPT1"	4346	248545	0	0	0	0	0	0	0	0	0	0	0	0	0	0	0	0
"ANGPT2"	5274	63609	2211	1262	1189	1022	725	537	1281	623	296	943	10	8	11	14	9	8
"ANGPT4"	1928	43663	5	0	0	5	0	0	105	13	0	0	0	0	3	0	0	0
"ANGPTL1"	3551	21546	20	60	10	10	31	29	0	0	0	32	0	0	0	0	0	0
"ANGPTL2"	3577	35418	60	0	35	25	0	0	178	98	0	40	0	0	0	0	0	0
"ANGPTL3"	2133	7995	545	68	297	248	45	23	243	25	0	0	1	1	0	0	0	0
"ANGPTL4"	1910	10248	10	0	10	0	0	0	85	35	0	1	0	124	0	75	14	3
"ANGPTL5"	2376	25849	0	0	0	0	0	0	0	0	0	0	0	0	0	0	0	0
"ANGPTL6"	1863	10414	156	17	79	77	17	0	91	65	58	21	515	391	695	389	783	492
"ANGPTL7"	2242	6641	163	24	85	78	11	13	200	58	38	44	0	0	0	0	0	0
"ANK1"	8520	243537	0	0	0	0	0	0	488	206	0	0	86	19	8	6	39	21
"ANK2"	14287	334111	0	0	0	0	0	0	0	0	0	0	0	0	0	0	0	0
"ANK3"	14814	361330	0	0	0	0	0	0	0	0	0	0	0	7	0	0	0	0
"ANKAR"	4379	70190	71	0	54	17	0	0	228	0	0	0	7	36	28	17	40	9
"ANKDD1A"	3125	46940	3494	4129	2151	1343	2225	1904	1538	1617	883	2221	615	4249	653	589	846	570
"ANKFN1"	2443	329173	0	0	0	0	0	0	0	0	0	0	0	0	0	0	0	0
"ANKFY1"	8184	100477	4007	1015	2254	1753	584	431	2454	843	1781	656	3058	3064	4505	3038	4973	2926
"ANKH"	8218	166979	4303	1147	2367	1936	609	538	2490	836	952	731	1907	1980	1374	1182	2828	1742
"ANKHD1"	8223	138012	8037	6593	4650	3387	3591	3002	3301	3101	2973	5172	4347	4026	4672	4148	5924	3330
"ANKHD1-EIF4EBP3"	8355	147736	8872	7000	4966	3906	3806	3194	3689	3372	3630	5622	4471	4327	4696	4182	6217	3481
"ANKIB1"	6101	155152	2486	300	1441	1045	155	145	1668	295	218	170	1238	1614	1479	1174	1577	1002
"ANKK1"	2550	12628	0	0	0	0	0	0	33	0	0	0	0	0	0	0	0	0
"ANKLE1"	3226	6002	1	12	0	1	12	0	33	32	0	0	74	69	19	35	15	10
"ANKLE2"	4471	36199	3781	14212	2021	1760	7587	6625	1399	6958	967	12157	1889	6830	1798	4556	3211	3019
"ANKMY1"	3423	78568	3328	420	1874	1454	191	229	1882	301	1813	424	332	251	300	219	370	148
"ANKMY2"	2509	45987	768	191	417	351	148	43	587	30	22	65	111	356	680	347	787	439
"ANKRA2"	2056	13337	30	0	15	15	0	0	75	0	4	0	434	341	437	246	464	218
"ANKRD1"	1983	9177	0	0	0	0	0	0	0	0	0	0	0	0	0	0	0	0
"ANKRD10"	2500	36530	8606	9851	4755	3851	5353	4498	4435	4602	5062	6325	4556	6719	5701	5858	5827	3497
"ANKRD11"	9389	222936	40410	23595	22161	18249	12546	11049	15722	13033	36629	30644	3576	3793	4535	3736	5917	3461
"ANKRD12"	10576	147647	30518	45919	17103	13415	24732	21187	11597	17572	9864	34778	4724	8804	5194	6018	4957	3047
"ANKRD13"	2414	9952	2418	608	1395	1023	322	286	1067	648	987	1392	3199	3197	2958	2697	3718	2381
"ANKRD13A"	3921	40000	2418	608	1395	1023	322	286	1067	648	987	1392	3199	3197	2958	2696	3718	2381
"ANKRD13B"	3187	21253	18	0	9	9	0	0	33	47	0	0	20	10	4	3	20	35
"ANKRD13C"	5679	95733	1824	492	961	863	250	242	1067	244	217	349	959	1143	886	720	933	655
"ANKRD13D"	2646	4412	3240	520	1774	1466	278	242	1163	177	3012	482	1487	763	2031	679	2382	842
"ANKRD16"	2634	28171	0	0	0	0	0	0	29	0	0	0	34	29	15	24	53	27
"ANKRD17"	9408	184001	20821	15057	11708	9113	8251	6806	9059	7566	7967	14298	3391	3289	3866	2708	4845	2508
"ANKRD18B"	3803	25042	271	1332	148	123	749	583	83	354	0	658	36	113	3	99	45	5
"ANKRD19"	2317	28848	75	0	29	46	0	0	153	0	0	12	213	76	44	0	170	7
"ANKRD2"	1458	11385	0	0	0	0	0	0	41	20	0	0	0	0	0	0	0	0
"ANKRD20A1"	3974	43532	0	0	0	0	0	0	59	21	0	0	0	0	0	4	6	0
"ANKRD20A2"	5575	6741	29	0	21	8	0	0	44	6	0	0	3	7	378	350	241	131
"ANKRD20A3"	3977	43560	29	0	21	8	0	0	103	27	0	0	3	7	378	354	246	131
"ANKRD20A4"	3531	43129	0	0	0	0	0	0	47	0	0	0	0	0	0	0	0	0
"ANKRD20A5"	2060	6274	17	0	12	5	0	0	0	0	0	0	0	0	8	21	0	0
"ANKRD20B"	3692	96147	0	0	0	0	0	0	0	0	0	0	0	0	16	13	22	4
"ANKRD22"	3987	32073	0	0	0	0	0	0	0	0	0	0	0	0	0	0	0	0
"ANKRD23"	2590	6108	91	5	54	37	5	0	108	16	9	0	6	0	17	4	19	1
"ANKRD24"	4048	41462	0	5	0	0	4	1	211	103	0	0	0	0	0	0	0	0
"ANKRD26"	6813	96384	107	82	71	36	49	33	165	69	0	44	214	375	205	235	246	145
"ANKRD27"	4482	78197	714	52	369	345	29	23	695	82	227	163	769	1029	928	945	1081	786
"ANKRD28"	6410	130949	27	5029	19	8	2821	2208	10	1017	0	88	137	224	93	118	134	83
"ANKRD29"	2281	62871	0	0	0	0	0	0	11	0	0	0	8	1	0	4	0	0
"ANKRD30A"	4441	106712	0	0	0	0	0	0	0	0	0	0	0	0	0	0	0	0
"ANKRD30B"	4653	104500	0	0	0	0	0	0	0	0	0	0	0	0	0	0	0	0
"ANKRD32"	3832	77182	61	0	41	20	0	0	96	5	6	0	249	248	202	97	235	146
"ANKRD33"	3413	3648	141	3	71	70	3	0	72	58	27	26	156	153	162	180	264	144
"ANKRD34A"	3616	5141	0	0	0	0	0	0	0	10	0	0	0	0	0	0	0	0
"ANKRD34B"	3733	13525	0	0	0	0	0	0	0	0	0	0	0	0	0	0	0	0
"ANKRD34C"	5425	15436	0	0	0	0	0	0	0	0	0	0	0	0	0	0	0	0
"ANKRD35"	3377	19319	0	0	0	0	0	0	42	0	0	0	0	3	0	0	0	0
"ANKRD36"	6342	151024	1511	368	940	571	179	189	1747	444	59	223	68	110	235	237	382	211
"ANKRD36B"	6030	85169	1357	209	829	528	81	128	1417	355	385	256	23	72	159	172	287	150
"ANKRD36BL1"	1849	1849	13336	5760	7084	6252	3043	2717	4088	2437	3588	2130	9161	9552	830	483	928	396
"ANKRD37"	1571	3942	145	0	107	38	0	0	113	14	28	0	287	218	236	184	356	227
"ANKRD39"	895	10027	0	0	0	0	0	0	114	19	0	0	63	20	63	47	70	56
"ANKRD40"	4173	14720	375	56	210	165	13	43	225	32	72	51	1291	1280	1245	953	1375	866
"ANKRD42"	3561	20952	168	0	120	48	0	0	134	55	10	25	511	478	273	274	335	212
"ANKRD43"	3457	3457	0	1	0	0	1	0	1	0	0	0	0	0	0	0	0	0
"ANKRD44"	3712	203514	72462	37919	40357	32105	20590	17329	31889	16507	38340	26673	5425	7333	6272	5560	6882	4337
"ANKRD45"	2677	61528	0	0	0	0	0	0	0	0	0	0	0	0	0	0	0	0
"ANKRD46"	3278	38940	273	23	119	154	23	0	334	107	0	109	290	358	346	236	311	216
"ANKRD49"	3022	5589	163	0	93	70	0	0	104	47	0	0	587	416	539	299	598	280
"ANKRD5"	3832	21710	0	0	0	0	0	0	0	0	0	0	3	4	0	5	14	0
"ANKRD50"	8538	48421	479	2956	262	217	1662	1294	247	1495	0	1204	680	994	644	1616	771	855
"ANKRD52"	8683	20553	1765	456	1073	692	235	221	713	311	1037	455	2254	2497	2929	2411	3679	2043
"ANKRD53"	2126	7055	0	0	0	0	0	0	30	0	0	0	0	0	0	0	0	0
"ANKRD54"	2056	13442	39	0	36	3	0	0	61	54	0	0	382	260	224	129	244	150
"ANKRD55"	2511	133680	0	0	0	0	0	0	0	0	0	0	0	0	6	3	16	0
"ANKRD56"	2921	2921	0	0	0	0	0	0	9	0	0	0	0	0	0	0	0	0
"ANKRD57"	4654	4654	0	0	0	0	0	0	0	0	0	0	339	132	259	70	257	83
"ANKRD58"	1590	1590	0	0	0	0	0	0	17	0	0	0	131	0	253	1	225	20
"ANKRD6"	5520	71284	24	0	24	0	0	0	58	26	0	23	1010	79	183	91	137	136
"ANKRD7"	1362	18072	0	0	0	0	0	0	11	0	0	0	0	0	0	0	0	0
"ANKRD9"	1755	2376	48	0	24	24	0	0	0	0	0	0	42	324	386	280	83	53
"ANKS1A"	6498	202152	8886	1760	4903	3983	905	855	5545	1922	3439	2490	1026	1082	1357	1058	1626	1168
"ANKS1B"	4457	1249363	0	0	0	0	0	0	8	0	0	0	610	726	0	0	0	0
"ANKS3"	3113	31568	243	2	122	121	0	2	271	271	183	95	72	57	128	62	144	85
"ANKS4B"	2908	18736	0	0	0	0	0	0	0	0	0	0	0	0	0	0	0	0
"ANKS6"	7161	64504	33	0	16	17	0	0	120	9	0	0	123	127	313	100	292	214
"ANKZF1"	3390	4689	503	83	270	233	34	49	235	88	103	27	658	451	761	320	1152	419
"ANLN"	4792	63968	2	0	0	2	0	0	0	0	0	0	0	3	0	0	0	0
"ANO1"	4831	111243	0	0	0	0	0	0	592	162	0	0	0	0	0	0	0	0
"ANO10"	2749	255743	753	248	451	302	147	101	942	423	29	257	618	763	653	551	916	535
"ANO2"	3743	383583	0	0	0	0	0	0	58	14	0	0	0	0	0	0	0	0
"ANO3"	5962	331159	0	0	0	0	0	0	0	0	0	0	0	0	0	0	0	0
"ANO4"	4253	334047	0	0	0	0	0	0	10	13	0	0	539	557	0	0	0	0
"ANO5"	6683	90193	0	87	0	0	69	18	0	46	0	0	0	17	3	56	0	3
"ANO6"	6124	216362	8561	2352	4811	3750	1266	1086	5539	2208	2367	1210	5053	5935	6569	5881	6755	4266
"ANO7"	4153	36869	152	0	83	69	0	0	343	90	56	0	48	36	73	49	114	56
"ANO8"	4728	11608	380	93	221	159	48	45	197	129	286	100	921	1081	586	545	807	641
"ANO9"	2977	24083	36	0	17	19	0	0	226	110	0	79	0	14	14	7	65	14
"ANP32A"	2471	42386	10033	5191	5593	4440	2800	2391	4650	3171	9161	7184	2554	2526	4233	3341	4030	3053
"ANP32B"	1621	32735	1306	316	722	584	144	172	853	253	52	429	1768	1405	1406	1567	2609	1756
"ANP32C"	705	705	0	0	0	0	0	0	0	0	0	0	150	173	0	0	0	0
"ANP32D"	396	396	0	0	0	0	0	0	0	0	0	0	0	0	0	0	0	0
"ANP32E"	3459	17788	68	147	35	33	87	60	50	60	0	0	990	1455	797	938	844	680
"ANPEP"	3670	29947	11656	7834	6364	5292	4139	3695	2896	3867	8587	10831	17871	15444	19752	19393	18933	12483
"ANTXR1"	5909	236183	0	0	0	0	0	0	25	8	0	0	0	0	0	0	0	0
"ANTXR2"	8057	171706	16517	7561	9240	7277	4239	3322	9487	4757	4619	5404	5253	5881	4559	3998	5884	4249
"ANTXRL"	2150	43214	0	0	0	0	0	0	261	91	0	0	0	0	0	0	0	0
"ANUBL1"	3812	57213	0	0	0	0	0	0	47	0	12	10	82	83	90	37	102	13
"ANX2P2"	1351	1351	0	0	0	0	0	0	0	0	0	0	0	0	0	0	0	0
"ANXA1"	2219	12739	3238	1934	1885	1353	1111	823	1437	873	753	455	12955	13371	9324	8009	12100	8426
"ANXA10"	1438	95186	0	0	0	0	0	0	0	0	0	0	0	0	0	0	0	0
"ANXA11"	3089	49369	41970	11695	23173	18797	6533	5162	14485	4385	29684	14158	16727	13994	19140	13595	22593	16953
"ANXA13"	1604	56614	0	0	0	0	0	0	0	0	0	0	0	0	0	0	0	0
"ANXA2"	1672	50836	17529	25690	9803	7726	13729	11961	6334	14554	9940	27869	31841	39322	43721	48616	58189	47820
"ANXA3"	1770	58862	0	0	0	0	0	0	0	0	0	0	2	3	12	11	3	0
"ANXA4"	2188	84469	5678	2192	3209	2469	1221	971	2411	863	1749	638	2391	2080	3471	3225	3310	2342
"ANXA5"	1674	28996	5608	15257	2979	2629	7370	7887	1424	4830	1169	7688	15526	18399	13959	15143	14267	10467
"ANXA6"	2941	57101	1602	441	1005	597	232	209	1111	358	361	391	2040	2069	3880	2994	3742	2515
"ANXA7"	2218	38654	784	2662	421	363	1437	1225	528	1103	180	2676	2391	4111	2941	2769	3873	2239
"ANXA8"	2165	16143	0	0	0	0	0	0	558	163	0	0	0	0	0	0	0	0
"ANXA8L1"	2165	16138	0	0	0	0	0	0	0	0	0	0	0	0	0	0	0	0
"ANXA8L2"	2039	16120	0	0	0	0	0	0	0	0	0	0	0	0	0	0	0	0
"ANXA9"	1838	13617	139	0	90	49	0	0	83	41	73	0	452	120	277	119	332	134
"AOAH"	2517	211545	23475	14515	13358	10117	7866	6649	9845	6971	15954	23649	3028	4792	2946	3235	3054	2033
"AOC2"	2667	6115	0	0	0	0	0	0	32	218	0	0	0	9	0	0	3	0
"AOC3"	4027	6939	0	0	0	0	0	0	41	0	0	0	0	0	0	0	0	0
"AOF1"	3457	12360	938	85	538	400	25	60	543	46	80	11	789	907	463	476	927	551
"AOX1"	4966	85486	0	0	0	0	0	0	0	11	0	0	0	0	0	0	0	0
"AOX2"	988	23569	0	0	0	0	0	0	0	0	0	0	0	0	0	0	0	0
"AP1AR"	2916	38316	798	799	456	342	461	338	493	532	32	401	866	985	957	823	970	679
"AP1B1"	4196	60900	9173	5391	5150	4023	2792	2599	3924	3063	6058	9022	7634	6160	11469	9508	14801	12058
"AP1G1"	7429	80071	3113	4308	1545	1568	2438	1870	1500	2261	916	3686	4533	5257	4610	3925	5392	3334
"AP1G2"	2898	8504	1753	924	641	1112	569	355	1036	594	2170	1088	2101	2239	2297	2315	5110	2816
"AP1GBP1"	1427	37598	1195	434	712	483	267	167	657	301	492	413	210	151	300	232	388	179
"AP1M1"	2404	37493	1294	255	744	550	156	99	1027	418	936	481	897	981	1234	1063	1710	1184
"AP1M2"	1768	14645	0	0	0	0	0	0	68	48	0	0	0	0	0	0	0	0
"AP1S1"	1301	6872	36	0	20	16	0	0	96	38	0	0	400	472	688	521	895	598
"AP1S2"	2297	29172	2434	5751	1412	1022	3088	2663	988	1924	532	4063	3281	4702	2812	3955	3935	2902
"AP1S3"	4046	82273	813	10670	537	276	5650	5020	151	4937	11	8845	209	773	93	220	131	196
"AP2A1"	3521	40189	1688	458	936	752	287	171	954	883	1562	1537	3484	3220	3676	3347	4215	3113
"AP2A2"	4637	86400	17569	4812	9684	7885	2695	2117	8638	1604	11993	2239	6229	5252	7847	5472	9486	4635
"AP2B1"	5826	139153	1569	910	885	684	456	454	1423	1504	165	1313	3148	3291	4158	3413	4934	3347
"AP2M1"	1948	9246	1175	314	624	551	163	151	530	203	622	156	12560	10365	15297	13708	19109	11513
"AP2S1"	895	12782	217	0	122	95	0	0	149	33	192	24	2218	921	1680	1702	2090	1700
"AP3B1"	4012	292379	12233	8087	7166	5067	4361	3726	6978	4505	1724	5060	2390	3993	2436	2246	2398	1569
"AP3B2"	3788	50603	8	0	2	6	0	0	104	29	0	0	6	3	104	115	4	0
"AP3D1"	5081	50564	5564	3478	3136	2428	1826	1652	2362	2717	4698	6614	4295	3821	5559	4704	6637	4398
"AP3M1"	5262	30812	2064	869	653	1411	737	132	1221	535	79	258	10116	10293	2105	5013	2378	1470
"AP3M2"	3681	18240	374	0	226	148	0	0	283	14	50	0	464	213	512	111	759	256
"AP3S1"	1330	72159	1582	268	890	692	160	108	1020	286	123	165	1188	1184	1722	1549	2088	1506
"AP3S2"	6059	63787	2520	386	1291	1229	220	166	1410	139	421	77	1619	1467	970	623	1802	1040
"AP4B1"	2495	10066	159	24	72	87	24	0	216	27	31	63	522	330	619	359	875	222
"AP4E1"	6703	97153	1307	62	722	585	44	18	846	69	450	123	1437	1424	1199	906	1169	836
"AP4M1"	1903	5674	75	12	44	31	12	0	240	84	104	38	567	482	564	435	877	447
"AP4S1"	1910	60326	520	76	296	224	43	33	272	109	183	483	183	269	107	101	139	91
"APAF1"	7211	90128	1085	89	534	551	52	37	779	51	230	32	1092	1286	1249	989	1338	753
"APBA1"	6597	244828	10501	3181	5919	4582	1852	1329	4244	1350	1756	1022	773	868	933	839	1208	720
"APBA2"	3958	279348	3	0	3	0	0	0	530	183	0	0	0	4	0	0	12	6
"APBA3"	2169	10904	178	193	64	114	97	96	77	300	27	646	388	702	406	679	486	512
"APBB1"	2650	23947	0	0	0	0	0	0	64	29	0	0	8	5	10	7	31	8
"APBB1IP"	2650	129466	40835	18157	22735	18100	9743	8414	16849	6879	22054	18097	7505	7976	5473	4494	9754	5885
"APBB2"	8992	404592	0	0	0	0	0	0	55	40	0	0	0	0	0	0	0	0
"APBB3"	2306	6338	216	72	61	155	36	36	78	35	10	0	147	93	237	142	132	134
"APC"	11040	138719	6554	1126	3686	2868	629	497	3594	716	1427	586	2710	3196	2915	2106	3160	1680
"APC2"	11670	21957	252	152	129	123	128	24	406	237	443	169	927	441	379	272	468	273
"APC4"	2332	5581	407	0	247	160	0	0	343	64	77	16	610	513	576	402	539	352
"APC5"	1836	29147	1481	413	827	654	224	189	908	201	1211	322	1357	1343	1818	1319	2142	1490
"APCDD1"	2566	34074	0	0	0	0	0	0	0	0	0	0	71	23	10	0	54	0
"APCDD1L"	3288	55525	21	0	21	0	0	0	127	28	0	0	0	0	0	0	0	0
"APCS"	932	1046	0	0	0	0	0	0	0	0	0	0	0	0	0	0	0	0
"APECED"	1709	7964	6	1	3	3	0	1	28	60	0	0	1	2	0	0	0	0
"APEH"	2779	9500	645	129	361	284	30	99	406	250	382	183	3224	2968	2858	2239	3535	2578
"APEX1"	1603	2506	287	109	136	151	73	36	79	29	0	0	2606	2499	2485	2187	3968	2062
"APEX2"	1982	7433	775	168	470	305	124	44	320	114	257	166	1234	1015	1325	767	2094	1112
"APG4-D"	1861	9448	196	32	111	85	0	32	91	82	36	177	424	496	435	455	542	447
"APH1A"	2195	3735	530	233	333	197	155	78	195	255	422	500	1767	1000	1824	5483	2930	1399
"APH1B"	4263	31577	885	7	507	378	0	7	761	33	447	21	730	752	798	665	1173	618
"APHC"	4593	162935	6760	2781	3775	2985	1557	1224	3486	1792	733	1367	2110	2484	1477	1357	2034	1222
"API5"	3845	32577	1053	327	610	443	158	169	712	365	38	335	2512	3255	3596	2852	4141	2673
"APIP"	1265	34098	1451	421	753	698	207	214	754	160	2938	2304	209	17	634	537	449	384
"APITD1"	1472	22051	0	0	0	0	0	0	46	13	0	27	46	43	20	33	64	23
"APLF"	3858	112604	510	3948	252	258	2142	1806	294	1675	32	2022	92	143	62	47	89	58
"APLN"	3118	9590	0	0	0	0	0	0	0	0	0	0	0	0	0	0	0	0
"APLNR"	3875	3875	0	0	0	0	0	0	14	0	0	0	0	0	0	0	0	0
"APLP1"	2466	11299	0	376	0	0	189	187	37	181	0	334	0	80	0	95	0	173
"APLP2"	3829	74991	2334	609	1274	1060	382	227	1894	677	619	590	7106	6893	15170	18608	15637	12583
"APMAP"	2035	29846	2633	2127	1450	1183	1169	958	1235	1303	981	1209	3848	4505	4696	4416	5040	3527
"APNH"	4121	56152	1008	114	643	365	27	87	833	145	227	174	829	698	943	601	1367	752
"APO"	2404	12473	1131	61	647	484	32	29	872	104	38	51	83	112	17	11	106	29
"APO3L"	1632	8833	93	0	50	43	0	0	172	35	0	22	903	564	1303	792	1488	951
"APOA1"	942	1835	0	0	0	0	0	0	0	0	0	0	0	0	0	0	0	0
"APOA1BP"	1430	2513	128	69	72	56	47	22	135	97	11	0	924	1039	894	950	865	976
"APOA2"	477	1337	12	0	12	0	0	0	24	0	0	0	0	0	0	0	0	0
"APOA4"	1463	2595	0	0	0	0	0	0	0	9	0	0	0	0	0	0	0	0
"APOA5"	1911	3051	0	0	0	0	0	0	15	0	0	0	0	0	0	0	0	0
"APOB"	14149	42645	0	0	0	0	0	0	0	0	0	0	0	0	0	0	0	0
"APOB48R"	3764	4291	2475	1363	1283	1192	706	657	387	783	671	651	7305	7317	4817	0	9728	6500
"APOBEC-2"	1467	11691	228	65	107	121	27	38	220	32	0	18	31	16	0	0	0	1
"APOBEC1"	896	16507	0	0	0	0	0	0	0	0	0	0	0	0	0	0	0	0
"APOBEC2"	1636	11691	228	65	107	121	27	38	220	32	0	18	31	16	0	0	0	1
"APOBEC3A"	1449	5663	0	0	0	0	0	0	182	197	0	0	0	66	59	95	28	31
"APOBEC3B"	1544	10380	0	0	0	0	0	0	47	48	0	0	0	0	11	25	7	4
"APOBEC3C"	1111	4560	0	0	0	0	0	0	20	32	0	0	1648	1557	729	315	758	582
"APOBEC3D"	2509	12139	17	0	15	2	0	0	288	175	0	0	1666	1557	755	354	791	586
"APOBEC3F"	4695	15302	0	0	0	0	0	0	126	43	0	0	13	8	17	10	47	47
"APOBEC3G"	2582	8082	143	0	68	75	0	0	170	28	88	0	242	232	211	181	247	268
"APOBEC3H"	921	6712	0	0	0	0	0	0	19	0	0	0	0	0	3	0	0	5
"APOBEC4"	2773	7032	110	0	99	11	0	0	33	61	0	51	0	0	0	0	0	0
"APOC1"	628	5031	1	0	1	0	0	0	41	12	0	0	156	488	1336	2474	923	989
"APOC2"	724	3576	12	0	10	2	0	0	31	19	3	1	62	0	218	202	465	441
"APOC3"	537	3165	0	0	0	0	0	0	0	0	0	0	0	0	0	0	0	0
"APOC4"	616	3258	0	0	0	0	0	0	52	9	0	0	0	0	0	0	3	0
"APOD"	1386	13616	3	0	0	3	0	0	0	0	0	0	64	75	30	15	51	43
"APOE"	1183	3612	0	0	0	0	0	0	26	16	0	0	1065	682	5939	6500	2850	3225
"APOF"	1691	2230	1	0	0	1	0	0	0	0	0	0	0	0	0	0	0	0
"APOH"	1208	17410	0	2	0	0	0	2	0	0	0	0	0	0	0	0	0	0
"APOL1"	3057	14461	88	490	6	82	277	213	154	451	53	77	1044	1675	598	838	843	624
"APOL2"	2691	13746	2043	825	1116	927	445	380	748	615	1128	380	2701	2403	2656	1972	2650	1229
"APOL3"	3637	25855	553	188	359	194	105	83	294	141	176	565	603	555	443	714	653	500
"APOL4"	3522	15703	3058	186	1667	1391	103	83	1240	59	2720	135	486	4024	6249	2551	10755	4136
"APOL5"	1440	11610	0	0	0	0	0	0	0	0	0	0	0	0	0	0	0	0
"APOL6"	10141	20033	421	1638	274	147	892	746	320	840	128	457	2340	3371	493	492	471	261
"APOLD1"	4737	65548	184	590	105	79	332	258	100	331	74	475	138	489	294	418	217	175
"APOLIV"	940	7379	1832	25	819	1013	7	18	863	0	1269	18	464	137	624	180	1496	506
"APOM"	766	2317	129	1	89	40	0	1	186	130	44	55	185	7	1135	21	47	22
"APOO"	1115	74571	81	131	42	39	71	60	84	197	0	313	109	211	4449	4866	6520	4901
"APOOL"	3118	86069	248	108	134	114	52	56	450	23	0	22	617	668	441	272	309	178
"APP"	3650	290278	2458	1967	1456	1002	1108	859	1201	1094	190	1053	4404	5209	5429	5073	6883	5268
"APPBP2"	6481	83062	792	379	511	281	232	147	813	300	161	533	879	717	826	614	959	662
"APPL1"	6080	45733	1626	180	862	764	98	82	1216	91	200	78	2973	3107	2930	1995	3324	1810
"APPL2"	3269	62935	9062	2411	5479	3583	1214	1197	5168	941	3959	1273	1367	1292	1528	1231	1732	925
"APR2"	781	781	0	0	0	0	0	0	0	0	0	0	0	0	0	0	0	0
"APRG1"	839	30835	94	0	54	40	0	0	183	31	0	0	0	0	0	0	0	0
"APRT"	810	2465	182	39	105	77	19	20	110	76	107	77	190	813	1115	1748	1057	2073
"APTX"	2133	29019	449	186	271	178	118	68	799	331	405	343	397	465	447	418	288	412
"AQ27"	2485	52386	0	0	0	0	0	0	0	0	0	0	0	16	0	0	0	0
"AQP1"	3238	72123	0	0	0	0	0	0	403	211	0	0	8	0	0	0	0	0
"AQP10"	2270	4210	0	0	0	0	0	0	48	0	0	0	0	0	0	0	0	0
"AQP11"	1446	20013	1278	110	712	566	84	26	663	59	505	78	35	0	0	0	0	0
"AQP12"	3017	6639	0	0	0	0	0	0	0	0	0	0	0	0	0	0	0	0
"AQP12A"	1087	6639	0	0	0	0	0	0	0	0	0	0	0	0	0	0	0	0
"AQP12B"	3017	6489	0	0	0	0	0	0	0	0	0	0	0	0	0	0	0	0
"AQP2"	4181	8140	0	0	0	0	0	0	13	0	0	0	0	0	0	0	0	0
"AQP3"	2909	6438	545	135	274	271	59	76	187	63	42	0	8200	6139	4117	2751	10310	4970
"AQP4"	5205	13708	0	0	0	0	0	0	0	0	0	0	0	0	0	0	0	0
"AQP5"	1825	4184	0	0	0	0	0	0	44	0	0	0	0	0	0	0	0	0
"AQP6"	3014	4660	16	9	16	0	9	0	130	81	0	0	0	0	0	2	0	3
"AQP7"	1528	17160	0	0	0	0	0	0	94	17	0	0	4	5	0	0	18	7
"AQP7L"	965	17160	0	0	0	0	0	0	94	17	0	0	4	5	0	0	18	6
"AQP7P1"	3184	19279	0	0	0	0	0	0	25	0	0	0	0	0	0	0	0	0
"AQP7P3"	531	34985	0	0	0	0	0	0	0	0	0	0	0	0	0	0	0	0
"AQP7P4"	1085	17160	0	0	0	0	0	0	94	17	0	0	4	5	0	0	18	6
"AQP8"	1313	11969	0	0	0	0	0	0	0	0	0	0	0	0	0	0	0	0
"AQP9"	3027	47704	956	10519	539	417	5643	4876	729	6297	62	9200	3209	5892	7995	16598	4271	8219
"AQR"	5114	113444	1047	419	519	528	192	227	942	370	247	415	910	1204	1245	982	1391	837
"AR"	4355	151708	0	0	0	0	0	0	0	0	0	0	0	0	0	0	0	0
"ARAF"	2429	10743	641	445	344	297	262	183	300	292	37	428	1677	1757	1848	1518	2201	1373
"ARAF1"	1403	7856	492	382	265	227	220	162	287	234	37	428	1163	1229	1135	876	1384	683
"ARAP1"	5906	108637	18110	7562	10625	7485	3944	3618	5702	4948	17494	13086	6934	6087	12313	9897	14687	9568
"ARAP2"	7393	178359	22674	137954	12787	9887	74306	63648	5269	60730	1437	33117	1442	4914	2858	5404	2396	1103
"ARAP3"	5294	28833	17	0	4	13	0	0	215	51	0	0	385	299	197	176	446	246
"ARC"	2946	3425	0	0	0	0	0	0	42	51	0	0	0	0	0	0	0	6
"ARC20"	1978	62597	7492	5713	4186	3306	3080	2633	3080	2946	6468	6846	12616	13712	11455	10822	15365	10794
"ARCH"	333	50414	269	20	140	129	0	20	175	0	0	61	359	249	257	283	361	273
"ARCN1"	4188	30645	727	997	436	291	602	395	311	541	112	941	5433	6520	5280	5230	6120	4265
"ARD1A"	1486	3730	172	8	113	59	8	0	71	12	134	0	407	340	412	540	630	593
"ARD1B"	1517	8900	0	0	0	0	0	0	0	0	0	0	0	0	0	0	0	0
"AREG"	2482	179631	0	0	0	0	0	0	0	0	0	0	0	2	0	6	0	5
"ARF1"	2011	16063	5244	7197	2840	2404	3825	3372	1538	3806	3840	7530	10950	12081	14784	17405	16580	14564
"ARF1GAP"	3502	16978	1874	1054	1020	854	509	545	943	800	1569	1754	1475	1450	2517	2277	3156	2049
"ARF3"	3542	21262	2837	1462	1614	1223	834	628	1060	1984	413	1952	7269	8246	1384	1303	1941	768
"ARF4"	1769	26125	1684	2157	915	769	1182	975	612	1061	266	2505	1785	405	3002	2043	1632	1537
"ARF5"	984	3237	164	0	89	75	0	0	15	49	0	35	2652	2296	1463	2026	1861	2396
"ARF6"	3940	4037	745	1093	409	336	585	508	241	443	231	586	6766	6707	5730	3723	6964	3557
"ARFGAP1"	3287	16978	1874	1054	1020	854	509	545	943	800	1569	1754	1475	1450	2517	2277	3156	2049
"ARFGAP2"	2776	12567	2205	857	1173	1032	484	373	503	558	1406	1548	2980	1401	1569	2025	3878	2270
"ARFGAP3"	2849	60878	2324	3140	1379	945	1862	1278	573	1879	583	2950	1652	1990	1713	1531	1299	1366
"ARFGEF1"	7251	146017	9432	4534	5197	4235	2484	2050	4889	2974	1934	3601	2670	2952	3613	3038	4069	2406
"ARFGEF2"	9042	114956	7549	3772	4402	3147	2003	1769	4075	2171	4106	3983	3017	3997	4580	3893	4838	2939
"ARFIP1"	3097	131951	2159	446	1290	869	253	193	1621	418	253	278	678	743	777	662	885	729
"ARFIP2"	2725	5669	227	0	123	104	0	0	152	301	89	144	612	557	631	642	870	616
"ARFRP1"	2979	9016	1011	424	513	498	260	164	441	522	1097	1274	569	559	850	790	1108	848
"ARG1"	1479	11105	61	14	22	39	14	0	95	0	0	0	0	8	4	3	0	7
"ARG2"	1986	31857	864	197	502	362	101	96	544	190	43	132	2615	2857	2855	2376	3137	2128
"ARGFX"	5069	22692	0	0	0	0	0	0	12	0	0	0	1	0	0	0	0	0
"ARGFXP2"	1203	1203	25	0	25	0	0	0	34	0	0	0	0	0	0	0	0	0
"ARGLU1"	2825	4998	3575	3316	1920	1655	1785	1531	1584	1660	1470	2020	3080	2186	4005	3244	4632	2588
"ARHE"	1288	18425	0	0	0	0	0	0	0	0	0	0	0	0	0	0	0	0
"ARHGAP1"	3355	23488	812	161	463	349	70	91	581	142	876	231	929	1866	2255	1451	3278	1795
"ARHGAP10"	3078	340475	199168	181123	111474	87694	96516	84607	75781	80416	117854	147621	5521	6191	5581	5387	7313	4819
"ARHGAP11A"	5628	24179	75	0	37	38	0	0	43	0	0	0	284	193	191	126	225	90
"ARHGAP11B"	1577	58932	178	39	119	59	19	20	293	32	0	29	35	33	167	112	145	46
"ARHGAP12"	4192	122547	2130	111	1207	923	66	45	1825	104	336	55	382	332	549	454	708	371
"ARHGAP15"	1772	639023	26800	26226	15110	11690	14472	11754	16028	13801	5227	14369	757	766	745	741	806	647
"ARHGAP17"	5476	38145	12197	922	6760	5437	483	439	6150	556	6273	504	2074	1299	2026	2240	4339	2126
"ARHGAP18"	3513	133131	42954	15293	17212	25742	10774	4519	24374	4710	20309	3592	5918	7556	6267	5791	6756	3659
"ARHGAP19"	5474	70484	44	0	23	21	0	0	303	89	59	0	802	894	817	639	821	453
"ARHGAP20"	6207	135009	0	0	0	0	0	0	0	0	0	0	0	0	0	0	0	0
"ARHGAP21"	7193	140061	3326	1247	1885	1441	685	562	3191	1201	711	1351	2110	2122	3677	3098	4607	2966
"ARHGAP22"	3296	210232	16763	6863	9064	7699	3662	3201	9023	5259	8230	8770	972	1001	1161	1117	1480	741
"ARHGAP23"	6299	54985	0	0	0	0	0	0	243	65	0	0	73	50	13	0	165	14
"ARHGAP24"	4653	527540	0	39	0	0	24	15	0	32	0	34	3	0	0	3	5	0
"ARHGAP25"	2938	91982	23697	19872	13079	10618	10828	9044	10231	8147	12918	16020	3321	3395	3521	2394	4228	3308
"ARHGAP26"	9063	458281	60555	51440	34127	26428	27911	23529	27010	24709	20496	27263	4431	4683	4048	3210	4497	2529
"ARHGAP27"	3666	31745	4035	1092	2392	1643	567	525	1328	1049	2611	797	1906	1808	2019	1549	2681	1552
"ARHGAP28"	5494	81228	0	0	0	0	0	0	13	0	0	0	0	0	0	0	0	0
"ARHGAP29"	9139	68845	0	0	0	0	0	0	0	0	0	0	0	0	0	0	0	0
"ARHGAP30"	4970	23029	3155	579	1683	1472	298	281	1249	185	2667	360	5960	4562	8090	5015	10886	5598
"ARHGAP4"	3378	18869	2821	633	1334	1487	477	156	1313	246	2971	709	3028	2958	4693	4183	5351	4074
"ARHGAP5"	9609	82439	0	0	0	0	0	0	0	0	0	0	59	76	17	37	11	0
"ARHGAP6"	5319	528160	0	0	0	0	0	0	15	0	0	0	0	9	7	18	0	0
"ARHGAP8"	2931	98407	100	0	63	37	0	0	535	249	0	31	56	42	85	82	102	113
"ARHGAP9"	2941	16560	3292	1193	1759	1533	608	585	1316	571	1852	992	3153	2375	2902	2259	5601	1974
"ARHGDIA"	1867	3642	606	769	210	396	412	357	300	367	737	711	6450	1122	2749	2868	3178	2839
"ARHGDIB"	1222	19614	4858	7668	2701	2157	4061	3607	1509	5163	1413	4766	5457	23251	6617	15224	15969	17719
"ARHGDIG"	2304	4596	0	0	0	0	0	0	26	0	0	0	0	1	0	0	0	0
"ARHGEF1"	3493	10509	4538	1748	2590	1948	859	889	2116	1189	4919	2097	2932	3013	3542	3349	6603	3914
"ARHGEF10"	5619	134659	0	0	0	0	0	0	214	39	0	12	2	3	6	0	5	4
"ARHGEF10L"	4619	82788	610	385	306	304	208	177	2129	2538	257	1651	426	401	851	1170	645	449
"ARHGEF11"	6929	110531	4733	850	2766	1967	475	375	2533	730	1354	588	2129	2070	2759	2400	3778	2543
"ARHGEF11/KIAA0380"	553	8247	279	57	134	145	29	28	132	88	10	44	216	252	276	244	393	235
"ARHGEF12"	9672	104620	426	221	253	173	134	87	506	129	28	133	1326	1662	1425	1043	1568	826
"ARHGEF15"	4180	12240	0	0	0	0	0	0	239	60	0	0	57	71	76	3	298	86
"ARHGEF16"	2917	26530	0	0	0	0	0	0	211	80	0	0	0	0	0	0	0	0
"ARHGEF17"	7833	60763	349	12	174	175	7	5	818	259	67	11	460	402	318	256	722	466
"ARHGEF18"	5760	32798	2467	357	1405	1062	158	199	1965	458	2695	893	1585	1341	2247	1701	2818	1847
"ARHGEF19"	3045	14507	10	0	10	0	0	0	61	34	23	0	51	48	55	35	168	81
"ARHGEF2"	4477	43236	7856	9015	4289	3567	4583	4432	2160	4634	4820	13434	3996	4703	5827	7470	6060	6910
"ARHGEF3"	4065	48301	4415	436	2406	2009	257	179	2313	150	1781	94	1779	156	2135	758	2583	1141
"ARHGEF4"	4270	130614	1	0	0	1	0	0	71	36	0	0	0	0	0	0	0	0
"ARHGEF5"	5502	25237	0	0	0	0	0	0	0	0	0	0	0	0	0	0	0	0
"ARHGEF5L"	1920	9061	0	0	0	0	0	0	0	0	0	0	0	0	0	0	0	0
"ARHGEF6"	5289	115791	1335	403	830	505	215	188	1562	172	304	379	4176	1280	3575	3635	4650	2808
"ARHGEF7"	5545	179920	9113	4622	5144	3969	2484	2138	4961	3585	3160	5634	1699	1528	2204	1627	2336	1375
"ARHGEF9"	5460	120185	567	54	334	233	34	20	463	78	56	0	234	214	205	129	338	173
"ARID1A"	8605	86081	18708	3802	10475	8233	2094	1708	7746	1938	15359	4019	3789	2493	4126	1920	5443	2373
"ARID1A variant protein"	4255	7783	2288	558	1251	1037	280	278	753	239	1027	293	3137	2010	3230	1472	4316	1928
"ARID1B"	8244	431317	34673	21612	19500	15173	11795	9817	17962	10823	11243	15375	1930	1963	1926	1618	2599	1478
"ARID2"	8487	178201	7854	2947	4337	3517	1740	1207	4321	2030	1516	3067	1661	1901	1628	1137	1809	911
"ARID3A"	2807	46756	4591	2131	2477	2114	1099	1032	1729	1506	1974	1935	2045	1791	1139	1211	1384	1152
"ARID3B"	4251	56924	60	0	37	23	0	0	116	67	0	0	42	36	94	40	130	11
"ARID3C"	1245	6557	0	0	0	0	0	0	41	12	0	0	0	0	0	0	0	0
"ARID4A"	5793	75228	5103	476	2820	2283	296	180	2617	338	503	296	1736	1666	1842	1005	1864	1194
"ARID4B"	6090	161323	11169	25617	6241	4928	13987	11630	5079	12553	3398	22778	2431	2963	2727	2506	2868	1713
"ARID4B variant protein"	2326	99908	8029	19840	4459	3570	10803	9037	3317	9210	2867	18778	244	261	349	376	309	164
"ARID5A"	2593	15908	3543	9415	1961	1582	5001	4414	921	3219	2176	4527	2379	3792	3175	3220	3414	2394
"ARID5B"	7517	195262	509	1988	251	258	1178	810	1011	2688	42	1766	557	794	850	1160	670	531
"ARIH1"	5264	112230	8865	10576	4914	3951	5708	4868	4032	5793	2559	8266	2404	2811	2370	2175	2578	1743
"ARIH2"	4199	66690	2987	2595	1712	1275	1411	1184	1408	1487	1439	3377	2412	2878	2916	2785	3105	2205
"ARL1"	3196	14651	146	0	95	51	0	0	92	0	0	0	815	840	854	874	829	784
"ARL10"	2409	8003	47	0	39	8	0	0	151	38	0	0	86	64	68	72	136	49
"ARL11"	3296	5109	67	0	12	55	0	0	117	10	0	0	418	264	392	191	413	149
"ARL13A"	1544	21123	0	0	0	0	0	0	0	0	0	0	0	0	0	0	4	0
"ARL13B"	3720	75141	386	36	249	137	19	17	283	247	0	120	209	369	174	209	269	200
"ARL14"	1287	1287	0	0	0	0	0	0	0	0	0	0	0	0	0	0	0	0
"ARL15"	2491	425791	33220	24705	18365	14855	13743	10962	13691	9118	7517	14137	465	645	123	771	527	410
"ARL16"	1495	2392	117	14	39	78	3	11	62	28	0	0	60	76	328	215	298	233
"ARL17"	5276	26936	51	0	42	9	0	0	74	41	0	0	0	0	892	886	1053	602
"ARL17P1"	5277	26968	1063	466	609	454	269	197	1139	391	123	130	352	284	2432	1833	3365	1739
"ARL2"	1287	5472	43	0	29	14	0	0	90	24	0	0	715	573	638	664	1250	818
"ARL2BP"	2106	8509	10	0	10	0	0	0	60	23	0	20	1275	1244	1319	950	1879	1201
"ARL3"	3874	40702	0	0	0	0	0	0	91	0	0	0	284	305	302	233	378	265
"ARL4A"	3161	3597	0	73	0	0	18	55	0	53	0	0	543	1955	104	352	212	299
"ARL4C"	4007	4007	870	190	510	360	109	81	330	79	182	0	4549	3473	3810	1762	3917	2030
"ARL4D"	1586	2152	0	0	0	0	0	0	11	11	0	0	0	4	4	26	24	16
"ARL5"	1330	39418	2171	0	1266	905	0	0	1391	43	264	0	1687	1982	2135	1689	2211	1482
"ARL5A"	3175	27531	1239	0	764	475	0	0	1022	22	154	0	1626	1674	497	423	472	308
"ARL5B"	3595	18629	349	7122	180	169	3835	3287	41	4121	0	4650	666	14157	712	9880	293	7177
"ARL5C"	1189	3514	0	0	0	0	0	0	61	28	0	0	0	0	0	0	0	0
"ARL6"	1483	36358	0	0	0	0	0	0	6	0	0	0	0	31	15	0	23	10
"ARL6IP1"	2337	9703	422	278	251	171	144	134	219	244	0	305	6817	7027	8360	1902	2017	6617
"ARL6IP4"	1405	2583	331	138	189	142	81	57	131	77	213	107	2631	2132	2618	2122	3552	2287
"ARL6IP5"	2129	21149	4547	2811	2554	1993	1561	1250	1837	1124	1775	2371	15983	17149	10612	7995	24811	13603
"ARL6IP6"	2814	43346	2822	859	1607	1215	487	372	1470	610	629	568	657	821	634	383	677	446
"ARL8A"	2352	11891	1038	187	523	515	108	79	456	227	634	507	1649	1571	2193	1593	2621	1572
"ARL8B"	2990	58671	12894	66575	7304	5590	36123	30452	3384	26500	5169	54775	3378	8849	4326	9288	4654	5786
"ARL9"	840	18685	0	0	0	0	0	0	0	0	0	0	0	0	0	0	0	0
"ARM2"	1706	19433	229	0	119	110	0	0	215	20	166	0	770	885	1344	1153	1489	1104
"ARMC1"	2648	31362	285	18	198	87	0	18	218	12	0	0	148	114	252	280	292	216
"ARMC10"	2858	24879	470	74	262	208	41	33	333	0	0	13	621	758	1018	840	940	739
"ARMC2"	3429	125733	0	0	0	0	0	0	26	9	0	0	22	7	24	21	15	9
"ARMC3"	2825	109560	0	0	0	0	0	0	0	0	0	0	0	0	0	0	0	0
"ARMC4"	3595	186694	0	0	0	0	0	0	0	0	0	0	0	0	0	0	0	0
"ARMC5"	4676	8172	120	38	64	56	20	18	80	80	0	50	425	530	444	732	570	615
"ARMC6"	2404	24509	291	83	144	147	42	41	345	85	100	109	665	440	893	600	1167	705
"ARMC7"	2129	20280	437	0	173	264	0	0	310	39	312	21	761	379	603	131	1176	443
"ARMC8"	3855	110073	3027	385	1734	1293	215	170	2019	222	502	209	964	761	1263	1042	1589	971
"ARMC9"	3804	111589	16	0	6	10	0	0	234	47	16	37	56	57	69	71	158	113
"ARMCX1"	2135	4161	0	0	0	0	0	0	22	0	0	0	44	45	101	134	84	52
"ARMCX2"	3121	4597	0	0	0	0	0	0	0	0	0	0	0	0	0	0	7	0
"ARMCX3"	3400	4713	215	497	82	133	312	185	70	327	0	236	980	1630	1244	1630	1257	1056
"ARMCX5"	2943	4927	104	19	53	51	19	0	13	4	0	0	378	334	409	271	409	231
"ARMCX6"	1845	2879	0	0	0	0	0	0	0	0	0	0	120	145	412	394	358	347
"ARMS2"	809	2690	0	0	0	0	0	0	0	0	0	0	0	0	0	0	0	0
"ARNIP"	4344	35275	1506	31	822	684	20	11	910	17	178	64	752	462	656	260	723	368
"ARNT"	4888	67002	1430	347	816	614	210	137	803	223	799	265	1739	1639	1566	761	1907	1167
"ARNT2"	6572	193582	0	0	0	0	0	0	109	54	0	0	0	0	0	0	0	0
"ARNTL"	2829	109487	11044	5097	6034	5010	2611	2486	4104	2047	3008	4908	1080	948	1101	617	1498	856
"ARNTL2"	1969	87615	2104	2479	1201	903	1402	1077	847	1385	152	2404	1615	2435	636	635	702	430
"ARP3beta"	2154	95614	1440	121	849	591	42	79	1165	175	601	313	189	127	207	137	293	177
"ARPC1A"	1603	40377	907	862	514	393	493	369	494	572	321	1514	838	731	995	861	1155	763
"ARPC1B"	1824	62376	7626	2346	3861	3765	1175	1171	2617	1457	8352	5768	21795	17877	25048	20243	28547	21736
"ARPC2"	2467	19008	15897	14117	8822	7075	7653	6464	5912	6401	11895	15392	28514	31315	22171	21398	29782	21897
"ARPC3"	890	15453	1225	411	686	539	266	145	536	279	1002	1148	3839	4000	8784	6296	11344	8378
"ARPC4"	1982	14564	3457	3027	1909	1548	1607	1420	1347	1473	3322	3755	3725	11770	8919	8704	11613	8534
"ARPC5"	1985	9654	2318	1193	1215	1103	624	569	863	549	837	1045	3056	790	5639	14419	17279	12042
"ARPC5L"	2515	3724	979	199	541	438	115	84	401	188	393	336	1127	633	1040	681	1553	764
"ARPM1"	2003	2972	0	0	0	0	0	0	0	0	0	0	0	10	0	0	0	0
"ARPP-21"	3260	152140	0	0	0	0	0	0	0	0	0	0	0	0	0	0	0	0
"ARPP19"	5165	21783	778	1349	433	345	718	631	546	730	185	814	4119	5294	3055	2907	3845	2649
"ARPP21"	2089	72892	0	0	0	0	0	0	0	0	0	0	0	0	0	0	0	0
"ARR3"	1326	13507	0	0	0	0	0	0	23	0	0	0	0	0	0	0	0	0
"ARRB1"	2220	86393	29999	15829	16435	13564	8374	7455	11038	11029	33867	26688	8058	1652	1918	1772	2656	1532
"ARRB2"	1996	11007	4568	1804	2575	1993	1028	776	1175	696	3789	1647	8521	4858	10078	8258	11789	6013
"ARRDC1"	2390	2555	2547	960	1487	1060	528	432	772	440	3215	1348	1314	1147	1833	1235	2625	1474
"ARRDC2"	2527	12963	1858	1209	1019	839	614	595	580	723	1723	2140	1845	1962	1986	1714	3038	1663
"ARRDC3"	4169	14610	746	3992	411	335	2136	1856	355	2703	74	1783	165	4576	986	5036	845	2333
"ARRDC4"	4074	13136	6163	2486	3338	2825	1373	1113	4267	1026	3876	1034	16912	10370	31615	11608	24470	11206
"ARRDC5"	1640	12431	415	97	233	182	41	56	191	94	696	141	30	28	7	0	9	10
"ARSA"	2061	3159	299	93	132	167	47	46	164	80	436	70	556	522	849	735	1016	787
"ARSB"	6077	209320	8359	5259	4792	3567	2826	2433	4293	3800	570	3549	349	528	2664	2531	2167	1740
"ARSD"	5168	25382	147	90	75	72	55	35	162	54	75	51	1166	1258	815	703	1658	1110
"ARSDR1"	2360	18991	342	30	183	159	17	13	221	31	19	0	1800	1626	2273	2031	2040	1662
"ARSE"	2517	29822	0	0	0	0	0	0	0	0	0	0	0	0	0	0	0	0
"ARSF"	2155	71237	0	0	0	0	0	0	0	0	0	0	0	0	0	0	0	0
"ARSG"	2782	161679	3419	1121	1913	1506	584	537	1560	981	1098	1973	2374	2844	1581	2100	1949	1840
"ARSH"	1697	26773	0	0	0	0	0	0	0	0	0	0	0	0	0	0	0	0
"ARSI"	3169	6618	1	0	1	0	0	0	33	0	0	0	0	10	0	0	0	0
"ARSJ"	4680	79440	0	0	0	0	0	0	0	0	0	0	0	0	0	0	0	0
"ARSK"	3404	49982	0	0	0	0	0	0	20	0	0	0	10	0	24	31	29	18
"ART1"	1317	19287	0	0	0	0	0	0	0	43	0	0	0	0	0	0	0	0
"ART3"	1585	24893	23	817	23	0	436	381	9	451	0	111	0	18101	19	6021	7	2370
"ART4"	1374	14170	0	0	0	0	0	0	0	0	0	0	0	0	0	0	0	0
"ART5"	1505	3751	0	0	0	0	0	0	0	0	0	0	0	0	0	0	0	0
"ARTN"	1948	3921	0	0	0	0	0	0	0	0	0	0	0	0	0	0	0	0
"ARV1"	1443	21650	1089	0	547	542	0	0	552	0	28	25	721	803	949	353	1252	507
"ARVCF"	4037	46890	459	55	252	207	29	26	667	262	33	0	143	112	135	123	378	159
"ARX"	2877	12252	0	0	0	0	0	0	0	0	0	0	0	0	0	0	0	0
"AS3MT"	2744	47688	62	83	49	13	69	14	59	33	0	18	760	914	620	461	747	425
"ASAH1"	2644	27956	2268	141	1314	954	95	46	1472	104	854	56	8702	7202	9224	8072	7160	5372
"ASAH2"	2436	61370	0	0	0	0	0	0	0	0	0	0	0	0	0	0	0	0
"ASAH2B"	703	14873	0	0	0	0	0	0	0	0	0	0	0	0	0	0	0	0
"ASAM"	2635	122974	0	0	0	0	0	0	33	0	0	0	0	1	0	0	0	0
"ASAP1"	6173	349865	300460	471233	165518	134942	298984	172249	130140	160885	193824	267192	12081	13464	19375	11573	29760	7798
"ASAP2"	5745	198920	117	158	91	26	73	85	356	964	31	904	261	270	340	370	1493	270
"ASAP3"	4154	55696	0	0	0	0	0	0	52	10	0	0	0	0	0	0	0	3
"ASB1"	6837	25266	920	491	504	416	254	237	487	404	443	599	527	941	840	781	993	883
"ASB10"	1940	11695	0	0	0	0	0	0	61	20	0	0	0	0	0	0	0	0
"ASB11"	1098	32102	0	0	0	0	0	0	0	0	0	0	0	0	0	0	0	0
"ASB12"	1268	6413	0	0	0	0	0	0	0	0	0	0	0	0	0	0	0	0
"ASB13"	2815	27740	27	0	6	21	0	0	175	26	0	0	696	423	905	587	1034	670
"ASB14"	3161	24309	1419	126	753	666	70	56	648	44	245	30	2387	2311	1969	1307	2307	1296
"ASB15"	2968	36013	0	0	0	0	0	0	0	0	0	0	0	0	0	0	0	0
"ASB16"	2144	8379	315	18	190	125	18	0	242	85	264	79	331	222	249	142	503	172
"ASB17"	1108	13558	0	0	0	0	0	0	0	0	0	0	0	0	0	0	0	0
"ASB18"	1406	69474	0	0	0	0	0	0	14	0	0	0	0	0	0	0	0	0
"ASB2"	2777	42565	0	3	0	0	3	0	140	42	0	0	0	0	33	19	7	8
"ASB3"	2224	116963	3532	1098	2003	1529	666	432	2319	583	1598	912	854	1039	381	291	369	384
"ASB4"	1478	42830	0	0	0	0	0	0	0	0	0	0	0	0	0	0	0	0
"ASB5"	2939	28001	0	0	0	0	0	0	0	0	0	0	1	0	0	0	0	0
"ASB6"	5148	6924	448	138	253	195	85	53	290	267	221	201	1101	828	1519	1629	2380	1598
"ASB7"	4967	49149	123	19	59	64	19	0	290	141	26	62	460	399	623	269	650	291
"ASB8"	2614	9804	57	50	40	17	41	9	109	0	0	0	1137	716	952	487	1119	535
"ASB9"	1955	26480	0	0	0	0	0	0	0	0	0	0	0	0	0	0	0	0
"ASCC1"	2290	119763	136	14	64	72	14	0	116	38	8	45	280	247	246	196	294	221
"ASCC2"	2861	49653	2365	946	1221	1144	487	459	1148	637	1019	1164	1558	1319	1736	1228	2200	1307
"ASCC3"	7633	372617	2876	2707	1679	1197	1552	1155	2303	2305	358	983	1256	1756	1714	1504	1617	1047
"ASCL1"	2479	2837	0	0	0	0	0	0	0	0	0	0	0	0	0	0	0	0
"ASCL2"	1850	2455	13	0	13	0	0	0	0	0	0	0	114	101	139	65	209	166
"ASCL3"	652	5463	0	0	0	0	0	0	0	0	0	0	0	0	0	0	0	0
"ASCL4"	2260	2260	0	0	0	0	0	0	0	0	0	0	0	0	0	0	0	0
"ASF1A"	2510	15094	1063	113	638	425	62	51	583	44	291	122	796	408	642	308	637	398
"ASF1B"	1734	17120	1	0	1	0	0	0	98	89	0	0	51	56	57	68	65	66
"ASFMR1"	3030	12729	22	0	22	0	0	0	109	17	0	0	20	40	21	23	25	7
"ASGR1"	1511	6133	0	0	0	0	0	0	212	109	0	0	10	17	12	9	43	13
"ASGR2"	1553	13491	26	16	26	0	0	16	209	89	0	0	142	163	119	106	432	173
"ASH1L"	11816	227273	12955	8412	7537	5418	4747	3665	5575	5072	3512	10400	2059	2673	2256	2090	2540	1393
"ASH2L"	2662	33880	688	231	351	337	134	97	319	154	92	271	1352	1215	1341	1088	1639	997
"ASIC3"	1906	4216	0	0	0	0	0	0	111	66	0	0	5	1	19	17	45	22
"ASIP"	587	8979	0	0	0	0	0	0	26	0	0	0	0	0	5	3	0	0
"ASKL1"	899	32846	18	4	4	14	4	0	74	12	0	0	39	35	18	10	82	27
"ASL"	2068	17489	125	20	83	42	20	0	149	76	163	57	274	351	519	478	667	419
"ASMT"	1414	47698	0	0	0	0	0	0	0	0	0	0	0	0	1991	1795	2500	1527
"ASMTL"	2120	49814	0	0	0	0	0	0	0	0	0	0	0	0	411	597	559	556
"ASNA1"	1288	10834	23	0	5	18	0	0	90	56	0	1	981	895	1059	1154	1269	1064
"ASNS"	2357	20413	15	0	5	10	0	0	17	11	0	0	244	325	128	84	299	223
"ASNSD1"	2476	9433	29	150	17	12	82	68	40	93	0	0	858	1236	837	911	894	776
"ASPA"	1423	23405	0	0	0	0	0	0	0	0	0	0	0	0	0	0	0	0
"ASPDH"	1050	2286	0	20	0	0	0	20	185	60	0	39	0	9	0	0	0	0
"ASPG"	2253	21636	0	0	0	0	0	0	142	107	0	0	0	0	0	0	0	0
"ASPH"	5373	214085	8317	940	4646	3671	523	417	5749	549	1027	232	2191	2243	2857	3012	2491	2089
"ASPHD1"	1537	18808	1269	320	608	661	235	85	497	197	567	469	454	609	353	303	395	273
"ASPHD2"	3317	15700	350	25	175	175	15	10	180	0	31	0	655	287	552	102	1108	363
"ASPM"	10915	62568	0	0	0	0	0	0	0	3	0	0	0	0	0	0	0	0
"ASPN"	2476	26301	1847	1618	966	881	844	774	767	559	63	989	0	0	0	0	0	0
"ASPRV1"	2173	2173	0	0	0	0	0	0	11	0	0	0	0	0	0	0	0	0
"ASPSCR1"	2140	39856	2341	763	1231	1110	430	333	1302	727	1943	1589	423	371	698	528	1129	680
"ASRGL1"	2424	56113	42	0	23	19	0	0	88	0	0	0	371	448	170	142	222	156
"ASS1"	2243	56568	0	0	0	0	0	0	259	113	0	0	0	0	0	0	3	0
"ASTE1"	2729	12927	200	0	135	65	0	0	132	27	0	0	313	164	371	91	369	158
"ASTL"	1304	14587	43	4425	18	25	2321	2104	114	1	0	2837	0	134	0	53	0	110
"ASTN1"	7336	303822	0	0	0	0	0	0	0	9	0	0	0	0	0	0	0	0
"ASTN2"	4767	989812	14	0	14	0	0	0	171	37	0	0	175	66	492	120	438	152
"ASXH1"	997	70074	2382	1696	1311	1071	954	742	1143	954	998	3075	29	64	117	78	142	80
"ASXL1"	7041	80970	3277	2204	1811	1466	1228	976	1535	1186	1299	3461	1295	1097	1621	1107	2009	1118
"ASXL2"	7186	139061	7169	2824	3895	3274	1552	1272	4084	1447	2012	2022	481	538	620	385	551	278
"ASXL3"	7737	168860	0	0	0	0	0	0	0	0	0	0	0	0	0	0	0	0
"ASZ1"	1878	64303	0	0	0	0	0	0	0	0	0	0	0	0	0	0	0	0
"ATAD1"	3044	65044	723	67	385	338	43	24	629	13	48	65	788	798	791	321	295	269
"ATAD2"	5590	76614	559	10	325	234	10	0	377	21	96	62	731	733	742	550	1053	617
"ATAD2B"	8144	178395	21270	18109	11779	9491	9771	8338	8780	9258	6114	17101	2068	2753	1232	1258	2105	816
"ATAD3A"	2627	22511	44	6	22	22	6	0	225	84	68	30	210	176	527	515	755	542
"ATAD3B"	2681	18177	336	56	195	141	56	0	296	384	212	646	238	293	331	358	702	464
"ATAD3C"	3871	20471	1	0	1	0	0	0	92	25	0	0	0	3	48	58	78	40
"ATAD4"	1385	5777	78	0	61	17	0	0	47	10	50	0	0	0	0	0	0	0
"ATAD5"	6265	63274	418	33	251	167	14	19	319	0	74	4	83	79	53	12	68	17
"ATB0+"	941	10275	0	0	0	0	0	0	0	0	0	0	0	0	0	0	0	0
"ATCAY"	5047	47462	0	0	0	0	0	0	134	60	0	0	2	0	0	0	0	0
"ATE1"	2388	185593	1539	291	862	677	159	132	1281	178	119	188	128	785	303	265	263	164
"ATF1"	2445	57089	648	75	311	337	25	50	425	53	9	239	826	573	885	643	1033	617
"ATF2"	2323	93891	3442	2252	2083	1359	1260	992	1776	1421	220	1474	1789	777	872	764	866	480
"ATF3"	2362	12122	1521	12473	757	764	6704	5769	263	6684	0	5722	1264	20810	2591	17080	2322	7723
"ATF4"	2023	2123	1051	1030	568	483	580	450	339	491	317	573	3570	6049	4009	6443	6015	6004
"ATF5"	2263	5220	2064	4936	1109	955	1980	2956	517	186	265	972	3397	26094	2769	12847	3321	7760
"ATF6"	4443	99663	5227	8351	2981	2246	4477	3874	3310	6068	548	4632	2739	2754	1690	1613	1772	1287
"ATF6B"	2632	12972	1756	455	1030	726	239	216	848	233	1514	217	3261	3285	3063	2421	5838	3462
"ATF7"	6698	114356	3568	1321	1972	1596	815	506	2160	1005	1261	1358	1530	1518	1691	1020	1974	974
"ATF7IP"	4675	133087	5525	2315	3082	2443	1391	924	3714	1352	1002	1824	2240	1989	1547	1035	1532	939
"ATF7IP2"	3676	97584	1544	338	841	703	241	97	1280	266	338	600	160	202	203	166	162	95
"ATG10"	2430	283369	19	0	19	0	0	0	519	71	0	69	122	127	110	83	80	154
"ATG12"	2360	11683	1062	526	623	439	321	205	532	256	265	289	1890	1734	1249	726	1288	565
"ATG16L1"	3422	44104	2871	1944	1674	1197	1058	886	915	413	246	146	519	298	526	294	760	324
"ATG16L2"	2281	15229	5308	2631	2853	2455	1430	1201	2418	1499	5989	3132	1847	2109	3900	2781	5742	3036
"ATG2A"	6413	22719	299	121	162	137	51	70	246	248	109	234	747	751	828	910	1127	871
"ATG2B"	11140	82084	472	76	233	239	53	23	681	139	132	47	930	1161	1209	1074	1275	757
"ATG3"	2740	29127	3796	2548	2122	1674	1437	1111	1597	1162	1147	1993	3344	2495	2455	2132	3512	1679
"ATG4A"	2589	62963	88	8	50	38	8	0	65	0	0	0	404	433	386	362	467	343
"ATG4B"	2947	36239	4002	1377	2161	1841	698	679	1756	705	2958	1342	1531	1506	2840	1965	3203	1685
"ATG4C"	1817	80248	1701	12	981	720	12	0	1659	12	64	0	783	749	825	750	878	662
"ATG4D"	1979	9448	196	32	111	85	0	32	91	82	36	177	424	496	435	455	542	447
"ATG5"	3250	141343	2819	752	1805	1014	394	358	1874	833	272	660	906	998	998	763	1088	821
"ATG7"	5063	285124	26618	31697	14784	11834	17186	14511	11813	14628	10325	26127	1769	771	1096	1185	1103	797
"ATG9A"	5044	11516	1050	223	566	484	129	94	471	140	1007	73	3185	2391	3174	2101	5358	2803
"ATG9B"	4583	12282	0	0	0	0	0	0	83	103	0	0	3	10	43	48	83	39
"ATHL1"	3281	6551	62	34	28	34	15	19	66	12	0	0	3	27	46	28	99	48
"ATIC"	2194	37684	100	8	39	61	8	0	253	17	21	17	1355	1084	1516	1144	1451	1051
"ATL1"	2826	99984	41	1197	20	21	661	536	81	179	0	196	564	1683	129	106	270	200
"ATL2"	3660	81643	856	865	565	291	390	475	629	587	53	671	135	730	573	806	861	433
"ATL3"	2284	43009	1087	57	602	485	27	30	522	37	135	91	3953	3357	730	582	743	467
"ATM"	13299	146269	13915	5052	7732	6183	2662	2390	7192	2106	4653	2370	5183	7563	5462	5175	5743	3242
"ATMIN"	5346	6823	254	34	116	138	19	15	180	34	0	0	2490	2014	2160	1257	2368	1356
"ATN1"	6692	20191	736	323	443	293	200	123	311	378	406	522	1194	1284	1532	1963	1743	1591
"ATOH1"	1066	1066	0	0	0	0	0	0	0	0	0	0	0	0	0	0	0	0
"ATOH7"	1471	1471	0	0	0	0	0	0	0	0	0	0	0	0	0	0	0	0
"ATOH8"	5865	37598	0	0	0	0	0	0	132	35	0	0	0	0	0	0	0	0
"ATOX1"	492	15828	1330	576	723	607	318	258	687	400	878	614	814	694	1013	897	1233	810
"ATP10A"	5253	184489	108	0	63	45	0	0	530	146	32	0	123	129	185	148	143	169
"ATP10B"	7592	289094	0	0	0	0	0	0	16	26	0	19	0	0	0	0	0	0
"ATP10C"	1190	23688	1	0	0	1	0	0	88	22	0	0	0	0	5	12	10	0
"ATP10D"	6573	108095	4297	868	2463	1834	448	420	2473	495	846	596	2233	2295	2261	1900	2106	1458
"ATP11A"	8823	196839	12766	4249	7097	5669	2366	1883	7863	4594	8097	6475	3162	4101	5136	5006	5418	3907
"ATP11B"	7348	128130	5262	2400	2841	2421	1374	1026	2985	1553	493	1299	3100	3878	3296	2967	3450	2159
"ATP11C"	6147	105943	28	47	0	28	36	11	250	189	0	96	692	864	870	907	801	605
"ATP12A"	3605	31224	0	0	0	0	0	0	61	33	0	0	0	0	0	0	0	0
"ATP13A1"	3888	18493	1927	473	1024	903	254	219	948	325	1386	278	1829	1278	2412	1938	3301	2273
"ATP13A2"	4025	25972	112	28	36	76	3	25	238	119	0	0	572	614	690	641	612	599
"ATP13A3"	7358	65565	5446	44203	3045	2401	23825	20378	1466	7221	1270	12032	6109	11651	7203	10643	2617	5139
"ATP13A4"	4303	152831	0	3	0	0	0	3	0	0	0	0	0	0	0	0	0	0
"ATP13A5"	3685	103683	0	0	0	0	0	0	0	0	0	0	0	0	0	0	0	0
"ATP1A1"	3786	30907	1706	6807	901	805	3648	3159	439	3348	331	5547	4872	8015	8165	16979	4852	9735
"ATP1A2"	5478	27854	0	0	0	0	0	0	36	19	0	0	0	0	0	0	0	0
"ATP1A3"	3854	27648	0	2	0	0	2	0	206	135	0	0	0	5	0	0	0	0
"ATP1A4"	3930	20450	0	0	0	0	0	0	16	0	0	0	0	1	0	0	0	0
"ATP1B1"	2210	26015	3214	18920	1860	1354	10221	8699	882	10159	704	18291	2243	9040	2789	9109	3162	8237
"ATP1B2"	3339	6837	342	211	196	146	161	50	116	87	172	507	1392	2180	604	443	420	298
"ATP1B3"	1974	49914	3035	14920	1714	1321	8059	6861	898	6268	306	12237	3024	6205	3537	4726	3737	3925
"ATP1B4"	3899	20284	0	0	0	0	0	0	0	0	0	0	0	0	0	0	0	0
"ATP2A1"	3559	26023	41	37	40	1	37	0	130	116	1	21	272	196	0	3	414	230
"ATP2A2"	8332	69865	5955	3483	3352	2603	1967	1516	2909	2020	3426	4553	6906	7622	9988	10058	10011	6905
"ATP2A3"	4880	40569	4079	1085	2259	1820	619	466	1376	537	3344	1321	5622	4975	7688	6448	8427	3751
"ATP2B1"	6952	68018	20763	55548	11604	9159	38018	17530	8404	33711	5505	48044	11162	16297	7588	13796	11327	3617
"ATP2B2"	8985	384010	0	0	0	0	0	0	835	245	0	0	0	0	0	0	0	0
"ATP2B2 variant protein"	5335	12281	0	0	0	0	0	0	25	37	0	0	0	0	0	0	0	0
"ATP2B3"	6595	46809	0	0	0	0	0	0	525	166	0	0	0	0	0	0	0	0
"ATP2B4"	8927	117281	1101	137	577	524	86	51	860	204	1245	377	1942	2008	1404	1378	2765	2206
"ATP2C1"	4907	152549	2956	8616	1685	1271	4642	3974	1958	3364	368	1712	1958	2705	2201	1995	2449	1635
"ATP2C2"	3811	59761	19	0	19	0	0	0	207	52	0	0	0	0	0	0	0	0
"ATP4A"	3581	13467	10	0	10	0	0	0	92	88	0	0	0	0	0	0	0	0
"ATP4B"	1491	9380	0	0	0	0	0	0	27	24	0	0	0	0	0	0	0	0
"ATP5A1"	2196	14137	1572	826	898	674	407	419	478	432	332	931	10939	11793	9961	7283	12776	11068
"ATP5B"	1851	7893	1650	1442	908	742	700	742	367	503	524	727	22722	24359	17489	14510	21255	14654
"ATP5C1"	1149	19664	1269	250	714	555	155	95	804	232	723	414	3889	3205	3860	3419	4411	2355
"ATP5D"	999	3076	39	31	10	29	18	13	117	19	27	0	1182	694	1247	871	784	882
"ATP5E"	441	3690	103	75	63	40	59	16	104	76	0	0	2385	2724	4992	4319	4197	4094
"ATP5EP2"	368	368	0	0	0	0	0	0	0	0	0	0	0	0	0	0	0	0
"ATP5F1"	2106	12782	625	152	379	246	88	64	304	166	145	304	2236	2301	2771	3295	3297	2583
"ATP5G1"	649	3084	75	43	51	24	23	20	55	32	0	104	382	364	706	687	773	552
"ATP5G2"	1286	11569	591	47	313	278	22	25	262	106	354	129	2707	2329	3735	1663	3619	2603
"ATP5G3"	2732	5406	396	144	229	167	84	60	208	48	14	62	5430	5412	5242	5287	6546	4572
"ATP5H"	628	8121	0	0	0	0	0	0	30	0	43	0	1545	33	1910	1280	2438	1297
"ATP5I"	500	1386	1774	30	17	1757	16	14	1092	26	5273	69	852	695	599	571	814	533
"ATP5J"	1299	11175	15	0	15	0	0	0	65	9	0	0	677	907	749	642	778	621
"ATP5J2"	498	8025	894	312	508	386	177	135	339	274	337	680	1390	1486	2797	2364	3287	2398
"ATP5L"	1340	8459	558	415	312	246	195	220	193	210	86	528	2210	2439	2468	3172	4076	3156
"ATP5O"	812	12402	314	78	203	111	45	33	283	93	0	193	1964	1856	1934	1725	2606	1868
"ATP5S"	1572	13623	468	59	199	269	46	13	283	39	34	80	575	417	328	201	360	118
"ATP5SL"	1740	8222	128	0	75	53	0	0	192	28	0	0	878	664	882	721	1107	796
"ATP6AP1"	2109	7886	1590	1280	922	668	681	599	535	664	1134	1749	9796	10346	10339	14512	16491	13591
"ATP6AP1L"	2037	38867	0	0	0	0	0	0	105	0	0	3	0	14	35	27	36	42
"ATP6AP2"	2043	25672	654	315	358	296	194	121	211	92	213	86	6424	6782	8332	7836	8010	6644
"ATP6V0A1"	4163	63736	6649	5005	3762	2887	2702	2303	2461	1623	4242	4084	3193	2435	4925	3787	4776	3641
"ATP6V0A2"	6559	49436	2097	549	1237	860	327	222	1055	181	749	347	2342	2111	1956	1224	2576	1501
"ATP6V0A4"	3157	91903	0	0	0	0	0	0	0	0	0	0	0	0	0	0	0	0
"ATP6V0B"	2437	3325	471	315	255	216	157	158	226	185	377	330	3865	4332	3409	6651	7093	2871
"ATP6V0C"	1095	6267	1382	852	742	640	472	380	372	401	1333	1276	3881	3291	7642	6031	5342	5099
"ATP6V0D1"	1802	43174	5847	5122	3175	2672	2787	2335	2444	3017	3864	6603	4337	1993	2955	3219	3507	2898
"ATP6V0D2"	2378	55317	0	0	0	0	0	0	0	0	0	0	8	7	10	0	0	5
"ATP6V0E1"	886	51139	4208	5038	2394	1814	2765	2273	1370	2876	1479	5349	5622	5519	7363	6706	9295	6965
"ATP6V0E2"	2730	7731	0	0	0	0	0	0	19	0	0	0	195	168	444	400	341	248
"ATP6V1A"	4615	64995	6523	1861	3541	2982	1136	725	2545	939	2582	1658	8345	8678	7185	6672	7591	5411
"ATP6V1B1"	3001	24515	14	0	14	0	0	0	94	38	0	0	2	9	0	0	0	0
"ATP6V1B2"	3056	24503	8165	7017	4598	3567	3764	3253	3114	1813	3132	4010	13905	14954	19410	16025	18672	13506
"ATP6V1C1"	5716	52038	2294	2923	1363	931	1651	1272	1168	1596	496	2280	2784	3534	3124	3427	3020	2515
"ATP6V1C2"	3246	63455	91	28	54	37	20	8	140	74	91	5	2106	2273	3163	2862	2842	2225
"ATP6V1D"	1844	65503	1180	462	680	500	254	208	553	273	67	294	2271	2451	2491	2135	2496	1826
"ATP6V1E1"	1414	36687	1113	565	630	483	302	263	638	594	214	1100	1627	2038	1951	1820	1510	2934
"ATP6V1E2"	1979	8110	0	0	0	0	0	0	0	0	0	0	43	69	24	12	107	62
"ATP6V1F"	693	3006	250	235	132	118	132	103	192	131	84	303	1747	1653	4855	5581	4415	4844
"ATP6V1G1"	1613	11159	549	712	290	259	377	335	287	402	216	939	2771	3311	3393	3028	3448	2731
"ATP6V1G2"	1597	2386	0	0	0	0	0	0	0	0	0	0	0	0	0	0	0	0
"ATP6V1G3"	679	17721	0	0	0	0	0	0	0	0	0	0	0	0	0	0	0	0
"ATP6V1H"	2166	127736	7337	4175	4137	3200	2400	1775	3134	1786	1051	1840	1243	1276	1742	1536	1752	1622
"ATP7A"	8510	139699	269	61	163	106	36	25	271	95	0	8	814	1113	1152	1014	1070	723
"ATP7B"	6662	78826	26	0	26	0	0	0	35	27	0	0	321	429	238	157	407	205
"ATP8A1"	8305	248732	2008	830	1175	833	452	378	1344	513	203	804	878	1168	900	788	1277	678
"ATP8A2"	5042	649212	0	0	0	0	0	0	0	14	0	0	0	0	0	0	0	0
"ATP8B1"	5842	85380	5399	1950	3177	2222	1092	858	2609	1009	2013	1628	146	207	80	93	99	53
"ATP8B2"	5885	23505	7	0	5	2	0	0	57	58	0	16	48	94	28	88	144	51
"ATP8B3"	5261	30196	0	0	0	0	0	0	172	81	0	0	20	27	14	7	46	44
"ATP8B4"	5812	255079	3552	1565	1972	1580	867	698	5481	2376	360	1627	615	901	1163	1059	853	782
"ATP9A"	7608	171596	3	0	0	3	0	0	43	12	0	0	0	3	3	0	7	3
"ATP9B"	6521	250120	6869	5966	3962	2907	3294	2672	4934	4838	1724	5553	654	762	1140	1172	1013	658
"ATPAF1"	4136	35688	110	31	71	39	20	11	229	31	28	28	902	1081	918	689	977	649
"ATPAF2"	1834	24109	1386	42	760	626	27	15	656	50	392	18	703	531	731	597	1055	672
"ATPBD4"	2384	25932	25	0	8	17	0	0	59	8	0	0	41	31	53	57	42	45
"ATPGD1"	5093	9431	39	8	17	22	0	8	84	94	0	43	3	8	0	0	0	0
"ATPIF1"	1911	2000	102	0	39	63	0	0	87	17	33	0	876	795	1002	819	1326	895
"ATR"	8297	129592	5556	2449	3204	2352	1302	1147	3203	1364	1176	2129	1855	2591	1852	1409	2044	1190
"ATRIP"	3176	19492	320	38	143	177	3	35	108	60	135	69	152	122	1707	104	2291	165
"ATRN"	8684	180106	2357	190	1380	977	125	65	1653	263	376	214	1595	1650	1777	1642	2087	1329
"ATRNL1"	8759	855372	0	0	0	0	0	0	0	0	0	0	0	0	0	0	0	0
"ATRX"	11340	281362	8564	4605	4910	3654	2516	2089	4896	2959	1376	3070	3337	4524	3668	3237	3966	2204
"ATXN1"	10644	462379	188274	234181	105745	82529	125736	108445	60675	87089	109058	171430	8346	14808	7215	7168	8051	5632
"ATXN10"	2975	173144	8326	2759	4773	3553	1595	1164	4588	1717	1881	2946	1337	1484	1289	1269	1751	1328
"ATXN1L"	7879	11334	1351	1207	755	596	654	553	583	845	367	1106	1954	2828	2497	3325	2633	1974
"ATXN2"	4726	147463	6933	2212	3923	3010	688	1524	3481	8764	3176	1852	665	611	803	652	1024	668
"ATXN2L"	4387	14144	2437	1929	1294	1143	1026	903	902	1071	1619	2838	1473	2577	3744	3789	4884	4037
"ATXN3"	6933	48070	3166	478	1766	1400	222	256	1330	228	917	213	1248	1209	920	609	1130	644
"ATXN3L"	1750	1750	0	0	0	0	0	0	0	0	0	0	0	0	0	0	0	0
"ATXN7"	7304	138903	13776	4323	7694	6082	2362	1961	6447	2528	3751	2760	1502	1774	1797	1375	1930	1189
"ATXN7L1"	5703	271812	3709	2188	2165	1544	1209	979	3456	2961	508	2267	307	483	406	366	473	188
"ATXN7L2"	2415	3951	86	52	45	41	23	29	173	144	0	62	71	68	111	112	103	81
"ATXN7L3"	3625	6357	405	283	204	201	133	150	566	213	316	303	3209	2975	3513	2572	4665	2770
"AUH"	1596	148109	24532	11946	13805	10727	6682	5264	14537	4908	13933	9762	3315	3654	1392	743	2701	1320
"AUP1"	1809	3200	505	417	286	219	218	199	74	152	514	247	3291	3366	2642	2809	3664	3602
"AURKA"	2558	22908	0	0	0	0	0	0	42	9	0	0	195	184	219	200	298	241
"AURKAIP1"	994	1710	61	0	40	21	0	0	22	33	0	37	94	702	1000	269	1432	1219
"AURKAPS1"	1538	1538	194	87	103	91	52	35	147	103	0	96	16	11	0	0	0	0
"AURKB"	1247	5835	0	0	0	0	0	0	82	48	0	0	10	5	20	5	11	0
"AURKC"	1256	4489	0	0	0	0	0	0	45	0	0	0	12	13	20	6	0	5
"AUTS2"	6436	1193981	0	49	0	0	27	22	155	136	0	87	19	37	0	77	40	11
"AV1S3A1T"	531	631	0	0	0	0	0	0	0	0	0	0	0	0	0	0	0	0
"AV1S4A1N1T"	1934	3761	0	0	0	0	0	0	0	0	0	0	0	0	0	0	3	0
"AV22S1A2N1"	375	520	0	0	0	0	0	0	0	0	0	0	0	0	0	0	0	0
"AV25S1"	357	606	0	0	0	0	0	0	0	0	0	0	0	0	0	0	0	0
"AV2S1A1"	451	389876	0	0	0	0	0	0	0	0	0	0	0	0	0	8	20	0
"AV30S1"	415	415547	153	125	35	118	85	40	0	8	0	0	39	56	18	32	19	36
"AV4S1"	384	311415	291	278	113	178	188	90	43	15	0	101	235	347	109	113	158	108
"AV8S2"	421	579	0	0	0	0	0	0	0	0	0	0	0	0	0	0	0	0
"AV8S2A1N1T"	139	21541	12	95	12	0	51	44	16	0	0	0	0	0	2	0	4	3
"AVEN"	1536	172876	306	123	163	143	79	44	314	185	0	138	136	146	174	97	229	148
"AVIL"	2846	18411	49	44	22	27	15	29	102	23	10	0	48	81	21	20	47	18
"AVL9"	2369	88605	14547	6042	8093	6454	3321	2721	7406	2725	6414	5717	5073	5552	5774	4109	6013	3921
"AVP"	621	2169	0	0	0	0	0	0	0	15	0	0	0	0	0	0	0	0
"AVPI1"	1396	9836	647	183	465	182	54	129	350	82	352	0	683	225	538	437	602	481
"AVPR1A"	4156	6376	0	0	0	0	0	0	0	0	0	0	0	0	0	0	0	0
"AVPR1B"	1775	7201	0	0	0	0	0	0	0	0	0	0	0	0	0	0	0	0
"AVPR2"	1833	2193	385	78	121	264	0	78	382	126	201	0	0	677	0	0	0	0
"AWAT1"	1405	6007	0	0	0	0	0	0	0	0	0	0	0	0	0	0	0	0
"AWAT2"	2132	9398	0	0	0	0	0	0	0	0	0	0	0	0	0	0	0	0
"AX229788"	108	108	0	0	0	0	0	0	0	0	0	0	0	0	0	0	0	0
"AX721097"	1370	7169	1335	20213	828	507	10821	9392	260	15616	276	32875	299	10990	319	15969	248	4911
"AX721123"	349	12536	28	0	11	17	0	0	64	47	0	0	0	0	3	0	0	1
"AX721193"	325	4937	0	0	0	0	0	0	0	0	0	0	0	0	0	0	0	0
"AX721199"	704	5872	11	0	11	0	0	0	12	0	0	0	5	10	7	0	14	0
"AX721218"	1806	9750	0	0	0	0	0	0	36	0	0	0	0	0	0	0	0	0
"AX721251"	1121	1739	366	330	208	158	182	148	57	1	72	107	18	22	47	23	67	10
"AX721264"	442	442	0	0	0	0	0	0	13	0	0	0	0	0	0	0	0	0
"AX721280"	620	620	27	0	0	27	0	0	59	0	0	0	0	0	0	0	0	0
"AX721289"	750	8690	0	0	0	0	0	0	0	0	0	0	2	3	0	0	0	0
"AX721309"	744	1093	2309	1037	1178	1131	0	1037	724	1413	1950	5907	697	1862	690	1187	1199	833
"AX746478"	1958	1958	240	0	127	113	0	0	131	20	213	35	65	1225	29	0	34	0
"AX746481"	2785	14190	0	0	0	0	0	0	11	0	0	0	0	0	0	0	0	0
"AX746484"	2634	2634	112	182	56	56	120	62	6	23	166	227	114	67	153	56	173	90
"AX746487"	3136	3136	0	0	0	0	0	0	45	11	0	0	0	0	0	0	0	0
"AX746492"	2606	2606	234	76	115	119	62	14	99	39	102	26	0	0	0	0	0	0
"AX746504"	2283	2283	0	0	0	0	0	0	0	0	0	0	0	0	0	0	0	0
"AX746517"	2440	2440	29	0	0	29	0	0	57	0	0	0	188	169	132	52	195	75
"AX746522"	2718	2718	291	710	162	129	428	282	42	3082	4	1844	20	57	101	199	135	29
"AX746523"	2387	37432	0	10	0	0	0	10	27	22	0	24	79	99	296	331	160	163
"AX746529"	3325	5948	0	0	0	0	0	0	0	0	0	0	0	0	0	0	0	0
"AX746535"	1150	1150	0	0	0	0	0	0	0	0	0	0	35	0	0	0	0	0
"AX746542"	2005	2005	505	0	331	174	0	0	263	80	844	0	0	0	2	0	1	0
"AX746544"	2621	3995	0	0	0	0	0	0	0	14	0	0	0	0	0	0	0	0
"AX746562"	2154	2154	0	0	0	0	0	0	0	0	0	0	0	0	0	0	0	0
"AX746564"	1568	14120	0	0	0	0	0	0	0	0	0	0	0	0	0	0	0	0
"AX746567"	2153	249419	0	0	0	0	0	0	0	10	0	0	0	0	0	0	0	0
"AX746575"	2028	2028	0	0	0	0	0	0	26	10	0	0	0	0	0	0	0	0
"AX746582"	850	850	0	0	0	0	0	0	0	0	0	0	0	0	0	0	0	0
"AX746590"	2608	2608	230	86	156	74	22	64	160	10	28	5	91	65	90	64	112	75
"AX746596"	2459	4048	0	0	0	0	0	0	0	0	0	0	0	0	0	0	0	0
"AX746599"	2527	30929	4	0	1	3	0	0	187	116	0	0	4	1	4	0	0	0
"AX746604"	1791	1791	0	0	0	0	0	0	12	0	0	0	0	0	0	0	0	0
"AX746605"	3417	3417	0	0	0	0	0	0	42	13	0	0	0	0	0	1	1	0
"AX746617"	2159	3956	0	0	0	0	0	0	0	0	0	0	0	0	0	0	0	0
"AX746619"	2115	9119	373	70	190	183	38	32	153	16	0	12	607	182	186	72	241	129
"AX746620"	2070	2811	22	3	11	11	3	0	7	2	0	0	22	15	25	21	25	16
"AX746622"	2129	2129	0	0	0	0	0	0	33	0	0	0	22	17	21	3	11	14
"AX746627"	2096	2096	0	0	0	0	0	0	0	0	0	0	0	0	0	0	0	0
"AX746631"	2144	2144	0	0	0	0	0	0	26	9	0	0	0	0	0	0	0	0
"AX746635"	750	18124	71	0	50	21	0	0	62	0	10	0	152	303	251	194	296	227
"AX746638"	2672	2672	0	0	0	0	0	0	0	0	0	0	0	0	0	0	0	0
"AX746640"	2527	2527	253	14	130	123	14	0	95	73	84	25	349	372	504	320	409	271
"AX746648"	2701	7801	0	0	0	0	0	0	0	0	0	0	0	0	0	0	0	0
"AX746654"	2149	2149	0	0	0	0	0	0	10	0	0	0	0	0	0	0	0	0
"AX746665"	2492	2492	0	0	0	0	0	0	0	0	0	0	0	0	0	0	0	0
"AX746670"	2118	2118	225	751	161	64	261	490	167	17367	0	15443	83	711	103	929	114	168
"AX746671"	1863	1863	1770	279	907	863	96	183	298	941	314	2131	0	8	1	20	0	1
"AX746677"	2347	2347	0	0	0	0	0	0	0	0	0	0	0	0	0	0	0	0
"AX746678"	2367	21587	0	0	0	0	0	0	0	0	0	0	0	0	0	0	0	0
"AX746683"	2705	5322	0	0	0	0	0	0	0	10	0	0	0	0	0	1	0	0
"AX746690"	2004	10786	0	0	0	0	0	0	0	0	0	0	14	2	0	0	0	0
"AX746692"	2260	41857	0	0	0	0	0	0	37	0	0	0	89	44	117	33	196	43
"AX746699"	2747	2747	0	0	0	0	0	0	35	0	0	0	0	0	0	0	0	0
"AX746710"	1416	1416	0	0	0	0	0	0	0	0	0	0	0	0	0	0	0	0
"AX746718"	2320	2320	0	0	0	0	0	0	0	0	0	0	0	0	0	0	0	0
"AX746723"	2776	2776	0	0	0	0	0	0	0	0	0	0	0	0	0	0	0	0
"AX746725"	2826	6018	0	0	0	0	0	0	0	0	0	0	0	0	0	0	0	0
"AX746731"	2552	37586	0	0	0	0	0	0	27	0	0	0	0	0	0	0	0	0
"AX746733"	2740	3538	215	614	127	88	330	284	58	3089	24	2390	73	120	111	253	154	118
"AX746734"	2000	2000	0	0	0	0	0	0	11	0	0	0	0	0	0	0	0	0
"AX746741"	2699	3904	0	0	0	0	0	0	0	0	0	0	0	0	0	0	0	0
"AX746750"	2454	2454	9	0	0	9	0	0	33	0	0	0	106	115	4	3	4	2
"AX746752"	3676	3676	54	0	37	17	0	0	47	10	0	0	22	12	0	0	0	0
"AX746755"	2068	2068	0	358	0	0	295	63	28	0	0	35	121	26	0	85	0	0
"AX746764"	1840	1840	443	0	0	443	0	0	478	22	60	86	97	23	0	0	0	0
"AX746765"	2184	2184	0	0	0	0	0	0	0	0	0	0	0	0	0	0	0	0
"AX746780"	1080	1080	0	0	0	0	0	0	0	0	0	0	0	0	0	0	0	0
"AX746787"	2928	2928	0	0	0	0	0	0	17	0	0	0	0	0	0	0	0	0
"AX746800"	3629	3629	0	0	0	0	0	0	0	0	0	0	0	0	0	0	0	0
"AX746803"	2426	2527	0	0	0	0	0	0	0	11	0	0	0	0	0	0	0	0
"AX746823"	2944	2944	8262	5452	7	8255	2743	2709	7170	1796	2801	148	37	25	0	0	42	0
"AX746826"	3950	3950	0	0	0	0	0	0	28	16	0	0	0	0	0	0	0	0
"AX746830"	2522	2522	0	0	0	0	0	0	0	0	0	0	0	0	0	0	0	0
"AX746834"	2503	2503	63	34	28	35	34	0	42	67	0	89	0	0	0	0	0	0
"AX746839"	2964	5181	0	0	0	0	0	0	0	2	0	0	0	0	2	3	0	0
"AX746857"	3110	3110	0	0	0	0	0	0	0	0	0	44	0	0	0	0	0	0
"AX746867"	2725	2725	2372	1179	1318	1054	630	549	407	1067	472	2486	0	0	0	0	0	0
"AX746869"	2691	2691	169	990	84	85	360	630	159	880	113	939	52	435	0	92	20	42
"AX746871"	1926	1926	0	0	0	0	0	0	12	0	0	0	0	0	0	0	0	0
"AX746877"	1464	1464	0	0	0	0	0	0	0	0	0	0	0	0	0	0	0	0
"AX746880"	3101	3101	0	0	0	0	0	0	0	0	0	0	0	0	0	0	0	0
"AX746887"	1150	1150	0	0	0	0	0	0	0	0	0	0	0	0	0	0	0	0
"AX746903"	2965	2965	0	0	0	0	0	0	0	0	0	0	0	0	0	0	0	0
"AX746920"	2525	2525	0	0	0	0	0	0	0	0	0	0	0	0	0	0	0	0
"AX746944"	1398	1398	11	0	0	11	0	0	4	0	0	0	10	12	11	2	11	7
"AX746964"	2885	2885	0	0	0	0	0	0	0	0	0	0	0	0	0	0	0	0
"AX746967"	2996	2996	250	204	147	103	141	63	122	225	0	498	45	108	0	0	1	0
"AX746968"	1648	1648	8364	4436	3323	5041	2399	2037	4591	2903	7393	8626	3433	3443	552	529	729	399
"AX746969"	3028	3028	17	0	0	17	0	0	1	0	0	0	32	16	113	120	39	144
"AX746971"	2662	2662	117	12	41	76	0	12	279	0	0	0	5535	5054	624	460	385	283
"AX746988"	2609	124811	0	0	0	0	0	0	0	0	0	0	0	0	0	0	0	0
"AX746989"	1886	1886	327	176	182	145	94	82	150	118	187	158	13	52	0	0	0	0
"AX746991"	2553	2553	0	0	0	0	0	0	29	0	0	0	0	0	0	0	0	0
"AX746995"	2483	7181	0	0	0	0	0	0	9	0	0	0	0	0	0	0	0	0
"AX746996"	2238	2238	0	0	0	0	0	0	0	0	0	0	0	0	0	0	0	0
"AX747003"	2384	2384	108	0	85	23	0	0	137	0	134	25	68	76	39	58	45	30
"AX747021"	2758	2758	11	0	11	0	0	0	53	0	0	0	10	11	5	5	17	9
"AX747031"	2186	2186	0	0	0	0	0	0	0	0	0	0	0	0	0	0	0	0
"AX747048"	1963	3199	0	0	0	0	0	0	0	0	0	0	0	0	0	0	0	0
"AX747062"	2647	106262	0	0	0	0	0	0	0	0	0	0	66	93	0	5	0	0
"AX747064"	1361	1361	40	0	20	20	0	0	40	13	0	0	0	0	0	0	0	0
"AX747067"	2349	2349	0	7	0	0	7	0	70	0	0	0	259	407	31	0	27	0
"AX747070"	2991	2991	0	0	0	0	0	0	0	0	0	0	0	0	0	0	0	0
"AX747080"	1531	1531	88	223	50	38	129	94	45	194	0	265	0	0	0	0	0	1
"AX747081"	3585	3585	0	0	0	0	0	0	24	3	0	0	47	45	78	86	121	86
"AX747088"	2504	2504	19	0	19	0	0	0	63	34	0	52	165	214	272	265	461	223
"AX747090"	2952	2952	40	0	31	9	0	0	18	0	0	0	97	43	123	36	188	73
"AX747098"	657	657	247	28	142	105	11	17	74	131	0	143	0	0	0	0	0	0
"AX747103"	2318	2318	8428	1357	1540	6888	710	647	8034	2362	1023	393	4065	3777	3709	3635	3360	2291
"AX747113"	2584	15233	24	0	24	0	0	0	33	9	39	0	74	171	0	0	0	0
"AX747119"	1209	1209	0	0	0	0	0	0	0	0	0	0	0	0	0	0	0	0
"AX747123"	2409	2409	153	78	76	77	52	26	13	26	43	0	777	926	577	401	872	534
"AX747124"	1546	1546	0	0	0	0	0	0	0	0	0	0	0	0	0	0	0	0
"AX747125"	2324	2324	0	0	0	0	0	0	31	20	0	1	927	1033	251	228	1418	249
"AX747132"	1712	1712	0	0	0	0	0	0	9	0	0	0	0	0	0	0	0	0
"AX747133"	2256	3402	0	0	0	0	0	0	0	10	0	0	0	0	0	0	0	0
"AX747135"	2088	2667	13	0	0	13	0	0	24	13	0	0	10	12	5	17	13	7
"AX747140"	2096	2096	178	8	92	86	6	2	167	48	163	107	78	136	268	115	436	90
"AX747158"	2629	2629	289	174	120	169	116	58	306	144	98	84	11	49	129	0	119	0
"AX747161"	1875	1875	149	27	32	117	24	3	68	98	0	0	0	0	5	0	24	0
"AX747163"	2102	51859	0	0	0	0	0	0	0	0	0	0	0	0	0	0	0	0
"AX747167"	2034	2034	0	0	0	0	0	0	0	0	0	0	10	0	0	0	0	0
"AX747171"	2346	2346	0	0	0	0	0	0	46	15	0	0	0	0	0	0	0	0
"AX747172"	2144	2144	26	0	13	13	0	0	12	0	0	29	0	0	0	0	0	0
"AX747173"	1975	1975	38	19	19	19	19	0	40	37	0	0	316	266	497	391	632	461
"AX747174"	3054	3054	0	0	0	0	0	0	13	0	0	0	0	0	0	0	0	0
"AX747175"	2327	2327	797	152	346	451	114	38	380	531	352	605	58	57	122	146	135	135
"AX747178"	1720	1720	0	0	0	0	0	0	0	0	0	0	0	0	0	0	0	0
"AX747182"	1869	3822	211	64	146	65	43	21	153	70	173	97	1	0	115	117	410	0
"AX747187"	2308	90516	0	0	0	0	0	0	0	0	0	0	0	0	0	0	0	0
"AX747189"	2070	2070	0	0	0	0	0	0	0	0	0	0	0	0	0	0	0	0
"AX747190"	3370	12267	2299	1385	1307	992	732	653	10	302	1467	1363	255	204	168	253	218	126
"AX747191"	2026	2026	230	0	113	117	0	0	31	0	74	0	505	231	155	23	194	46
"AX747192"	2137	2137	347	58	206	141	30	28	164	52	172	30	622	477	171	455	929	520
"AX747197"	1921	1921	194	15	105	89	15	0	118	17	73	0	1	8	3	2	5	0
"AX747205"	2416	2416	0	0	0	0	0	0	0	0	0	0	0	0	0	0	0	0
"AX747206"	796	796	0	0	0	0	0	0	0	0	0	0	0	0	0	0	0	0
"AX747207"	2872	2872	490	38	328	162	38	0	89	90	0	127	1398	1307	0	754	0	0
"AX747210"	2310	16293	38	62	29	9	20	42	88	48	0	0	108	135	157	386	225	266
"AX747213"	903	903	0	0	0	0	0	0	27	8	0	0	0	0	0	0	0	0
"AX747215"	2164	2164	119	47	59	60	31	16	87	33	45	41	0	0	0	0	0	0
"AX747224"	2511	55206	0	0	0	0	0	0	0	0	0	0	0	0	0	0	0	0
"AX747238"	2140	2140	299	15	150	149	0	15	275	36	64	0	0	0	0	1	0	0
"AX747246"	2121	2121	0	0	0	0	0	0	0	0	0	0	0	0	0	0	0	0
"AX747250"	3438	25019	0	0	0	0	0	0	0	0	0	0	0	0	0	0	0	0
"AX747251"	2223	63836	0	0	0	0	0	0	31	0	0	0	0	0	0	0	0	0
"AX747261"	2608	10106	0	0	0	0	0	0	0	0	0	0	0	0	0	0	0	0
"AX747263"	793	5565	0	0	0	0	0	0	9	0	0	0	0	0	0	0	0	0
"AX747264"	1669	2154	0	0	0	0	0	0	0	28	0	81	649	1317	670	1347	587	1069
"AX747269"	2947	2947	24	0	0	24	0	0	0	0	0	0	76	75	87	40	88	13
"AX747284"	1168	1168	28	63	17	11	63	0	25	170	0	88	0	120	0	75	0	0
"AX747287"	1959	1959	0	0	0	0	0	0	0	0	0	0	0	0	0	0	0	0
"AX747308"	2770	87220	0	0	0	0	0	0	0	0	0	0	0	0	0	0	0	0
"AX747333"	2213	2213	0	0	0	0	0	0	0	0	0	0	0	0	0	0	0	0
"AX747340"	3319	16598	0	0	0	0	0	0	0	0	0	0	0	0	0	0	0	0
"AX747345"	1701	3826	0	0	0	0	0	0	0	0	0	0	0	0	0	0	0	0
"AX747360"	2141	5168	29	0	9	20	0	0	0	0	0	0	10	36	12	14	0	0
"AX747364"	1306	5590	0	0	0	0	0	0	31	0	0	0	0	0	0	0	0	0
"AX747367"	2391	2391	0	0	0	0	0	0	0	0	0	0	0	0	0	0	0	0
"AX747368"	1758	1758	0	0	0	0	0	0	12	0	0	0	238	0	0	0	0	0
"AX747372"	1128	1128	0	0	0	0	0	0	0	0	0	0	0	0	0	0	0	0
"AX747375"	559	2634	0	0	0	0	0	0	0	0	0	0	0	0	0	0	0	0
"AX747377"	2163	2163	0	0	0	0	0	0	0	0	0	0	0	0	0	0	0	0
"AX747379"	2129	2129	10	0	8	2	0	0	134	3	0	0	161	92	35	70	59	35
"AX747383"	1989	226917	0	0	0	0	0	0	33	9	0	53	33	22	0	0	40	0
"AX747384"	1856	1856	0	0	0	0	0	0	0	0	0	0	0	0	0	0	0	0
"AX747393"	1661	1661	8190	746	1211	6979	399	347	719	305	1892	878	3066	2839	3676	3230	4585	3237
"AX747401"	1773	1773	13	0	0	13	0	0	11	0	0	0	16	3	0	2	0	0
"AX747402"	2370	2370	0	0	0	0	0	0	0	0	0	0	0	0	0	0	0	0
"AX747405"	1804	40123	2526	648	1470	1056	358	290	1265	286	1396	396	141	91	126	53	140	51
"AX747408"	2225	10731	0	0	0	0	0	0	20	0	0	0	0	0	0	0	0	0
"AX747413"	1950	1950	0	0	0	0	0	0	0	0	0	0	0	0	0	0	0	0
"AX747415"	2048	5424	0	0	0	0	0	0	0	0	0	0	0	0	0	0	0	0
"AX747416"	936	936	0	0	0	0	0	0	0	0	0	0	0	0	0	0	0	0
"AX747417"	2600	28772	0	0	0	0	0	0	0	0	0	0	0	0	0	0	0	0
"AX747440"	3662	4942	224	187	127	97	84	103	197	132	114	211	98	106	41	55	98	67
"AX747444"	2480	2480	220	198	118	102	96	102	63	112	0	96	3	8	6	10	6	0
"AX747485"	2584	2584	6	0	6	0	0	0	33	26	0	0	0	8	0	0	8	0
"AX747493"	2884	18335	403	216	232	171	119	97	214	39	0	128	681	722	564	5	706	11
"AX747507"	1362	1362	683	52	423	260	24	28	314	38	75	92	510	0	322	0	0	0
"AX747516"	3403	3403	72	57	40	32	24	33	56	74	40	55	276	0	110	427	482	79
"AX747517"	1191	1191	0	0	0	0	0	0	0	11	0	0	25	12	5	0	18	14
"AX747519"	1491	1892	0	0	0	0	0	0	0	23	0	0	0	0	0	0	0	0
"AX747527"	2360	2360	0	0	0	0	0	0	0	0	0	0	0	0	0	0	0	0
"AX747530"	2090	2090	1	0	0	1	0	0	46	0	0	0	0	0	0	0	0	0
"AX747531"	1222	1222	15	0	15	0	0	0	38	13	0	0	0	0	36	8	41	34
"AX747534"	2033	2033	0	0	0	0	0	0	0	0	0	0	0	0	0	0	0	0
"AX747535"	2768	2768	78	0	36	42	0	0	53	0	0	0	1205	1307	1065	865	1154	715
"AX747537"	702	702	226	22	117	109	22	0	225	49	95	0	0	82	0	0	0	0
"AX747547"	2141	2141	713	37	523	190	24	13	234	131	389	566	75	108	29	19	83	22
"AX747550"	1961	1961	0	0	0	0	0	0	0	0	0	0	0	0	0	0	0	0
"AX747556"	2773	2773	0	0	0	0	0	0	0	0	0	0	0	0	0	0	0	0
"AX747565"	2969	2969	181	192	120	61	98	94	85	156	0	205	853	914	146	1040	1330	1002
"AX747577"	1881	1881	0	0	0	0	0	0	12	15	0	0	0	9	0	0	0	0
"AX747578"	1995	6565	0	0	0	0	0	0	0	0	0	0	0	0	0	0	0	0
"AX747582"	1725	1725	0	0	0	0	0	0	0	0	0	0	0	0	0	0	0	0
"AX747586"	2014	2014	242	73	168	74	32	41	146	65	139	174	0	0	0	0	0	0
"AX747590"	2985	2985	280	94	166	114	58	36	281	79	41	99	0	0	0	0	0	4
"AX747592"	3892	8473	1360	524	767	593	261	263	613	259	1159	568	2203	1428	2339	1757	3221	1934
"AX747593"	2279	2279	0	0	0	0	0	0	0	0	0	0	0	0	0	0	0	0
"AX747594"	2046	2046	0	0	0	0	0	0	0	0	0	0	0	0	0	0	0	0
"AX747596"	2232	6191	0	0	0	0	0	0	106	82	0	0	0	0	0	0	0	0
"AX747598"	1790	35699	0	0	0	0	0	0	10	10	0	0	0	0	254	180	152	47
"AX747618"	2689	48443	0	0	0	0	0	0	10	0	0	0	41	25	0	0	0	0
"AX747619"	3355	3355	449	0	285	164	0	0	132	11	0	0	31	32	19	54	37	55
"AX747623"	2353	178015	0	0	0	0	0	0	0	0	0	0	0	0	0	0	0	0
"AX747628"	2341	2341	114	234	56	58	132	102	50	16	57	0	0	0	0	0	0	0
"AX747630"	1881	1881	0	0	0	0	0	0	0	0	0	0	0	0	0	0	0	0
"AX747631"	1112	1112	0	0	0	0	0	0	0	16	0	0	0	0	0	0	0	0
"AX747639"	1606	1606	0	0	0	0	0	0	0	0	0	0	0	0	0	0	0	0
"AX747640"	3299	3299	0	0	0	0	0	0	0	13	0	0	52	39	0	0	0	0
"AX747641"	986	986	0	0	0	0	0	0	0	0	0	0	0	0	0	0	0	0
"AX747648"	2321	2321	239	23	108	131	23	0	56	32	0	0	127	25	0	0	0	0
"AX747649"	2502	2502	0	0	0	0	0	0	0	0	0	0	0	0	0	0	0	0
"AX747652"	1942	1942	40	0	23	17	0	0	0	0	0	29	0	0	0	0	0	0
"AX747658"	2164	12200	105	53	57	48	44	9	66	72	2	5	24	31	53	54	97	32
"AX747659"	1938	1938	179	49	100	79	23	26	61	31	0	86	0	0	0	0	0	0
"AX747662"	2869	2869	0	14	0	0	0	14	0	10	0	0	0	0	0	0	0	0
"AX747676"	1171	12775	0	0	0	0	0	0	0	0	0	0	0	0	0	0	0	0
"AX747691"	2103	2103	0	0	0	0	0	0	0	0	0	0	0	0	0	0	0	0
"AX747699"	734	734	23	0	23	0	0	0	39	0	0	0	0	0	2	0	2	12
"AX747702"	1940	13572	0	0	0	0	0	0	152	15	0	0	0	0	0	0	0	0
"AX747706"	2118	2118	0	0	0	0	0	0	15	21	0	2	0	0	0	0	0	0
"AX747721"	2461	2461	0	0	0	0	0	0	0	0	0	0	0	0	0	0	0	0
"AX747730"	2281	2281	484	349	273	211	138	211	104	0	489	1215	334	0	42	104	95	91
"AX747733"	2560	2560	350	3	186	164	0	3	182	43	77	0	0	0	8	12	10	11
"AX747737"	2556	2556	310	128	155	155	62	66	68	91	448	56	2	4	77	16	83	27
"AX747739"	2059	183779	8859	4192	4950	3909	2344	1848	2230	1087	1304	3263	17	45	4	0	0	0
"AX747741"	3028	3028	441	0	252	189	0	0	130	39	183	15	1206	799	546	98	694	110
"AX747742"	2005	2005	156	42	95	61	22	20	72	0	0	35	2042	1882	136	63	185	129
"AX747750"	2302	2302	0	0	0	0	0	0	0	0	0	0	18	0	0	0	0	0
"AX747752"	2533	2533	0	0	0	0	0	0	22	0	0	0	0	0	0	0	0	0
"AX747754"	2761	2761	2	0	1	1	0	0	10	15	0	0	24	0	4	8	28	3
"AX747755"	2617	2617	8	0	8	0	0	0	32	14	0	0	97	75	152	180	190	156
"AX747756"	2057	2057	253	727	170	83	1	726	21	5255	0	0	0	895	0	0	0	0
"AX747758"	1760	1760	632	269	330	302	158	111	151	277	397	156	0	800	172	101	83	72
"AX747764"	2197	70566	0	0	0	0	0	0	0	0	0	0	0	0	0	0	0	0
"AX747766"	2327	2327	17	0	0	17	0	0	0	32	0	84	0	0	0	0	0	0
"AX747770"	3247	6978	1554	732	641	913	407	325	1036	287	1547	825	1556	1638	1893	1445	3228	2118
"AX747775"	2567	2567	262	93	145	117	56	37	152	55	204	166	132	0	220	172	266	202
"AX747793"	2854	2854	315	73	271	44	52	21	111	78	79	72	4	0	0	0	8	4
"AX747798"	3025	21815	0	0	0	0	0	0	0	0	0	0	0	0	0	0	0	0
"AX747806"	1987	1987	179	29	159	20	29	0	102	43	33	47	0	1076	333	267	431	333
"AX747809"	2518	3399	0	0	0	0	0	0	0	0	0	0	0	0	0	0	0	0
"AX747817"	2610	2883	0	0	0	0	0	0	36	9	0	0	0	0	0	6	8	3
"AX747819"	2376	2376	0	509	0	0	293	216	0	350	697	494	0	0	0	36	0	0
"AX747826"	2213	2213	75	0	24	51	0	0	31	28	0	0	1	0	0	0	0	0
"AX747828"	2009	2009	61	0	34	27	0	0	27	0	0	43	8	5	12	15	20	9
"AX747832"	3643	3643	0	0	0	0	0	0	0	0	0	0	0	0	0	0	0	0
"AX747833"	953	953	386	157	208	178	157	0	0	62	0	62	1574	1747	0	0	0	0
"AX747836"	1591	1591	0	0	0	0	0	0	0	12	0	0	22	0	22	75	29	0
"AX747837"	1843	1843	0	0	0	0	0	0	0	0	0	0	0	14	0	0	0	0
"AX747838"	983	983	230	87	160	70	45	42	124	119	0	34	1032	347	1065	654	1164	748
"AX747844"	2074	2074	10	26	0	10	12	14	0	0	0	0	14	39	8	3	14	11
"AX747846"	3499	3499	171	0	97	74	0	0	133	76	90	0	512	429	462	324	610	354
"AX747850"	2546	2546	0	0	0	0	0	0	17	0	0	0	19	0	0	1	0	0
"AX747860"	2518	2518	0	0	0	0	0	0	0	0	0	0	0	0	0	0	0	0
"AX747861"	1914	5680	0	0	0	0	0	0	9	0	0	0	0	0	0	0	0	0
"AX747864"	2163	2163	0	0	0	0	0	0	12	0	0	0	0	0	0	0	0	0
"AX747865"	2392	2392	116	100	116	0	57	43	39	0	0	45	0	48	72	23	0	31
"AX747870"	2666	11868	114	93	79	35	58	35	191	417	22	184	135	9	164	156	209	162
"AX747879"	1693	1693	0	0	0	0	0	0	0	0	0	0	0	0	0	0	0	0
"AX747894"	872	872	0	0	0	0	0	0	13	0	0	0	0	0	0	0	0	0
"AX747898"	1242	18512	0	0	0	0	0	0	0	0	0	0	0	0	0	0	0	0
"AX747901"	1819	1819	1209	337	605	604	128	209	579	377	248	642	0	0	0	0	0	0
"AX747913"	2514	2514	0	0	0	0	0	0	0	0	0	0	0	0	0	0	0	0
"AX747935"	1757	89197	0	0	0	0	0	0	0	0	0	0	0	0	0	0	0	0
"AX747945"	2167	2331	89	0	55	34	0	0	70	11	0	0	0	0	0	0	0	0
"AX747950"	2131	5465	0	0	0	0	0	0	15	0	0	0	0	0	0	0	0	0
"AX747962"	2330	6160	0	0	0	0	0	0	0	0	0	0	0	0	0	0	0	0
"AX747968"	1739	1739	0	0	0	0	0	0	0	0	0	0	0	0	0	0	0	0
"AX747971"	1594	2474	0	0	0	0	0	0	0	0	0	0	0	0	49	36	83	37
"AX747981"	2633	6113	0	0	0	0	0	0	0	12	0	0	0	0	0	0	0	0
"AX747983"	2020	3321	0	3	0	0	1	2	22	0	0	0	0	0	0	0	0	0
"AX747985"	1426	1426	0	0	0	0	0	0	43	16	0	0	0	0	0	0	0	0
"AX747988"	2416	2416	0	0	0	0	0	0	0	0	0	0	0	0	0	0	0	0
"AX747991"	1822	1822	0	0	0	0	0	0	18	53	0	0	40	34	39	26	67	38
"AX747992"	1896	16737	0	0	0	0	0	0	0	0	0	0	0	0	0	0	0	0
"AX748015"	1873	3223	0	0	0	0	0	0	0	0	0	0	0	0	0	0	0	0
"AX748016"	741	741	0	0	0	0	0	0	0	0	0	0	0	0	0	0	0	0
"AX748020"	1846	45293	0	0	0	0	0	0	0	0	0	0	0	0	0	0	0	0
"AX748028"	1704	3020	0	0	0	0	0	0	0	0	0	0	0	0	0	0	0	0
"AX748030"	1765	10463	0	0	0	0	0	0	0	8	0	0	0	0	0	0	0	0
"AX748036"	2032	2032	134	62	72	62	25	37	189	64	258	19	0	0	0	0	0	0
"AX748042"	2364	2880	0	0	0	0	0	0	0	0	0	0	0	0	0	0	0	0
"AX748049"	1328	1328	0	0	0	0	0	0	0	0	0	0	0	0	0	0	0	0
"AX748058"	1895	1895	0	0	0	0	0	0	13	0	0	0	0	0	0	0	0	0
"AX748062"	2048	7292	81	18	44	37	18	0	94	0	0	0	130	68	146	154	93	95
"AX748066"	1545	6296	536	652	290	246	344	308	252	552	663	1578	1	1	0	3	2	0
"AX748080"	2047	3421	0	0	0	0	0	0	20	0	0	0	0	0	0	0	0	0
"AX748119"	2177	2177	0	0	0	0	0	0	0	0	0	0	0	0	0	0	0	0
"AX748120"	935	935	47	0	22	25	0	0	5	1	0	0	10	12	17	8	18	6
"AX748125"	1826	30471	0	0	0	0	0	0	15	0	0	0	0	0	0	0	0	0
"AX748135"	1752	1752	0	0	0	0	0	0	0	0	0	0	0	0	0	0	0	0
"AX748157"	2253	2253	0	0	0	0	0	0	19	0	0	0	0	0	0	0	0	0
"AX748165"	2000	81034	28	0	18	10	0	0	28	14	0	0	0	0	0	0	0	0
"AX748166"	2571	3555	0	0	0	0	0	0	0	11	0	0	0	0	0	0	0	0
"AX748173"	1717	147228	0	0	0	0	0	0	0	0	0	0	0	0	0	0	0	0
"AX748175"	1869	56449	0	0	0	0	0	0	0	0	0	0	0	0	0	0	0	0
"AX748181"	1767	1767	0	0	0	0	0	0	0	0	0	0	0	0	0	0	0	0
"AX748190"	2018	2018	26	0	14	12	0	0	0	7	0	0	0	0	0	0	0	0
"AX748195"	1412	1412	18	16	15	3	8	8	2525	7	0	6510	0	0	0	0	0	0
"AX748196"	2351	2351	309	53	162	147	22	31	154	50	50	57	0	0	0	0	0	0
"AX748200"	2097	2097	99	0	42	57	0	0	81	27	0	21	675	675	726	517	945	650
"AX748201"	2634	2634	0	0	0	0	0	0	0	0	0	0	0	0	0	0	0	0
"AX748204"	2179	2179	0	0	0	0	0	0	0	0	0	0	0	0	0	0	0	0
"AX748210"	2133	2133	0	4	0	0	3	1	16	0	0	0	10	3	20	15	13	14
"AX748212"	2142	2142	203	88	96	107	32	56	256	146	68	132	21	0	23	2	0	0
"AX748225"	2576	2576	853	673	580	273	384	289	285	328	238	410	0	998	0	0	0	0
"AX748230"	2345	7818	196	59	98	98	30	29	88	30	0	0	280	273	246	310	522	271
"AX748233"	2613	2613	228	82	131	97	44	38	54	60	0	52	13	27	27	0	11	0
"AX748236"	2048	2048	0	0	0	0	0	0	0	0	0	0	0	0	0	0	0	0
"AX748237"	1523	1841	0	0	0	0	0	0	0	0	0	0	0	0	0	0	0	0
"AX748239"	2520	2520	84	107	55	29	52	55	63	120	0	55	0	0	0	0	0	0
"AX748243"	2306	2306	211	0	126	85	0	0	57	16	0	58	0	221	83	27	101	21
"AX748249"	1871	1871	0	0	0	0	0	0	0	0	0	0	0	0	0	0	0	0
"AX748251"	1962	1962	0	0	0	0	0	0	0	0	0	0	0	0	0	0	0	0
"AX748261"	2044	2044	289	18	164	125	0	18	160	12	78	90	0	0	0	0	0	0
"AX748264"	1812	1812	0	0	0	0	0	0	0	0	0	0	0	0	0	0	0	0
"AX748265"	2440	2440	151	12	73	78	0	12	68	22	0	0	0	0	0	0	0	0
"AX748267"	2430	2430	518	128	262	256	43	85	172	146	86	37	0	0	0	0	0	0
"AX748268"	1952	1952	2736	1251	1320	1416	673	578	1296	646	931	2365	0	0	0	0	0	0
"AX748273"	2002	2002	0	0	0	0	0	0	0	0	0	0	0	0	0	0	0	0
"AX748283"	2094	2094	1147	419	409	738	231	188	344	388	420	402	18	87	34	41	54	58
"AX748285"	2026	2026	611	31	501	110	31	0	114	38	357	112	0	0	0	0	0	0
"AX748287"	2248	2248	0	0	0	0	0	0	21	0	0	0	0	0	0	0	0	0
"AX748291"	2240	2240	1284	83	152	1132	38	45	703	0	227	975	0	1	2	0	0	22
"AX748292"	2020	2020	115	0	60	55	0	0	67	45	0	107	13	52	0	21	0	0
"AX748294"	2434	2434	0	0	0	0	0	0	0	0	0	0	0	0	0	0	0	0
"AX748298"	2666	2666	2273	546	1254	1019	168	378	567	358	1399	172	8077	5705	5072	2690	5530	3087
"AX748308"	1086	1086	121	1900	85	36	992	908	242	1962	0	1579	0	0	0	0	0	0
"AX748312"	1504	1504	0	0	0	0	0	0	45	0	0	0	67	0	0	0	0	0
"AX748313"	2141	2141	0	0	0	0	0	0	0	0	0	0	0	0	0	0	0	0
"AX748314"	2184	2184	0	0	0	0	0	0	17	0	0	0	0	0	0	0	0	0
"AX748322"	1921	1921	145	32	106	39	14	18	123	33	71	32	11	29	0	0	0	0
"AX748330"	2212	2513	28	0	20	8	0	0	83	0	0	0	14	13	15	8	54	24
"AX748336"	2708	2708	30	263	14	16	128	135	31	179	0	146	0	0	0	0	0	0
"AX748339"	2129	2129	51748	10425	28770	22978	5435	4990	12145	4528	39480	9932	17185	13623	157	82	180	133
"AX748340"	2360	2360	0	0	0	0	0	0	38	13	0	0	0	0	0	0	0	0
"AX748345"	1892	5425	0	0	0	0	0	0	54	22	0	0	0	0	0	0	0	0
"AX748351"	2573	2573	0	0	0	0	0	0	22	0	0	0	0	0	0	0	0	0
"AX748362"	1971	1971	0	0	0	0	0	0	0	0	0	0	0	0	0	0	0	0
"AX748369"	2576	2576	0	0	0	0	0	0	0	0	0	0	0	0	0	0	0	0
"AX748371"	2110	2110	83	40	47	36	23	17	0	0	0	0	0	0	0	0	0	0
"AX748379"	2271	2271	0	0	0	0	0	0	1	0	0	0	12	26	71	79	93	79
"AX748380"	3077	3971	0	0	0	0	0	0	0	0	0	0	0	0	0	0	0	0
"AX748385"	2579	2579	0	0	0	0	0	0	0	0	0	0	0	0	0	0	0	0
"AX748388"	2180	2180	0	0	0	0	0	0	0	26	0	0	41	37	52	36	78	32
"AX748411"	1932	1932	27	0	0	27	0	0	45	20	0	0	0	0	0	0	0	0
"AX748417"	2691	2691	359	83	359	0	38	45	245	54	594	33	389	1224	1575	1105	1721	1074
"AX748420"	1842	1842	0	0	0	0	0	0	0	0	0	0	0	0	0	0	0	0
"AX748428"	1873	4035	0	0	0	0	0	0	0	0	0	0	0	0	0	0	0	0
"AX748435"	2050	2050	0	0	0	0	0	0	0	0	0	0	0	0	0	0	0	0
"AX748438"	1166	1166	133	18	80	53	18	0	75	0	0	25	16	0	0	0	0	0
"AX748440"	732	732	0	0	0	0	0	0	20	15	0	0	0	0	0	0	0	0
"AX765705"	689	689	0	0	0	0	0	0	0	0	0	0	0	0	0	0	0	0
"AX765719"	1183	1183	0	0	0	0	0	0	0	0	0	0	0	0	0	0	0	0
"AX795351"	940	940	8	0	8	0	0	0	0	0	0	0	100	0	0	0	161	81
"AX813477"	102	102	7717	2767	0	7717	1494	1273	2609	1719	10	0	0	0	0	0	0	0
"AXIN1"	3459	65026	3879	878	2090	1789	493	385	2218	1215	2644	3205	1283	815	1460	942	2371	1176
"AXIN2"	4241	33057	0	0	0	0	0	0	52	25	0	0	75	65	2	13	98	60
"AXL"	4756	42564	0	0	0	0	0	0	225	81	1	0	0	19	3	0	0	3
"AY007155"	1014	3761	0	0	0	0	0	0	0	0	0	0	0	12	3	9	4	0
"AY070437"	1014	3100	42	14	42	0	14	0	44	11	5	0	0	1	0	0	0	0
"AY124788"	324	412	0	0	0	0	0	0	0	0	0	0	0	0	0	0	0	0
"AY203940"	1164	1656	0	0	0	0	0	0	0	0	0	0	0	1	0	0	1	0
"AY236870"	1147	18512	0	0	0	0	0	0	0	0	0	0	0	0	0	0	0	0
"AY255583"	163	163	0	0	0	0	0	0	0	13	0	0	0	0	0	0	0	0
"AY257479"	129	20224	0	0	0	0	0	0	0	0	0	0	0	2	0	0	0	0
"AY312144"	536	1307	0	0	0	0	0	0	0	0	0	0	0	0	0	0	0	0
"AY343891"	538	2614	0	0	0	0	0	0	0	0	0	0	0	0	0	0	0	0
"AY343892"	532	2596	0	0	0	0	0	0	0	0	0	0	0	0	0	0	0	0
"AY343902"	584	1948	0	0	0	0	0	0	0	0	0	0	0	0	0	0	0	0
"AY364433"	506	506	0	0	0	0	0	0	0	0	0	0	0	0	0	0	0	0
"AY383626"	902	5289	0	0	0	0	0	0	39	22	0	0	0	0	0	0	4	0
"AY387666"	753	14776	0	0	0	0	0	0	0	0	0	0	0	0	0	0	0	0
"AY395524"	122	122	0	0	0	0	0	0	0	0	0	0	0	0	0	0	0	0
"AY395526"	198	198	0	0	0	0	0	0	0	0	0	0	0	0	0	0	0	0
"AY429594"	1532	6463	0	3	0	0	1	2	0	1	0	1	0	0	0	0	0	0
"AY429595"	1298	6463	0	3	0	0	1	2	0	1	0	1	0	0	0	0	0	0
"AY455283"	606	606	0	0	0	0	0	0	0	0	0	0	0	0	0	0	0	0
"AY494056"	721	85131	0	0	0	0	0	0	0	0	0	0	0	0	0	0	0	0
"AY660577"	827	143620	0	0	0	0	0	0	0	0	0	0	0	0	0	0	0	0
"AY660578"	1099	141249	0	0	0	0	0	0	0	0	0	0	0	0	0	0	0	0
"AY685359"	287	287	0	0	0	0	0	0	0	0	0	0	0	0	0	0	0	0
"AY730280"	609	1500	0	0	0	0	0	0	0	0	0	0	0	0	0	0	0	0
"AY748447"	181	181	0	0	0	0	0	0	0	0	0	0	0	0	0	0	0	0
"AY769439"	893	324683	0	0	0	0	0	0	0	0	0	0	0	0	0	0	0	0
"AY927445"	602	9958	0	0	0	0	0	0	0	0	0	0	0	0	0	0	0	0
"AY927447"	1577	10411	0	0	0	0	0	0	0	0	0	0	0	0	0	0	0	0
"AY927448"	1758	18290	0	0	0	0	0	0	0	0	0	0	0	0	0	0	0	0
"AY927449"	1885	17918	0	0	0	0	0	0	0	0	0	0	0	0	0	0	0	0
"AY927465"	570	15385	0	0	0	0	0	0	0	0	0	0	0	0	0	0	0	0
"AY927475"	622	6029	0	0	0	0	0	0	0	0	0	0	0	0	0	0	0	0
"AY927499"	1101	1101	0	0	0	0	0	0	0	0	0	0	0	0	0	0	0	0
"AY927512"	654	16689	373	3744	223	150	2243	1501	42	2335	0	3649	583	8467	587	7047	536	3334
"AY927513"	1250	1664	83	517	49	34	512	5	0	1323	0	775	2	96	50	288	52	271
"AY927515"	622	622	0	0	0	0	0	0	0	0	0	0	0	0	0	0	0	0
"AY927540"	273	375	0	0	0	0	0	0	0	0	0	0	0	0	0	0	0	0
"AY927613"	331	1986	177	1	15	162	1	0	70	105	472	196	66	45	242	219	1028	807
"AY927633"	4660	115021	0	0	0	0	0	0	0	0	0	0	0	0	0	0	0	0
"AY927641"	597	126872	0	0	0	0	0	0	14	0	0	0	0	0	0	0	0	0
"AY940074"	1560	1560	80	0	37	43	0	0	240	15	124	33	0	0	0	0	0	0
"AY940866"	94	94	0	0	0	0	0	0	0	0	0	0	0	0	0	0	0	0
"AY947523"	41	41	0	0	0	0	0	0	0	0	0	0	0	0	0	0	0	0
"AZGP1"	1219	9337	0	0	0	0	0	0	14	10	0	0	0	0	0	0	0	0
"AZI1"	3654	33360	80	0	47	33	0	0	419	200	0	40	252	211	370	327	646	394
"AZI2"	3470	26773	256	506	143	113	349	157	288	210	0	60	177	780	745	783	580	494
"AZIN1"	4360	37862	1836	10384	961	875	5493	4891	604	4830	165	6432	3288	4605	3756	4364	3909	4042
"AZU1"	917	4188	0	0	0	0	0	0	45	40	0	0	15	9	24	19	31	24
"AlphaTFEB"	8706	8706	808022	772247	448055	359967	417285	354962	317375	329988	339489	438130	8033	14811	12226	18494	16658	14693
"Ari2"	4650	58820	2967	2560	1692	1275	1397	1163	1329	1433	1385	3224	2360	2855	2894	2785	3035	2182
"B-ind1"	1167	41879	28	0	0	28	0	0	108	0	17	0	361	253	474	371	465	342
"B2M"	1059	4867	3378	11475	1914	1464	6219	5256	1025	4317	1076	5946	77397	114420	103461	89965	109817	87880
"B3GALNT1"	3647	21489	0	0	0	0	0	0	26	0	0	15	166	170	236	144	189	109
"B3GALNT2"	4732	57250	1877	101	1107	770	46	55	987	43	778	164	1249	1171	774	548	1502	843
"B3GALT1"	2170	52186	0	0	0	0	0	0	0	0	0	0	0	0	0	0	0	0
"B3GALT2"	3549	7884	437	267	258	179	139	128	249	242	0	79	0	0	0	0	0	0
"B3GALT4"	1689	1689	10	53	10	0	23	30	0	30	0	0	398	226	401	202	547	276
"B3GALT5"	3411	5563	0	0	0	0	0	0	30	8	0	0	0	0	0	0	0	0
"B3GALT6"	2791	2791	53	0	19	34	0	0	43	43	0	0	635	531	746	856	772	774
"B3GALTL"	4226	132299	418	51	255	163	21	30	366	78	53	86	740	791	811	662	768	541
"B3GAT1"	3660	33414	0	0	0	0	0	0	187	80	0	0	0	0	0	0	0	0
"B3GAT2"	3725	98771	42	37	28	14	31	6	51	19	0	8	720	835	685	570	838	560
"B3GAT3"	1686	6681	122	0	68	54	0	0	167	18	55	0	551	145	734	376	718	560
"B3GNT1"	2071	2319	0	0	0	0	0	0	65	0	0	0	85	68	96	33	80	82
"B3GNT2"	2749	28604	927	425	484	443	247	178	575	429	146	335	555	648	983	774	817	542
"B3GNT3"	2742	18468	0	0	0	0	0	0	10	16	0	0	0	0	0	0	0	0
"B3GNT4"	1506	3857	18	14	0	18	14	0	90	122	0	169	0	0	0	0	0	0
"B3GNT5"	4311	19574	4792	3898	2647	2145	2084	1814	1363	993	739	1484	4341	4558	2688	2227	3292	2303
"B3GNT6"	2495	7570	0	0	0	0	0	0	0	0	0	0	13	6	0	0	0	0
"B3GNT7"	3625	5540	0	0	0	0	0	0	0	21	0	0	0	0	0	0	0	0
"B3GNT8"	1876	3372	0	0	0	0	0	0	53	26	0	0	0	0	72	71	54	0
"B3GNT9"	2706	2898	214	21	110	104	11	10	46	16	0	0	517	268	760	262	904	426
"B3GNTL1"	2456	64835	1113	510	576	537	274	236	1082	467	221	616	278	310	187	195	421	246
"B4GALNT1"	3021	7436	0	0	0	0	0	0	14	17	0	0	0	0	0	0	0	0
"B4GALNT2"	2032	37024	0	0	0	0	0	0	0	0	0	0	0	0	0	0	0	0
"B4GALNT3"	3458	101517	0	0	0	0	0	0	208	66	0	0	0	0	0	0	0	0
"B4GALNT4"	3473	12323	0	0	0	0	0	0	23	18	0	0	0	0	0	0	0	0
"B4GALT1"	4205	56719	11430	52049	6341	5089	27946	24103	2641	30010	3023	59460	4553	644	4829	23875	951	13602
"B4GALT2"	2215	11975	0	1	0	0	0	1	57	19	0	0	126	88	148	139	145	144
"B4GALT3"	1978	6215	295	0	191	104	0	0	137	58	81	0	753	582	796	687	1123	686
"B4GALT4"	5828	29167	222	103	134	88	61	42	151	115	0	137	382	513	326	334	581	428
"B4GALT5"	4734	80938	8784	23953	4913	3871	13031	10922	2397	12620	1309	24882	325	5338	1433	4131	1817	2755
"B4GALT6"	4822	62478	0	0	0	0	0	0	14	0	0	0	37	60	24	14	14	4
"B4GALT7"	1885	6464	842	143	475	367	113	30	323	178	371	46	245	189	427	257	585	369
"B5R.1"	940	4212	265	107	183	82	43	64	173	33	290	21	1315	715	1524	979	1572	821
"B7"	427	1931	10	0	0	10	0	0	27	12	0	0	66	51	57	74	51	45
"B7-H3"	3286	30239	8742	17267	4836	3906	9218	8049	2047	9120	3681	15796	5621	9747	9733	15019	10990	12332
"B9D1"	935	40630	16	0	0	16	0	0	178	54	0	0	1	5	11	9	9	14
"B9D2"	1035	9758	190	14	144	46	0	14	197	87	40	76	163	118	64	121	175	114
"BAALC"	2849	89611	0	8	0	0	0	8	0	0	0	0	0	0	0	0	0	0
"BAAT"	3481	24589	0	0	0	0	0	0	0	0	0	0	0	0	0	0	0	0
"BACE"	982	22387	643	25	362	281	20	5	725	61	603	56	235	56	1134	701	1000	486
"BACE1"	5841	30557	1356	135	785	571	82	53	762	199	739	180	1277	1146	5239	3841	4404	3237
"BACE2"	3001	108797	0	0	0	0	0	0	23	70	0	0	27	19	77	60	24	11
"BACH"	1887	129495	3186	357	1749	1437	195	162	2817	1054	1917	902	1477	1382	2047	1645	2767	2881
"BACH1"	5772	46732	13830	12259	7580	6250	6781	5478	6317	4369	5928	7722	4496	3663	4553	3395	4799	2380
"BACH2"	9223	370316	0	0	0	0	0	0	45	28	0	0	0	38	0	3	0	0
"BAD"	1226	14877	365	76	253	112	37	39	392	255	361	360	169	84	335	354	364	297
"BAF53b"	1560	13358	0	0	0	0	0	0	206	0	0	0	0	0	0	0	0	0
"BAFF"	203	561	474	830	127	347	517	313	654	1401	39	101	929	6246	531	730	832	252
"BAG"	3392	9718	301	434	125	176	200	234	248	141	35	265	704	1083	613	660	788	581
"BAG1"	4022	12291	259	20	130	129	0	20	259	133	43	288	1285	960	1582	1438	1861	1226
"BAG2"	2053	12908	15	0	15	0	0	0	0	0	0	0	89	72	52	36	94	50
"BAG3"	2571	26447	0	44	0	0	34	10	90	57	0	21	254	233	438	664	394	431
"BAG4"	2187	34433	937	49	564	373	34	15	379	61	157	80	1143	625	758	348	982	274
"BAG5"	5008	5727	512	216	271	241	97	119	267	92	0	60	1862	1512	1823	1150	2028	980
"BAGE"	939	41143	0	0	0	0	0	0	0	0	0	0	0	0	16	11	15	5
"BAGE1"	1219	2687	0	0	0	0	0	0	0	0	0	0	0	0	16	11	15	5
"BAGE2"	4067	132688	0	0	0	0	0	0	18	0	0	0	0	0	62	52	44	32
"BAGE5"	1801	78126	0	0	0	0	0	0	18	0	0	0	0	0	37	29	27	21
"BAHCC1"	10183	59820	317	36	148	169	24	12	1263	519	93	123	458	359	655	480	816	462
"BAHD1"	4718	28523	888	112	490	398	60	52	547	314	43	58	1142	659	1272	773	1832	826
"BAI 2"	2946	9563	0	0	0	0	0	0	176	86	0	0	0	0	0	0	0	0
"BAI 3"	1612	105226	0	0	0	0	0	0	0	0	0	0	0	0	0	0	0	0
"BAI1"	5557	80992	686	4524	342	344	2544	1980	1368	4032	260	4892	80	61	157	211	580	575
"BAI2"	5447	36931	0	0	0	0	0	0	228	86	0	0	0	0	0	0	0	0
"BAI3"	5668	753772	0	0	0	0	0	0	80	0	0	0	0	0	0	0	0	0
"BAIAP2"	3535	32339	9313	3286	5060	4253	1686	1600	4546	3476	11891	5539	1161	1171	1920	1998	2817	1902
"BAIAP2L1"	3682	109465	2276	438	1235	1041	156	282	810	388	1250	534	4421	1868	4300	3898	10763	4523
"BAIAP2L2"	2158	25781	0	0	0	0	0	0	25	9	0	0	0	0	0	0	0	0
"BAIAP3"	4618	15798	19	0	17	2	0	0	202	61	0	11	1	3	0	0	3	0
"BAK"	2219	7748	99	0	67	32	0	0	244	71	0	0	745	363	325	1046	2185	1224
"BAK1"	2310	7748	99	0	67	32	0	0	244	71	0	0	745	363	325	1046	2185	1224
"BAMBI"	1900	5183	0	0	0	0	0	0	0	0	0	0	0	23	0	11	0	0
"BANF1"	1154	2068	89	88	42	47	44	44	50	53	0	0	1500	1265	2038	1834	3120	1843
"BANF2"	612	35926	0	0	0	0	0	0	35	9	0	0	0	0	0	0	0	0
"BANK1"	3563	654851	2	0	2	0	0	0	11	8	0	0	111	134	49	28	53	28
"BANP"	2451	107301	1793	279	1012	781	181	98	1779	744	587	365	207	158	239	218	283	213
"BAP1"	3599	8984	1384	625	644	740	338	287	467	206	1258	476	2180	1927	2962	1778	3687	1755
"BAR"	2635	24963	375	74	208	167	43	31	149	144	106	369	683	588	585	705	728	783
"BARD1"	2605	81155	235	20	124	111	0	20	211	35	0	36	77	89	151	55	95	16
"BARHL1"	1910	7649	0	0	0	0	0	0	0	14	0	9	0	0	0	0	0	0
"BARHL2"	1498	5216	0	0	0	0	0	0	0	0	0	0	0	0	0	0	0	0
"BARX1"	1484	3699	0	0	0	0	0	0	11	10	0	0	0	0	0	0	0	0
"BARX2"	1770	76294	0	0	0	0	0	0	0	11	0	0	0	0	0	0	0	0
"BASE"	1229	16859	0	0	0	0	0	0	0	0	0	0	0	0	0	0	0	0
"BASH"	1624	79872	13440	1312	7197	6243	730	582	5900	258	5879	263	2056	2584	1501	569	2720	933
"BASP1"	1791	59187	2683	10087	1514	1169	5550	4537	901	4179	141	4080	1054	1416	1210	1509	1352	1280
"BAT1"	3579	8004	7840	7352	4211	3629	3905	3447	2371	2860	6436	6415	6269	7333	7536	7449	9195	6359
"BAT2"	6981	17105	2841	1659	1552	1289	919	740	1008	1115	1627	1631	6428	5220	6809	6084	9959	5332
"BAT2D1"	10417	107985	11870	17288	6482	5388	9363	7925	5096	8162	4041	12060	6369	9494	8177	8061	9562	5639
"BAT2L"	11088	70098	8563	2316	4776	3787	1155	1161	4071	2033	4599	3987	2441	2409	3222	2564	4037	2715
"BAT3"	3845	13680	866	717	449	417	349	368	430	395	418	430	4354	4320	5106	5162	6123	4468
"BAT4"	1942	4201	92	3	52	40	0	3	107	0	2	0	407	321	623	484	823	497
"BAT5"	2350	27108	1084	699	601	483	352	347	550	546	342	1213	1473	1578	2496	1781	2497	1503
"BATF"	936	24545	114	1464	82	32	732	732	171	2080	35	2457	129	879	217	807	393	864
"BATF2"	2143	9102	0	0	0	0	0	0	55	30	0	0	108	29	191	4	169	62
"BATF3"	983	13569	3892	2520	2108	1784	1365	1155	2325	1623	4542	3265	2923	893	1821	2374	3608	2740
"BAX"	914	6939	566	208	355	211	144	64	108	110	526	173	1325	1233	2101	1842	1668	1143
"BAZ1A"	6041	122916	11796	38288	6598	5198	20560	17728	3767	18239	3194	31624	4305	10219	4281	7580	5132	3993
"BAZ1B"	6114	81868	3349	998	1855	1494	512	486	1625	484	919	1104	3025	2360	2959	1668	3484	1808
"BAZ2"	3530	31625	0	0	0	0	0	0	0	0	0	0	0	0	0	0	0	0
"BAZ2A"	8963	40785	5369	2042	2681	2688	1102	940	2454	1090	4365	1832	3073	2689	3924	2795	5662	2246
"BAZ2B"	8233	297622	22951	21369	12799	10152	11659	9710	12970	11703	5627	14542	3091	3286	2460	2985	2730	1970
"BBAP"	4233	10864	712	289	379	333	163	126	344	216	0	42	3339	2949	2517	1077	2686	1015
"BBC3"	1846	10373	163	111	62	101	64	47	155	191	129	142	213	77	325	167	440	263
"BBOX1"	1895	86847	0	0	0	0	0	0	0	0	0	0	0	0	0	0	0	0
"BBS1"	3564	24536	52	0	37	15	0	0	227	65	24	0	400	410	418	448	553	324
"BBS10"	3585	3958	60	0	24	36	0	0	27	0	0	0	319	232	434	139	382	153
"BBS12"	3245	12242	0	0	0	0	0	0	0	0	0	0	79	11	97	0	125	0
"BBS2"	5418	21661	125	4	67	58	4	0	129	9	0	0	385	465	514	290	451	393
"BBS4"	2780	52252	804	88	377	427	49	39	668	79	128	36	390	234	332	193	461	241
"BBS5"	3168	27160	0	0	0	0	0	0	17	0	0	0	25	21	42	50	42	16
"BBS7"	3717	46005	0	18	0	0	12	6	8	0	0	0	127	176	112	133	114	97
"BBS9"	4187	476530	31	7	22	9	7	0	193	32	0	10	110	152	108	123	124	99
"BBX"	8914	288266	2195	477	1289	906	301	176	2705	835	261	429	1284	1760	1291	1174	1351	865
"BC000492"	2187	2187	104	0	67	37	0	0	14	15	0	39	107	67	99	65	212	87
"BC000869"	1481	2318	0	0	0	0	0	0	0	0	0	0	0	23	3	10	16	11
"BC002534"	1076	14918	3340	2961	2044	1296	1498	1463	1068	1812	3983	6764	0	0	0	0	0	0
"BC002572"	1437	68923	4511	992	2509	2002	524	468	2217	621	1737	437	2317	1777	2812	1592	3343	1677
"BC004918"	1560	55906	669	291	325	344	117	174	880	326	591	658	212	180	74	48	73	42
"BC004962"	743	2707	0	0	0	0	0	0	0	0	0	0	5	0	0	7	0	0
"BC005018"	743	487891	0	0	0	0	0	0	0	0	0	0	0	0	0	0	0	0
"BC005905"	2244	3964	1974	1491	665	1309	918	573	847	536	563	2886	4666	7	7	13	11	8
"BC005927"	812	812	0	1560	0	0	895	665	29	1763	0	751	0	5900	15	300	17	206
"BC006361"	1324	13771	0	0	0	0	0	0	27	4	14	33	0	0	119	90	109	23
"BC006435"	381	381	0	0	0	0	0	0	0	0	0	0	0	0	0	0	0	0
"BC007100"	696	696	0	0	0	0	0	0	0	0	0	0	97	84	0	0	0	0
"BC007204"	3187	3187	346	182	194	152	109	73	227	158	39	42	1582	2004	1558	1331	1866	1077
"BC007358"	881	1143	0	0	0	0	0	0	19	17	0	0	0	0	0	0	0	4
"BC007360"	649	2196	167	128	86	81	81	47	28	50	0	86	32	28	81	0	163	112
"BC007399"	1504	22660	0	0	0	0	0	0	47	10	0	0	0	0	0	0	0	0
"BC007817"	797	5345	0	0	0	0	0	0	15	15	0	0	0	0	0	0	0	0
"BC007896"	1750	1750	0	0	0	0	0	0	46	0	0	0	21	268	6	3	30	426
"BC007940"	1620	2487	0	0	0	0	0	0	0	0	0	0	0	0	0	0	0	0
"BC007973"	605	2138	1	0	1	0	0	0	35	14	0	0	308	157	253	102	269	141
"BC007984"	881	26491	0	0	0	0	0	0	0	0	0	0	0	2	0	0	0	0
"BC008049"	1942	2281	1116	1247	685	431	774	473	260	743	187	1729	702	1116	982	1787	1384	1396
"BC008050"	1795	6915	0	0	0	0	0	0	0	0	0	0	0	0	0	0	0	0
"BC008178"	337	39330	0	0	0	0	0	0	0	0	0	0	0	0	1568	1252	2313	1226
"BC008215"	564	2801	0	0	0	0	0	0	14	0	0	0	0	0	0	0	4	0
"BC008357"	1627	1627	608	941	311	297	500	441	235	352	623	1202	0	643	805	878	883	737
"BC008359"	1881	4539	0	0	0	0	0	0	0	0	0	0	0	0	0	0	0	0
"BC009321"	1009	1009	138	23	107	31	22	1	161	0	60	84	958	88	87	75	106	407
"BC009440"	675	7375	0	0	0	0	0	0	0	0	0	0	0	0	0	0	0	0
"BC009467"	567	4071	2	2	1	1	2	0	315	0	0	0	5	5	11	17	18	20
"BC009500"	1707	9174	163	0	75	88	0	0	137	77	0	72	23	52	30	25	0	1
"BC009626"	2162	11948	0	0	0	0	0	0	0	0	0	0	0	2	0	0	0	0
"BC009730"	2060	22648	0	0	0	0	0	0	0	0	0	0	0	0	0	0	0	0
"BC009735"	590	7433	0	0	0	0	0	0	35	0	0	0	260	80	25	21	29	0
"BC009800"	956	3852	0	0	0	0	0	0	0	0	0	0	14	0	3	0	0	0
"BC009838"	1267	1267	387	1789	202	185	1031	758	18	8338	0	1744	92	198	399	354	120	246
"BC010030"	2001	2001	181	382	177	4	211	171	453	135	438	286	82	104	88	90	99	82
"BC010168"	438	438	0	0	0	0	0	0	0	0	0	0	0	0	0	0	0	0
"BC010180"	995	23903	0	0	0	0	0	0	71	78	0	0	0	0	0	0	0	0
"BC010186"	1200	1200	0	0	0	0	0	0	0	0	0	0	98	0	0	0	0	0
"BC010526"	1530	1648	0	0	0	0	0	0	0	0	0	0	42	67	0	0	0	0
"BC011648"	765	10170	0	0	0	0	0	0	39	0	0	0	1	0	0	0	0	0
"BC011773"	1103	4115	0	0	0	0	0	0	0	0	0	0	0	0	0	0	9	0
"BC011779"	1874	1874	604	64	311	293	43	21	529	214	207	0	143	93	166	93	200	67
"BC011998"	1602	248277	0	0	0	0	0	0	0	0	0	0	0	0	0	0	0	0
"BC012108"	1212	11212	0	0	0	0	0	0	0	0	0	0	0	0	0	0	0	0
"BC012193"	1318	1318	53	0	20	33	0	0	55	11	94	0	37	16	0	0	226	10
"BC012200"	1654	1888	0	0	0	0	0	0	0	23	0	0	0	0	0	0	0	0
"BC012558"	1447	3076	641	557	338	303	248	309	152	281	69	383	53	197	55	110	227	27
"BC012753"	1342	37674	0	0	0	0	0	0	0	0	0	0	0	0	0	0	0	0
"BC012788"	568	7156	133	59	101	32	30	29	127	35	81	20	76	45	10	8	29	5
"BC013229"	1914	10190	0	0	0	0	0	0	25	0	0	0	88	70	0	12	13	18
"BC013370"	2641	110423	0	0	0	0	0	0	0	0	0	0	0	0	0	0	0	0
"BC013599"	1116	3208	48	0	37	11	0	0	38	10	0	0	51	20	3	0	31	1
"BC013653"	2470	4392	51	0	18	33	0	0	19	24	0	0	360	258	188	64	265	119
"BC013681"	3338	10165	0	0	0	0	0	0	0	10	0	0	0	0	0	0	0	0
"BC013821"	2681	2681	296	213	177	119	104	109	25	174	0	36	7	37	36	61	70	157
"BC013905"	951	7577	0	0	0	0	0	0	0	0	0	0	0	0	0	0	0	0
"BC014119"	810	1992	0	0	0	0	0	0	0	0	0	0	0	0	0	0	0	0
"BC014138"	3413	3413	1135	163	364	771	66	97	523	55	131	272	4664	3510	3611	2205	4956	2759
"BC014150"	624	1044	0	0	0	0	0	0	0	0	0	0	0	0	0	0	0	0
"BC014180"	4792	4792	0	0	0	0	0	0	30	0	0	0	402	234	155	0	173	0
"BC014312"	1890	7812	0	0	0	0	0	0	18	17	0	0	5	0	0	0	0	5
"BC014360"	1071	21016	68	43	39	29	16	27	114	92	12	2	292	315	221	154	210	141
"BC014373"	1297	19999	90	0	50	40	0	0	95	0	0	0	46	42	37	32	52	24
"BC014430"	1788	2001	0	0	0	0	0	0	18	40	0	0	0	0	0	0	0	0
"BC014506"	984	16276	88	9	61	27	2	7	146	54	4	4	79	82	42	27	54	80
"BC014575"	1402	18217	0	0	0	0	0	0	0	0	0	0	0	0	0	0	0	0
"BC014606"	694	32200	395	275	250	145	149	126	180	86	0	38	474	327	444	261	544	224
"BC014938"	889	12301	0	0	0	0	0	0	0	0	0	0	0	0	0	0	0	0
"BC014971"	2117	3201	0	0	0	0	0	0	0	0	0	0	0	0	0	0	0	0
"BC015159"	690	3503	0	0	0	0	0	0	0	0	0	0	0	0	0	0	0	0
"BC015383"	910	2852	0	0	0	0	0	0	0	0	0	0	0	0	0	0	0	0
"BC015429"	974	4396	0	0	0	0	0	0	0	0	0	0	0	0	0	0	0	0
"BC015432"	2667	2667	1235	169	603	632	71	98	577	43	487	147	3306	3266	933	596	1356	742
"BC015433"	917	30132	0	0	0	0	0	0	0	0	0	0	0	0	0	0	0	0
"BC015572"	2030	2030	0	0	0	0	0	0	0	25	0	0	0	0	0	0	0	0
"BC015590"	2028	15556	0	0	0	0	0	0	0	0	0	0	0	0	0	0	0	0
"BC015635"	1676	1894	90	0	44	46	0	0	17	13	0	0	0	0	4	0	0	0
"BC015662"	1046	1046	64	0	27	37	0	0	34	0	93	0	2166	1675	2604	2046	3169	2269
"BC015671"	1358	1358	0	0	0	0	0	0	2	0	0	0	26	28	28	27	24	14
"BC015688"	1119	3175	0	0	0	0	0	0	36	47	0	0	444	296	479	305	633	369
"BC015784"	2819	50168	0	0	0	0	0	0	0	0	0	0	0	0	0	0	0	0
"BC015836"	780	3452	0	0	0	0	0	0	0	0	0	0	0	0	0	0	0	0
"BC015846"	931	68364	0	0	0	0	0	0	60	0	0	0	0	0	0	0	0	0
"BC015977"	273	1368	0	0	0	0	0	0	0	0	0	0	0	0	0	0	0	0
"BC016035"	1179	68742	0	0	0	0	0	0	0	0	0	0	0	2	0	0	0	0
"BC016143"	737	1038	15	4745	0	15	2736	2009	17	261	0	7070	0	0	0	0	0	0
"BC016291"	674	11086	0	0	0	0	0	0	20	30	0	0	1030	769	510	33	524	19
"BC016361"	825	52243	0	0	0	0	0	0	0	0	0	0	10	11	1	0	2	0
"BC016366"	635	11071	0	838	0	0	491	347	13	356	0	350	4	974	3	566	13	149
"BC016484"	3146	48748	0	0	0	0	0	0	16	16	0	0	0	0	0	0	0	0
"BC016656"	3500	4844	0	0	0	0	0	0	12	8	0	0	0	0	0	0	0	0
"BC016751"	582	1966	0	0	0	0	0	0	0	0	0	0	0	0	0	0	0	0
"BC016831"	1121	2633	0	0	0	0	0	0	0	0	0	0	0	0	0	0	0	0
"BC016878"	1351	32293	0	0	0	0	0	0	120	9	0	0	0	0	0	0	0	1
"BC016962"	1795	1795	27	92	14	13	54	38	0	0	0	0	130	118	94	41	121	62
"BC016970"	840	103608	3804	12275	2175	1629	6599	5676	687	3266	51	6255	7	1127	0	23	0	62
"BC016972"	890	6656	0	0	0	0	0	0	63	59	0	48	51	57	74	63	41	23
"BC016976"	2442	14994	6850	3895	3800	3050	2154	1741	3710	1022	3642	1332	553	675	182	126	576	126
"BC017209"	4178	4178	324	362	251	73	138	224	190	95	314	3015	47	40	132	146	196	107
"BC017214"	1498	1577	0	0	0	0	0	0	13	17	0	0	33	8	49	26	66	18
"BC017255"	1339	11670	0	0	0	0	0	0	56	0	0	0	375	393	314	260	407	267
"BC017347"	908	1870	103	34	63	40	0	34	33	93	166	138	41	36	27	70	16	34
"BC017398"	1387	1387	0	0	0	0	0	0	0	0	0	0	0	0	0	0	0	0
"BC017578"	714	13856	0	0	0	0	0	0	0	0	0	0	0	0	0	0	0	0
"BC017581"	1657	13051	1283	223	910	373	103	120	810	261	407	272	1603	1073	1044	546	1742	1047
"BC017652"	1211	4151	10	0	10	0	0	0	68	0	36	49	1234	545	463	362	360	299
"BC017818"	272	3097	2911	8904	1594	1317	4675	4229	267	28060	992	56648	478	8191	1311	36909	1161	13302
"BC017910"	490	4048	120	0	56	64	0	0	56	0	0	0	0	9	3	11	89	0
"BC017935"	942	37270	0	0	0	0	0	0	0	0	0	0	0	0	0	0	0	0
"BC017971"	2336	4205	112	0	54	58	0	0	105	0	56	0	432	351	177	137	217	19
"BC017988"	1315	153979	0	0	0	0	0	0	0	0	0	0	0	0	0	0	0	0
"BC018008"	1035	8541	0	0	0	0	0	0	0	0	0	0	0	0	0	0	0	0
"BC018065"	1001	23689	0	0	0	0	0	0	0	0	0	0	0	0	0	0	0	0
"BC018166"	550	5043	0	0	0	0	0	0	0	0	0	0	0	0	8	7	10	9
"BC018626"	481	6603	0	0	0	0	0	0	0	0	0	0	0	0	0	0	0	0
"BC018651"	638	638	0	0	0	0	0	0	15	0	0	0	11	18	20	30	9	17
"BC018779"	1944	1944	22	0	11	11	0	0	106	41	0	24	57	12	71	0	158	0
"BC018860"	1585	1585	0	0	0	0	0	0	0	16	0	0	33780	38355	142489	150801	266135	139334
"BC019085"	1831	1831	44	0	44	0	0	0	48	13	0	0	413	0	217	0	267	154
"BC019594"	1150	3184	0	0	0	0	0	0	13	20	0	0	68	17	10	16	53	25
"BC019672"	1163	1163	0	0	0	0	0	0	0	0	0	0	5	11	6	4	12	10
"BC019858"	1483	14946	0	0	0	0	0	0	0	0	0	0	38	0	0	0	11	0
"BC019880"	549	6174	0	0	0	0	0	0	10	0	0	0	0	0	13	1	4	3
"BC019893"	1361	29304	0	0	0	0	0	0	0	0	0	0	0	0	34	32	90	65
"BC019904"	1462	49244	276	177	157	119	152	25	175	229	0	703	325	442	552	533	666	477
"BC020168"	2919	13816	0	2	0	0	0	2	0	0	0	0	0	0	0	0	0	0
"BC020234"	1653	13882	0	0	0	0	0	0	0	0	0	0	0	0	0	0	0	0
"BC020343"	1392	2424	0	2	0	0	2	0	30	40	0	0	0	0	0	0	0	0
"BC020876"	1386	307393	0	0	0	0	0	0	358	105	0	49	0	0	0	0	0	4
"BC020884"	1919	3133	304	51	148	156	27	24	72	31	0	31	10	12	0	0	5	0
"BC020917"	1248	41951	0	0	0	0	0	0	0	0	0	0	0	0	0	0	0	0
"BC021024"	621	1904	0	0	0	0	0	0	18	0	0	0	2	0	1	2	0	1
"BC021061"	1419	1419	14	0	14	0	0	0	20	19	0	0	0	0	0	0	0	0
"BC021189"	675	976	0	0	0	0	0	0	23	17	0	0	0	0	0	0	0	0
"BC021234"	1152	3413	0	0	0	0	0	0	16	13	0	0	0	0	0	0	0	0
"BC021693"	1034	81717	68	0	37	31	0	0	110	0	59	0	276	103	343	110	366	71
"BC021732"	1240	40247	0	0	0	0	0	0	56	13	0	0	0	0	51	36	101	82
"BC021736"	1141	3285	0	0	0	0	0	0	0	0	0	0	0	0	0	0	0	0
"BC021738"	1178	10510	0	0	0	0	0	0	0	0	0	0	0	0	0	0	0	0
"BC021741"	775	73233	0	0	0	0	0	0	0	0	0	0	0	0	0	0	0	0
"BC022047"	2436	2436	53	0	34	19	0	0	84	10	0	0	182	139	0	0	0	0
"BC022056"	1979	50309	0	0	0	0	0	0	0	0	0	0	0	0	0	0	0	0
"BC022082"	815	400128	2	0	2	0	0	0	261	69	0	0	0	0	0	0	0	0
"BC022085"	878	20915	0	0	0	0	0	0	0	0	0	0	0	0	0	0	0	0
"BC022313"	1063	1063	1162	11674	1162	0	6263	5411	302	7564	0	22474	2852	16317	2210	4430	634	2750
"BC022365"	1721	1721	1214	668	655	559	420	248	407	109	120	148	17270	19345	11365	9026	12228	7996
"BC022382"	1921	13205	0	0	0	0	0	0	0	0	0	0	0	0	0	0	0	0
"BC022431"	1191	47358	0	0	0	0	0	0	18	0	0	0	3	3	0	0	2	0
"BC022468"	934	934	11	0	0	11	0	0	16	4	0	0	2	1	1	0	0	2
"BC022568"	2008	2008	47	0	19	28	0	0	18	14	0	0	0	0	0	0	0	0
"BC022569"	2199	5125	0	0	0	0	0	0	0	0	0	0	0	0	0	0	0	0
"BC022892"	1068	1068	100	211	100	0	173	38	0	240	0	138	25	40	0	20	0	0
"BC023201"	1000	1450	0	0	0	0	0	0	15	0	0	0	0	8	0	0	18	0
"BC023506"	494	494	0	0	0	0	0	0	0	0	0	0	0	0	0	0	0	0
"BC023516"	1987	4293	82	0	50	32	0	0	67	21	0	0	38	55	34	30	105	26
"BC023568"	739	7653	45	6	18	27	0	6	62	13	0	0	34	3	25	17	19	12
"BC023610"	825	4485	0	0	0	0	0	0	0	0	0	0	0	0	0	0	0	0
"BC024008"	2947	26470	0	0	0	0	0	0	0	0	0	0	0	0	0	0	0	0
"BC024027"	1885	224079	0	0	0	0	0	0	0	0	0	0	0	0	0	0	0	0
"BC024169"	1259	1259	0	0	0	0	0	0	0	0	0	0	0	0	0	0	0	0
"BC024173"	1405	117119	0	0	0	0	0	0	17	11	0	0	0	0	0	0	0	0
"BC024195"	1171	1171	39	0	29	10	0	0	0	0	0	0	68	19	86	41	96	41
"BC024248"	1182	129516	0	0	0	0	0	0	0	0	0	0	0	0	0	0	0	0
"BC024262"	3303	4303	75	12	61	14	12	0	104	33	48	33	73	8	49	4	94	0
"BC024306"	1290	1290	0	0	0	0	0	0	0	0	0	0	0	0	0	0	0	0
"BC024732"	829	12782	928	70	417	511	29	41	427	9	223	14	442	356	199	112	165	52
"BC025350"	1364	3029	0	0	0	0	0	0	0	0	0	0	0	0	0	0	0	0
"BC025370"	978	5635	0	0	0	0	0	0	0	0	0	0	0	0	0	0	0	0
"BC025664"	1478	312806	391	0	240	151	0	0	622	13	86	0	0	0	0	0	0	0
"BC025734"	2409	168733	0	39	0	0	13	26	143	20	0	25	0	3	0	0	0	0
"BC026229"	1357	1665	0	0	0	0	0	0	0	0	0	0	0	0	0	0	0	0
"BC026240"	1862	1862	75	20	43	32	14	6	9	4	0	5	31	36	35	19	37	19
"BC026261"	604	1429	0	0	0	0	0	0	0	0	0	0	0	0	0	0	0	0
"BC026300"	637	11928	0	0	0	0	0	0	0	0	0	0	0	0	0	0	0	0
"BC026963"	1723	18376	26	2	10	16	2	0	162	2	0	0	13	10	27	12	24	19
"BC027024"	1443	12949	0	0	0	0	0	0	25	0	0	0	0	0	0	0	0	0
"BC027486"	1111	11231	0	0	0	0	0	0	34	0	0	0	0	0	0	0	0	0
"BC027619"	1564	5211	0	0	0	0	0	0	0	0	0	0	0	0	0	0	0	0
"BC027846"	1658	46480	0	0	0	0	0	0	0	0	0	0	0	0	0	0	0	0
"BC027906"	2321	3689	0	0	0	0	0	0	0	0	0	0	0	0	0	0	0	0
"BC027928"	2126	2187	0	0	0	0	0	0	12	0	0	0	0	0	0	0	0	0
"BC028014"	1619	7037	0	0	0	0	0	0	48	11	0	0	0	1	0	0	0	0
"BC028022"	1984	8571	0	0	0	0	0	0	0	0	0	0	31	17	23	0	42	0
"BC028044"	763	176760	0	0	0	0	0	0	0	0	0	0	0	0	0	0	0	0
"BC028204"	1814	119038	0	0	0	0	0	0	0	0	0	0	0	0	0	0	0	0
"BC028211"	2008	3066	15	0	15	0	0	0	32	0	0	0	635	464	7206	385	6755	0
"BC028224"	2392	2392	2605	29	2587	18	11	18	1050	2446	3664	7610	5174	5151	1388	4766	1857	3667
"BC028329"	1344	1344	0	0	0	0	0	0	0	0	0	0	0	0	0	0	0	0
"BC028422"	3836	6663	0	0	0	0	0	0	0	0	0	0	0	0	0	0	0	0
"BC028619"	3251	71480	1924	675	1060	864	347	328	955	290	196	224	766	380	787	379	851	263
"BC028670"	1651	4324	0	0	0	0	0	0	0	0	0	0	0	0	0	0	0	0
"BC028746"	1234	6248	70	59	18	52	43	16	133	173	12	34	90	56	95	95	191	124
"BC028842"	603	726	0	0	0	0	0	0	0	0	0	0	0	0	0	0	0	0
"BC029038"	1198	1198	115	0	42	73	0	0	138	4	0	51	0	0	16	12	33	5
"BC029255"	963	3232	982	51	682	300	51	0	320	127	390	66	904	691	689	108	911	538
"BC029464"	2423	2423	0	0	0	0	0	0	0	0	0	0	0	0	0	0	0	0
"BC029465"	1430	42592	0	0	0	0	0	0	0	0	0	0	0	0	0	0	0	0
"BC029473"	1117	85773	0	0	0	0	0	0	95	15	0	14	0	0	4	5	5	0
"BC029479"	828	62789	0	0	0	0	0	0	0	0	0	0	1	0	0	0	0	0
"BC029533"	1223	1565	0	0	0	0	0	0	0	0	0	0	0	0	0	0	0	0
"BC029534"	1181	16489	475	225	298	177	166	59	876	701	154	785	0	7	0	0	0	0
"BC029578"	1305	70120	0	0	0	0	0	0	0	0	0	0	0	0	0	0	0	0
"BC029580"	1724	43542	10369	3638	5835	4534	1925	1713	4205	1321	15178	5710	19561	17433	18970	14146	25133	18114
"BC029598"	1707	14301	0	0	0	0	0	0	0	0	0	0	0	0	0	0	0	0
"BC029599"	837	8597	0	0	0	0	0	0	0	0	0	0	1	0	0	0	0	0
"BC029655"	556	21348	18	0	9	9	0	0	86	0	0	0	3	4	10	13	7	1
"BC029835"	1190	17716	0	0	0	0	0	0	0	0	0	0	0	0	0	0	0	0
"BC029877"	1491	2526	0	0	0	0	0	0	21	0	0	0	0	0	0	0	0	0
"BC030092"	494	65961	0	0	0	0	0	0	0	0	0	0	0	0	0	0	0	0
"BC030102"	492	906	46	0	26	20	0	0	17	13	0	0	0	0	4	0	0	0
"BC030111"	1321	17699	6	30	0	6	0	30	0	0	0	9	0	0	0	5	0	0
"BC030116"	778	63967	0	0	0	0	0	0	0	0	0	0	0	0	0	0	0	0
"BC030122"	672	167732	1718	175	996	722	86	89	1214	73	753	142	336	45	67	6	55	13
"BC030123"	551	20281	1	0	0	1	0	0	0	0	0	0	0	0	0	0	0	0
"BC030125"	1009	272659	0	0	0	0	0	0	0	0	0	0	0	0	0	0	0	0
"BC030152"	915	915	12	0	12	0	0	0	17	0	0	0	0	0	0	0	35	0
"BC030271"	3837	3837	1182	443	623	559	261	182	386	539	312	655	4454	5798	7034	8092	6279	6321
"BC030294"	709	34185	0	11	0	0	0	11	25	15	0	0	0	0	0	0	0	0
"BC030525"	2509	46407	499	25	277	222	15	10	295	134	106	51	370	327	234	141	738	557
"BC030591"	2097	2097	96	69	27	69	27	42	77	54	59	111	84	93	39	31	61	42
"BC030624"	2526	16047	0	0	0	0	0	0	0	0	0	0	3	9	0	0	0	0
"BC030750"	1332	162746	0	0	0	0	0	0	10	0	0	0	0	0	0	0	0	0
"BC030753"	1276	30533	0	0	0	0	0	0	0	0	0	0	0	0	0	0	0	0
"BC030765"	1112	8414	0	0	0	0	0	0	0	0	0	0	0	0	0	0	0	0
"BC030768"	1081	4521	0	0	0	0	0	0	0	26	0	0	1	0	0	0	0	0
"BC031092"	2151	385894	0	0	0	0	0	0	0	0	0	0	0	0	0	0	0	0
"BC031235"	1654	2870	0	0	0	0	0	0	0	0	0	0	0	0	0	0	0	0
"BC031238"	1577	4612	0	0	0	0	0	0	0	0	0	0	0	0	0	0	0	0
"BC031239"	2099	5793	0	0	0	0	0	0	0	0	0	0	0	0	0	0	0	0
"BC031243"	2048	89103	0	0	0	0	0	0	0	0	0	0	0	0	0	0	0	0
"BC031255"	1960	477539	0	0	0	0	0	0	0	0	0	0	0	0	0	0	0	0
"BC031259"	2043	4707	0	0	0	0	0	0	43	13	0	0	0	0	0	0	0	0
"BC031280"	2013	2447	0	0	0	0	0	0	0	0	0	0	13	8	37	31	43	13
"BC031283"	1981	125615	1311	2043	775	536	1120	923	474	4496	145	718	751	1304	1176	1763	1082	848
"BC031304"	739	12639	0	0	0	0	0	0	0	0	0	0	0	0	0	0	0	0
"BC031305"	897	1089	0	0	0	0	0	0	0	0	0	0	0	0	0	0	0	0
"BC031316"	551	1523	470	453	271	199	238	215	347	533	358	628	109	187	31	104	57	68
"BC031318"	572	14722	0	0	0	0	0	0	0	0	0	0	0	0	0	0	0	0
"BC031342"	724	3843	603	315	320	283	198	117	366	148	413	269	679	375	732	161	931	176
"BC031657"	457	2914	18	0	4	14	0	0	33	57	0	0	0	0	0	0	0	0
"BC031827"	817	1849	0	0	0	0	0	0	0	0	0	0	0	0	0	0	0	0
"BC031864"	1683	70728	0	0	0	0	0	0	0	0	0	0	0	0	0	0	0	0
"BC031866"	1371	16503	0	0	0	0	0	0	12	0	0	0	0	0	0	0	0	0
"BC031872"	1685	15911	0	0	0	0	0	0	0	0	0	0	0	0	0	0	0	0
"BC031876"	1059	13277	0	0	0	0	0	0	0	0	0	0	0	0	0	0	0	0
"BC031880"	916	8971	0	0	0	0	0	0	0	0	0	0	0	0	0	0	0	0
"BC031884"	588	5105	0	0	0	0	0	0	0	0	0	0	0	0	0	0	0	0
"BC031919"	1404	2068	18	0	0	18	0	0	28	10	0	20	0	0	0	0	0	0
"BC031939"	968	15916	0	0	0	0	0	0	14	12	0	0	0	1	0	0	0	0
"BC031941"	559	1252	0	0	0	0	0	0	0	0	0	0	0	0	0	0	0	0
"BC031952"	586	2528	0	0	0	0	0	0	22	0	0	0	0	0	0	0	0	0
"BC031953"	537	631	0	0	0	0	0	0	37	0	0	0	0	1	0	0	21	0
"BC031955"	495	4344	0	0	0	0	0	0	0	0	0	0	0	0	0	0	0	0
"BC031960"	886	31784	0	0	0	0	0	0	0	7	0	0	0	0	0	0	0	0
"BC031974"	431	1482	0	0	0	0	0	0	0	0	0	0	0	0	0	0	0	0
"BC031979"	1452	17912	0	0	0	0	0	0	0	0	0	0	0	0	0	0	0	0
"BC032020"	694	57304	1681	408	872	809	207	201	1169	204	125	178	1072	885	945	571	1180	533
"BC032026"	631	1120	0	0	0	0	0	0	0	0	0	0	0	0	0	0	0	0
"BC032030"	1697	16331	0	0	0	0	0	0	0	0	0	0	0	0	0	0	0	0
"BC032034"	349	46604	0	0	0	0	0	0	0	0	0	0	0	0	0	0	0	0
"BC032040"	1376	14636	0	0	0	0	0	0	0	0	0	0	0	0	0	0	0	0
"BC032042"	955	1840	0	0	0	0	0	0	29	27	0	0	65	11	72	154	178	39
"BC032117"	740	22649	37	51	19	18	15	36	135	145	0	198	136	251	117	147	158	163
"BC032239"	1444	17542	0	0	0	0	0	0	64	0	0	0	0	9	3	0	2	10
"BC032342"	1646	5710	2	0	1	1	0	0	28	0	0	0	67	141	25	45	0	16
"BC032407"	1749	234386	0	0	0	0	0	0	0	0	0	0	0	0	0	0	0	0
"BC032409"	2817	9218	0	0	0	0	0	0	7	0	0	0	8	12	47	52	67	53
"BC032415"	2362	2362	230	96	87	143	58	38	254	60	66	81	0	0	0	0	0	0
"BC032458"	1400	15025	0	0	0	0	0	0	203	484	0	0	38	0	0	0	14	0
"BC032469"	1762	5466	0	1	0	0	1	0	86	15	0	5	0	0	0	0	0	0
"BC032475"	1843	15980	1889	1875	1075	814	1030	845	657	844	374	1619	1765	2294	2299	1987	2631	1752
"BC032506"	2420	2420	182	94	100	82	47	47	17	36	0	33	145	434	136	182	228	199
"BC032716"	713	2647	0	0	0	0	0	0	0	0	0	0	0	0	0	0	0	0
"BC032741"	2014	26917	0	0	0	0	0	0	10	10	0	0	2	7	3	0	0	1
"BC032795"	1047	2617	0	0	0	0	0	0	0	0	0	0	0	0	0	0	0	0
"BC032873"	2221	10870	6	0	2	4	0	0	31	0	0	2	0	0	0	0	0	0
"BC032874"	1334	145161	0	0	0	0	0	0	0	0	0	0	0	0	0	0	0	0
"BC032891"	1007	41757	0	0	0	0	0	0	0	0	0	0	0	0	0	0	0	0
"BC032899"	506	6336	0	0	0	0	0	0	0	0	0	0	0	0	0	0	0	0
"BC032900"	1011	10181	0	0	0	0	0	0	0	0	0	0	0	0	0	0	0	0
"BC032901"	1054	2213	0	0	0	0	0	0	0	0	0	0	0	0	0	0	0	0
"BC032910"	1171	3667	0	0	0	0	0	0	11	0	0	0	0	0	0	0	0	0
"BC032911"	797	4171	0	0	0	0	0	0	0	0	0	0	0	0	0	0	0	0
"BC032913"	732	17296	0	0	0	0	0	0	0	0	0	0	0	0	0	0	0	0
"BC032914"	579	4782	0	0	0	0	0	0	0	0	0	0	0	0	0	0	0	0
"BC032915"	570	11849	0	0	0	0	0	0	0	0	0	0	0	0	0	0	0	0
"BC032916"	860	22046	0	0	0	0	0	0	0	0	0	0	0	0	0	0	0	0
"BC032918"	746	2919	0	0	0	0	0	0	0	0	0	0	0	0	0	0	0	0
"BC033124"	1190	10772	0	0	0	0	0	0	64	13	0	0	0	0	0	0	0	0
"BC033164"	1233	1233	300	292	236	64	93	199	78	841	0	119	0	0	0	0	0	0
"BC033241"	2014	2462	0	0	0	0	0	0	0	20	0	0	0	0	0	0	0	0
"BC033260"	2824	2943	0	0	0	0	0	0	0	0	0	0	0	0	0	0	0	0
"BC033323"	2228	3861	0	0	0	0	0	0	0	0	0	0	17	18	17	17	23	15
"BC033330"	2885	5375	0	0	0	0	0	0	0	0	0	0	0	0	0	0	0	0
"BC033360"	1075	14052	98	0	58	40	0	0	69	0	0	0	0	0	0	0	0	0
"BC033363"	1183	4174	40	0	27	13	0	0	0	25	0	0	560	0	0	0	41	117
"BC033370"	862	15089	0	0	0	0	0	0	0	0	0	0	0	0	0	0	0	0
"BC033373"	2409	6574	0	0	0	0	0	0	0	7	0	0	0	0	0	0	0	0
"BC033397"	505	2621	0	0	0	0	0	0	0	0	0	0	0	0	0	0	0	0
"BC033400"	1186	12458	0	0	0	0	0	0	0	0	0	0	0	0	0	0	0	0
"BC033403"	1933	45884	15	0	15	0	0	0	77	7	78	0	448	400	457	310	506	287
"BC033456"	1220	9751	1	0	0	1	0	0	79	15	0	0	0	0	0	0	0	0
"BC033528"	2626	3056	275	47	170	105	36	11	111	75	160	169	1	0	0	0	0	0
"BC033554"	2114	18785	487	556	307	180	351	205	360	511	34	110	0	0	0	0	0	0
"BC033560"	1812	2770	2	0	0	2	0	0	0	10	0	0	0	0	0	0	0	0
"BC033565"	1474	5184	0	0	0	0	0	0	0	0	0	0	0	0	0	0	0	0
"BC033739"	2087	2087	2540	4	2531	9	0	4	1	2446	1116	7447	5165	5354	426	1320	2	0
"BC033836"	1945	2500	5	0	5	0	0	0	23	0	0	6	834	534	11	24	19	4
"BC033837"	2237	243016	6212	1431	3396	2816	805	626	8583	5315	13934	11230	89	105	39	49	131	73
"BC033949"	975	6718	0	55	0	0	34	21	10	124	0	96	2	96	0	122	0	17
"BC033961"	1722	1722	0	0	0	0	0	0	0	0	0	0	0	0	0	0	0	0
"BC033962"	927	6729	0	0	0	0	0	0	0	0	0	0	0	0	0	0	0	0
"BC033978"	940	2522	0	0	0	0	0	0	0	0	0	0	0	0	0	0	0	0
"BC033983"	758	1554	0	0	0	0	0	0	0	0	0	0	0	0	0	0	22	0
"BC033989"	896	1728	0	0	0	0	0	0	9	0	0	0	0	0	0	0	0	0
"BC033991"	1094	24819	0	0	0	0	0	0	0	0	0	0	0	0	0	0	0	0
"BC033996"	476	840	1815	1032	973	842	548	484	415	242	0	0	0	0	0	0	0	0
"BC033997"	681	18472	1619	118	828	791	74	44	941	66	1394	263	45	25	50	22	77	22
"BC034000"	693	2257	0	0	0	0	0	0	0	0	0	0	0	0	0	0	0	0
"BC034006"	927	18978	114	207	50	64	94	113	35	37	0	42	840	976	717	599	607	557
"BC034020"	159	159	1142	1207	519	623	624	583	225	1043	893	1857	0	561	462	719	0	481
"BC034233"	3067	8305	0	0	0	0	0	0	0	12	0	0	0	0	0	0	0	0
"BC034268"	2068	10088	383	87	240	143	46	41	291	33	280	119	57	60	81	113	118	59
"BC034301"	1730	44238	0	0	0	0	0	0	0	0	0	0	0	0	0	0	0	0
"BC034307"	1178	214901	0	0	0	0	0	0	11	0	0	0	0	0	0	0	0	0
"BC034319"	841	116886	0	0	0	0	0	0	89	0	0	0	38	49	16	9	28	27
"BC034326"	867	3944	0	0	0	0	0	0	0	0	0	0	0	0	0	0	0	0
"BC034407"	1618	25945	0	0	0	0	0	0	0	12	0	0	0	0	0	0	0	0
"BC034416"	793	2023	0	0	0	0	0	0	0	0	0	0	0	0	0	0	0	0
"BC034423"	1654	2295	0	0	0	0	0	0	16	0	0	0	0	0	0	0	0	0
"BC034424"	3149	72927	3979	793	2170	1809	420	373	2280	492	3231	768	1938	1729	3435	2471	4479	2530
"BC034426"	1168	23884	16	0	16	0	0	0	30	1	0	0	27	33	27	29	24	17
"BC034434"	1035	1434	0	0	0	0	0	0	0	0	0	0	0	0	0	0	0	0
"BC034444"	729	729	0	0	0	0	0	0	0	0	0	0	0	0	0	0	0	0
"BC034456"	818	818	0	0	0	0	0	0	31	21	0	0	0	0	0	0	0	0
"BC034557"	4302	11505	275	0	134	141	0	0	246	22	223	18	547	317	2633	2118	499	566
"BC034577"	1767	16978	0	0	0	0	0	0	0	0	0	0	0	0	0	0	0	0
"BC034578"	1084	1084	7	0	7	0	0	0	0	0	0	2	0	0	0	0	0	0
"BC034583"	1583	113241	0	0	0	0	0	0	0	0	0	0	0	0	0	0	0	0
"BC034605"	3159	14384	0	0	0	0	0	0	18	0	0	0	0	1	0	0	0	0
"BC034612"	1618	16487	0	0	0	0	0	0	0	21	0	0	0	0	0	0	0	0
"BC034618"	2482	32768	9250	9038	5168	4082	4776	4262	3650	3475	4646	2026	3160	4524	1648	1437	3097	2106
"BC034630"	774	1357	0	0	0	0	0	0	0	0	0	0	0	0	0	0	0	0
"BC034636"	1564	3171	0	0	0	0	0	0	0	0	0	0	0	0	0	0	0	0
"BC034684"	462	549	0	0	0	0	0	0	0	0	0	0	0	232	0	1	0	0
"BC034767"	957	54842	0	0	0	0	0	0	0	0	0	0	0	0	0	0	0	0
"BC034773"	2161	53326	5749	422	3197	2552	247	175	2851	353	2494	425	8672	8518	10797	9094	13016	8987
"BC034788"	1909	1909	0	0	0	0	0	0	0	0	0	0	0	0	0	0	0	0
"BC034795"	1761	13211	0	0	0	0	0	0	0	0	0	0	0	0	0	0	0	0
"BC034799"	1044	40116	0	0	0	0	0	0	0	0	0	0	0	0	0	0	0	0
"BC034802"	579	2270	0	0	0	0	0	0	0	0	0	0	0	0	0	0	0	0
"BC034811"	2803	22088	0	0	0	0	0	0	0	0	0	0	0	0	0	0	0	0
"BC034812"	2476	18024	2	0	2	0	0	0	12	0	0	0	9	0	3	0	2	0
"BC034817"	2081	10422	0	0	0	0	0	0	0	0	0	0	0	6	0	0	5	3
"BC034827"	3170	3690	0	0	0	0	0	0	0	14	0	0	86	97	0	0	0	0
"BC034913"	1368	5055	0	0	0	0	0	0	0	0	0	0	0	0	0	0	0	0
"BC034927"	1757	2060	0	0	0	0	0	0	29	0	0	0	0	0	0	0	0	0
"BC034929"	1007	3521	0	0	0	0	0	0	11	0	0	0	0	0	0	0	0	0
"BC034940"	1473	127870	0	0	0	0	0	0	0	0	0	0	0	0	0	0	0	0
"BC035019"	3156	118896	0	0	0	0	0	0	31	0	0	0	0	0	0	0	0	0
"BC035052"	1968	97396	0	0	0	0	0	0	0	10	0	0	0	0	0	0	3	0
"BC035067"	2391	4826	27	0	0	27	0	0	86	44	34	43	63	52	67	53	39	17
"BC035080"	1466	39673	2030	3570	1113	917	2018	1552	1157	1912	654	1367	2197	3098	3719	3364	3756	2901
"BC035084"	2372	7580	76	0	51	25	0	0	57	49	25	63	0	0	0	0	0	0
"BC035094"	1952	51788	92	62	37	55	38	24	73	34	56	85	70	174	23	16	31	3
"BC035096"	3009	3009	0	0	0	0	0	0	0	0	0	0	0	0	0	0	0	0
"BC035101"	2766	15072	0	0	0	0	0	0	0	0	0	0	0	0	0	0	0	0
"BC035104"	2142	66235	0	0	0	0	0	0	0	0	0	0	0	0	0	0	0	0
"BC035106"	2902	4084	0	0	0	0	0	0	12	0	0	0	54	62	0	44	25	0
"BC035112"	3506	172085	0	0	0	0	0	0	0	0	0	0	0	0	0	0	0	0
"BC035119"	4404	198932	0	0	0	0	0	0	0	12	0	0	0	0	20	14	40	0
"BC035125"	4165	4165	0	0	0	0	0	0	0	0	0	0	0	16	17	20	58	49
"BC035172"	1967	47308	0	0	0	0	0	0	0	0	0	0	0	0	0	0	0	0
"BC035176"	2743	3902	0	0	0	0	0	0	0	0	0	0	0	0	0	0	0	0
"BC035179"	2652	13390	0	0	0	0	0	0	14	0	0	0	0	0	0	0	0	0
"BC035181"	3490	4182	0	0	0	0	0	0	0	0	0	0	0	0	0	0	0	0
"BC035182"	1562	270181	0	0	0	0	0	0	45	31	8	0	0	0	0	0	0	0
"BC035187"	3739	184504	0	0	0	0	0	0	0	0	0	0	43	49	97	147	145	128
"BC035195"	2852	5525	0	0	0	0	0	0	0	0	0	0	0	0	0	0	0	0
"BC035245"	2889	14474	405	333	243	162	182	151	145	142	57	59	3628	4849	3811	3648	3850	3009
"BC035247"	973	41888	144	0	65	79	0	0	44	16	0	0	64	36	0	0	0	0
"BC035261"	1086	21303	0	0	0	0	0	0	0	0	0	0	0	0	0	0	0	0
"BC035340"	2712	55970	0	0	0	0	0	0	150	47	0	0	0	0	0	0	0	0
"BC035370"	1162	22900	19	14	0	19	14	0	171	57	0	57	43	77	0	0	0	0
"BC035377"	767	857	0	0	0	0	0	0	0	0	0	0	13	0	4	0	9	0
"BC035380"	1611	9135	0	0	0	0	0	0	0	0	0	0	0	0	0	0	0	0
"BC035381"	3104	20394	0	0	0	0	0	0	0	0	0	0	0	0	0	0	0	0
"BC035392"	1271	11454	0	0	0	0	0	0	0	0	0	0	11	20	0	0	5	3
"BC035398"	4276	11353	0	0	0	0	0	0	0	0	0	0	0	0	0	0	0	0
"BC035400"	2678	72974	18446	16129	8838	9608	9144	6985	8937	3760	3623	3211	116	269	49	29	55	2
"BC035411"	5183	86833	11	10	4	7	0	10	134	66	0	12	0	6	1104	637	7	0
"BC035413"	1754	4393	0	0	0	0	0	0	0	0	0	0	0	0	0	0	0	0
"BC035417"	1036	10454	0	0	0	0	0	0	0	0	0	0	0	0	0	0	0	0
"BC035465"	835	835	0	0	0	0	0	0	24	0	0	0	0	0	0	0	0	0
"BC035629"	2285	34595	0	0	0	0	0	0	0	0	0	0	0	0	0	0	0	0
"BC035642"	763	50430	0	0	0	0	0	0	0	0	0	0	0	0	0	0	0	0
"BC035647"	2521	3398	27	139	25	2	62	77	12	7	0	13	216	361	44	299	42	75
"BC035722"	1951	8018	0	0	0	0	0	0	22	0	0	0	0	0	0	0	0	0
"BC035733"	1511	20374	0	0	0	0	0	0	0	0	0	0	0	0	0	0	0	0
"BC035769"	1811	42051	0	0	0	0	0	0	0	0	0	0	0	0	0	0	0	0
"BC035826"	2334	306346	0	0	0	0	0	0	0	0	0	0	0	0	0	0	0	0
"BC035866"	1056	25803	0	0	0	0	0	0	0	0	0	0	0	0	0	0	0	0
"BC035867"	2116	40685	1	0	0	1	0	0	55	24	0	0	0	0	0	0	0	0
"BC035889"	2023	6842	0	0	0	0	0	0	0	0	0	0	0	0	1	1	0	1
"BC035922"	594	2303	0	0	0	0	0	0	0	0	0	0	0	0	0	0	0	0
"BC036043"	559	38335	0	0	0	0	0	0	0	0	0	0	0	1	0	0	0	0
"BC036055"	3034	3034	0	0	0	0	0	0	0	0	0	16	0	0	0	0	0	0
"BC036195"	2889	34037	0	0	0	0	0	0	53	0	0	0	10	0	0	0	31	0
"BC036196"	2631	30950	0	0	0	0	0	0	0	0	0	0	0	0	0	0	0	0
"BC036209"	4132	14614	0	0	0	0	0	0	0	0	0	0	0	0	0	0	0	0
"BC036212"	3094	259161	3844	648	2123	1721	365	283	1292	338	1851	914	1909	2089	1500	970	2066	1097
"BC036236"	2912	51661	0	0	0	0	0	0	0	0	0	0	0	0	0	0	0	0
"BC036244"	1678	3090	0	0	0	0	0	0	0	0	0	0	0	0	0	0	0	0
"BC036251"	805	1635	0	0	0	0	0	0	0	0	0	0	0	0	0	0	0	0
"BC036258"	673	1190	0	0	0	0	0	0	0	0	0	0	0	0	0	0	0	0
"BC036259"	1378	3577	0	0	0	0	0	0	0	0	0	0	0	0	0	0	0	0
"BC036261"	759	2744	0	0	0	0	0	0	0	0	0	0	0	0	0	0	0	0
"BC036297"	822	1208	0	0	0	0	0	0	9	0	0	0	0	0	0	0	0	0
"BC036306"	1721	319502	0	0	0	0	0	0	0	0	0	0	0	0	0	0	0	0
"BC036308"	1681	45395	6521	4060	3639	2882	2139	1921	3167	1681	4401	3437	4355	5373	5061	4147	6786	4457
"BC036309"	2095	23589	0	0	0	0	0	0	0	0	0	0	0	0	0	0	0	0
"BC036310"	987	45451	0	0	0	0	0	0	0	0	0	0	0	0	0	0	0	0
"BC036311"	2282	41356	0	0	0	0	0	0	0	0	0	0	0	0	0	0	0	0
"BC036345"	2405	143552	0	0	0	0	0	0	0	0	0	0	0	0	0	0	0	0
"BC036361"	2121	5258	0	0	0	0	0	0	14	0	0	0	0	0	2	0	6	0
"BC036382"	3036	15838	0	0	0	0	0	0	0	13	0	0	2	17	6	0	11	3
"BC036404"	2012	24611	0	0	0	0	0	0	0	0	0	0	0	0	0	0	0	0
"BC036412"	2133	34304	0	0	0	0	0	0	0	0	0	0	0	0	0	0	0	0
"BC036431"	1450	87186	0	0	0	0	0	0	0	0	0	0	0	0	0	0	0	0
"BC036441"	2988	6616	0	0	0	0	0	0	0	0	0	0	0	0	0	0	0	0
"BC036442"	2140	31511	0	0	0	0	0	0	0	0	0	0	0	0	0	0	0	0
"BC036500"	4105	6210	0	0	0	0	0	0	0	0	0	0	0	0	0	0	0	0
"BC036544"	1217	22215	21810	22431	11564	10246	10745	11686	10203	23398	19766	42148	52	62	0	0	0	0
"BC036594"	3165	285207	0	0	0	0	0	0	0	0	0	0	0	0	0	0	0	0
"BC036617"	1110	2967	0	0	0	0	0	0	0	0	0	0	0	0	0	4	13	0
"BC036624"	1342	1427	0	0	0	0	0	0	10	0	0	0	76	40	33	10	49	20
"BC036635"	1052	21012	68	43	39	29	16	27	114	92	12	2	292	315	221	154	210	141
"BC036645"	2227	21687	4	0	0	4	0	0	50	63	58	4	28	74	0	0	0	0
"BC036646"	1325	34587	0	0	0	0	0	0	0	0	0	0	0	0	0	0	0	0
"BC036695"	1316	27961	988	602	569	419	304	298	411	215	460	479	236	168	206	156	281	155
"BC036698"	3255	46966	1578	2182	883	695	1151	1031	657	832	460	2107	1331	1767	871	899	765	482
"BC036778"	2529	2529	818	796	465	353	421	375	247	377	311	719	10	16	5	18	19	7
"BC036830"	1494	7546	0	0	0	0	0	0	0	0	0	0	0	0	0	0	0	0
"BC036848"	762	336798	0	1	0	0	1	0	0	0	0	0	0	0	0	0	0	0
"BC036850"	5031	53973	0	0	0	0	0	0	0	0	0	0	0	0	0	0	0	0
"BC036874"	1947	7871	0	0	0	0	0	0	66	56	0	0	0	0	0	0	0	0
"BC036876"	2370	12361	0	0	0	0	0	0	0	0	0	0	0	0	0	0	0	0
"BC036909"	1479	4506	899	323	332	567	168	155	240	115	196	157	1473	699	1640	1430	799	481
"BC036918"	1787	13051	1283	223	910	373	103	120	810	261	407	272	1603	1073	1044	546	1742	1047
"BC036921"	1325	11352	1	0	0	1	0	0	35	11	0	0	47	30	44	9	84	52
"BC036928"	1612	5439	0	0	0	0	0	0	0	0	0	0	8	0	0	0	0	0
"BC037167"	1091	3637	0	0	0	0	0	0	0	23	0	0	0	0	0	0	0	0
"BC037214"	692	21870	12	0	0	12	0	0	19	0	0	0	0	0	0	0	0	0
"BC037250"	719	73521	0	0	0	0	0	0	0	0	0	0	0	0	0	0	0	0
"BC037254"	2835	3250	0	0	0	0	0	0	0	0	0	0	0	0	0	0	0	0
"BC037297"	4016	7244	0	0	0	0	0	0	0	0	0	0	0	0	0	0	0	0
"BC037304"	2716	2716	0	0	0	0	0	0	0	0	0	0	0	0	0	0	0	0
"BC037321"	4626	4626	0	0	0	0	0	0	0	0	0	0	0	0	0	0	0	0
"BC037327"	3106	3106	0	0	0	0	0	0	0	0	0	0	0	0	0	0	0	0
"BC037331"	2749	5331	0	120	0	0	74	46	0	54	0	43	0	61	0	44	0	3
"BC037345"	3709	16066	0	0	0	0	0	0	0	0	0	0	0	0	0	0	0	0
"BC037347"	3176	31711	0	0	0	0	0	0	28	0	0	0	2	0	0	0	0	0
"BC037357"	1021	1021	0	0	0	0	0	0	0	0	0	0	0	0	0	0	0	0
"BC037382"	792	2066	0	0	0	0	0	0	0	0	0	0	0	0	0	0	0	0
"BC037383"	1259	7561	0	0	0	0	0	0	0	0	0	0	0	0	0	0	0	0
"BC037384"	1901	16304	0	0	0	0	0	0	0	0	0	0	0	0	0	0	0	0
"BC037494"	1341	1341	0	0	0	0	0	0	0	0	0	0	0	0	0	0	0	0
"BC037497"	1058	139986	0	0	0	0	0	0	9	0	0	0	0	0	0	0	0	0
"BC037540"	2459	61417	376	102	217	159	39	63	225	27	42	32	30	0	0	0	0	0
"BC037783"	2115	38691	1880	2661	994	886	1345	1316	680	1332	551	2231	106	92	231	128	200	92
"BC037788"	3679	5720	0	0	0	0	0	0	76	0	0	0	0	0	0	0	0	0
"BC037833"	2453	9149	0	0	0	0	0	0	95	47	0	0	0	1	0	0	0	0
"BC037839"	1282	43897	8	0	0	8	0	0	50	8	0	0	25	74	0	0	0	18
"BC037850"	2206	36958	0	0	0	0	0	0	0	0	0	0	0	0	0	0	0	0
"BC037852"	2147	2147	0	0	0	0	0	0	0	0	0	0	0	0	0	1	0	23
"BC037858"	1436	5149	0	0	0	0	0	0	0	0	0	0	0	0	0	0	0	0
"BC037861"	4351	4788	156	73	93	63	24	49	130	85	0	75	467	0	128	268	496	256
"BC037865"	2017	102113	56	65	30	26	42	23	80	9	0	24	491	812	8	0	159	1
"BC037873"	1844	6442	0	0	0	0	0	0	0	0	0	0	0	0	0	0	0	0
"BC037884"	1386	13592	299	428	175	124	205	223	263	285	128	460	194	181	85	54	82	52
"BC037891"	1165	16200	0	0	0	0	0	0	15	0	0	0	0	0	0	0	0	0
"BC037892"	1497	86634	130	0	97	33	0	0	26	0	0	0	0	0	0	0	0	0
"BC037904"	1448	30101	9	52110	2	7	52053	57	62	41262	0	31	0	0	13	24	15	5
"BC037918"	951	430781	12	0	0	12	0	0	89	0	0	0	9	11	0	0	3	0
"BC037927"	1612	61390	0	0	0	0	0	0	0	0	0	0	0	0	0	0	0	0
"BC037929"	2341	10675	0	0	0	0	0	0	0	0	0	0	0	0	0	0	0	0
"BC037934"	3099	113933	1000	428	521	479	259	169	657	334	472	685	0	53	13	11	14	4
"BC037952"	2473	87270	0	0	0	0	0	0	0	0	0	0	0	0	0	0	0	0
"BC037970"	2367	47268	0	0	0	0	0	0	0	0	0	0	0	0	0	0	0	0
"BC037972"	986	25813	0	0	0	0	0	0	24	0	0	0	0	0	0	0	0	0
"BC038188"	1355	117391	0	0	0	0	0	0	0	0	0	0	0	0	0	0	0	0
"BC038194"	1066	122903	0	0	0	0	0	0	0	0	0	0	0	0	0	0	0	0
"BC038197"	1035	1570	0	0	0	0	0	0	0	0	0	0	0	0	0	0	0	0
"BC038201"	993	3561	0	0	0	0	0	0	29	0	0	0	0	0	0	0	0	0
"BC038204"	1176	7578	0	0	0	0	0	0	0	0	0	0	0	0	0	0	0	0
"BC038205"	439	3730	10	0	10	0	0	0	0	0	0	0	1	9	0	3	4	0
"BC038210"	965	92413	0	0	0	0	0	0	0	11	0	0	0	0	0	0	0	0
"BC038211"	482	1171	0	0	0	0	0	0	15	0	0	0	9	0	0	0	0	0
"BC038216"	379	1894	0	0	0	0	0	0	0	9	0	0	0	0	5	0	0	0
"BC038218"	857	11658	0	0	0	0	0	0	12	10	0	0	0	0	0	0	0	0
"BC038245"	1076	4645	0	0	0	0	0	0	30	0	0	0	0	0	0	0	0	0
"BC038361"	3550	15008	468	117	300	168	56	61	183	75	4	7	513	454	479	244	549	266
"BC038368"	2670	20611	0	0	0	0	0	0	14	0	0	0	0	0	0	0	0	0
"BC038424"	2888	5679	0	0	0	0	0	0	0	0	0	0	0	0	0	0	0	0
"BC038429"	2182	46512	0	0	0	0	0	0	0	0	0	0	0	0	0	0	0	0
"BC038431"	2602	96811	0	0	0	0	0	0	0	0	0	0	0	0	0	0	0	0
"BC038442"	1716	19788	496	319	307	189	169	150	475	403	273	362	316	352	304	322	404	312
"BC038455"	2042	2042	0	0	0	0	0	0	0	0	0	0	0	0	0	0	0	0
"BC038464"	2163	8193	160	68	102	58	46	22	264	28	110	0	735	417	888	566	1154	735
"BC038465"	1117	5290	0	0	0	0	0	0	0	0	0	0	0	0	0	0	0	0
"BC038529"	1006	42053	0	0	0	0	0	0	0	0	0	0	0	0	0	0	0	0
"BC038530"	1013	16403	0	99	0	0	46	53	0	124	0	17	0	0	0	0	0	0
"BC038532"	920	21123	0	0	0	0	0	0	0	0	0	0	0	0	0	0	0	0
"BC038535"	854	163260	0	0	0	0	0	0	0	0	0	0	0	0	0	0	0	0
"BC038536"	1220	21883	0	0	0	0	0	0	0	0	0	0	0	0	0	0	0	0
"BC038542"	1013	29824	0	0	0	0	0	0	33	8	0	0	0	0	0	0	0	0
"BC038546"	909	1564	0	0	0	0	0	0	0	0	0	0	0	0	0	0	0	0
"BC038548"	1076	75351	0	0	0	0	0	0	0	0	0	0	0	0	0	0	0	0
"BC038559"	1390	20808	2085	2089	1132	953	1098	991	824	1143	2462	2658	2086	1305	916	1001	1075	845
"BC038563"	783	9779	45	0	11	34	0	0	70	0	0	0	0	0	0	0	0	0
"BC038566"	1419	17463	0	0	0	0	0	0	0	0	0	0	0	0	0	0	0	0
"BC038570"	1429	49433	480	168	271	209	122	46	223	58	32	0	796	909	646	636	651	473
"BC038574"	826	20200	2109	1402	1183	926	805	597	1323	491	824	891	164	611	77	113	146	64
"BC038576"	555	906	0	0	0	0	0	0	0	0	0	0	0	0	0	0	0	0
"BC038578"	1518	5139	0	0	0	0	0	0	0	0	0	0	0	0	0	0	0	0
"BC038717"	1728	84872	0	0	0	0	0	0	0	0	0	0	0	0	0	0	0	0
"BC038719"	1574	28977	0	0	0	0	0	0	0	0	0	0	0	0	0	0	0	0
"BC038722"	747	830	0	0	0	0	0	0	0	0	0	0	0	0	0	0	0	0
"BC038723"	232	28314	0	0	0	0	0	0	0	0	0	0	0	0	0	0	0	0
"BC038725"	1103	6349	0	0	0	0	0	0	0	0	0	0	0	0	0	0	0	0
"BC038727"	569	5670	0	0	0	0	0	0	0	0	0	0	0	0	0	0	0	0
"BC038729"	558	27660	0	0	0	0	0	0	14	9	0	0	0	0	0	0	0	0
"BC038731"	1489	10041	0	0	0	0	0	0	29	0	0	0	0	16	21	5	11	5
"BC038739"	1824	12779	4	8	0	4	3	5	18	6	0	0	17	28	23	29	21	30
"BC038742"	1308	5907	0	0	0	0	0	0	0	0	0	0	0	0	0	0	0	0
"BC038745"	1035	2255	0	0	0	0	0	0	0	0	0	0	0	0	0	0	0	0
"BC038746"	956	100117	0	0	0	0	0	0	0	0	0	0	0	0	0	0	0	0
"BC038750"	538	5411	0	0	0	0	0	0	0	0	0	0	0	0	0	0	0	0
"BC038755"	1491	29286	0	0	0	0	0	0	0	0	0	0	0	0	0	0	0	0
"BC038759"	599	34329	0	0	0	0	0	0	0	0	0	0	0	0	0	0	0	0
"BC038761"	459	1369	0	0	0	0	0	0	0	0	0	0	0	0	0	0	0	0
"BC038767"	559	667	0	0	0	0	0	0	0	0	0	0	0	0	0	0	0	0
"BC038769"	1127	1601	0	0	0	0	0	0	28	0	0	0	0	0	0	9	0	0
"BC038777"	1171	10546	0	0	0	0	0	0	0	0	0	0	0	0	0	0	0	0
"BC038778"	1276	4713	0	0	0	0	0	0	16	0	0	0	0	0	0	0	0	0
"BC038779"	940	50758	0	0	0	0	0	0	0	0	0	0	0	0	0	0	0	0
"BC038783"	1747	149734	0	0	0	0	0	0	116	16	0	0	0	0	0	0	0	0
"BC038791"	1333	5078	0	0	0	0	0	0	0	0	0	0	0	0	0	0	0	0
"BC038792"	366	33084	0	0	0	0	0	0	83	0	0	0	0	0	0	0	0	0
"BC039000"	3312	64066	0	0	0	0	0	0	0	0	0	0	0	0	0	0	0	0
"BC039088"	2587	4392	51	0	18	33	0	0	19	24	0	0	360	258	188	64	265	119
"BC039094"	1484	3699	0	0	0	0	0	0	0	0	0	0	0	0	0	0	0	0
"BC039096"	2225	9211	0	0	0	0	0	0	0	0	0	0	0	0	0	0	0	0
"BC039122"	2680	2680	2	0	1	1	0	0	34	0	0	0	0	0	0	0	0	0
"BC039159"	976	1710	319	35	183	136	35	0	55	15	119	0	1701	1117	280	79	407	196
"BC039168"	2056	14757	0	0	0	0	0	0	50	0	0	0	8	0	5	8	0	4
"BC039180"	1054	79085	301	19	198	103	19	0	305	46	55	51	0	0	0	0	0	0
"BC039313"	2597	8458	0	0	0	0	0	0	0	0	0	0	0	0	0	0	0	0
"BC039319"	1477	1477	0	0	0	0	0	0	0	0	0	0	0	0	0	0	0	0
"BC039327"	2064	104405	0	0	0	0	0	0	0	0	0	0	0	0	0	0	0	0
"BC039329"	1688	5488	0	1	0	0	0	1	0	0	0	0	0	0	0	0	2	0
"BC039351"	1506	10192	0	0	0	0	0	0	0	0	0	0	0	0	0	0	0	0
"BC039356"	1960	37431	0	0	0	0	0	0	0	0	0	0	0	0	0	0	0	0
"BC039357"	1956	2043	0	0	0	0	0	0	0	0	2	0	0	0	0	0	0	0
"BC039358"	2029	16779	1	0	1	0	0	0	37	24	0	0	3	0	1	2	0	0
"BC039364"	1970	10959	0	0	0	0	0	0	0	0	0	0	18	9	28	54	21	23
"BC039374"	1366	33312	341	818	209	132	465	353	232	275	287	461	103	444	109	306	311	175
"BC039377"	901	89301	0	0	0	0	0	0	0	0	0	0	0	0	0	0	0	0
"BC039381"	1251	2880	0	0	0	0	0	0	0	0	0	0	0	0	0	0	0	0
"BC039382"	1169	18835	0	0	0	0	0	0	0	0	0	0	0	0	0	0	0	0
"BC039385"	975	1262	0	0	0	0	0	0	0	0	0	0	0	0	0	0	0	0
"BC039386"	887	2198	0	0	0	0	0	0	0	0	0	0	0	0	0	0	0	0
"BC039389"	1105	23120	0	0	0	0	0	0	0	0	0	0	0	105	0	0	0	0
"BC039399"	895	3296	0	0	0	0	0	0	8	13	0	0	61	86	16	84	65	66
"BC039402"	626	3483	0	0	0	0	0	0	68	25	0	0	0	0	0	0	0	0
"BC039424"	1554	37390	780	729	431	349	419	310	631	492	12	618	2196	2140	1653	1702	1985	1234
"BC039437"	1589	287923	0	0	0	0	0	0	0	17	0	0	0	0	0	0	0	0
"BC039445"	948	90631	4871	1036	2733	2138	578	458	2740	614	314	205	385	377	228	216	230	154
"BC039452"	2169	2169	0	0	0	0	0	0	0	0	0	0	0	0	0	0	0	0
"BC039455"	1360	1587	0	0	0	0	0	0	0	0	0	0	74	17	66	0	44	0
"BC039477"	870	5822	0	0	0	0	0	0	0	0	0	0	0	0	0	0	0	0
"BC039483"	1884	12016	0	0	0	0	0	0	0	0	0	0	0	0	0	0	0	0
"BC039485"	1171	11093	0	0	0	0	0	0	0	0	0	0	0	0	0	0	0	0
"BC039487"	1009	303332	9	0	9	0	0	0	34	0	0	0	0	0	0	0	0	0
"BC039493"	541	7722	0	0	0	0	0	0	0	0	0	0	0	0	0	0	0	0
"BC039495"	1456	7031	0	0	0	0	0	0	43	22	0	0	0	41	0	0	0	0
"BC039497"	1475	31108	26	3	26	0	1	2	77	7	28	26	368	394	858	682	990	730
"BC039500"	1133	1246	129	71	43	86	1	70	14	119	62	185	481	945	152	200	132	143
"BC039503"	1295	89398	0	0	0	0	0	0	0	0	0	0	0	0	0	0	0	0
"BC039509"	1303	13546	0	0	0	0	0	0	0	0	0	0	0	0	0	0	0	0
"BC039516"	1494	6016	1	0	0	1	0	0	113	25	0	1	0	0	0	0	0	0
"BC039519"	1393	95538	0	0	0	0	0	0	50	11	0	0	37	33	4	22	34	23
"BC039521"	1894	29674	0	0	0	0	0	0	12	0	0	0	0	0	0	0	0	0
"BC039523"	742	16100	803	243	204	599	126	117	214	63	186	0	6421	5503	14864	12440	11875	11304
"BC039524"	1036	21638	403	254	243	160	141	113	288	67	87	28	233	214	52	7	20	6
"BC039527"	981	9305	1086	212	625	461	101	111	368	162	231	38	0	0	0	0	0	0
"BC039537"	365	1962	91	0	66	25	0	0	59	0	67	0	1	0	0	0	0	0
"BC039545"	644	55717	9	185	9	0	104	81	49	138	0	71	435	628	78	86	66	66
"BC039546"	1261	18891	0	0	0	0	0	0	0	0	0	0	15	0	0	6	0	4
"BC039551"	1122	2319	0	0	0	0	0	0	0	0	0	0	0	0	0	0	0	0
"BC039553"	1144	7148	0	0	0	0	0	0	0	0	4	0	0	1	0	0	0	0
"BC039561"	332	1195	0	0	0	0	0	0	0	0	0	0	0	0	0	0	0	0
"BC039603"	1867	1867	506	89	235	271	49	40	131	22	0	108	901	938	1047	686	1318	723
"BC039664"	1181	1458	0	0	0	0	0	0	29	0	0	0	31	22	20	5	57	18
"BC039665"	1258	3274	0	0	0	0	0	0	0	0	0	0	0	0	0	0	0	0
"BC039668"	1212	65575	221	144	119	102	76	68	342	220	41	230	1405	953	1465	1471	1685	1385
"BC039670"	1604	244050	0	0	0	0	0	0	0	0	0	0	0	0	0	0	0	0
"BC039673"	873	2648	0	0	0	0	0	0	0	0	0	0	0	0	0	0	0	0
"BC039675"	789	5762	11	0	11	0	0	0	12	0	0	0	5	10	3	0	4	0
"BC039676"	1292	4344	2380	90	1293	1087	44	46	4471	24	1407	96	6	6	8	28	55	33
"BC039678"	1328	5022	7087	836	3658	3429	504	332	6133	1377	1958	1074	0	0	0	0	0	0
"BC039681"	1096	1834	4	0	0	4	0	0	0	0	0	0	0	0	0	0	1	0
"BC039683"	860	8386	0	0	0	0	0	0	11	16	0	0	0	0	0	0	0	0
"BC039685"	844	2179	124	30	71	53	22	8	24	13	0	15	224	293	224	205	212	140
"BC040060"	591	41528	0	0	0	0	0	0	0	0	0	0	0	0	0	0	0	0
"BC040064"	2281	8624	3376	659	2919	457	330	329	1069	282	4321	1404	246	52	644	518	1083	687
"BC040166"	1998	3080	0	0	0	0	0	0	0	0	0	0	0	0	0	0	0	0
"BC040177"	2485	2485	0	0	0	0	0	0	0	0	0	0	0	0	0	0	0	0
"BC040182"	2561	37001	0	0	0	0	0	0	62	0	0	0	207	174	181	145	246	106
"BC040189"	4443	8468	2	0	1	1	0	0	12	1	0	0	0	0	0	0	0	0
"BC040195"	2859	3886	0	0	0	0	0	0	13	0	0	0	0	0	0	0	0	0
"BC040208"	2281	2281	249	5790	87	162	3180	2610	263	686	56	1079	0	0	60	71	156	98
"BC040219"	2826	55252	0	0	0	0	0	0	8	0	0	0	0	0	0	0	0	0
"BC040304"	1217	7109	395	122	268	127	77	45	284	97	0	47	0	0	0	0	0	0
"BC040308"	1991	50667	3391	8589	2009	1382	4658	3931	866	873	258	1522	92	114	212	169	180	162
"BC040309"	1100	147080	0	0	0	0	0	0	0	0	0	0	0	0	0	0	0	0
"BC040311"	3471	15724	0	0	0	0	0	0	0	0	0	0	0	0	0	0	0	0
"BC040327"	2079	132565	0	0	0	0	0	0	0	0	0	0	0	0	0	0	0	0
"BC040328"	1914	14795	0	0	0	0	0	0	0	0	0	0	0	0	0	0	0	0
"BC040333"	1053	12923	0	0	0	0	0	0	10	0	0	0	0	0	0	0	0	0
"BC040358"	4477	28174	0	0	0	0	0	0	20	25	0	0	19	9	47	31	0	4
"BC040412"	387	1958	0	0	0	0	0	0	0	0	0	0	0	0	0	0	0	0
"BC040473"	3071	3071	1445	1292	698	747	577	715	691	641	258	2886	4666	0	0	3	0	0
"BC040476"	1935	38926	2992	1721	1714	1278	944	777	1439	762	1275	1344	153	233	57	85	88	47
"BC040563"	3267	55908	0	0	0	0	0	0	14	0	0	0	0	0	5	0	0	0
"BC040565"	2360	84140	1745	701	992	753	413	288	1109	569	165	633	2412	3103	1547	1369	1610	1138
"BC040572"	3473	5316	0	0	0	0	0	0	0	0	0	0	0	0	0	0	0	0
"BC040576"	1165	1854	0	0	0	0	0	0	0	0	0	0	0	0	0	0	0	0
"BC040577"	2038	37721	248	0	147	101	0	0	168	10	0	12	50	44	9	3	20	19
"BC040586"	2887	78708	0	0	0	0	0	0	0	0	0	0	0	0	0	0	0	0
"BC040587"	1451	10806	0	0	0	0	0	0	0	0	0	0	0	0	0	0	0	0
"BC040588"	2479	67679	0	0	0	0	0	0	48	0	0	0	0	0	0	0	0	0
"BC040598"	2396	124753	1634	685	945	689	372	313	1079	535	333	735	131	173	48	63	62	54
"BC040601"	2557	5129	0	0	0	0	0	0	0	0	0	0	0	0	0	0	0	0
"BC040612"	2296	276595	0	0	0	0	0	0	0	0	0	0	0	0	0	0	0	0
"BC040624"	705	16086	453	474	208	245	251	223	363	335	59	368	0	0	0	0	0	0
"BC040625"	2437	120727	0	0	0	0	0	0	0	0	0	0	0	0	0	0	0	0
"BC040628"	1127	1239	0	0	0	0	0	0	0	0	0	0	8	0	0	0	0	0
"BC040629"	2279	12832	1199	409	614	585	217	192	873	651	2186	1403	132	122	914	752	1637	908
"BC040631"	2047	4188	0	0	0	0	0	0	15	0	0	0	0	0	0	9	0	0
"BC040632"	2185	326550	0	0	0	0	0	0	0	0	0	0	0	0	0	0	0	0
"BC040634"	1746	2822	0	0	0	0	0	0	51	39	0	0	0	0	0	0	0	0
"BC040637"	352	352	0	0	0	0	0	0	0	0	0	0	0	0	0	0	0	0
"BC040646"	1951	1951	0	0	0	0	0	0	0	0	0	0	0	0	0	0	0	0
"BC040700"	1378	12286	0	0	0	0	0	0	0	0	0	0	0	0	0	0	0	0
"BC040701"	1258	4569	0	0	0	0	0	0	0	0	0	0	0	0	0	0	0	0
"BC040713"	471	801	2	87	0	2	45	42	173	86	0	55	64	14	62	42	32	33
"BC040715"	1429	1429	0	0	0	0	0	0	0	16	0	0	79	56	0	0	0	0
"BC040718"	1567	265581	0	0	0	0	0	0	8	0	0	0	0	0	0	0	0	0
"BC040728"	387	2742	51	37	21	30	19	18	57	12	0	29	0	1	0	0	0	0
"BC040731"	1422	31250	71	0	36	35	0	0	51	0	0	0	0	0	0	0	0	0
"BC040734"	1554	78263	31	5	31	0	5	0	37	0	0	0	145	139	1	0	0	0
"BC040735"	1151	6978	0	0	0	0	0	0	16	0	0	0	0	369	724	495	946	816
"BC040831"	2281	2864	0	0	0	0	0	0	0	0	0	0	0	0	0	0	0	0
"BC040833"	1120	65010	5281	52870	2898	2383	28444	24426	35	20923	0	11476	297	216726	1464	82021	437	35589
"BC040855"	728	10226	0	0	0	0	0	0	0	0	0	0	0	0	0	0	0	0
"BC040860"	674	308823	0	0	0	0	0	0	18	10	0	0	0	0	0	0	0	0
"BC040861"	1762	129689	147	194	115	32	109	85	414	136	0	117	0	0	0	0	0	0
"BC040863"	686	202795	0	0	0	0	0	0	0	0	0	0	0	0	0	0	0	0
"BC040865"	1779	3725	698	345	440	258	0	345	180	417	365	959	0	380	0	883	0	347
"BC040866"	1909	5775	0	0	0	0	0	0	0	0	0	0	0	0	0	0	0	0
"BC040869"	1787	14998	0	0	0	0	0	0	0	0	0	0	0	0	0	0	0	0
"BC040870"	1345	13080	0	0	0	0	0	0	0	0	0	0	0	0	0	0	0	0
"BC040875"	1380	47810	0	0	0	0	0	0	0	0	0	0	0	0	0	0	0	0
"BC040886"	681	45636	0	0	0	0	0	0	8	0	0	0	0	0	0	0	0	0
"BC040894"	2348	19053	5	0	0	5	0	0	301	113	0	0	0	0	0	0	0	0
"BC040898"	1106	1793	0	0	0	0	0	0	26	21	0	0	0	0	0	0	0	0
"BC040901"	1453	2269	26	0	14	12	0	0	11	0	0	0	1	0	2	0	0	0
"BC040909"	1579	17764	0	0	0	0	0	0	15	0	0	0	257	303	75	56	44	47
"BC040914"	1512	3821	0	0	0	0	0	0	0	0	0	0	0	0	0	0	0	0
"BC040926"	1720	7433	327	104	151	176	69	35	238	103	192	149	184	257	291	241	526	380
"BC040927"	599	1506	1	0	0	1	0	0	26	0	0	0	1	7	0	3	20	0
"BC040935"	834	834	0	0	0	0	0	0	0	0	0	0	29	79	0	0	0	0
"BC040939"	1280	5454	0	0	0	0	0	0	0	0	0	0	8	0	0	0	0	0
"BC040959"	2109	116229	0	0	0	0	0	0	52	29	0	0	2	27	10	0	4	5
"BC040985"	3223	3223	0	0	0	0	0	0	0	0	0	0	0	0	0	0	0	0
"BC040999"	4630	89134	19191	33004	15616	3575	8944	24060	1493	3102	1933	5508	9909	24404	5883	7623	4240	4187
"BC041003"	1334	15642	0	0	0	0	0	0	16	0	0	0	0	0	0	0	0	0
"BC041007"	1631	10732	642	0	344	298	0	0	552	36	527	37	89	63	99	63	151	63
"BC041025"	848	848	0	0	0	0	0	0	31	25	0	45	19	26	101	102	267	156
"BC041030"	2186	2186	35	0	22	13	0	0	0	0	0	0	0	0	0	0	0	0
"BC041327"	1214	32124	33	0	28	5	0	0	10	0	0	0	211	176	103	54	121	64
"BC041341"	3874	32708	0	0	0	0	0	0	0	0	0	0	0	0	0	0	0	0
"BC041342"	3058	12017	0	0	0	0	0	0	0	0	0	0	0	0	0	0	0	0
"BC041346"	2193	9245	643	167	377	266	81	86	470	192	494	175	0	0	0	0	0	0
"BC041347"	3687	8067	0	0	0	0	0	0	97	31	11	18	1	319	394	269	906	522
"BC041356"	1724	9121	0	0	0	0	0	0	0	0	0	0	0	0	0	0	0	0
"BC041363"	4078	21968	0	552	0	0	324	228	0	79	0	7	2	2	0	4	7	0
"BC041393"	2095	2955	0	0	0	0	0	0	0	0	0	0	0	0	0	0	0	0
"BC041406"	3123	3123	0	0	0	0	0	0	0	0	0	0	0	0	0	0	0	0
"BC041417"	3188	4397	321	90	160	161	50	40	92	50	213	70	862	825	853	153	1165	101
"BC041422"	1402	10055	1859	303	980	879	166	137	650	82	1920	372	1069	735	1591	1019	1848	1176
"BC041426"	2751	23360	0	0	0	0	0	0	0	0	0	0	0	0	0	0	0	0
"BC041434"	1669	76512	216	50	131	85	1	49	542	61	559	62	235	5	6	4	19	4
"BC041439"	516	1276	0	0	0	0	0	0	16	0	0	0	0	0	0	0	0	0
"BC041440"	597	2661	0	0	0	0	0	0	0	0	0	0	0	0	0	0	0	0
"BC041441"	2091	80015	0	0	0	0	0	0	0	0	0	0	0	0	0	0	0	0
"BC041443"	1364	3522	0	0	0	0	0	0	0	11	0	0	0	0	0	0	0	0
"BC041444"	1759	3212	0	0	0	0	0	0	0	0	0	0	0	0	0	0	0	0
"BC041448"	1764	175360	0	0	0	0	0	0	0	0	0	0	0	0	0	0	0	0
"BC041449"	1271	4944	0	0	0	0	0	0	0	0	0	0	0	0	0	0	0	0
"BC041451"	1713	18032	0	0	0	0	0	0	0	0	0	0	0	0	0	0	0	0
"BC041455"	1777	15780	0	0	0	0	0	0	25	14	0	0	0	0	0	0	0	0
"BC041457"	1190	1919	0	0	0	0	0	0	0	0	0	0	0	0	0	0	0	0
"BC041459"	2969	386732	0	0	0	0	0	0	33	0	0	0	0	0	0	0	0	0
"BC041466"	1963	4552	0	0	0	0	0	0	0	0	0	0	0	5	12	2	45	8
"BC041470"	1247	40792	0	0	0	0	0	0	12	0	0	0	10	0	56	31	0	3
"BC041476"	1434	5902	0	0	0	0	0	0	31	0	0	0	0	1	2	0	4	0
"BC041478"	1706	11688	1	0	1	0	0	0	0	0	0	0	0	0	0	0	0	0
"BC041480"	1602	28024	0	0	0	0	0	0	0	0	0	0	0	0	0	0	0	0
"BC041484"	1060	30273	0	0	0	0	0	0	0	0	0	0	0	0	0	0	0	0
"BC041486"	1702	116922	0	0	0	0	0	0	0	0	0	0	0	0	0	0	0	0
"BC041488"	2150	35477	0	0	0	0	0	0	0	0	0	0	0	0	0	0	0	0
"BC041589"	2010	39606	4191	8837	2405	1786	4772	4065	790	976	226	1741	1131	1072	1234	959	1021	857
"BC041634"	1468	9124	0	0	0	0	0	0	0	0	0	0	0	0	0	0	0	0
"BC041636"	1134	45818	6715	2392	3708	3007	1322	1070	6331	1203	4536	1188	474	792	494	238	630	225
"BC041646"	1291	21790	10	0	10	0	0	0	36	0	0	0	28	36	13	6	5	8
"BC041818"	3778	46924	0	0	0	0	0	0	0	0	0	0	0	0	0	0	0	0
"BC041827"	3677	16371	128	90	101	27	68	22	241	78	0	111	99	118	84	114	99	72
"BC041855"	1845	12586	0	0	0	0	0	0	0	10	0	0	0	0	0	0	0	0
"BC041856"	4146	45126	0	0	0	0	0	0	0	0	0	0	0	0	0	0	0	0
"BC041872"	2277	31715	0	0	0	0	0	0	28	0	0	0	2	0	0	0	0	0
"BC041879"	2517	20918	0	0	0	0	0	0	24	0	0	0	0	0	0	0	0	0
"BC041884"	1036	66666	0	0	0	0	0	0	0	0	0	0	9	0	4	5	0	0
"BC041886"	2650	57107	0	0	0	0	0	0	0	0	0	0	0	0	0	0	0	0
"BC041890"	2770	10194	0	0	0	0	0	0	32	8	0	0	0	0	0	0	0	0
"BC041900"	1405	524061	0	0	0	0	0	0	0	0	0	0	0	0	0	0	0	0
"BC041902"	2783	19720	0	0	0	0	0	0	0	0	0	0	0	0	0	0	0	0
"BC041908"	2480	6951	2151	305	1227	924	184	121	980	137	1106	143	0	0	0	0	0	0
"BC041923"	1941	9748	0	0	0	0	0	0	0	0	0	0	0	5	0	0	0	0
"BC041929"	1357	46321	0	0	0	0	0	0	0	0	0	0	0	0	0	0	0	0
"BC041947"	1742	33022	0	0	0	0	0	0	0	0	0	0	0	0	0	0	0	0
"BC041949"	1745	11994	0	0	0	0	0	0	35	0	0	0	17	9	5	0	3	0
"BC041951"	1254	1254	3090	67198	3090	0	36281	30917	53	27931	78	48200	4558	166446	1480	1	1573	25213
"BC041964"	4091	4091	205	91	94	111	38	53	61	13	0	0	850	1250	562	483	862	667
"BC041984"	1210	45326	0	0	0	0	0	0	0	0	0	0	0	0	0	0	0	0
"BC041993"	2108	2765	175	161	97	78	90	71	106	118	0	101	5	0	7	8	12	8
"BC041998"	2595	5156	0	0	0	0	0	0	0	0	0	0	0	0	0	0	0	0
"BC042022"	1835	2728	0	0	0	0	0	0	0	0	0	0	0	0	0	0	0	0
"BC042024"	1489	32983	0	0	0	0	0	0	0	0	0	0	0	0	0	0	0	0
"BC042029"	609	609	0	0	0	0	0	0	0	0	0	0	0	0	0	0	0	0
"BC042032"	1087	13478	0	0	0	0	0	0	0	0	0	0	0	0	0	0	0	0
"BC042033"	633	4083	0	0	0	0	0	0	80	12	0	19	94	110	64	92	124	111
"BC042039"	677	865	0	0	0	0	0	0	0	0	0	0	0	0	0	0	0	0
"BC042046"	1559	7846	0	0	0	0	0	0	0	0	0	0	0	0	0	0	0	0
"BC042048"	529	16034	0	0	0	0	0	0	0	0	0	0	0	0	0	0	0	0
"BC042052"	3299	47622	0	0	0	0	0	0	0	0	0	0	1	3	0	0	0	0
"BC042059"	3452	56054	554	50	331	223	28	22	669	113	0	103	780	877	981	831	1215	761
"BC042073"	1445	167438	43	0	35	8	0	0	80	23	0	0	139	32	102	116	138	82
"BC042079"	1277	1591	0	0	0	0	0	0	0	0	0	0	0	0	0	0	0	0
"BC042085"	2233	8100	669	519	351	318	297	222	351	412	200	475	0	0	0	0	0	0
"BC042086"	1704	27373	163	26	82	81	26	0	183	72	17	34	162	171	475	464	646	417
"BC042091"	2508	5363	0	0	0	0	0	0	37	0	0	0	0	0	0	0	0	0
"BC042092"	1720	7475	0	0	0	0	0	0	79	19	0	0	0	0	0	0	0	0
"BC042096"	2944	3077	129	41	70	59	25	16	50	26	0	0	111	60	205	238	195	157
"BC042098"	2017	371030	6464	24631	3658	2806	13180	11451	2373	10786	562	24950	656	4646	495	1634	629	1773
"BC042121"	2985	3240	0	0	0	0	0	0	0	0	0	0	0	0	0	0	0	0
"BC042140"	709	3941	2	0	0	2	0	0	0	0	0	0	0	0	0	0	0	0
"BC042152"	686	4470	0	0	0	0	0	0	12	32	0	0	0	3	8	5	4	5
"BC042169"	2031	3467	0	0	0	0	0	0	0	0	0	0	0	0	0	0	0	0
"BC042176"	1071	6802	2975	645	1591	1384	366	279	2248	133	1692	587	0	100	59	30	51	24
"BC042366"	1103	1103	0	0	0	0	0	0	0	0	0	0	0	0	0	0	0	0
"BC042372"	695	695	0	0	0	0	0	0	0	0	0	0	32	11	0	0	0	0
"BC042374"	951	2374	4895	1136	2376	2519	819	317	2058	309	676	326	4180	3455	805	687	1091	758
"BC042377"	1086	5894	646	57	347	299	21	36	181	22	47	0	0	0	0	0	0	0
"BC042378"	1237	1237	0	0	0	0	0	0	0	0	0	0	0	0	0	0	0	0
"BC042381"	1035	4263	0	0	0	0	0	0	19	0	0	0	0	0	0	0	0	0
"BC042382"	1037	1037	0	0	0	0	0	0	0	0	0	0	0	0	0	0	0	0
"BC042384"	752	45256	419	0	236	183	0	0	373	23	104	13	93	69	71	3	84	4
"BC042385"	841	841	112	1811	52	60	1019	792	156	775	118	1575	0	0	0	0	0	0
"BC042431"	4631	4631	0	0	0	0	0	0	0	0	0	0	0	0	0	0	0	0
"BC042433"	611	27803	0	0	0	0	0	0	0	0	0	0	0	0	0	0	0	0
"BC042439"	3686	3686	155	36	59	96	14	22	131	0	0	36	148	126	131	40	423	20
"BC042448"	2771	4722	0	0	0	0	0	0	0	0	0	0	4	0	3	0	13	0
"BC042451"	622	1283	0	0	0	0	0	0	0	0	0	0	0	0	0	0	0	0
"BC042457"	2938	12946	0	0	0	0	0	0	0	0	0	0	0	0	0	0	0	0
"BC042465"	2540	24935	0	0	0	0	0	0	0	0	0	0	0	0	0	0	0	0
"BC042469"	1722	2690	0	0	0	0	0	0	0	0	0	0	0	0	0	0	0	0
"BC042472"	702	25372	0	0	0	0	0	0	25	0	0	0	0	0	0	0	0	0
"BC042488"	2777	38397	42	0	25	17	0	0	22	0	0	0	28	0	6	0	6	0
"BC042493"	2406	46970	0	0	0	0	0	0	0	0	0	0	0	0	0	0	0	0
"BC042538"	1523	23659	0	0	0	0	0	0	27	0	0	0	0	0	0	0	0	0
"BC042588"	2237	2440	0	0	0	0	0	0	0	0	0	0	0	0	0	0	0	0
"BC042590"	1762	1762	26	0	10	16	0	0	18	0	0	0	0	0	0	0	0	0
"BC042616"	1345	41428	0	0	0	0	0	0	0	0	0	0	0	0	0	0	0	0
"BC042630"	1718	31472	0	0	0	0	0	0	0	0	0	0	0	0	0	0	0	0
"BC042649"	1312	1859	0	0	0	0	0	0	14	0	0	0	0	0	0	0	0	0
"BC042673"	3434	24040	0	0	0	0	0	0	0	0	0	0	0	0	0	0	0	0
"BC042734"	2790	15673	0	0	0	0	0	0	0	0	0	0	0	0	0	0	0	0
"BC042737"	1486	3374	0	0	0	0	0	0	0	0	0	0	0	0	0	0	0	0
"BC042802"	1010	2032	0	0	0	0	0	0	0	0	0	0	0	0	0	0	0	0
"BC042811"	639	17171	0	0	0	0	0	0	0	0	0	0	260	321	0	0	0	0
"BC042816"	859	995	0	0	0	0	0	0	0	0	0	0	0	0	0	0	0	0
"BC042823"	1224	41887	0	0	0	0	0	0	0	0	0	0	0	0	0	0	0	0
"BC042825"	1101	38103	0	0	0	0	0	0	0	0	0	0	0	0	0	0	0	0
"BC042855"	1365	174724	0	0	0	0	0	0	0	0	0	0	0	216	0	0	0	0
"BC042876"	3001	29035	0	0	0	0	0	0	0	0	0	0	0	0	0	0	0	0
"BC042886"	2025	103262	0	0	0	0	0	0	0	0	0	1	0	0	0	0	0	0
"BC042893"	5395	64260	67	0	39	28	0	0	42	3	12	0	139	156	136	110	106	105
"BC042913"	1167	13060	0	0	0	0	0	0	0	0	0	0	0	0	0	0	0	0
"BC042949"	2015	5977	0	349	0	0	202	147	38	151	0	222	16	76	257	388	403	390
"BC042955"	1960	40807	0	0	0	0	0	0	0	0	0	0	0	0	0	0	0	0
"BC042978"	1746	4807	9	0	9	0	0	0	23	0	0	0	0	0	0	1	0	0
"BC042984"	1551	15450	0	0	0	0	0	0	0	0	0	0	0	0	0	0	0	0
"BC042986"	1990	14765	0	0	0	0	0	0	0	0	0	0	0	0	0	0	4	0
"BC042990"	1730	6554	0	0	0	0	0	0	0	0	0	0	0	0	0	0	0	0
"BC042994"	2079	21197	0	0	0	0	0	0	16	0	0	0	0	0	0	0	0	0
"BC043001"	2050	5331	0	0	0	0	0	0	0	0	0	0	0	0	0	0	0	0
"BC043173"	1475	2799	70	52	40	30	27	25	57	44	0	0	539	674	116	68	181	119
"BC043177"	1968	15500	141	31	89	52	16	15	128	26	0	24	151	19	159	11	193	83
"BC043188"	3371	3371	0	0	0	0	0	0	0	0	0	0	0	0	0	0	0	0
"BC043205"	3680	5110	0	0	0	0	0	0	0	0	0	0	0	0	0	0	0	0
"BC043213"	3015	8864	0	0	0	0	0	0	0	0	0	0	0	0	0	0	0	0
"BC043218"	1963	2647	0	5	0	0	0	5	0	0	0	0	0	0	0	0	0	0
"BC043220"	757	968	0	0	0	0	0	0	0	0	0	0	0	0	0	0	0	0
"BC043223"	1655	47187	48	0	21	27	0	0	0	0	0	0	364	272	498	367	607	310
"BC043225"	2924	9526	0	0	0	0	0	0	52	0	0	0	0	0	0	0	0	0
"BC043227"	2196	4434	0	0	0	0	0	0	0	0	0	0	0	0	0	0	0	0
"BC043229"	2208	29525	0	0	0	0	0	0	0	0	0	0	0	0	0	0	0	0
"BC043243"	2473	13236	863	926	596	267	532	394	418	154	153	464	61	109	68	65	72	38
"BC043245"	2863	3926	0	0	0	0	0	0	0	0	0	0	0	0	0	0	0	0
"BC043252"	5554	12267	2299	1385	1307	992	732	653	10	302	1467	1363	255	204	168	253	218	126
"BC043254"	1398	6533	0	0	0	0	0	0	0	0	0	0	0	0	0	0	0	0
"BC043255"	2726	25803	0	0	0	0	0	0	0	0	0	0	0	0	0	0	0	0
"BC043257"	2571	9099	0	0	0	0	0	0	0	0	0	0	0	0	0	0	0	0
"BC043259"	2079	4250	0	0	0	0	0	0	0	0	0	0	0	0	0	0	0	0
"BC043261"	1675	35275	0	0	0	0	0	0	0	0	0	0	0	0	0	0	0	0
"BC043264"	1723	5333	0	0	0	0	0	0	15	0	0	0	0	0	0	0	0	0
"BC043266"	2494	36749	0	0	0	0	0	0	0	0	0	0	0	0	0	0	0	0
"BC043280"	2195	55354	0	0	0	0	0	0	33	0	0	0	0	0	0	0	0	0
"BC043282"	1591	124077	0	0	0	0	0	0	0	0	0	0	0	0	0	0	0	0
"BC043283"	2406	16366	0	0	0	0	0	0	24	0	0	0	0	0	0	0	0	0
"BC043284"	2689	38397	42	0	25	17	0	0	22	0	0	0	28	0	6	0	6	0
"BC043286"	1430	5297	0	0	0	0	0	0	0	0	0	0	0	0	0	0	0	0
"BC043288"	1616	21032	0	0	0	0	0	0	0	0	0	0	0	0	0	0	0	0
"BC043291"	1927	11262	0	0	0	0	0	0	0	0	0	0	0	0	0	0	0	0
"BC043293"	1828	16783	0	0	0	0	0	0	0	0	0	0	0	0	0	0	0	0
"BC043355"	1282	229496	0	0	0	0	0	0	0	0	0	0	0	0	0	0	0	0
"BC043356"	2917	152083	37890	39375	20881	17009	21539	17836	15292	16529	13821	35203	2784	8140	2117	3782	1573	1579
"BC043359"	2150	13030	358	404	178	180	216	188	211	297	192	281	337	303	111	12	186	104
"BC043365"	2081	9848	898	127	485	413	91	36	390	26	425	33	1557	41	574	461	1010	590
"BC043370"	2272	6722	0	0	0	0	0	0	0	0	0	0	0	0	0	0	0	0
"BC043373"	1662	101608	0	0	0	0	0	0	12	0	0	0	0	0	0	0	0	0
"BC043375"	2031	29908	0	0	0	0	0	0	0	0	0	0	0	1	0	0	0	0
"BC043378"	2537	31550	0	0	0	0	0	0	0	0	0	0	0	0	0	0	0	0
"BC043380"	969	332351	6098	7211	3483	2615	4048	3163	5504	6558	2984	8003	1145	1020	2284	1784	1657	1314
"BC043382"	2082	4483	0	0	0	0	0	0	30	0	0	0	28	30	30	24	27	19
"BC043400"	1943	12952	131	363	55	76	209	154	88	275	0	299	2547	8544	807	919	862	913
"BC043424"	1418	48833	238	0	156	82	0	0	311	26	0	12	96	98	60	42	96	89
"BC043434"	1307	9865	0	0	0	0	0	0	0	0	0	0	0	0	0	0	0	0
"BC043508"	1824	158463	0	0	0	0	0	0	0	0	0	0	0	0	0	0	0	0
"BC043509"	923	28985	0	0	0	0	0	0	0	0	0	0	0	0	0	0	0	0
"BC043510"	1564	22756	0	0	0	0	0	0	0	0	0	0	0	0	0	0	0	0
"BC043511"	806	56836	973	893	522	451	529	364	624	451	51	914	1492	2121	1072	1056	1162	786
"BC043515"	1506	4340	0	0	0	0	0	0	0	0	0	0	0	0	3	10	7	0
"BC043516"	627	24857	0	0	0	0	0	0	0	0	0	0	0	0	0	0	0	0
"BC043519"	1801	48091	0	0	0	0	0	0	0	0	0	0	0	0	0	0	0	0
"BC043527"	970	23131	0	0	0	0	0	0	0	0	0	0	0	0	0	0	0	0
"BC043529"	1676	43821	0	0	0	0	0	0	0	0	0	0	0	0	0	0	0	0
"BC043532"	1318	2285	0	0	0	0	0	0	16	0	0	0	0	0	0	0	0	0
"BC043534"	888	18128	0	0	0	0	0	0	14	0	0	0	0	0	0	0	0	0
"BC043537"	785	5871	0	0	0	0	0	0	0	0	0	0	0	0	0	0	0	0
"BC043538"	2352	28060	0	0	0	0	0	0	0	0	0	0	0	0	0	0	0	0
"BC043540"	1965	11190	2910	1340	1595	1315	688	652	877	911	1353	1837	132	89	102	43	133	1
"BC043541"	2366	31169	0	0	0	0	0	0	0	0	0	0	0	0	0	0	0	0
"BC043544"	736	8718	0	0	0	0	0	0	0	0	0	0	0	0	0	0	0	0
"BC043546"	1240	32911	0	0	0	0	0	0	0	0	0	0	0	0	0	0	0	0
"BC043549"	4771	408739	3703	2339	2204	1499	1387	952	3073	1560	210	1042	0	1	5	0	0	5
"BC043551"	727	13074	0	0	0	0	0	0	0	0	0	0	0	0	0	0	0	0
"BC043553"	780	83532	0	0	0	0	0	0	12	14	0	0	0	0	0	0	0	0
"BC043554"	1272	7200	106	143	3	103	63	80	96	11	69	23	10	39	0	0	4	4
"BC043555"	1896	17972	0	0	0	0	0	0	112	27	0	0	0	0	0	0	0	0
"BC043563"	1821	316914	153	81	90	63	55	26	1107	210	96	240	7	5	0	0	4	0
"BC043570"	2527	4175	0	0	0	0	0	0	0	0	0	0	0	0	0	0	0	0
"BC043572"	1772	56175	6992	3718	4011	2981	2016	1702	3856	1296	3023	2568	1311	1039	841	419	1087	501
"BC043573"	1258	35845	20	12	20	0	12	0	70	0	0	0	0	0	0	0	0	0
"BC043576"	1528	1962	0	0	0	0	0	0	0	0	0	0	0	0	0	0	0	0
"BC043578"	839	4527	0	0	0	0	0	0	0	11	0	0	0	0	0	0	0	0
"BC043579"	1512	4618	0	0	0	0	0	0	0	0	0	0	0	0	9	11	0	0
"BC043580"	2606	89695	0	0	0	0	0	0	0	0	0	0	0	0	0	0	0	0
"BC043582"	1835	55328	0	0	0	0	0	0	0	0	0	0	0	0	0	0	0	0
"BC043587"	2187	3409	0	0	0	0	0	0	0	0	0	0	0	0	0	0	0	0
"BC043592"	4071	71675	511	9	302	209	9	0	616	37	0	0	14	42	131	90	1	11
"BC043601"	2471	43398	1382	975	849	533	535	440	619	281	279	348	122	136	70	26	50	8
"BC043620"	2281	2281	83	0	20	63	0	0	53	26	54	0	347	143	336	76	436	186
"BC043649"	1812	44415	118	0	65	53	0	0	90	0	0	0	408	378	385	246	346	218
"BC044229"	1130	15152	2085	2089	1132	953	1098	991	772	1092	2462	2658	2086	1305	916	1001	1075	845
"BC044253"	2054	7976	0	0	0	0	0	0	74	35	0	0	1	0	0	0	0	0
"BC044305"	1684	1962	0	0	0	0	0	0	0	0	0	0	0	45	26	13	64	7
"BC044307"	2571	362715	146	60	90	56	34	26	130	47	86	50	60	110	95	85	99	75
"BC044310"	1506	1506	20	0	11	9	0	0	13	21	0	0	0	0	0	0	0	0
"BC044583"	1450	20925	0	0	0	0	0	0	0	1	0	0	0	0	0	0	0	0
"BC044596"	1231	1231	234	0	128	106	0	0	68	18	81	39	0	0	0	0	0	0
"BC044599"	1826	34455	0	0	0	0	0	0	0	0	0	0	0	0	0	0	0	0
"BC044606"	1248	11111	14879	14529	8294	6585	7694	6835	3324	8558	1452	22118	3	2	0	0	0	0
"BC044608"	621	2657	1	0	0	1	0	0	17	0	0	0	0	0	2	0	0	0
"BC044609"	1204	2188	0	0	0	0	0	0	0	0	0	0	0	0	0	0	0	0
"BC044611"	2808	23216	0	0	0	0	0	0	0	0	0	0	0	0	0	0	0	0
"BC044614"	1434	1434	0	0	0	0	0	0	0	0	0	0	0	0	0	0	0	0
"BC044653"	1245	18757	482	29	262	220	29	0	335	17	162	0	265	19	23	2	128	77
"BC044655"	2839	10420	0	0	0	0	0	0	0	0	0	0	0	0	0	0	0	0
"BC044741"	971	21476	0	0	0	0	0	0	0	0	0	0	0	0	3	0	0	0
"BC044765"	951	951	0	0	0	0	0	0	0	0	0	0	0	0	0	0	0	0
"BC044845"	604	22263	13	0	1	12	0	0	20	0	7	0	24	46	40	40	69	50
"BC044934"	1263	27740	187	0	139	48	0	0	80	0	0	0	0	0	0	1	0	0
"BC044935"	2012	15024	0	0	0	0	0	0	0	0	0	0	0	0	0	0	0	0
"BC044939"	1526	4639	0	0	0	0	0	0	17	0	0	0	0	0	0	0	0	0
"BC044942"	2471	12699	30	139	19	11	83	56	24	0	0	382	64	63	28	21	22	10
"BC044946"	2216	3920	0	0	0	0	0	0	0	0	0	0	0	0	0	0	0	0
"BC044947"	1972	2321	0	0	0	0	0	0	11	0	0	0	0	0	0	0	0	0
"BC045098"	1775	56540	0	26	0	0	15	11	38	242	0	35	29	229	32	527	29	19
"BC045163"	550	1191	0	0	0	0	0	0	16	0	0	0	0	0	0	0	0	0
"BC045185"	2344	3071	0	0	0	0	0	0	0	0	0	0	0	0	0	0	0	0
"BC045187"	2163	11944	13	0	0	13	0	0	86	10	0	0	0	0	0	0	0	0
"BC045192"	3090	164226	0	0	0	0	0	0	0	7	0	0	0	0	0	0	0	0
"BC045559"	1051	1051	0	0	0	0	0	0	0	0	0	0	0	0	0	0	0	0
"BC045560"	1071	1071	0	0	0	0	0	0	17	0	0	0	0	0	0	0	0	0
"BC045574"	1185	1562	0	0	0	0	0	0	0	0	0	0	0	0	0	0	0	0
"BC045578"	2866	113903	0	0	0	0	0	0	0	0	0	0	0	0	0	0	0	0
"BC045603"	817	10387	907	356	479	428	221	135	447	188	283	400	3059	3363	450	390	471	338
"BC045663"	1831	21686	0	0	0	0	0	0	0	0	0	0	0	0	0	0	0	0
"BC045668"	3759	70175	0	0	0	0	0	0	0	0	0	0	0	0	0	0	0	0
"BC045725"	788	1371	34	9	19	15	9	0	38	9	57	0	29	18	49	24	46	0
"BC045731"	751	7342	521	35	271	250	6	29	89	69	47	85	821	779	311	418	1670	648
"BC045735"	963	3173	1	0	1	0	0	0	0	0	0	0	34	7	0	0	0	0
"BC045738"	1708	33377	0	0	0	0	0	0	0	0	0	0	0	0	0	0	0	0
"BC045767"	2897	174469	0	0	0	0	0	0	0	0	0	0	0	0	0	0	0	0
"BC045769"	1560	3497	1932	2102	1085	847	1215	887	402	1161	1651	4541	1212	2790	1257	2719	2751	2306
"BC045779"	1610	2154	123	0	52	71	0	0	19	120	60	118	0	0	0	0	0	0
"BC045784"	1848	1848	179	122	114	65	96	26	50	15	73	46	0	0	0	0	0	0
"BC045788"	1047	1047	0	0	0	0	0	0	0	0	0	0	0	0	0	0	0	0
"BC045789"	1600	1600	0	0	0	0	0	0	0	0	0	0	0	0	0	0	0	0
"BC045790"	1766	1766	228	80	129	99	45	35	66	100	0	66	697	812	600	0	770	679
"BC045791"	1566	1566	0	0	0	0	0	0	0	0	0	0	0	0	0	0	0	0
"BC045795"	2703	4490	0	0	0	0	0	0	0	0	0	0	0	0	0	0	0	0
"BC045798"	1987	36133	0	0	0	0	0	0	0	0	0	0	0	0	0	0	0	0
"BC045805"	1576	1576	0	0	0	0	0	0	0	0	0	0	0	0	0	0	0	0
"BC045806"	2085	16716	0	0	0	0	0	0	0	0	0	0	0	0	0	0	0	0
"BC045807"	1298	14603	0	0	0	0	0	0	0	7	0	0	18	35	65	39	42	15
"BC045810"	1266	33068	0	0	0	0	0	0	8	0	0	0	0	0	0	0	0	0
"BC045816"	1229	32948	0	0	0	0	0	0	0	0	0	0	0	0	0	0	0	0
"BC046187"	1304	3080	34	33	15	19	0	33	0	10	0	0	205	49	52	36	41	12
"BC046191"	1804	2083	0	0	0	0	0	0	29	9	0	0	0	0	0	0	0	0
"BC046201"	1117	24117	0	0	0	0	0	0	0	0	0	0	0	0	0	0	0	0
"BC046381"	2283	33948	0	0	0	0	0	0	0	0	0	0	0	0	0	0	0	0
"BC046476"	1326	3992	0	0	0	0	0	0	0	10	0	0	0	0	0	0	0	0
"BC046483"	1205	1205	37	0	26	11	0	0	0	0	0	31	0	68	54	0	2	42
"BC046497"	2401	227685	26333	6267	14655	11678	3457	2810	14198	2176	13514	2964	12917	12487	21845	17908	24393	17195
"BC046564"	746	2816	2	0	0	2	0	0	0	15	0	0	92	75	0	0	0	0
"BC046644"	1809	129915	0	0	0	0	0	0	9	0	0	0	0	0	0	0	0	0
"BC047000"	2263	2263	35	28	20	15	17	11	843	1714	2394	1	2421	2170	3219	2759	3970	2634
"BC047014"	1502	24542	83	0	37	46	0	0	209	37	0	0	467	295	746	621	1435	779
"BC047059"	1103	167646	1718	175	996	722	86	89	1214	73	753	142	336	45	67	6	55	13
"BC047065"	2842	2842	0	0	0	0	0	0	0	0	0	0	0	0	0	0	0	0
"BC047072"	690	3888	67	19	39	28	19	0	100	57	0	0	259	203	138	93	198	89
"BC047074"	1236	1236	3	0	0	3	0	0	1	0	0	2	43	52	59	43	33	25
"BC047077"	1784	18554	0	0	0	0	0	0	0	0	0	0	0	0	0	0	0	0
"BC047090"	701	793	0	0	0	0	0	0	0	0	0	0	0	0	0	0	0	0
"BC047127"	1632	92080	0	17	0	0	0	17	1	9	0	0	0	0	0	0	0	0
"BC047230"	501	1300	0	0	0	0	0	0	0	0	0	0	0	0	0	0	0	0
"BC047234"	4392	30155	0	0	0	0	0	0	12	0	0	0	0	0	0	0	0	0
"BC047364"	3478	3478	44	0	31	13	0	0	0	0	0	0	7	0	0	0	0	0
"BC047373"	2712	17306	14	0	0	14	0	0	21	0	0	0	0	0	0	0	0	3
"BC047380"	1506	13592	299	428	175	124	205	223	263	285	128	460	194	181	85	54	82	52
"BC047384"	1269	1550	0	0	0	0	0	0	10	0	0	0	76	40	33	10	49	20
"BC047403"	1620	19425	114	313	50	64	143	170	35	37	0	144	849	1005	916	653	648	599
"BC047410"	2053	22874	0	0	0	0	0	0	0	0	0	0	0	0	0	0	0	0
"BC047417"	1722	1722	103	0	44	59	0	0	70	0	0	25	152	199	138	192	150	86
"BC047427"	2559	2559	0	0	0	0	0	0	0	0	0	0	0	0	0	0	0	0
"BC047459"	3404	52865	0	0	0	0	0	0	0	0	0	0	0	0	0	0	0	0
"BC047481"	4064	4917	0	0	0	0	0	0	0	0	0	0	0	0	0	0	0	0
"BC047484"	1221	1221	0	0	0	0	0	0	0	0	0	0	85	46	68	21	79	21
"BC047487"	1152	2573	0	0	0	0	0	0	0	0	0	0	0	0	0	0	0	0
"BC047513"	2865	2865	218	195	143	75	118	77	70	39	97	443	17	8	1	4	15	11
"BC047537"	3975	116448	37	0	12	25	0	0	20	9	0	0	113	40	77	58	149	50
"BC047540"	2745	6870	0	0	0	0	0	0	0	0	0	0	0	0	0	0	0	0
"BC047542"	1255	8534	0	0	0	0	0	0	0	0	0	0	0	0	0	0	0	0
"BC047546"	2040	62356	22	0	22	0	0	0	54	0	0	0	15	0	11	0	15	0
"BC047594"	2060	5964	0	0	0	0	0	0	0	0	0	0	0	0	421	311	246	98
"BC047598"	1421	29054	0	0	0	0	0	0	0	0	0	0	0	86	20	0	35	0
"BC047599"	1657	1657	0	0	0	0	0	0	0	0	0	0	0	0	0	0	0	0
"BC047600"	4488	112571	0	0	0	0	0	0	0	0	0	0	0	0	0	0	0	0
"BC047605"	1784	3780	0	0	0	0	0	0	0	0	0	0	0	0	0	0	0	0
"BC047609"	1808	2071	239	0	112	127	0	0	243	0	65	0	0	0	0	0	0	0
"BC047615"	1635	1635	0	0	0	0	0	0	0	0	0	0	0	0	0	0	0	0
"BC047625"	2172	2172	230	76	128	102	39	37	94	176	0	139	0	0	0	0	0	0
"BC047626"	2695	2695	0	0	0	0	0	0	0	0	0	0	0	0	0	0	0	0
"BC047638"	2250	60111	0	0	0	0	0	0	0	0	0	0	0	0	0	0	0	0
"BC047644"	1563	1563	0	0	0	0	0	0	14	18	0	0	0	0	0	0	0	0
"BC047651"	1006	1006	0	0	0	0	0	0	12	0	0	0	0	0	0	0	0	0
"BC047694"	1550	1550	0	0	0	0	0	0	0	0	0	0	0	0	0	0	0	0
"BC047723"	1211	43083	377	19	211	166	13	6	323	33	45	17	134	40	50	30	33	13
"BC047942"	674	674	0	0	0	0	0	0	0	0	0	0	0	0	0	0	0	0
"BC047952"	884	59144	1158	439	703	455	246	193	755	288	123	243	1095	1209	862	818	1053	718
"BC048103"	3754	3754	0	0	0	0	0	0	0	0	0	0	0	0	0	0	0	0
"BC048109"	1569	13740	0	0	0	0	0	0	0	0	0	0	0	0	0	0	0	0
"BC048113"	1322	5232	0	0	0	0	0	0	14	0	0	0	0	0	2	0	6	0
"BC048114"	1817	3234	0	0	0	0	0	0	0	0	0	0	0	0	0	0	0	0
"BC048118"	1838	21069	0	0	0	0	0	0	0	0	0	0	0	0	0	0	0	0
"BC048130"	1327	37818	0	0	0	0	0	0	62	0	0	0	0	0	0	0	0	0
"BC048132"	1066	1066	0	0	0	0	0	0	0	0	0	0	0	0	0	0	0	0
"BC048141"	909	909	0	0	0	0	0	0	0	8	0	0	0	0	0	0	0	0
"BC048192"	1456	1456	16	12	14	2	12	0	15	0	0	1	29	21	64	42	87	53
"BC048201"	1074	117036	0	0	0	0	0	0	17	11	0	0	0	0	0	0	0	0
"BC048278"	1820	1820	32	1939	18	14	1890	49	4	5	0	1638	0	72	20	46	16	61
"BC048326"	634	7826	25	0	25	0	0	0	100	76	0	0	0	0	9	3	3	0
"BC048420"	1706	1706	0	0	0	0	0	0	0	0	0	0	0	0	0	0	0	0
"BC048424"	1515	11978	4876	9854	2897	1979	5284	4570	1676	4840	1710	7929	3035	5457	409	570	318	301
"BC048427"	2163	13344	0	0	0	0	0	0	0	0	0	0	0	0	0	0	0	0
"BC048428"	3010	4024	0	0	0	0	0	0	211	89	0	0	0	0	0	0	0	0
"BC048981"	3147	26429	0	0	0	0	0	0	0	0	0	0	11	10	0	0	0	0
"BC048982"	1799	144217	0	0	0	0	0	0	0	0	0	0	0	0	0	0	0	0
"BC048997"	691	691	0	0	0	0	0	0	0	0	0	0	0	0	0	0	0	0
"BC048998"	976	1255	226	64	119	107	32	32	146	44	141	83	896	1	259	128	323	139
"BC049386"	1051	5252	0	0	0	0	0	0	0	0	0	0	0	0	0	0	0	0
"BC049825"	595	3655	0	0	0	0	0	0	12	0	0	0	0	0	0	0	0	0
"BC050034"	2258	17281	0	0	0	0	0	0	0	0	0	0	0	0	0	0	0	0
"BC050301"	4491	19789	26	26	22	4	23	3	0	9	0	0	9	17	1	0	18	0
"BC050332"	4009	6959	929	441	560	369	187	254	162	373	137	301	940	949	939	1043	831	663
"BC050343"	2026	2310	0	0	0	0	0	0	33	0	0	0	0	0	0	0	0	0
"BC050344"	4301	9423	0	0	0	0	0	0	0	0	0	0	0	0	0	0	0	0
"BC050357"	2847	2847	34	0	0	34	0	0	50	0	51	0	565	44	150	0	170	0
"BC050403"	1834	15980	1889	1875	1075	814	1030	845	657	844	374	1619	1765	2294	2299	1987	2631	1752
"BC050580"	3686	55882	0	0	0	0	0	0	0	0	0	0	0	0	0	0	0	0
"BC051441"	664	198547	0	0	0	0	0	0	0	0	0	0	0	0	0	0	0	0
"BC051708"	3193	3193	0	0	0	0	0	0	0	8	0	0	2	0	0	0	0	0
"BC051721"	2341	5802	0	0	0	0	0	0	10	0	0	0	0	0	0	0	0	30
"BC051727"	2074	208264	0	0	0	0	0	0	0	0	0	0	0	0	0	0	0	0
"BC051736"	854	854	0	0	0	0	0	0	0	0	0	0	0	0	0	0	0	0
"BC051759"	2314	220252	4737	3122	2579	2158	1717	1405	1587	671	560	1319	2073	3103	535	449	1113	422
"BC051760"	1857	4848	0	0	0	0	0	0	2	0	0	0	0	0	0	0	0	0
"BC051808"	2574	12586	0	0	0	0	0	0	0	0	0	0	0	0	0	0	0	0
"BC052241"	1396	1396	3463	76	1944	1519	30	46	728	10320	3241	49124	0	40	839	4205	0	3694
"BC052578"	825	172578	0	0	0	0	0	0	9	0	0	0	0	0	0	0	0	0
"BC052596"	639	4992	0	0	0	0	0	0	44	18	0	0	0	0	3	0	0	0
"BC052603"	3483	25095	50	0	35	15	0	0	54	0	37	0	8	0	0	0	4	0
"BC052612"	1447	3261	153	264	94	59	165	99	69	210	0	191	0	20	347	303	264	328
"BC052775"	2044	2044	13	0	0	13	0	0	38	0	0	0	0	0	0	0	0	0
"BC052811"	968	1057	0	0	0	0	0	0	0	0	0	0	0	0	0	0	0	0
"BC052942"	2311	8402	0	0	0	0	0	0	0	0	0	0	0	0	0	0	0	0
"BC052945"	3841	42258	0	0	0	0	0	0	0	12	0	0	0	0	0	0	0	0
"BC052952"	4602	13472	0	0	0	0	0	0	0	0	0	0	0	0	0	0	0	0
"BC052961"	2608	4955	871	1171	467	404	773	398	341	499	251	1194	360	858	97	130	127	28
"BC053344"	2611	52794	0	0	0	0	0	0	55	8	0	0	24	29	0	0	0	0
"BC053352"	2071	2071	0	0	0	0	0	0	0	0	0	0	17	4	0	0	0	0
"BC053580"	1123	3688	1	0	1	0	0	0	0	1	0	0	0	0	0	0	0	0
"BC053597"	1699	1699	0	0	0	0	0	0	10	0	0	0	0	0	0	0	0	0
"BC053669"	2763	5754	168	19	116	52	4	15	179	45	119	114	48	96	0	0	1	0
"BC053679"	1804	85574	0	0	0	0	0	0	95	15	0	14	0	0	4	5	5	0
"BC053951"	1827	1827	0	0	0	0	0	0	0	0	0	0	0	0	0	0	0	0
"BC054098"	2124	46608	0	0	0	0	0	0	0	0	0	0	0	0	0	0	0	0
"BC054514"	2505	2505	0	0	0	0	0	0	55	37	0	0	483	0	0	0	0	0
"BC054859"	645	38335	0	0	0	0	0	0	0	0	0	0	0	1	0	0	0	0
"BC054862"	948	10247	2457	2540	1384	1073	1292	1248	541	1333	508	1953	0	0	0	0	0	0
"BC054887"	744	156358	0	0	0	0	0	0	0	0	0	0	0	0	0	0	0	0
"BC055085"	918	918	0	0	0	0	0	0	0	9	0	0	0	4	4	25	3	3
"BC057241"	1281	1281	107	33	71	36	33	0	88	38	0	0	0	0	0	0	0	0
"BC057846"	2082	24686	0	0	0	0	0	0	0	0	0	0	0	0	0	0	0	0
"BC058012"	774	3386	2	1	0	2	1	0	0	0	0	0	0	0	0	0	0	0
"BC058547"	866	53204	0	0	0	0	0	0	336	158	0	0	0	0	0	0	0	0
"BC058818"	1995	1995	56	0	27	29	0	0	34	0	0	0	1011	1172	1057	985	1120	795
"BC059370"	2929	2929	0	0	0	0	0	0	18	0	0	0	0	0	0	0	0	0
"BC060326"	444	3602	0	0	0	0	0	0	0	0	0	0	0	0	0	0	0	0
"BC061632"	633	1190	0	0	0	0	0	0	17	0	0	0	22	0	0	23	37	1
"BC061638"	743	159455	0	0	0	0	0	0	7	0	0	0	0	0	0	0	0	0
"BC061642"	414	2981	0	0	0	0	0	0	0	0	0	0	0	0	0	0	0	0
"BC061893"	928	928	0	0	0	0	0	0	0	0	0	0	0	0	0	0	0	0
"BC061904"	934	1639	364	323	221	143	167	156	58	435	174	0	159	74	28	29	226	27
"BC061905"	915	1229	0	0	0	0	0	0	0	0	0	0	0	0	0	0	0	0
"BC061919"	891	21128	286	1083	132	154	564	519	378	1230	253	1510	147	410	103	222	164	154
"BC061923"	633	2306	0	0	0	0	0	0	0	0	0	0	0	0	0	0	0	0
"BC062328"	1646	14034	0	0	0	0	0	0	0	0	0	0	0	0	0	0	0	0
"BC062337"	1006	1006	0	0	0	0	0	0	57	0	0	0	7	5	0	0	25	0
"BC062349"	1454	1454	69	0	42	27	0	0	14	25	33	0	21	2	42	13	15	11
"BC062350"	814	814	0	0	0	0	0	0	0	0	0	0	0	0	0	0	0	0
"BC062469"	965	965	0	0	0	0	0	0	0	0	0	0	0	0	0	0	0	0
"BC062482"	1355	14105	0	0	0	0	0	0	24	0	0	0	0	0	0	0	0	0
"BC062737"	1324	13982	0	0	0	0	0	0	0	0	0	0	0	0	0	0	0	0
"BC062745"	1074	1839	0	0	0	0	0	0	0	0	0	0	0	0	0	0	0	0
"BC062753"	869	869	33	21	17	16	0	21	29	0	0	0	1104	906	101	51	143	55
"BC062758"	1145	55037	0	0	0	0	0	0	0	0	0	0	0	0	0	0	0	0
"BC062763"	1291	1291	75	7	75	0	0	7	55	0	0	0	25	52	0	0	0	0
"BC062769"	1409	4086	0	0	0	0	0	0	0	0	0	0	32	50	72	80	35	22
"BC062774"	1035	5982	0	0	0	0	0	0	0	0	0	0	0	0	0	0	0	0
"BC062794"	1083	14258	0	0	0	0	0	0	0	0	0	0	0	0	0	0	0	0
"BC063132"	694	14145	0	0	0	0	0	0	0	0	0	0	0	0	0	0	0	0
"BC063441"	1805	2759	622	256	332	290	173	83	333	119	313	121	0	29	32	33	138	14
"BC063548"	1631	9319	427	153	325	102	82	71	196	72	18	110	128	43	130	79	161	96
"BC063600"	1194	10985	187	234	96	91	114	120	160	70	41	30	36	79	16	26	16	8
"BC063675"	1564	20394	447	30	235	212	30	0	337	28	217	18	374	364	272	166	306	172
"BC063714"	973	12548	2299	1967	1307	992	1024	943	10	693	1467	1363	477	204	168	253	218	126
"BC064148"	1546	5660	0	0	0	0	0	0	82	30	0	43	11	34	12	0	0	0
"BC064339"	892	925	313	141	261	52	67	74	132	120	135	334	409	197	0	54	86	77
"BC064489"	1527	1527	0	0	0	0	0	0	0	0	0	0	0	0	0	0	0	0
"BC064972"	2430	36074	0	6	0	0	3	3	16	8	0	0	0	0	0	0	0	0
"BC064974"	1829	1829	86	80	83	3	50	30	45	43	137	103	163	3068	198	84	135	109
"BC065231"	507	507	0	2415	0	0	1071	1344	79	1372	0	450	0	17	0	0	0	0
"BC065373"	1737	1737	0	0	0	0	0	0	0	0	0	0	0	0	0	0	0	0
"BC065754"	913	22424	0	0	0	0	0	0	0	0	0	0	0	0	0	0	0	0
"BC065757"	1198	11128	0	0	0	0	0	0	0	0	0	0	0	0	0	0	0	0
"BC065763"	1242	11865	0	0	0	0	0	0	0	0	0	0	0	0	0	0	0	0
"BC065766"	1598	1598	0	0	0	0	0	0	10	20	0	0	91	58	54	52	58	25
"BC066355"	939	939	0	0	0	0	0	0	0	0	0	0	0	0	0	0	0	0
"BC066991"	1946	14757	98	172	82	16	147	25	125	109	0	131	451	638	54	88	72	52
"BC067112"	1870	8000	572	110	321	251	65	45	223	143	82	132	1597	1911	1020	764	1023	531
"BC067230"	4158	4158	835	153	425	410	98	55	399	133	288	79	7312	7698	3615	2336	3714	2129
"BC067243"	1743	9275	0	0	0	0	0	0	0	0	0	0	0	0	0	0	0	0
"BC067244"	2080	2187	113	144	57	56	78	66	17	67	0	51	804	1725	267	360	294	291
"BC067269"	1820	1820	460	238	246	214	134	104	261	121	241	216	479	510	501	362	481	276
"BC067347"	1083	3452	0	0	0	0	0	0	0	0	0	0	0	0	35	35	371	39
"BC067356"	1261	1549	402	8	216	186	0	8	240	52	0	0	272	222	309	56	407	324
"BC067758"	1263	42256	162	0	73	89	0	0	69	10	44	33	26	37	96	66	140	101
"BC067868"	1717	2073	199	1460	121	78	856	604	3	1942	0	22691	0	50	73	71	80	56
"BC067883"	1442	5125	0	0	0	0	0	0	0	0	0	0	0	0	0	0	0	0
"BC067907"	1778	37498	0	0	0	0	0	0	0	0	0	0	0	0	0	0	0	0
"BC068029"	1672	1672	0	0	0	0	0	0	0	0	0	0	0	0	0	0	0	0
"BC068088"	769	8138	290	22	198	92	22	0	148	38	31	17	4	14	15	15	20	3
"BC068095"	1209	1209	0	0	0	0	0	0	0	0	0	0	127	55	40	0	25	0
"BC068238"	3372	6222	0	0	0	0	0	0	21	20	0	0	1	1	0	0	4	11
"BC068246"	7329	231171	0	0	0	0	0	0	0	0	0	0	0	0	0	0	0	0
"BC068290"	776	2017	0	0	0	0	0	0	0	0	0	0	0	0	0	0	0	0
"BC068543"	2534	2534	54	64	36	18	49	15	59	64	10	64	28	23	12	11	37	17
"BC068572"	3018	16188	18	0	9	9	0	0	51	0	0	0	0	0	0	0	0	0
"BC068605"	3123	6559	0	0	0	0	0	0	0	0	0	0	0	0	0	0	0	0
"BC068609"	3123	292294	0	0	0	0	0	0	8	0	0	0	0	0	0	0	0	0
"BC069004"	1311	1311	0	0	0	0	0	0	29	25	0	0	12	0	12	24	0	0
"BC069037"	684	2864	0	0	0	0	0	0	15	0	0	0	0	0	0	0	5	1
"BC069047"	1166	1166	0	0	0	0	0	0	32	23	0	0	0	36	35	25	30	34
"BC069212"	1475	2823	0	0	0	0	0	0	16	13	0	0	0	0	0	0	0	0
"BC069252"	2102	2102	0	0	0	0	0	0	0	10	0	5	0	1	0	0	0	0
"BC069257"	2401	2401	6	0	6	0	0	0	40	47	0	0	155	96	623	580	440	31
"BC069694"	1769	1769	17	832	17	0	440	392	34	321	0	875	5	123	23	184	18	25
"BC069739"	1636	1636	1517	191	666	851	103	88	770	140	0	127	1049	1027	1026	386	1076	198
"BC069756"	1365	1365	191	36	102	89	36	0	265	37	82	21	0	0	0	0	0	0
"BC069776"	1493	1493	39	0	39	0	0	0	14	0	0	0	0	0	0	202	0	240
"BC069782"	1227	1227	23	0	23	0	0	0	0	0	0	0	22	25	21	19	21	20
"BC069792"	632	632	244	366	193	51	167	199	20	128	0	123	28	24	39	51	58	21
"BC069804"	1873	1873	156	0	99	57	0	0	48	1	0	0	146	106	183	89	198	93
"BC069809"	2214	5754	0	0	0	0	0	0	0	0	0	0	0	0	0	0	0	0
"BC069815"	355	355	0	20	0	0	0	20	34	15	0	0	919	854	1314	1042	1581	996
"BC070039"	3730	4499	0	0	0	0	0	0	0	13	0	0	70	192	148	354	128	148
"BC070061"	3888	5717	0	0	0	0	0	0	0	0	0	0	0	0	0	0	0	0
"BC070093"	2647	137389	0	0	0	0	0	0	50	0	0	0	0	0	0	0	136	0
"BC070102"	2328	45334	0	0	0	0	0	0	0	29	0	0	0	0	0	0	0	0
"BC070106"	1891	43320	366	90	188	178	53	37	853	482	188	312	0	0	0	0	0	0
"BC070113"	4608	82579	5196	18131	2986	2210	9724	8407	4095	19858	1626	23083	650	4959	1144	5541	1331	1771
"BC070115"	1675	20674	725	986	152	573	546	440	972	161	264	431	1759	2015	88	1310	1955	1110
"BC070118"	3874	4681	0	0	0	0	0	0	0	0	0	0	26	37	28	27	59	16
"BC070228"	550	1136	0	0	0	0	0	0	20	10	0	0	114	62	79	26	128	33
"BC070322"	1309	17967	0	0	0	0	0	0	0	0	0	0	0	0	0	0	0	0
"BC070350"	2695	2695	218	588	148	70	0	588	114	695	0	181	0	0	0	832	478	551
"BC070363"	361	1122	0	0	0	0	0	0	0	0	0	0	82	74	114	82	221	118
"BC070367"	1189	1889	0	0	0	0	0	0	0	0	0	0	0	0	0	17	0	0
"BC070371"	1371	1371	0	0	0	0	0	0	0	0	0	0	0	0	211	0	209	83
"BC070376"	1185	29394	1406	234	839	567	151	83	843	145	549	245	426	676	559	400	581	312
"BC070385"	1032	3396	0	0	0	0	0	0	0	0	0	0	0	0	0	0	0	0
"BC070391"	940	5059	18	0	8	10	0	0	35	9	0	0	0	0	14	5	6	5
"BC070396"	296	84531	0	0	0	0	0	0	0	0	0	0	0	0	0	0	0	0
"BC070495"	1274	1274	0	0	0	0	0	0	0	0	0	0	0	0	0	0	0	0
"BC071555"	2842	2842	1428	2173	771	657	1196	977	782	1225	681	1347	4709	8419	0	0	0	0
"BC071617"	2255	36361	498	74	298	200	51	23	317	14	201	76	26	0	195	104	274	39
"BC071631"	2482	2482	0	0	0	0	0	0	0	0	0	0	0	0	0	0	0	0
"BC071633"	911	911	57	0	35	22	0	0	13	25	0	59	505	0	101	80	128	71
"BC071667"	1622	44957	0	0	0	0	0	0	0	0	0	0	0	0	99	25	157	27
"BC071770"	2148	6519	0	0	0	0	0	0	8	7	0	0	0	191	0	0	0	0
"BC071794"	856	30004	0	0	0	0	0	0	69	0	0	0	0	0	0	0	0	0
"BC071797"	1208	57290	268	0	131	137	0	0	148	73	43	40	0	0	0	0	2	0
"BC071801"	1168	24939	0	0	0	0	0	0	0	0	0	0	0	0	0	0	0	0
"BC071802"	1682	77426	417	369	248	169	186	183	391	371	0	411	173	207	1	1	404	0
"BC071803"	617	27639	0	0	0	0	0	0	0	0	0	0	0	0	0	0	0	0
"BC071807"	199	8533	0	0	0	0	0	0	9	0	0	0	4	2	0	1	7	4
"BC071809"	647	31466	38	0	23	15	0	0	211	83	0	0	130	67	135	56	174	80
"BC071811"	568	1551	0	0	0	0	0	0	25	18	0	0	0	14	4	16	0	9
"BC071813"	1005	5622	264	17	142	122	17	0	200	29	117	51	185	78	350	139	276	132
"BC072410"	1407	1407	0	0	0	0	0	0	0	0	0	0	0	0	0	0	0	0
"BC072675"	1212	1212	19	401	19	0	217	184	43	105	0	58	743	969	446	669	494	419
"BC072678"	1650	6782	0	0	0	0	0	0	0	0	0	0	26	20	0	0	0	0
"BC073144"	1222	26820	8955	9165	4972	3983	4904	4261	2695	3500	5519	7622	17328	4196	5278	7281	7782	6117
"BC073780"	2258	4987	0	0	0	0	0	0	9	0	0	0	0	0	63	53	102	59
"BC073801"	1601	7987	31	4	22	9	0	4	25	17	38	0	40	41	51	56	12	40
"BC073807"	2280	507409	0	0	0	0	0	0	0	0	0	0	0	0	0	0	0	0
"BC073810"	1296	4678	265	134	131	134	65	69	138	65	82	57	259	302	302	272	457	304
"BC073817"	3257	6079	186	10	102	84	0	10	116	43	0	0	35	16	33	0	119	4
"BC073897"	619	619	25	51	0	25	25	26	67	26	0	0	0	0	0	1	0	1
"BC073899"	575	10867	694	76	339	355	59	17	400	189	72	4	521	740	616	215	841	560
"BC073918"	984	9901	18069	23351	10171	7898	12316	11035	5974	13485	15995	28525	4232	9953	1247	2258	1739	1493
"BC073927"	1592	19498	10	0	10	0	0	0	47	33	0	0	8	4	64	3	85	46
"BC073928"	1124	19306	175	0	117	58	0	0	219	35	66	0	487	343	596	368	737	456
"BC073932"	2085	5707	0	0	0	0	0	0	14	0	0	0	0	0	0	0	0	0
"BC073948"	541	3602	0	0	0	0	0	0	0	0	0	0	0	0	0	0	0	0
"BC075797"	6893	20626	0	0	0	0	0	0	0	0	0	0	0	1	4	0	0	0
"BC075841"	3755	51695	0	0	0	0	0	0	0	0	0	0	0	0	1184	626	2131	659
"BC077729"	2478	3752	0	0	0	0	0	0	0	0	0	0	0	0	0	0	0	0
"BC078172"	920	14790	8857	14312	5030	3827	7634	6678	1532	8334	1634	10718	48788	7118	49627	77691	76639	73353
"BC079832"	556	556	0	0	0	0	0	0	0	0	0	0	0	0	0	0	0	0
"BC080517"	905	905	0	0	0	0	0	0	0	0	0	0	0	0	0	0	0	0
"BC080555"	425	748	345	28	201	144	16	12	109	60	0	71	82	3	148	83	193	48
"BC080587"	830	1426	0	0	0	0	0	0	0	0	0	0	11	14	0	0	0	0
"BC080605"	1483	1483	262	22	145	117	12	10	233	144	41	0	167	121	54	29	78	24
"BC080653"	1215	12988	0	0	0	0	0	0	0	0	0	0	0	0	0	0	0	0
"BC082233"	940	8680	0	0	0	0	0	0	0	0	0	0	0	0	0	0	0	0
"BC082237"	2320	50168	0	0	0	0	0	0	0	0	0	0	0	0	0	0	0	0
"BC082979"	892	12505	8	0	0	8	0	0	35	0	0	0	45	25	102	92	112	47
"BC084558"	1011	1011	0	0	0	0	0	0	0	0	0	0	0	0	0	0	0	0
"BC084560"	1443	1443	0	0	0	0	0	0	0	0	0	0	0	0	0	0	0	0
"BC084561"	2304	3636	85	2679	55	30	1477	1202	16	629	0	528	1	43	0	55	68	55
"BC084573"	1464	4514	0	0	0	0	0	0	0	0	0	0	0	0	0	0	0	0
"BC085014"	822	11429	0	0	0	0	0	0	12	0	0	0	0	0	849	538	1220	671
"BC086863"	1593	92776	0	0	0	0	0	0	0	11	0	0	0	1	0	0	0	0
"BC087855"	1860	6145	0	0	0	0	0	0	0	0	0	0	0	0	0	0	0	0
"BC087857"	1647	76380	0	0	0	0	0	0	71	0	0	0	0	0	0	0	0	0
"BC087858"	1327	23206	0	0	0	0	0	0	16	0	0	0	0	0	0	0	0	0
"BC087859"	1145	1378	0	526	0	0	267	259	0	146	0	95	19	349	0	156	3	54
"BC089413"	361	488	0	0	0	0	0	0	0	0	0	0	0	0	0	0	0	0
"BC089416"	1577	6458	9	0	0	9	0	0	68	0	0	0	142	130	16	11	72	14
"BC089451"	1140	72124	0	0	0	0	0	0	0	0	0	0	0	0	0	0	0	0
"BC089453"	591	32757	0	0	0	0	0	0	0	0	0	0	0	0	0	0	0	0
"BC090058"	1978	3784	374	117	210	164	66	51	766	84	84	129	1	0	1	15	1	0
"BC090059"	1296	10721	0	0	0	0	0	0	149	42	0	0	0	8	16	8	13	13
"BC090855"	1779	37373	136	0	73	63	0	0	27	0	0	0	26	37	96	66	140	101
"BC090895"	394	868	0	0	0	0	0	0	0	0	0	0	0	0	0	0	0	0
"BC092420"	2478	20654	0	0	0	0	0	0	0	0	0	0	0	0	0	0	0	0
"BC092452"	1843	2774	622	256	332	290	173	83	333	119	313	121	0	29	32	33	138	14
"BC093087"	1696	45624	0	0	0	0	0	0	0	0	0	0	0	0	0	0	0	0
"BC093719"	800	800	0	0	0	0	0	0	0	32	0	0	1	0	0	0	0	0
"BC094703"	2248	4585	0	0	0	0	0	0	0	12	0	0	0	49	3	0	8	0
"BC094782"	1112	208973	49674	64514	27756	21918	35113	29401	16386	25117	19078	50042	1649	8965	907	518	1042	5076
"BC094791"	3092	38343	0	0	0	0	0	0	0	0	0	0	0	0	0	0	0	0
"BC094793"	3846	3846	0	0	0	0	0	0	0	0	0	0	0	0	0	0	0	0
"BC094833"	978	93060	0	0	0	0	0	0	7	0	0	0	0	0	0	0	0	0
"BC094867"	927	7656	220	15	134	86	15	0	92	27	115	0	445	403	546	291	692	394
"BC094873"	1214	1214	0	0	0	0	0	0	33	27	0	0	0	0	0	0	0	0
"BC094874"	2286	2286	40	0	10	30	0	0	0	0	0	0	0	0	0	0	0	0
"BC095475"	4715	4715	360	26	201	159	0	26	322	61	67	55	777	741	613	318	1184	807
"BC096759"	2415	30403	0	0	0	0	0	0	0	0	0	0	0	0	0	3	0	0
"BC098409"	3224	5154	66	12	27	39	12	0	193	103	0	0	54	63	81	0	308	189
"BC100293"	932	5980	0	349	0	0	202	147	38	151	0	222	16	76	257	388	403	390
"BC101234"	2284	2284	0	0	0	0	0	0	0	0	0	0	0	0	0	0	0	0
"BC101441"	501	22053	0	0	0	0	0	0	0	0	0	0	0	0	0	0	0	0
"BC101937"	109	109	0	0	0	0	0	0	0	0	0	0	0	0	0	0	0	0
"BC101982"	975	22036	0	0	0	0	0	0	0	0	0	0	0	0	0	0	0	0
"BC104003"	1297	1297	17	0	0	17	0	0	80	32	0	0	121	26	127	25	177	28
"BC104151"	652	12543	3153	2373	2028	1125	1072	1301	1446	1184	1128	1210	127	259	51	52	118	45
"BC104435"	1104	102422	0	0	0	0	0	0	27	23	0	0	0	0	0	0	0	0
"BC104454"	422	1310	0	0	0	0	0	0	0	0	0	0	0	0	0	0	0	0
"BC104455"	1193	2352	0	0	0	0	0	0	0	0	0	0	0	0	0	0	0	0
"BC104460"	984	5469	264	17	142	122	17	0	200	29	117	51	185	78	350	139	276	132
"BC104461"	892	5231	264	17	142	122	17	0	200	29	117	51	185	78	350	139	276	132
"BC105019"	3118	43232	0	0	0	0	0	0	0	0	0	0	0	0	0	0	0	0
"BC105706"	2306	2306	0	0	0	0	0	0	0	0	0	0	0	0	0	0	0	0
"BC106081"	567	567	0	0	0	0	0	0	7	0	0	0	0	0	0	0	0	0
"BC107081"	626	626	0	0	0	0	0	0	20	0	0	0	0	0	0	0	0	0
"BC107094"	483	483	35	0	22	13	0	0	36	0	0	0	0	0	0	0	0	0
"BC107108"	379	1734	0	0	0	0	0	0	0	0	0	0	0	0	23	32	26	43
"BC107568"	935	3395	0	0	0	0	0	0	0	0	0	0	0	0	0	0	0	0
"BC107595"	2020	157580	993	4405	586	407	2338	2067	323	1558	124	2363	0	0	0	0	0	0
"BC108260"	1695	1964	0	0	0	0	0	0	0	0	0	0	0	0	208	178	217	159
"BC108660"	571	359326	0	0	0	0	0	0	130	37	0	0	0	0	0	0	0	0
"BC108718"	1738	36844	3	0	0	3	0	0	40	12	0	0	5	0	31	10	24	15
"BC109387"	1856	14488	0	0	0	0	0	0	0	9	0	0	0	0	0	0	0	0
"BC110060"	168	5496	0	0	0	0	0	0	0	0	0	0	3	0	65	0	5	1
"BC110411"	1525	17305	0	0	0	0	0	0	13	0	0	0	45	22	21	0	26	0
"BC110641"	1943	2967	0	0	0	0	0	0	24	13	0	0	0	0	0	0	0	0
"BC110795"	1973	5964	0	0	0	0	0	0	0	0	0	0	0	0	421	311	246	98
"BC110832"	541	541	36	64	24	12	64	0	255	359	17	301	321	480	1126	1731	1613	1075
"BC111371"	1294	7031	0	0	0	0	0	0	43	22	0	0	0	41	0	0	0	0
"BC111382"	2095	2288	133	281	0	133	146	135	304	108	274	236	11	1485	144	0	31	127
"BC112056"	610	610	0	0	0	0	0	0	0	0	0	0	0	0	0	0	0	0
"BC112270"	438	7425	0	0	0	0	0	0	10	0	0	0	0	0	0	0	0	0
"BC112298"	1515	11289	762	316	467	295	138	178	188	254	323	1583	1475	1357	744	715	994	712
"BC112312"	579	1405	0	0	0	0	0	0	0	0	0	0	0	0	0	0	0	0
"BC112333"	1952	68390	0	0	0	0	0	0	184	41	0	0	0	0	0	0	0	0
"BC112340"	1689	4996	0	0	0	0	0	0	0	0	0	0	0	0	0	0	0	0
"BC112347"	1944	1944	0	0	0	0	0	0	0	18	0	0	0	0	0	0	0	0
"BC112974"	591	12543	3153	2373	2028	1125	1072	1301	1446	1184	1128	1210	127	259	51	52	118	45
"BC112987"	841	841	0	0	0	0	0	0	0	0	0	0	0	0	0	0	0	0
"BC113052"	1414	7011	0	0	0	0	0	0	0	0	0	0	0	0	0	0	0	0
"BC113076"	406	406	0	0	0	0	0	0	0	0	0	0	0	0	0	0	0	0
"BC113726"	689	689	0	0	0	0	0	0	0	32	0	0	0	0	0	0	0	0
"BC113958"	585	585	394	157	278	116	51	106	1	140	624	112	0	0	0	0	0	0
"BC114339"	920	920	819	150	542	277	73	77	446	184	378	65	0	0	0	0	0	0
"BC114455"	477	477	0	0	0	0	0	0	31	0	0	0	0	0	0	1	0	0
"BC117556"	1679	11050	0	0	0	0	0	0	10	0	0	0	110	15	250	125	192	76
"BC118602"	1024	6278	0	0	0	0	0	0	0	0	0	0	0	0	0	0	0	0
"BC118662"	735	4097	0	0	0	0	0	0	0	0	0	0	0	0	0	0	0	0
"BC118985"	2096	157580	993	4405	586	407	2338	2067	323	1558	124	2363	0	0	0	0	0	0
"BC121143"	1215	27497	0	0	0	0	0	0	10	0	0	0	0	0	0	0	0	0
"BC121813"	1109	6278	0	0	0	0	0	0	0	0	0	0	0	0	0	0	0	0
"BC121815"	741	741	0	0	0	0	0	0	0	0	0	22	0	17	44	0	0	0
"BC121819"	1323	19663	90	0	50	40	0	0	95	0	0	0	46	42	37	32	52	24
"BC122523"	712	22053	0	0	0	0	0	0	0	0	0	0	0	0	0	0	0	0
"BC122534"	2043	157580	993	4405	586	407	2338	2067	323	1558	124	2363	0	0	0	0	0	0
"BC122562"	2607	87220	0	0	0	0	0	0	0	0	0	0	0	0	0	0	0	0
"BC122864"	532	532	22	0	22	0	0	0	53	26	0	0	16	0	0	0	23	0
"BC125159"	1579	1579	118	40	57	61	40	0	144	43	0	0	136	110	116	104	132	78
"BC126324"	803	13876	0	0	0	0	0	0	0	0	0	0	0	0	0	0	0	0
"BC126393"	1255	5235	0	0	0	0	0	0	34	24	0	0	0	0	0	0	0	0
"BC126901"	1018	1018	0	0	0	0	0	0	0	0	0	0	0	0	0	0	0	0
"BC127192"	489	188950	0	0	0	0	0	0	779	149	0	0	0	0	0	0	0	0
"BC127664"	1261	11259	0	0	0	0	0	0	0	0	0	0	0	0	0	7	13	10
"BC127665"	1133	11259	0	0	0	0	0	0	0	0	0	0	0	0	0	7	13	10
"BC127738"	567	18080	0	0	0	0	0	0	0	0	0	0	0	0	0	0	0	0
"BC127786"	271	510	0	0	0	0	0	0	0	0	0	0	0	0	0	0	0	0
"BC127823"	575	575	33	97	15	18	61	36	0	70	0	102	448	520	713	0	962	0
"BC127854"	533	533	214	63	152	62	41	22	102	54	176	106	1527	1392	1022	701	1169	823
"BC127858"	285	7188	44	17	24	20	9	8	41	0	24	0	25	0	101	76	93	51
"BC127868"	107	778	0	0	0	0	0	0	0	0	0	0	0	0	0	0	0	0
"BC127870"	707	707	0	0	0	0	0	0	0	0	0	0	0	0	0	0	0	0
"BC127913"	537	12575	169	4	138	31	3	1	202	26	159	0	27	0	0	0	23	0
"BC127952"	557	557	0	0	0	0	0	0	0	22	0	0	0	79	0	30	0	0
"BC128043"	854	854	957	76	413	544	36	40	455	37	353	83	99	72	78	81	153	103
"BC128113"	734	1630	0	0	0	0	0	0	0	0	0	0	0	0	0	0	0	0
"BC128130"	1055	11073	0	0	0	0	0	0	0	0	0	0	0	0	0	0	0	0
"BC128131"	877	11073	0	0	0	0	0	0	0	0	0	0	0	0	0	0	0	0
"BC128161"	446	44443	0	0	0	0	0	0	0	0	0	0	0	0	0	0	0	0
"BC128384"	1187	1571	0	0	0	0	0	0	11	0	0	0	0	0	0	0	0	0
"BC128433"	420	420	0	3	0	0	3	0	0	0	0	0	0	0	0	0	0	0
"BC128532"	540	83532	0	0	0	0	0	0	12	14	0	0	0	0	0	0	0	0
"BC128546"	1220	1220	2	0	0	2	0	0	0	16	0	0	98	61	57	37	75	54
"BC128552"	1440	1440	1385	19918	975	410	8637	11281	520	22596	984	2447	0	0	0	0	0	0
"BC128554"	1581	4652	1161	509	698	463	308	201	498	528	434	801	345	545	192	154	356	157
"BC128560"	510	1848	0	0	0	0	0	0	0	11	0	0	0	0	0	0	0	0
"BC130595"	1286	1286	0	0	0	0	0	0	0	0	0	0	0	0	0	0	0	0
"BC130604"	386	13233	0	0	0	0	0	0	0	0	0	0	0	0	0	0	0	0
"BC131526"	1456	44591	0	0	0	0	0	0	35	0	0	0	0	0	0	0	0	0
"BC131532"	925	379220	0	0	0	0	0	0	0	0	0	0	0	0	13209	15032	17940	14915
"BC131560"	385	1774	256	332	256	0	172	160	118	118	437	480	27	13	1	340	32	273
"BC131584"	925	13844	0	0	0	0	0	0	152	15	0	0	0	0	0	0	0	0
"BC131616"	2021	5144	1	0	1	0	0	0	0	0	0	0	14	5	17	12	22	19
"BC131755"	1544	1544	3066	238	1688	1378	133	105	256	148	970	318	345	329	819	643	837	625
"BC131758"	549	21445	0	0	0	0	0	0	81	29	0	0	0	0	0	0	0	0
"BC131767"	1555	1555	0	0	0	0	0	0	24	0	0	0	0	0	0	0	0	0
"BC132797"	1077	1077	0	0	0	0	0	0	0	0	0	0	0	0	0	0	0	0
"BC132805"	3125	11663	0	0	0	0	0	0	19	0	0	0	0	0	0	0	0	0
"BC132836"	393	12529	0	0	0	0	0	0	0	0	0	0	0	0	0	0	0	0
"BC132841"	1992	1992	0	0	0	0	0	0	13	0	0	0	0	0	0	0	0	0
"BC132858"	1621	1621	0	0	0	0	0	0	0	0	0	0	0	0	0	0	0	0
"BC132896"	1410	1410	0	0	0	0	0	0	16	21	0	0	2	35167	0	28345	0	19671
"BC132944"	783	783	0	0	0	0	0	0	0	0	0	0	0	0	0	0	0	0
"BC132948"	3702	7795	0	0	0	0	0	0	15	0	0	0	0	0	0	0	0	0
"BC132949"	2513	3573	0	0	0	0	0	0	0	0	0	0	0	0	0	0	0	0
"BC133032"	317	317	0	0	0	0	0	0	0	0	0	0	0	0	0	0	0	0
"BC133670"	658	12967	0	0	0	0	0	0	0	0	0	0	0	0	0	0	0	0
"BC136808"	1661	43415	627	0	352	275	0	0	654	49	0	0	0	2	0	0	0	1
"BC137157"	2412	3438	0	0	0	0	0	0	0	0	0	0	0	0	0	0	0	0
"BC137484"	3515	8567	0	0	0	0	0	0	0	0	0	0	0	0	0	0	0	0
"BC139719"	1691	2332	0	0	0	0	0	0	0	0	0	0	0	0	0	0	0	0
"BC139743"	1554	8876	1	0	0	1	0	0	18	27	0	0	0	0	0	0	0	0
"BC140093"	164	38369	1210	555	626	584	260	295	1014	795	252	747	1581	1820	2458	2243	2556	1791
"BC140723"	1891	1891	941	132	6	935	44	88	546	54	2255	541	44	5	64	41	40	44
"BC141902"	820	820	0	0	0	0	0	0	17	0	0	0	0	0	0	0	0	0
"BC141903"	223	967	0	0	0	0	0	0	0	0	0	0	0	0	0	0	0	0
"BC141932"	598	673	0	0	0	0	0	0	12	0	0	0	0	0	0	0	0	0
"BC141944"	358	358	0	0	0	0	0	0	0	57	0	0	0	0	0	0	0	0
"BC141948"	610	21509	670	273	374	296	152	121	517	183	335	241	270	208	158	35	381	65
"BC141952"	572	572	0	0	0	0	0	0	0	0	0	0	0	0	0	0	0	0
"BC142949"	3951	215335	0	0	0	0	0	0	0	10	0	0	0	0	0	0	0	0
"BC143637"	3386	25095	50	0	35	15	0	0	54	0	37	0	8	0	0	0	4	0
"BC143987"	880	13876	0	0	0	0	0	0	0	0	0	0	0	0	0	0	0	0
"BC143997"	1436	2274	0	0	0	0	0	0	16	0	0	0	0	0	0	0	0	0
"BC143998"	877	13876	0	0	0	0	0	0	0	0	0	0	0	0	0	0	0	0
"BC143999"	907	13876	0	0	0	0	0	0	0	0	0	0	0	0	0	0	0	0
"BC144390"	450	10026	0	0	0	0	0	0	0	0	0	0	0	0	0	0	0	0
"BC144391"	444	10026	0	0	0	0	0	0	0	0	0	0	0	0	0	0	0	0
"BC144418"	926	33406	0	0	0	0	0	0	45	20	0	0	0	0	0	0	0	0
"BC144419"	1005	33406	0	0	0	0	0	0	45	20	0	0	0	0	0	0	0	0
"BC144457"	2393	8856	4957	4220	2535	2422	2745	1475	3829	1639	5104	2544	1123	1561	98	39	296	102
"BC144501"	1884	5436	0	0	0	0	0	0	26	0	0	0	0	0	0	0	0	0
"BC144502"	2013	5436	0	0	0	0	0	0	26	0	0	0	0	0	0	0	0	0
"BC144506"	760	3112	0	0	0	0	0	0	18	23	0	0	0	0	0	0	0	0
"BC144508"	792	3112	0	0	0	0	0	0	18	23	0	0	0	0	0	0	0	0
"BC144580"	985	17272	1	0	0	1	0	0	38	0	0	0	19	19	0	0	0	0
"BC146941"	833	833	0	0	0	0	0	0	10	0	0	0	0	0	0	0	0	0
"BC148240"	558	558	0	0	0	0	0	0	0	0	0	0	0	0	0	0	0	0
"BC148242"	516	516	0	0	0	0	0	0	36	0	0	0	0	0	0	0	0	0
"BC148245"	522	610	25	0	25	0	0	0	52	30	0	0	0	0	1	0	0	0
"BC148262"	501	351221	0	0	0	0	0	0	0	0	0	0	0	0	0	0	0	0
"BC150162"	699	699	90	0	0	90	0	0	0	0	67	0	112	86	120	102	190	123
"BC150495"	1553	14282	0	0	0	0	0	0	11	19	0	0	0	0	0	0	0	0
"BC150497"	286	1784	37	0	23	14	0	0	26	27	1	20	114	125	318	299	308	253
"BC150500"	479	479	311	386	199	112	284	102	110	260	113	113	0	0	0	0	0	0
"BC150503"	308	308	0	0	0	0	0	0	0	0	0	0	0	0	0	0	0	0
"BC150506"	612	612	0	0	0	0	0	0	0	0	0	0	0	0	0	0	0	0
"BC150507"	612	612	0	0	0	0	0	0	0	0	0	0	0	0	0	0	0	0
"BC150535"	3278	3278	31	0	0	31	0	0	10	13	0	0	89	28	32	17	51	0
"BC150551"	499	18080	0	0	0	0	0	0	0	0	0	0	0	0	0	0	0	0
"BC150552"	510	18080	0	0	0	0	0	0	0	0	0	0	0	0	0	0	0	0
"BC150585"	792	792	1924	38	1910	14	21	17	25	12	12	16	240	215	329	275	356	290
"BC151150"	966	17391	1	0	0	1	0	0	38	0	0	0	19	19	0	0	0	0
"BC152379"	612	612	0	0	0	0	0	0	0	0	0	0	0	0	0	0	0	0
"BC152380"	612	612	0	0	0	0	0	0	0	0	0	0	0	0	0	0	0	0
"BC153822"	2489	4548	0	0	0	0	0	0	0	0	0	0	0	0	0	0	0	0
"BC160930"	2081	2666	265	495	85	180	239	256	215	474	280	553	0	41	3	57	31	33
"BC171823"	627	627	0	0	0	0	0	0	0	0	0	0	0	0	0	0	0	0
"BC171856"	425	425	1	0	1	0	0	0	18	37	0	0	0	0	0	0	0	0
"BC171868"	533	16061	1	0	1	0	0	0	8	0	0	0	0	0	0	0	0	0
"BC2028"	2643	2643	17	0	0	17	0	0	32	22	0	0	137	122	0	0	68	0
"BCA3"	1357	6865	19	0	0	19	0	0	68	0	0	0	358	255	445	339	448	312
"BCAM"	2447	11274	0	0	0	0	0	0	60	36	0	0	5	0	0	16	3	0
"BCAN"	3478	17580	0	0	0	0	0	0	140	68	0	0	0	0	0	0	0	0
"BCAP29"	6027	43342	1198	522	657	541	283	239	646	175	0	165	1348	1490	1136	998	1271	933
"BCAP31"	1825	23604	1976	96	1087	889	46	50	863	207	961	169	7024	6770	7890	8989	7358	5733
"BCAR1"	3523	36978	0	0	0	0	0	0	193	118	0	0	12	0	10	11	0	0
"BCAR3"	3228	285357	33809	34459	18934	14875	18543	15916	10944	16052	19823	21195	1675	2094	2065	2021	2498	1786
"BCAR4"	974	8997	0	0	0	0	0	0	0	0	0	0	0	0	0	0	0	0
"BCAS1"	3487	127227	0	0	0	0	0	0	8	0	0	0	0	0	0	0	0	0
"BCAS2"	1306	14084	8	0	0	8	0	0	0	31	0	0	214	268	332	142	314	289
"BCAS3"	3746	715028	5717	3831	3354	2363	2119	1712	4729	4227	870	4124	477	446	429	356	993	697
"BCAS4"	1347	82248	24	8	14	10	8	0	258	106	0	0	5045	0	9694	8743	0	8451
"BCAT1"	8275	138029	0	16	0	0	8	8	20	79	0	0	282	295	503	577	490	426
"BCAT2"	2259	8984	31	0	6	25	0	0	167	26	0	0	199	405	451	312	707	354
"BCCIP"	2356	19273	613	183	344	269	109	74	448	254	0	129	770	961	804	878	1440	905
"BCDIN3D"	3250	7087	29	0	18	11	0	0	77	10	0	0	262	72	243	67	217	81
"BCDO"	2307	52453	0	0	0	0	0	0	0	0	0	0	0	0	0	0	0	0
"BCDO2"	2409	40254	141	44	50	91	17	27	123	0	0	34	20	21	21	16	20	14
"BCHE"	2449	64561	0	0	0	0	0	0	0	0	0	0	0	0	0	0	0	0
"BCKDHA"	2197	48473	593	19	357	236	13	6	648	160	155	0	1422	726	1685	1274	2523	1533
"BCKDHB"	3722	239645	43	13	28	15	0	13	185	9	0	0	107	97	119	149	119	100
"BCKDK"	2183	4450	537	170	320	217	92	78	268	145	456	251	3901	3314	4026	3434	4759	3291
"BCL10"	3260	12124	495	1088	327	168	593	495	288	453	15	422	835	1691	874	739	999	757
"BCL11A"	5950	96306	12205	16881	6724	5481	9058	7823	4840	7232	4363	16765	956	1419	478	839	564	489
"BCL11B"	7817	102197	639	237	340	299	156	81	582	378	0	187	14	29	0	0	0	0
"BCL2"	6759	196080	288	1964	183	105	1090	874	515	1205	217	1355	135	187	98	147	175	79
"BCL2A1"	945	10412	10	4425	10	0	2373	2052	0	1775	0	2575	52	4389	157	6043	160	2683
"BCL2L1"	2560	58395	14226	72674	9583	4643	38849	33825	3556	56148	6063	86853	2266	4167	2567	4969	3164	6543
"BCL2L10"	887	3150	0	0	0	0	0	0	0	0	0	0	0	0	0	0	0	0
"BCL2L11"	5103	47533	11205	7157	6244	4961	3832	3325	4986	3598	7902	7713	5801	5030	6764	4340	6515	4040
"BCL2L12"	1861	8775	276	32	148	128	0	32	197	73	0	0	94	141	459	385	768	169
"BCL2L13"	3370	90504	627	2406	420	207	1335	1071	540	7017	82	15558	1390	7329	1550	1420	1719	1313
"BCL2L14"	2041	28225	0	4	0	0	4	0	37	9	0	0	5	10	19	22	0	4
"BCL2L15"	4976	10734	0	0	0	0	0	0	0	0	0	0	0	0	0	0	0	1
"BCL2L2"	3566	4956	315	84	151	164	59	25	209	37	107	20	295	350	546	437	696	426
"BCL3"	1872	11324	1609	2708	885	724	1410	1298	344	1382	720	5567	1738	5578	1329	7075	1535	6417
"BCL6"	3669	15122	30465	19248	16383	14082	10043	9205	12682	9639	30234	22146	12997	10755	19147	14225	29489	15591
"BCL6B"	3534	6594	0	0	0	0	0	0	89	27	0	0	1	0	0	0	0	0
"BCL7A"	3718	40089	1891	122	1109	782	83	39	907	200	1477	335	1111	928	1139	754	1885	1036
"BCL7B"	1676	20897	224	158	145	79	124	34	110	256	37	344	693	994	1015	1179	1015	1020
"BCL7C"	1765	60028	250	0	162	88	0	0	499	44	66	0	568	449	596	369	738	461
"BCL8"	3035	6543	0	0	0	0	0	0	0	0	0	0	0	0	0	0	0	0
"BCL9"	6284	84833	138	0	97	41	0	0	113	3	19	21	693	539	679	336	961	394
"BCL9L"	7745	14763	42	21	14	28	21	0	152	203	0	161	181	223	436	1386	355	244
"BCLAF1"	7440	32990	4863	5637	2724	2139	3095	2542	2455	2255	1517	3418	5596	7107	5611	4743	5682	3700
"BCMA"	1121	2962	0	0	0	0	0	0	16	0	0	0	0	0	0	0	0	0
"BCMO1"	2438	52453	0	0	0	0	0	0	0	0	0	0	0	0	0	0	0	0
"BCMS"	1663	230375	0	0	0	0	0	0	11	0	0	0	0	0	0	0	0	0
"BCMSUN"	3082	142991	29941	43108	16833	13108	23233	19875	11806	20105	14426	30481	1720	2868	1298	1148	1555	1088
"BCMSUNL"	1658	1658	0	0	0	0	0	0	0	0	0	0	0	0	0	0	0	0
"BCO2"	2919	43441	184	44	77	107	17	27	156	0	0	34	30	21	28	23	29	14
"BCOR"	6436	46220	2070	1216	977	1093	773	443	965	1072	254	2147	1555	1380	1243	1225	1517	957
"BCORL1"	6753	74934	101	364	25	76	202	162	318	1317	24	1345	322	532	403	923	538	501
"BCORL2"	3679	47724	0	0	0	0	0	0	0	0	0	0	0	0	0	0	0	0
"BCR"	6949	137673	2390	252	1309	1081	180	72	2438	1029	383	388	834	710	1093	878	1600	1041
"BCR variant protein"	2875	7924	126	25	66	60	16	9	209	94	21	20	171	174	250	212	378	263
"BCR-ABL"	1027	31404	434	35	262	172	17	18	730	384	176	39	228	235	356	255	460	281
"BCR/ABL fusion"	1431	20446	0	0	0	0	0	0	71	37	0	0	0	0	0	13	0	0
"BCRM1"	1490	24775	172	2	105	67	0	2	108	9	111	81	324	183	331	342	303	272
"BCS1L"	1742	4639	259	66	151	108	41	25	83	32	0	9	220	288	323	286	383	245
"BCYRN1"	183	518929	14426	15731	7548	6878	7935	7796	7068	7678	7873	14928	15218	19309	19183	19695	25639	15051
"BD495725"	1950	1950	54	220	24	30	127	93	0	54	0	61	0	1983	0	0	0	0
"BDH1"	3553	46205	838	33	449	389	33	0	306	43	0	0	359	282	342	231	533	357
"BDH2"	2929	22243	0	0	0	0	0	0	0	0	0	0	12	0	42	54	81	66
"BDKRB1"	1518	12746	0	0	0	0	0	0	0	0	0	0	0	0	0	0	0	0
"BDKRB2"	4367	39533	0	0	0	0	0	0	47	10	0	0	0	0	0	0	0	0
"BDNF"	4940	44772	10	0	10	0	0	0	22	0	0	0	0	5	0	4	16	0
"BDP1"	11114	112209	2788	1534	1559	1229	764	770	1707	821	875	1049	1872	2483	2055	1859	2137	1245
"BDTN"	2260	296391	9	10	0	9	10	0	92	60	0	12	50	68	104	125	72	63
"BEAN"	2770	55506	0	0	0	0	0	0	65	40	0	0	89	34	5	12	18	4
"BECN1"	2797	14157	586	303	280	306	181	122	279	205	214	418	2681	1640	2970	2628	3082	2166
"BEGAIN"	2754	30923	0	0	0	0	0	0	123	137	0	0	0	0	0	0	0	0
"BEND2"	4644	57973	0	0	0	0	0	0	0	0	0	0	0	0	0	0	0	0
"BEND3"	6665	49253	0	0	0	0	0	0	32	10	0	0	131	71	51	5	27	0
"BEND4"	8854	42025	0	0	0	0	0	0	0	0	0	0	1	0	0	0	0	0
"BEND5"	1414	49007	0	0	0	0	0	0	0	0	0	0	0	0	0	0	0	0
"BEND6"	3654	55973	0	0	0	0	0	0	10	0	0	0	0	0	0	0	0	0
"BEND7"	6576	40036	0	0	0	0	0	0	0	0	0	0	0	0	0	0	0	0
"BEST1"	2841	13712	1146	3960	645	501	2122	1838	425	2437	208	6019	25386	35254	35333	55837	31750	42103
"BEST2"	1917	5864	0	4	0	0	0	4	67	51	1	1	1	0	0	0	0	0
"BEST3"	3540	45807	0	0	0	0	0	0	0	0	0	0	0	0	0	0	0	0
"BEST4"	2103	4169	0	0	0	0	0	0	12	10	0	0	0	0	0	0	0	0
"BET1"	3065	12692	47	0	29	18	0	0	18	0	0	0	387	451	298	224	414	310
"BET1L"	2959	4500	318	104	289	29	65	39	198	179	533	265	92	35	149	63	733	429
"BET3L"	1111	49122	0	0	0	0	0	0	0	0	0	0	0	0	0	0	0	0
"BEX1"	865	1589	0	0	0	0	0	0	0	0	0	0	0	0	0	0	0	0
"BEX2"	1052	1575	0	0	0	0	0	0	0	0	0	0	0	0	0	0	0	0
"BEX4"	1277	2102	26	0	10	16	0	0	0	12	0	0	1006	932	1899	1802	1528	1061
"BEX5"	863	2084	0	0	0	0	0	0	0	0	0	0	0	0	0	0	0	0
"BEYLA"	2161	14901	0	0	0	0	0	0	0	0	0	0	0	0	0	0	0	0
"BFAR"	3050	36426	375	74	208	167	43	31	149	144	106	369	683	588	585	705	728	783
"BFP/ZNF179"	1145	3519	0	0	0	0	0	0	25	25	0	0	1	0	0	0	0	0
"BFSP1"	2213	37464	5	0	2	3	0	0	38	8	0	0	6	6	0	0	0	0
"BFSP2"	1633	75268	0	0	0	0	0	0	0	9	0	0	0	2	0	0	0	0
"BGLAP"	538	1163	0	0	0	0	0	0	38	20	0	0	11	23	26	18	0	5
"BGN"	2388	14595	0	0	0	0	0	0	75	46	0	0	0	0	0	0	0	0
"BGR"	1208	11945	14030	14473	7872	6158	7889	6584	5038	3961	7208	5689	1203	1571	7964	5493	9838	4986
"BHD"	3360	36193	2011	1768	1123	888	990	778	1064	1086	1253	2143	1299	1175	2202	1971	1936	1124
"BHLHA15"	739	1495	0	0	0	0	0	0	18	0	0	0	0	0	0	0	0	0
"BHLHB2"	3305	5768	1779	2530	1007	772	1313	1217	457	1001	1216	2250	5478	6203	3791	6246	4385	8050
"BHLHB9"	4088	31728	0	0	0	0	0	0	19	0	0	0	3	11	5	0	0	0
"BHLHE22"	3373	3373	0	0	0	0	0	0	0	0	0	0	0	35	0	0	0	0
"BHLHE23"	1058	1058	1	0	1	0	0	0	0	0	0	0	0	0	0	0	0	0
"BHLHE40"	3037	5768	1779	2530	1007	772	1313	1217	457	1001	1216	2250	5478	6203	3791	6246	4385	8050
"BHLHE41"	3783	5044	0	9	0	0	5	4	0	17	6	0	219	473	514	958	292	326
"BHMT"	2507	20510	0	0	0	0	0	0	0	0	0	0	0	0	0	0	0	0
"BHMT2"	1999	19692	0	0	0	0	0	0	0	0	0	0	0	0	0	0	0	0
"BICC1"	3140	315943	0	0	0	0	0	0	0	0	0	0	0	0	0	0	0	0
"BICD1"	3598	270957	0	0	0	0	0	0	36	0	0	0	3	39	20	30	6	22
"BICD2"	6423	53440	4467	644	2484	1983	353	291	2165	526	2720	628	3343	3611	4149	3652	2168	3441
"BID"	2496	39875	13299	50145	7288	6011	26602	23543	2300	31926	6011	91262	1297	16287	1541	15126	2391	12538
"BIK"	954	18962	0	0	0	0	0	0	73	49	0	0	0	5	8	8	0	0
"BIN1"	2641	59259	327	18	208	119	7	11	1127	571	376	71	329	305	553	613	697	476
"BIN2"	2792	43117	1391	165	800	591	79	86	779	93	618	102	2260	2043	2302	1938	3644	2008
"BIN3"	1854	48714	1686	1646	902	784	929	717	1111	1633	411	2055	1459	470	1285	363	1844	465
"BIRC2"	4070	31286	1925	7775	1118	807	4222	3553	952	4828	423	5051	1958	4085	2170	4535	2371	2631
"BIRC3"	5237	20272	2152	17226	1185	967	9258	7968	292	7267	23	11894	1614	46526	2078	25155	2367	15818
"BIRC5"	2704	11440	0	0	0	0	0	0	28	0	0	0	0	0	0	0	4	0
"BIRC6"	15774	261869	33053	19874	18064	14989	10789	9085	14020	8419	13300	14257	5679	6994	6881	6424	7325	4371
"BIRC7"	1328	4579	0	2	0	0	2	0	49	41	0	0	0	0	0	0	69	18
"BIRC8"	2021	2021	0	0	0	0	0	0	0	0	0	0	0	0	0	0	0	0
"BIVM"	3874	42490	27	0	12	15	0	0	35	3	0	0	156	170	210	106	183	76
"BLCAP"	2044	10485	2645	1419	1413	1232	795	624	842	991	2098	2186	2194	1887	207	508	448	159
"BLID"	862	862	0	0	0	0	0	0	0	0	0	0	0	0	0	0	0	0
"BLK"	2602	70588	0	0	0	0	0	0	121	42	0	0	0	3	52	44	24	16
"BLM"	4714	98107	13	2	0	13	0	2	22	5	0	0	125	131	129	61	153	77
"BLMH"	2429	43853	17	17	0	17	14	3	91	62	0	28	561	209	379	347	850	604
"BLNK"	1832	79872	13440	1312	7197	6243	730	582	5900	258	5879	263	2056	2584	1501	569	2720	933
"BLOC1S1"	1341	6624	193	66	97	96	51	15	152	73	45	52	1109	803	1197	1162	1913	1215
"BLOC1S2"	2028	12403	262	43	144	118	36	7	183	116	84	314	1840	1864	1986	1392	2176	1465
"BLOC1S3"	2601	3056	21	0	0	21	0	0	127	0	0	0	491	186	516	136	619	162
"BLP"	1447	4953	531	348	320	211	189	159	490	274	33	426	798	73	705	442	1840	618
"BLVRA"	1179	48666	1725	7097	922	803	3708	3389	682	3238	636	4139	2076	3426	2158	2413	1542	1228
"BLVRB"	1517	18036	1205	171	698	507	108	63	475	129	1021	192	1209	979	1584	913	1597	955
"BLZF1"	2670	20251	43	0	29	14	0	0	158	24	0	0	406	369	456	295	413	263
"BM009"	1750	98284	19080	15346	11004	8076	8358	6988	8106	6443	9699	11105	2823	5857	3834	3369	3865	2646
"BMCC1"	4961	92724	2558	720	1364	1194	386	334	703	232	0	30	114	226	0	0	16	0
"BMCP1"	1864	25742	0	0	0	0	0	0	10	0	0	0	77	70	31	71	82	62
"BMF"	4689	20983	284	50	148	136	50	0	356	181	114	296	692	669	908	557	1095	720
"BMI1"	3576	10413	335	16	209	126	7	9	314	27	17	0	2090	2022	2158	1258	2722	1385
"BMP1"	4377	47164	56	7	46	10	0	7	478	285	12	0	345	303	258	254	422	308
"BMP10"	1586	6038	0	0	0	0	0	0	0	0	0	0	0	0	0	0	0	0
"BMP15"	1180	5824	0	0	0	0	0	0	0	0	0	0	0	0	0	0	0	0
"BMP2"	3153	12167	0	0	0	0	0	0	0	0	0	0	0	0	4	64	0	0
"BMP2K"	3820	135809	28448	15009	15806	12642	8170	6839	16203	5486	12123	8283	5715	6723	4936	4322	4416	2329
"BMP3"	5736	26567	0	0	0	0	0	0	0	0	0	0	0	0	0	0	0	0
"BMP4"	1943	7099	0	0	0	0	0	0	0	0	0	0	0	0	0	0	0	0
"BMP5"	2175	120137	0	0	0	0	0	0	0	0	0	0	0	0	0	0	0	0
"BMP6"	3111	154951	0	115	0	0	80	35	44	76	0	0	1269	1270	30	27	5	1047
"BMP7"	4038	97900	0	0	0	0	0	0	207	62	0	0	0	0	0	0	0	0
"BMP8A"	5629	38221	160	95	87	73	51	44	215	87	68	94	32	80	147	131	144	42
"BMP8B"	3780	30632	55	0	24	31	0	0	75	9	0	0	111	129	40	33	88	17
"BMPER"	3439	249027	0	0	0	0	0	0	0	0	0	0	0	0	0	0	0	0
"BMPR1A"	3628	168550	116	0	66	50	0	0	70	30	0	0	72	87	159	124	51	66
"BMPR1B"	5564	400466	0	0	0	0	0	0	10	0	0	0	0	0	0	0	0	0
"BMPR2"	12082	191425	4211	544	2397	1814	280	264	2370	429	852	489	2342	2721	2474	1952	2628	1552
"BMS1"	8069	52431	390	70	219	171	20	50	343	119	40	64	844	815	1094	1077	1373	900
"BMS1P4"	1972	31365	620	33	356	264	12	21	574	78	32	190	234	197	178	88	166	58
"BMS1P5"	4241	25255	0	0	0	0	0	0	11	0	0	0	0	0	239	140	411	48
"BMX"	2616	92284	40	0	18	22	0	0	16	0	0	0	63	56	72	84	51	31
"BNC1"	4617	28815	0	0	0	0	0	0	0	0	0	0	0	0	0	0	0	0
"BNC2"	12932	461286	0	0	0	0	0	0	0	0	0	0	0	0	0	0	0	0
"BNIP1"	1392	19946	12	0	12	0	0	0	15	32	0	29	134	225	168	145	151	119
"BNIP2"	2525	26580	2166	728	1283	883	436	292	1099	374	654	695	5435	1794	2148	1509	2006	904
"BNIP3"	1620	12246	864	341	500	364	193	148	472	354	0	224	146	110	0	0	0	0
"BNIP3L"	3506	30123	673	0	412	261	0	0	581	54	49	25	3305	3658	2334	1834	3083	2102
"BNIPL"	2422	11049	0	0	0	0	0	0	16	11	0	0	2	0	0	0	0	0
"BNIPL-1"	1947	8806	0	0	0	0	0	0	0	11	0	0	2	0	0	0	0	0
"BNPI"	2233	5292	2	0	0	2	0	0	83	27	0	0	0	18	3	0	9	3
"BOC"	6314	18076	0	0	0	0	0	0	15	0	0	0	0	0	0	0	0	0
"BOD1"	1938	9520	435	304	236	199	178	126	267	216	279	308	470	548	618	679	697	532
"BOD1L"	10568	58964	3300	1314	1914	1386	682	632	1487	603	532	578	2352	3087	2764	2547	3449	1753
"BOK"	2604	15361	4	0	0	4	0	0	38	31	0	24	44	15	59	26	87	25
"BOLA1"	858	1194	0	0	0	0	0	0	0	11	0	0	99	63	95	49	127	41
"BOLA2B"	1014	1372	0	0	0	0	0	0	0	0	0	0	0	0	1039	1050	2078	983
"BOLA3"	558	12513	0	0	0	0	0	0	12	0	2	0	13	7	89	132	140	116
"BOLL"	2936	58133	0	0	0	0	0	0	7	0	0	0	0	0	0	0	0	0
"BOMB"	8724	117260	258	63	140	118	41	22	388	160	0	65	484	708	851	815	764	598
"BOP1"	2389	29066	29	1	16	13	0	1	191	170	2	33	15	12	1087	1019	1178	515
"BORIS"	807	19882	0	0	0	0	0	0	9	0	0	0	0	0	0	0	0	0
"BOULE"	2653	59337	0	0	0	0	0	0	7	0	0	0	0	0	0	0	0	0
"BPAG1"	3190	54389	377	109	194	183	67	42	304	174	46	73	135	229	227	238	277	99
"BPESC1"	3515	20978	0	0	0	0	0	0	0	0	0	0	0	0	0	0	0	0
"BPGM"	2107	33036	30	0	0	30	0	0	98	33	0	0	454	635	412	356	609	459
"BPHL"	1851	34506	16	1	16	0	0	1	183	35	0	16	113	98	75	72	116	85
"BPI"	1860	33355	0	0	0	0	0	0	48	13	0	0	0	4	4	7	11	0
"BPIL1"	1912	16109	0	0	0	0	0	0	43	11	0	0	0	0	0	0	0	0
"BPIL2"	1995	43541	0	0	0	0	0	0	0	0	0	0	1	0	0	0	0	0
"BPIL3"	1691	12400	0	0	0	0	0	0	0	0	0	0	0	0	0	0	0	0
"BPNT1"	2468	32367	33	5	9	24	0	5	27	0	19	0	611	630	593	566	577	439
"BPTF"	10941	158715	8651	5961	4756	3895	3309	2652	3686	2568	2669	4092	2818	3599	3248	2733	3829	1965
"BPY2"	1211	21200	0	0	0	0	0	0	0	0	0	0	0	0	0	0	0	0
"BRAF"	2962	190751	2743	8725	1613	1130	4792	3933	1540	5517	148	5664	62	99	224	240	207	183
"BRAP"	4037	43841	423	175	302	121	85	90	261	207	92	347	679	644	409	607	997	586
"BRCA1"	7293	81189	1013	255	612	401	173	82	934	431	286	355	786	1134	208	84	303	81
"BRCA2"	11413	84194	409	1007	262	147	555	452	197	364	0	206	497	879	363	237	256	166
"BRCC1"	5883	15944	95	0	71	24	0	0	224	0	0	5	247	252	314	217	330	193
"BRCC3"	2925	51640	793	51	409	384	34	17	692	10	115	0	960	980	433	371	402	291
"BRD1"	4856	51043	6008	2437	3316	2692	1283	1154	2697	1921	4970	5049	1086	604	1533	1056	2008	802
"BRD2"	4907	62856	4796	4892	2621	2175	2597	2295	1417	1953	2813	3994	7327	11836	7988	13023	10099	9958
"BRD3"	5639	37689	1500	30	787	713	26	4	939	169	984	39	896	773	976	504	531	731
"BRD4"	5217	42962	16618	17619	9340	7278	9529	8090	5937	9011	10676	18427	1582	1972	1701	2051	2928	2123
"BRD7"	2222	49890	13835	8092	4423	9412	3626	4466	3789	8534	4711	555	11347	13997	13725	1083	17819	885
"BRD8"	4094	38901	189	10	110	79	0	10	114	0	0	17	505	313	856	460	874	498
"BRD9"	2888	29090	2474	1294	1354	1120	711	583	1127	954	1161	1852	855	900	968	879	1234	789
"BRDT"	3720	65057	0	0	0	0	0	0	0	0	0	0	0	0	0	0	0	0
"BRE"	1976	448285	7087	4845	4204	2883	2743	2102	5458	4407	893	4274	1074	1174	809	888	1171	788
"BRF"	1523	38458	1657	324	945	712	167	157	1100	469	1283	667	334	283	497	415	618	408
"BRF1"	3680	91708	4195	741	2378	1817	409	332	2637	991	3439	1688	1551	1254	2091	1721	2741	1836
"BRF2"	1980	6011	2	0	0	2	0	0	13	10	0	0	240	38	89	82	86	84
"BRI3"	794	9862	3047	1335	1624	1423	664	671	837	551	2267	1398	3211	2522	4664	3795	6043	4094
"BRI3BP"	1275	32157	1124	23	688	436	23	0	740	53	688	0	2863	2765	625	496	794	448
"BRIP1"	4583	180772	8	0	0	8	0	0	49	0	0	0	27	47	30	7	58	26
"BRIX"	1129	7644	299	324	162	137	209	115	168	156	0	225	93	86	280	164	346	138
"BRIX1"	1281	9967	361	419	224	137	230	189	219	179	0	225	303	263	335	274	538	268
"BRMS1"	1447	7780	76	0	32	44	0	0	219	106	0	19	351	647	939	791	1066	774
"BRMS1L"	2593	45573	0	0	0	0	0	0	9	0	0	13	81	99	83	79	91	32
"BROX"	1195	19390	360	97	196	164	33	64	138	33	26	55	2121	2206	1151	860	991	552
"BRP44"	940	18071	50	0	22	28	0	0	37	9	0	0	247	312	268	220	215	264
"BRP44L"	1580	14163	1249	821	721	528	461	360	511	437	82	584	1248	1415	631	699	984	841
"BRPF1"	4740	16265	1177	233	657	520	127	106	778	297	209	176	1871	853	2391	1195	3204	1418
"BRPF3"	6035	36018	112	179	45	67	140	39	213	169	0	170	381	528	653	1042	713	531
"BRS3"	1416	4475	0	0	0	0	0	0	0	0	0	0	0	0	0	0	0	0
"BRSK1"	3098	28369	413	517	198	215	109	408	127	218	0	173	58	136	26	885	23	406
"BRSK2"	3946	50945	0	0	0	0	0	0	384	184	0	0	0	0	0	0	0	0
"BRUNOL4"	4067	322994	0	0	0	0	0	0	1467	690	0	0	0	0	0	0	0	0
"BRUNOL5"	4356	71635	0	0	0	0	0	0	206	100	0	0	8	5	0	0	0	0
"BRUNOL6"	4588	91454	8133	1696	4453	3680	943	753	4197	900	5621	995	3354	3108	5577	4456	7179	4412
"BRWD1"	13020	123409	7809	2177	4311	3498	1203	974	4162	1048	2652	1332	797	2211	1136	2015	971	1582
"BRWD2"	4749	58342	2195	864	1368	827	420	444	1354	604	474	779	2374	2630	3167	2900	3482	2226
"BRWD3"	6299	133552	2311	623	1464	847	346	277	1549	1284	105	465	559	859	1637	1000	1428	808
"BSCL2"	2056	19301	621	25	391	230	13	12	431	139	242	41	676	378	754	690	992	645
"BSDC1"	4627	29275	1030	874	446	584	505	369	919	540	817	1146	605	2095	1999	1884	1105	807
"BSG"	2148	4644	657	157	362	295	81	76	295	316	488	226	5014	2955	9284	8145	7229	6332
"BSN"	15970	117061	16	1	13	3	1	0	122	99	5	0	0	2	0	0	0	0
"BSND"	1373	9849	0	0	0	0	0	0	44	0	0	0	0	0	0	0	0	0
"BSPH1"	660	24126	0	0	0	0	0	0	0	0	0	0	0	0	0	0	0	0
"BSPRY"	2353	21702	0	0	0	0	0	0	0	0	0	0	0	1	0	0	0	0
"BST1"	1488	29224	0	0	0	0	0	0	16	0	0	0	98	98	111	110	191	139
"BST2"	943	2630	82	17	42	40	0	17	18	44	16	0	375	1112	1922	835	896	767
"BSX"	704	4023	0	0	0	0	0	0	0	0	0	0	0	0	0	0	0	0
"BTAF1"	7074	106344	7546	8101	4338	3208	4552	3549	4114	4805	2065	4463	2562	3518	3521	3072	4196	2369
"BTBD1"	3296	50925	3999	264	2230	1769	160	104	1665	119	1072	369	316	1605	3385	2138	3640	2520
"BTBD10"	2552	52271	5368	561	3196	2172	310	251	2353	428	644	653	1029	1151	655	760	1350	391
"BTBD11"	5777	341224	0	0	0	0	0	0	158	0	0	0	0	0	0	0	0	0
"BTBD12"	7306	30403	675	106	382	293	53	53	598	144	175	105	949	1097	1442	776	2303	1055
"BTBD16"	1867	66857	16	0	16	0	0	0	35	27	0	0	0	0	0	0	0	0
"BTBD17"	1681	5405	0	0	0	0	0	0	39	17	0	0	0	0	0	0	0	0
"BTBD18"	3050	8268	261	129	159	102	65	64	195	107	128	99	0	742	0	0	0	0
"BTBD19"	1580	5649	1241	7836	675	566	4144	3692	248	5019	9	18985	118	2437	412	6380	388	3855
"BTBD2"	2627	30257	810	241	479	331	169	72	461	356	951	327	680	579	1040	440	1379	912
"BTBD3"	4860	8679	1689	151	994	695	104	47	866	127	385	113	1107	1091	1016	642	1032	647
"BTBD6"	1988	2549	177	137	175	2	75	62	0	82	305	183	847	721	1134	1016	1527	1018
"BTBD7"	8457	95489	3546	3957	1897	1649	2114	1843	1882	2072	552	3443	1377	1678	1483	1182	807	803
"BTBD8"	1450	67535	0	0	0	0	0	0	47	24	0	0	317	418	0	0	3	0
"BTBD9"	8960	471698	12474	10909	6936	5538	6017	4892	6091	5670	1642	6333	678	634	667	484	822	458
"BTC"	1329	48436	0	0	0	0	0	0	0	0	0	0	0	0	0	0	0	0
"BTCC-1"	1086	33041	247	27	150	97	7	20	332	178	0	250	937	866	1198	1200	972	903
"BTD"	2263	43850	13	0	13	0	0	0	18	0	0	0	298	260	311	304	330	352
"BTF3"	1255	7200	168	357	99	69	185	172	40	132	0	221	4252	4951	5302	4099	5638	3047
"BTF3L1"	640	640	0	0	0	0	0	0	0	0	0	0	0	0	0	0	0	0
"BTF3L4"	2351	32235	1382	808	793	589	434	374	744	436	737	1419	1247	1312	1336	1186	1813	1332
"BTG1"	4682	5621	501	2827	260	241	1508	1319	160	716	0	1492	1092	3542	1097	3581	1596	2920
"BTG2"	2711	4065	2275	10512	1279	996	5546	4966	407	5441	800	14298	5778	77531	3943	62450	6954	62948
"BTG3"	1598	19300	9	1464	0	9	829	635	8	848	0	1311	131	1244	226	744	121	548
"BTG4"	1002	44808	0	0	0	0	0	0	0	0	0	0	0	0	0	0	0	0
"BTK"	2772	41337	1082	56	526	556	27	29	503	161	330	0	2916	3265	3178	2867	5474	2180
"BTLA"	3218	35595	5	0	0	5	0	0	0	0	0	0	0	0	0	0	0	0
"BTN1A1"	2856	9157	0	0	0	0	0	0	0	0	0	0	0	0	0	0	0	0
"BTN2A1"	3121	11678	1916	1558	1057	859	835	723	667	622	931	1362	1162	1602	1355	1380	1626	1027
"BTN2A2"	3592	11637	685	2129	420	265	1131	998	389	1313	17	1518	1176	3873	1249	3752	1478	2997
"BTN2A3"	1912	9612	0	0	0	0	0	0	48	0	0	0	42	24	48	45	99	15
"BTN3A1"	4199	12979	779	262	438	341	127	135	400	147	341	195	1098	1225	996	654	1477	660
"BTN3A2"	3821	13150	196	49	116	80	20	29	132	8	0	49	1287	1246	1174	953	994	577
"BTN3A3"	2949	12881	215	60	109	106	24	36	187	27	42	39	517	474	761	472	947	543
"BTNL2"	1374	12389	0	0	0	0	0	0	0	0	0	0	2	9	0	0	0	0
"BTNL3"	2391	17827	0	0	0	0	0	0	0	0	0	0	0	0	0	0	0	0
"BTNL8"	2235	51829	0	0	0	0	0	0	0	0	0	0	0	0	0	0	0	0
"BTNL9"	3510	21299	0	0	0	0	0	0	0	15	0	0	0	0	0	0	0	0
"BTRC"	6134	203245	1404	296	821	583	163	133	1098	495	252	452	661	511	670	426	829	449
"BUB1"	3525	40275	0	0	0	0	0	0	0	0	0	0	31	35	29	6	6	8
"BUB1B"	3763	60127	0	4	0	0	3	1	9	3	9	3	21	31	3	0	0	0
"BUB3"	3755	11121	388	309	217	171	172	137	367	176	154	101	909	860	1170	856	1452	832
"BUD13"	2214	24828	344	42	237	107	27	15	245	92	0	40	340	277	589	336	788	346
"BUD31"	1098	8895	105	75	73	32	22	53	69	179	36	93	723	614	551	699	1141	1073
"BUP1"	3344	59348	0	0	0	0	0	0	70	39	0	0	0	0	0	19	3	0
"BV02S1J2.2"	394	728	0	0	0	0	0	0	0	0	0	0	0	7	0	0	0	0
"BV03S1J2.2"	716	70414	35	12	35	0	12	0	40	29	0	37	130	150	80	100	206	116
"BV07S1J2.7"	368	486	0	0	0	0	0	0	0	0	0	0	0	0	0	0	0	0
"BV13S6J2.1"	410	501	0	0	0	0	0	0	0	0	0	0	0	0	0	3	0	0
"BV5-8"	423	544	0	0	0	0	0	0	0	0	0	0	0	0	0	0	0	0
"BV6S4-BJ2S2"	55	32111	0	0	0	0	0	0	12	1	0	0	3	4	0	5	12	2
"BVES"	5572	40351	0	0	0	0	0	0	0	0	0	0	0	0	0	0	0	0
"BWR1B"	1154	15849	71	0	55	16	0	0	192	157	0	51	138	83	121	168	240	126
"BX161428"	1445	9455	0	0	0	0	0	0	0	0	0	0	0	0	0	0	0	0
"BX161461"	1560	1808	0	0	0	0	0	0	0	1	0	0	0	0	0	0	0	0
"BX161483"	1640	53979	0	0	0	0	0	0	11	0	0	0	0	0	0	0	0	0
"BX161496"	1240	3203	0	0	0	0	0	0	0	0	0	0	0	0	0	0	0	0
"BX247990"	1861	41298	0	0	0	0	0	0	0	0	0	0	0	0	0	0	0	0
"BX247991"	1726	6831	0	0	0	0	0	0	22	0	0	0	0	0	0	0	0	0
"BX248253"	1749	4857	0	0	0	0	0	0	0	0	0	0	0	0	0	0	0	0
"BX248273"	875	21156	0	0	0	0	0	0	0	0	0	0	0	0	0	0	0	0
"BX248745"	896	9297	0	0	0	0	0	0	0	0	0	0	0	0	0	0	0	0
"BX248778"	1414	34260	0	0	0	0	0	0	0	0	0	0	0	0	0	0	0	0
"BX537481"	2286	2839	584	163	334	250	91	72	1152	219	318	203	271	1152	370	0	191	111
"BX537548"	3086	56271	0	0	0	0	0	0	78	24	0	0	0	0	0	0	0	0
"BX537629"	3521	3521	0	0	0	0	0	0	0	0	0	0	0	0	0	0	0	0
"BX537644"	1196	4907	0	0	0	0	0	0	0	0	0	0	33	23	13	14	46	0
"BX537697"	4585	10726	0	0	0	0	0	0	0	0	0	0	0	0	0	0	0	0
"BX537706"	2861	34084	2238	1628	1243	995	894	734	1000	1436	1844	2445	897	1052	1450	1598	1153	712
"BX537710"	5189	8007	0	0	0	0	0	0	0	0	0	0	0	0	0	0	0	0
"BX537742"	2157	2157	104	0	52	52	0	0	72	0	0	0	321	285	238	177	283	160
"BX537783"	2016	31136	0	0	0	0	0	0	0	0	0	0	0	0	0	0	0	0
"BX537811"	2669	4103	4420	4961	4420	0	0	4961	0	4659	2579	7949	64	107	167	142	178	129
"BX537835"	3457	19211	0	0	0	0	0	0	0	0	0	0	0	0	0	0	0	0
"BX537874"	3610	4033	0	0	0	0	0	0	0	0	0	0	0	0	0	9	0	0
"BX537900"	2212	5324	0	0	0	0	0	0	0	0	0	0	0	0	0	0	0	0
"BX537909"	1858	3432	0	0	0	0	0	0	0	0	0	0	0	3	0	0	0	0
"BX537921"	3450	3450	408	19	220	188	8	11	268	10	802	71	138	59	73	28	109	28
"BX537922"	2361	2361	263	52	149	114	43	9	184	40	38	0	0	0	31	64	579	52
"BX537950"	402	7004	23	0	13	10	0	0	14	2	0	0	22	32	23	16	10	12
"BX538073"	3532	27042	0	0	0	0	0	0	0	0	0	0	0	0	0	0	0	0
"BX538221"	4348	4348	0	0	0	0	0	0	28	0	0	0	0	0	0	0	0	0
"BX538226"	6876	6876	0	0	0	0	0	0	0	0	0	0	0	0	0	0	0	0
"BX538249"	2026	61410	48	10	40	8	0	10	177	7	0	0	18	35	66	39	44	20
"BX538252"	918	3552	0	0	0	0	0	0	0	10	0	0	5	0	0	0	0	0
"BX538254"	1251	20006	655	117	377	278	80	37	298	89	33	189	137	1276	467	322	484	360
"BX538274"	3744	14032	0	0	0	0	0	0	0	0	0	0	0	0	0	0	0	0
"BX538315"	3644	5131	419	36	172	247	21	15	393	50	344	15	328	339	174	119	605	162
"BX640678"	3670	3670	541	22	306	235	22	0	277	53	127	21	4	1648	1242	594	1064	507
"BX640700"	5117	7120	0	0	0	0	0	0	19	0	0	0	0	0	0	0	0	0
"BX640963"	3659	7252	771	1303	449	322	704	599	714	325	1152	1317	0	1	1412	1085	1408	1052
"BX641110"	3721	3721	0	0	0	0	0	0	0	0	0	0	0	0	0	0	0	0
"BX641143"	4286	4286	0	0	0	0	0	0	0	0	0	0	0	0	0	0	0	0
"BX641154"	2622	2622	897	193	486	411	108	85	0	202	443	213	0	0	184	45	234	35
"BX647075"	2016	12190	72	0	52	20	0	0	16	0	26	0	7	18	16	12	15	13
"BX647114"	620	20101	223	298	177	46	141	157	130	302	0	139	0	1	0	6	6	0
"BX647243"	6003	664474	0	0	0	0	0	0	0	0	0	0	0	0	0	0	0	0
"BX647249"	2047	21847	11	0	0	11	0	0	83	13	0	0	132	111	86	46	138	41
"BX647282"	5124	6418	264	81	162	102	29	52	109	23	127	22	4	13	0	6	0	0
"BX647607"	2932	2932	17	0	0	17	0	0	55	26	0	0	40	45	47	11	62	37
"BX647608"	2694	11347	0	0	0	0	0	0	0	0	0	0	0	0	0	0	0	0
"BX647715"	1584	6238	0	0	0	0	0	0	8	0	0	0	0	0	0	0	0	0
"BX647792"	705	4676	140	3248	103	37	1601	1647	208	1493	17	776	104	173	185	191	207	223
"BX647864"	1046	16819	0	0	0	0	0	0	0	0	0	0	0	0	0	0	0	0
"BX647900"	4107	42369	0	0	0	0	0	0	0	0	0	0	0	0	0	0	0	0
"BX647938"	7875	18956	1	0	0	1	0	0	0	0	0	0	0	0	0	0	0	0
"BX647987"	4832	212504	0	0	0	0	0	0	0	0	0	0	0	5	0	0	0	0
"BX647993"	832	5980	0	349	0	0	202	147	38	151	0	222	16	76	257	388	403	390
"BX648073"	2364	2364	160	60	97	63	26	34	212	42	0	202	590	463	63	51	97	47
"BX648235"	2150	2150	53	0	33	20	0	0	20	17	0	0	0	0	0	0	0	0
"BX648270"	4562	14966	37	0	23	14	0	0	71	0	0	0	27	37	1	2	2	2
"BX648371"	5327	10057	124	129	79	45	94	35	15	34	42	107	78	175	11	0	38	0
"BX648448"	2071	2071	418	39	228	190	39	0	56	422	224	453	0	24	0	52	0	0
"BX648455"	2856	2856	189	69	56	133	55	14	172	54	111	82	171	256	235	198	351	298
"BX648496"	2022	6710	0	0	0	0	0	0	0	0	0	0	0	0	0	0	0	0
"BX648501"	2422	2422	0	0	0	0	0	0	0	0	0	0	0	0	0	0	0	0
"BX648541"	3241	5406	0	0	0	0	0	0	0	12	0	0	39	45	34	54	56	54
"BX648566"	4228	5920	62	111	30	32	65	46	127	131	0	31	0	0	0	0	0	0
"BX648577"	729	10164	0	0	0	0	0	0	0	0	0	0	3	0	0	0	0	0
"BX648586"	4158	6152	0	0	0	0	0	0	15	0	0	0	0	0	0	0	0	0
"BX648695"	3260	215335	0	0	0	0	0	0	0	10	0	0	0	0	0	0	0	0
"BX648696"	3724	16103	0	0	0	0	0	0	0	0	0	0	0	0	0	0	0	0
"BX648714"	3332	13771	3473	1034	2011	1462	549	485	5295	507	2114	516	160	301	158	114	183	124
"BX648763"	4155	4155	11	24	11	0	24	0	48	18	39	0	30	41	31	32	90	72
"BX648826"	4091	4638	0	0	0	0	0	0	0	0	0	0	0	0	0	0	0	0
"BX648855"	2316	12527	114	6	60	54	0	6	125	13	0	0	59	3	29	30	31	12
"BX648926"	4224	6153	0	0	0	0	0	0	14	0	0	0	0	0	0	0	0	0
"BX648957"	3110	58994	0	0	0	0	0	0	0	0	0	0	0	0	0	0	0	0
"BX648961"	6380	6380	134	0	42	92	0	0	144	49	0	13	0	0	0	0	0	0
"BX649021"	3834	27043	0	0	0	0	0	0	0	0	0	0	0	0	0	0	0	0
"BX649060"	3711	36361	498	74	298	200	51	23	317	14	201	76	26	0	195	104	274	39
"BX649164"	5271	6895	172	1735	104	68	1150	585	0	2277	0	2302	545	15120	322	7329	351	4967
"BXDC1"	919	43504	68	102	46	22	66	36	85	269	0	339	262	396	326	363	369	290
"BXDC2"	2366	6194	221	178	128	93	95	83	156	156	0	225	35	46	147	73	213	61
"BY55"	282	7876	236	0	121	115	0	0	116	59	65	0	11	19	3	5	5	0
"BYSL"	1995	11819	197	126	110	87	72	54	163	180	0	222	301	414	369	594	378	403
"BZRAP1"	7722	27558	2509	3143	1359	1150	1868	1275	771	2166	629	3031	81	145	139	97	352	225
"BZRPL1"	873	1839	0	0	0	0	0	0	14	0	0	35	0	0	0	0	0	0
"BZW1"	3078	11482	544	985	355	189	520	465	326	541	48	766	2262	3359	6821	7725	8254	7541
"BZW2"	2107	26342	1984	2182	1122	862	1166	1016	846	1175	192	1066	1502	1325	1326	1366	1751	1368
"Borg4"	2893	28381	0	12	0	0	0	12	314	203	0	19	331	206	304	202	441	197
"C-NAP1"	2536	22701	469	47	273	196	24	23	497	23	148	0	238	145	242	195	342	152
"C10orf10"	2060	2621	4326	3863	2227	2099	1984	1879	369	3177	817	10071	139	1920	231	1513	316	663
"C10orf104"	3524	19812	743	14	480	263	8	6	241	74	451	228	1611	1478	1456	972	1566	856
"C10orf107"	1257	103372	0	0	0	0	0	0	0	0	0	0	0	0	0	0	0	0
"C10orf108"	2840	15093	0	0	0	0	0	0	32	4	0	0	0	0	0	0	0	0
"C10orf11"	896	774607	26655	22013	14676	11979	12229	9784	24065	23367	6799	19273	75	69	52	62	141	120
"C10orf110"	1310	21566	536	1082	293	243	525	557	130	321	0	240	2396	4555	2538	2290	2414	2400
"C10orf111"	1715	1935	0	0	0	0	0	0	41	12	0	0	34	13	62	30	61	32
"C10orf113"	519	20736	0	0	0	0	0	0	0	0	0	0	0	0	0	0	0	0
"C10orf114"	1990	2793	0	0	0	0	0	0	0	0	0	0	0	0	0	0	0	0
"C10orf116"	675	2480	22	0	22	0	0	0	74	0	0	0	0	10	38	20	27	0
"C10orf118"	6905	52392	76	4	31	45	4	0	70	27	8	7	547	219	589	331	579	190
"C10orf119"	4257	43424	983	842	587	396	418	424	820	1440	123	1837	2235	2604	1855	3057	1873	2167
"C10orf12"	4545	4545	13003	13140	7389	5614	7111	6029	5596	5131	4028	10633	1355	2757	1981	1921	1652	1015
"C10orf120"	1065	2113	0	0	0	0	0	0	0	0	0	0	0	0	0	0	0	0
"C10orf122"	925	27451	0	0	0	0	0	0	7	14	0	0	0	0	0	0	0	0
"C10orf125"	774	2873	131	82	96	35	43	39	254	177	687	32	591	380	620	637	737	602
"C10orf128"	1730	28013	16986	6680	9453	7533	3597	3083	5274	1129	11625	1991	7765	5411	2956	1359	3563	1434
"C10orf129"	1723	34730	0	0	0	0	0	0	0	0	0	0	0	0	0	0	0	0
"C10orf131"	1183	30694	224	81	126	98	35	46	71	40	0	0	0	6	0	0	1	0
"C10orf134"	1828	32998	312	0	175	137	0	0	3137	19	0	22	0	0	0	0	0	0
"C10orf137"	4706	44630	660	79	367	293	41	38	400	125	89	89	539	418	655	377	699	354
"C10orf140"	6598	12202	0	0	0	0	0	0	0	0	0	0	0	0	0	0	0	0
"C10orf18"	9887	80144	8180	4710	4509	3671	2449	2261	3476	3295	1968	3753	8820	10666	6566	5707	8268	5747
"C10orf2"	3670	6867	12	0	12	0	0	0	22	13	0	0	217	91	217	125	285	154
"C10orf25"	3080	3192	3172	2482	1758	1414	1330	1152	1111	2056	719	10166	3399	4924	3307	4850	5013	4601
"C10orf26"	4219	40128	2694	402	1481	1213	209	193	1372	479	1510	890	1995	1399	2026	1212	2713	1510
"C10orf27"	1597	14164	2	0	2	0	0	0	157	43	0	0	0	2	0	0	0	0
"C10orf28"	3478	110274	9200	6472	5131	4069	3695	2777	4484	3838	2585	5347	900	1153	919	778	1121	739
"C10orf32"	2440	10753	59	57	49	10	57	0	45	33	0	18	757	914	620	461	741	422
"C10orf33"	2879	28313	520	20	57	463	20	0	230	275	72	0	143	97	144	98	253	109
"C10orf35"	1072	3346	0	0	0	0	0	0	0	0	0	0	0	0	0	0	0	0
"C10orf4"	3632	11260	178	0	89	89	0	0	121	7	0	0	241	204	313	175	83	48
"C10orf40"	1816	2697	0	0	0	0	0	0	0	0	0	0	0	0	0	0	0	0
"C10orf41"	2463	7455	0	0	0	0	0	0	0	22	0	0	0	0	0	23	0	0
"C10orf42"	3232	195075	2845	1110	1593	1252	667	443	1830	730	238	892	405	398	458	404	578	397
"C10orf46"	6749	74266	2660	421	1473	1187	194	227	1869	380	594	410	2245	2284	3104	2250	3111	1863
"C10orf47"	3335	48879	0	22	0	0	13	9	20	22	0	0	0	21	9	56	11	6
"C10orf50"	1085	4457	193	0	92	101	0	0	3	4	1	0	61	63	8	0	15	5
"C10orf53"	2430	16408	0	0	0	0	0	0	0	0	0	0	0	0	0	0	0	0
"C10orf54"	4778	26023	5611	1008	3004	2607	552	456	2749	431	5693	861	5758	1396	3899	1745	6008	2517
"C10orf55"	2511	12803	1229	2871	668	561	1482	1389	416	821	714	1790	3855	11382	3692	11251	5776	15792
"C10orf57"	2135	13882	0	0	0	0	0	0	11	0	0	0	492	535	533	430	554	378
"C10orf58"	2060	12998	0	0	0	0	0	0	46	0	0	0	97	62	114	93	84	74
"C10orf59"	1099	451027	0	0	0	0	0	0	11	0	0	15	10	22	15	19	36	9
"C10orf62"	1208	1208	0	0	0	0	0	0	16	0	0	0	0	0	0	0	0	0
"C10orf65"	2562	16605	0	0	0	0	0	0	46	12	0	0	0	0	0	0	0	0
"C10orf67"	2947	28253	0	0	0	0	0	0	0	0	0	0	0	0	0	0	0	0
"C10orf68"	2794	315195	0	0	0	0	0	0	0	0	0	0	6	0	0	0	0	0
"C10orf71"	2979	28352	0	0	0	0	0	0	38	0	0	0	0	0	0	0	0	0
"C10orf72"	6362	101228	64	37	5	59	28	9	71	24	24	0	0	1	0	0	0	0
"C10orf75"	997	14783	0	0	0	0	0	0	28	0	0	0	153	125	63	16	94	62
"C10orf76"	4127	210578	11650	6616	6603	5047	3613	3003	5277	3948	3831	6107	1499	1000	1024	961	1637	781
"C10orf78"	2184	4197	0	0	0	0	0	0	22	10	0	0	81	71	69	62	66	43
"C10orf79"	5402	102475	0	0	0	0	0	0	25	0	0	0	0	0	0	0	0	0
"C10orf81"	3456	30980	0	0	0	0	0	0	0	0	0	0	0	0	0	0	0	0
"C10orf82"	1794	5980	0	0	0	0	0	0	0	0	0	0	0	0	0	0	0	0
"C10orf84"	2775	33269	1527	156	885	642	65	91	894	132	0	36	770	547	618	452	748	452
"C10orf88"	3093	23502	73	0	26	47	0	0	84	0	0	0	191	149	189	104	234	141
"C10orf90"	3288	245505	0	0	0	0	0	0	13	0	0	0	0	0	0	0	0	0
"C10orf91"	740	3112	0	0	0	0	0	0	56	20	0	0	0	0	0	4	70	49
"C10orf93"	1569	13375	0	45	0	0	22	23	55	175	0	13	0	0	0	9	0	0
"C10orf95"	1471	1708	0	0	0	0	0	0	18	0	0	0	38	16	16	11	48	14
"C10orf96"	1707	55602	0	0	0	0	0	0	0	0	0	0	0	0	0	0	0	0
"C10orf99"	830	11497	0	0	0	0	0	0	22	0	0	0	0	0	0	0	0	0
"C11orf1"	1443	3297	0	0	0	0	0	0	14	0	0	0	110	61	82	60	90	58
"C11orf10"	414	3484	58	48	34	24	32	16	216	38	0	61	411	752	950	757	679	452
"C11orf16"	1931	12931	0	0	0	0	0	0	29	0	0	0	0	0	0	1	0	0
"C11orf17"	1439	6865	19	0	0	19	0	0	68	0	0	0	358	255	445	339	448	312
"C11orf2"	2520	15499	999	355	585	414	228	127	438	313	596	501	1924	1728	1611	1437	2219	1527
"C11orf20"	1793	5422	0	0	0	0	0	0	19	39	0	0	0	0	0	0	0	0
"C11orf21"	2267	5638	2072	217	1098	974	145	72	722	87	2023	315	1702	1167	1761	611	3295	1056
"C11orf24"	2104	10666	48	0	16	32	0	0	118	0	0	0	675	458	538	374	649	442
"C11orf30"	5531	106521	1225	379	734	491	191	188	1063	359	49	329	538	577	638	552	776	473
"C11orf31"	1296	2163	617	124	238	379	73	51	271	184	232	305	790	742	869	918	2885	1025
"C11orf34"	1545	12709	198	31	136	62	0	31	68	45	53	19	0	0	0	0	0	0
"C11orf35"	2104	5923	62	0	23	39	0	0	99	65	6	0	17	18	37	23	189	75
"C11orf36"	1882	4801	0	0	0	0	0	0	38	13	0	0	0	0	0	0	0	0
"C11orf40"	657	6398	0	0	0	0	0	0	0	0	0	0	0	0	0	0	0	0
"C11orf41"	11656	131769	0	0	0	0	0	0	0	0	0	0	0	0	0	0	0	0
"C11orf42"	1140	5563	0	0	0	0	0	0	62	10	0	0	0	0	0	0	0	0
"C11orf45"	3620	6126	7	0	0	7	0	0	78	18	0	0	116	103	513	464	287	294
"C11orf46"	1774	14518	712	336	358	354	203	133	351	204	109	55	896	972	481	335	749	399
"C11orf48"	1545	8724	1140	694	607	533	316	378	450	485	360	160	718	452	972	416	1346	916
"C11orf49"	1990	225547	854	134	485	369	77	57	449	100	220	483	1443	189	168	169	247	177
"C11orf51"	898	3194	0	0	0	0	0	0	32	35	0	0	369	243	524	510	660	350
"C11orf52"	1527	14132	0	0	0	0	0	0	10	7	0	0	0	0	0	0	0	0
"C11orf53"	1053	30265	0	0	0	0	0	0	0	0	0	0	0	0	0	0	0	0
"C11orf54"	3627	14071	146	7	86	60	3	4	156	4	0	44	440	450	355	303	507	377
"C11orf57"	3786	10906	130	0	68	62	0	0	34	58	12	51	1154	125	1148	1053	1487	897
"C11orf58"	4070	19755	2959	1828	1678	1281	1286	542	1141	635	1056	871	4097	4791	4085	3543	4973	3003
"C11orf59"	1148	1512	560	44	358	202	21	23	403	51	397	139	1153	2214	1438	2701	1452	3000
"C11orf60"	1831	21493	6	0	6	0	0	0	10	0	0	0	118	120	149	98	196	142
"C11orf61"	3119	9746	3001	1736	1751	1250	971	765	1358	898	1036	1393	365	412	276	239	387	235
"C11orf63"	2919	76958	2	0	2	0	0	0	31	0	0	0	57	82	33	30	47	58
"C11orf64"	856	71397	0	0	0	0	0	0	0	0	0	0	0	0	0	0	0	0
"C11orf65"	2754	136332	4678	2614	2583	2095	1333	1281	2295	1123	1501	975	3967	5422	3474	3196	4050	2353
"C11orf66"	1545	9809	12	0	3	9	0	0	221	56	32	6	32	15	44	18	105	25
"C11orf67"	636	97267	4833	240	4484	349	122	118	512	71	67	148	176	226	330	288	322	342
"C11orf68"	1559	2249	10	0	0	10	0	0	69	33	0	0	794	349	773	341	1066	444
"C11orf70"	1261	35947	0	0	0	0	0	0	0	0	0	0	0	0	0	0	0	0
"C11orf71"	1724	1724	0	0	0	0	0	0	22	17	0	0	152	139	211	150	214	93
"C11orf72"	1175	1960	0	0	0	0	0	0	20	15	0	0	0	0	0	0	0	0
"C11orf73"	1696	43427	69	51	42	27	26	25	151	18	0	15	189	198	358	261	412	273
"C11orf74"	2298	80325	0	0	0	0	0	0	30	0	0	0	39	56	62	70	56	47
"C11orf75"	976	64907	5955	28796	3366	2589	15469	13327	1472	14998	1177	21910	20	1051	905	1564	120	962
"C11orf76"	1685	2326	0	0	0	0	0	0	0	11	0	0	0	0	0	0	0	0
"C11orf80"	2347	98782	405	124	256	149	60	64	299	97	170	150	254	140	144	68	244	84
"C11orf82"	3567	32962	30	0	17	13	0	0	221	0	0	0	172	181	375	308	809	481
"C11orf83"	640	726	255	117	126	129	51	66	73	24	102	62	516	381	361	0	462	246
"C11orf84"	1966	14268	106	0	58	48	0	0	64	57	13	38	197	144	333	298	429	265
"C11orf85"	1832	33630	0	0	0	0	0	0	24	0	0	0	0	1	0	0	0	0
"C11orf86"	1186	1726	0	0	0	0	0	0	0	9	0	0	0	0	0	0	0	0
"C11orf87"	2339	3449	0	0	0	0	0	0	0	0	0	0	0	0	0	0	0	0
"C11orf88"	3105	22247	0	0	0	0	0	0	0	0	0	0	0	0	0	0	0	0
"C11orf9"	5953	35870	244	58	128	116	28	30	806	340	87	73	395	445	362	211	877	370
"C11orf90"	607	29935	0	0	0	0	0	0	0	0	0	0	0	0	0	0	0	0
"C11orf92"	5444	6370	0	0	0	0	0	0	0	0	0	0	0	0	0	0	0	0
"C11orf93"	1419	9379	0	0	0	0	0	0	0	0	0	0	0	0	0	0	0	0
"C11orf94"	370	748	45	0	45	0	0	0	59	34	0	0	0	0	0	0	0	0
"C11orf95"	5586	8750	0	0	0	0	0	0	0	0	0	0	18	12	31	0	30	3
"C12ORF2"	378	96412	0	0	0	0	0	0	0	0	0	15	6	0	3	0	0	0
"C12orf10"	1221	7496	21	0	21	0	0	0	156	80	0	6	213	80	302	225	333	194
"C12orf11"	2990	33141	102	0	64	38	0	0	99	5	0	11	428	471	391	333	457	360
"C12orf12"	2962	2962	0	0	0	0	0	0	0	0	0	0	0	0	0	0	0	0
"C12orf23"	3371	18269	0	0	0	0	0	0	28	10	0	0	199	185	199	148	207	107
"C12orf24"	1531	18749	42	28	42	0	8	20	125	77	137	0	125	65	63	34	96	25
"C12orf26"	1983	120619	1429	222	772	657	145	77	997	159	67	65	215	211	196	162	198	133
"C12orf27"	2456	2456	0	0	0	0	0	0	0	0	0	0	0	0	0	0	0	0
"C12orf28"	1249	32068	0	0	0	0	0	0	0	0	0	0	0	0	0	0	0	0
"C12orf29"	2880	14670	0	0	0	0	0	0	13	0	0	0	188	167	240	140	274	130
"C12orf30"	5804	82105	5763	1537	3232	2531	860	677	2702	928	2654	1715	1401	1580	1933	1163	1035	600
"C12orf32"	1887	12261	288	0	160	128	0	0	189	10	108	0	933	730	881	604	1142	721
"C12orf33"	1618	7008	118	72	55	63	40	32	0	15	0	68	0	2	1	0	0	1
"C12orf34"	3127	56111	15	0	15	0	0	0	221	168	0	2	21	23	41	66	105	73
"C12orf35"	6226	33680	6927	2768	3846	3081	1518	1250	3245	831	2852	1639	3590	2995	3817	1948	4191	1945
"C12orf36"	2753	5624	0	0	0	0	0	0	0	0	0	0	0	0	0	0	0	0
"C12orf39"	589	4956	0	0	0	0	0	0	0	0	0	0	0	0	0	0	0	0
"C12orf4"	3823	50728	455	0	267	188	0	0	612	48	112	0	559	901	852	883	911	735
"C12orf40"	3128	282132	31	54	24	7	32	22	161	80	0	26	271	354	322	305	394	257
"C12orf41"	2913	29015	910	469	588	322	238	231	470	488	189	351	718	437	716	351	837	355
"C12orf42"	2100	258378	0	0	0	0	0	0	7	0	0	0	0	0	0	0	0	0
"C12orf43"	2019	13454	23	0	0	23	0	0	16	60	0	0	52	44	239	208	271	157
"C12orf44"	1440	7522	27	6	20	7	6	0	17	28	0	34	305	627	615	758	793	734
"C12orf45"	625	8408	481	0	211	270	0	0	419	0	79	41	251	434	383	304	581	436
"C12orf47"	2287	3135	96	18	54	42	0	18	99	86	82	104	420	247	451	283	451	264
"C12orf48"	3323	77343	0	0	0	0	0	0	0	0	0	0	55	55	37	4	46	5
"C12orf49"	2780	22249	103	85	60	43	30	55	173	111	114	106	83	87	187	183	187	153
"C12orf5"	8229	38831	4370	205	2487	1883	117	88	2215	33	2764	76	3573	2411	3087	1284	3607	1880
"C12orf50"	3878	45969	0	0	0	0	0	0	0	0	0	0	0	0	0	0	0	0
"C12orf51"	14157	145928	3253	1709	1831	1422	956	753	2070	1243	1677	1308	1002	1895	2373	2307	2648	1865
"C12orf52"	1779	6566	20	0	20	0	0	0	34	17	0	0	398	232	453	315	489	312
"C12orf53"	2546	6856	0	0	0	0	0	0	41	50	0	0	0	0	0	0	0	0
"C12orf54"	691	13144	0	0	0	0	0	0	0	0	0	0	0	0	0	0	0	0
"C12orf55"	2126	51414	0	0	0	0	0	0	9	0	0	0	0	0	0	0	0	0
"C12orf56"	1598	123582	0	0	0	0	0	0	0	0	0	0	0	216	0	0	0	0
"C12orf57"	545	1963	15	0	15	0	0	0	26	17	0	14	99	62	96	96	150	89
"C12orf59"	2837	12847	0	0	0	0	0	0	0	1	0	0	1	1	0	11	0	0
"C12orf6"	4560	64583	1510	626	844	666	380	246	1091	442	72	425	737	978	545	541	617	448
"C12orf60"	1126	20285	0	72	0	0	0	72	12	94	0	0	16	18	0	0	12	0
"C12orf61"	1685	1685	186	103	74	112	41	62	123	991	0	977	0	426	0	482	0	287
"C12orf62"	603	8336	386	40	200	186	12	28	229	0	308	0	731	0	137	0	0	814
"C12orf63"	3713	117297	0	0	0	0	0	0	0	0	0	0	0	0	0	0	0	0
"C12orf64"	2316	22595	0	0	0	0	0	0	0	0	0	0	0	0	0	0	0	0
"C12orf65"	2750	24642	420	28	246	174	28	0	228	131	0	130	419	268	66	41	129	56
"C12orf66"	2602	29658	10	10	0	10	10	0	30	0	0	0	112	54	32	29	102	35
"C12orf68"	2345	2345	0	0	0	0	0	0	20	0	0	0	0	0	0	0	0	0
"C12orf69"	2106	9534	0	0	0	0	0	0	0	0	0	0	0	0	0	0	1	0
"C12orf70"	1280	35376	3	0	0	3	0	0	0	0	0	0	2	0	4	5	8	0
"C12orf71"	967	1466	0	0	0	0	0	0	0	0	0	0	0	0	0	0	0	0
"C12orf72"	2172	9895	0	0	0	0	0	0	31	0	0	0	37	12	11	6	41	9
"C12orf73"	1696	7014	28	12	18	10	12	0	33	0	0	0	52	101	183	99	119	61
"C12orf74"	2149	5486	0	0	0	0	0	0	0	0	0	0	0	0	0	0	0	0
"C12orf75"	1371	40883	0	0	0	0	0	0	0	0	0	0	12	14	6	0	0	0
"C12orf76"	1951	26519	35	0	20	15	0	0	138	19	0	0	235	78	185	83	36	121
"C12orf77"	1508	4005	0	0	0	0	0	0	0	0	0	0	0	0	0	0	0	0
"C13orf1"	3207	23785	116	28	84	32	17	11	89	23	0	0	403	426	384	283	451	333
"C13orf15"	1113	13473	582	455	302	280	284	171	295	412	41	363	316	234	1191	849	1066	781
"C13orf16"	714	23580	0	0	0	0	0	0	45	23	0	0	0	0	0	0	8	0
"C13orf18"	3994	45498	0	68	0	0	36	32	8	439	0	69	21	92	12	157	32	66
"C13orf21"	1009	23873	0	0	0	0	0	0	9	7	0	0	0	0	0	0	0	0
"C13orf23"	5220	28251	1566	249	972	594	146	103	852	112	448	159	1675	1640	1933	1285	2290	1332
"C13orf25 v_1"	5020	6757	50	327	25	25	182	145	86	115	0	187	110	178	72	43	105	131
"C13orf26"	1003	42319	0	0	0	0	0	0	0	0	0	0	0	0	0	0	0	0
"C13orf27"	1688	4157	1	0	1	0	0	0	0	0	0	0	96	99	162	167	132	95
"C13orf28"	764	58334	0	0	0	0	0	0	29	16	0	0	0	0	0	0	0	0
"C13orf29"	6323	6323	0	52	0	0	31	21	14	19	0	0	0	11	0	0	0	0
"C13orf30"	3310	9999	0	0	0	0	0	0	0	0	0	0	0	0	0	0	0	0
"C13orf31"	4269	14649	161	216	100	61	111	105	36	221	0	207	623	1300	799	1394	772	874
"C13orf33"	2394	19398	0	0	0	0	0	0	0	0	0	0	0	0	0	0	0	0
"C13orf34"	3038	28288	448	100	242	206	59	41	386	66	0	0	410	295	308	131	374	116
"C13orf35"	2244	37455	0	0	0	0	0	0	79	15	0	0	0	0	0	0	0	0
"C13orf36"	3206	23926	0	0	0	0	0	0	0	0	0	0	0	0	0	0	0	0
"C13orf37"	2415	19445	22	0	0	22	0	0	40	0	0	0	430	455	488	451	527	406
"C13orf38"	1659	17799	0	0	0	0	0	0	0	0	0	0	0	0	0	0	0	0
"C13orf39"	1226	18555	0	0	0	0	0	0	22	0	0	0	0	0	0	0	0	0
"C14ORF10"	1159	23440	897	1077	479	418	578	499	454	604	263	798	596	536	422	458	535	398
"C14orf1"	1535	10297	1138	19	679	459	11	8	475	23	69	35	379	113	239	67	381	232
"C14orf10"	1758	37002	1026	1342	550	476	728	614	591	807	278	967	1226	1540	753	893	895	658
"C14orf101"	4277	69721	2417	563	1342	1075	320	243	1487	210	426	114	689	589	658	554	818	534
"C14orf102"	3822	53883	485	88	257	228	59	29	435	97	19	46	374	220	464	227	543	247
"C14orf104"	2964	10056	24	0	24	0	0	0	21	0	0	0	223	45	210	75	196	73
"C14orf105"	2639	23983	0	0	0	0	0	0	0	0	0	0	0	0	0	0	0	0
"C14orf106"	4793	50213	3905	236	2264	1641	129	107	1777	47	719	10	2364	1158	2410	917	2405	974
"C14orf109"	1283	2056	0	0	0	0	0	0	20	0	0	0	486	350	712	593	608	538
"C14orf115"	3417	11546	0	0	0	0	0	0	30	15	0	0	0	0	0	0	0	0
"C14orf118"	4771	23046	7337	10162	3955	3382	5448	4714	3370	5211	2447	10454	2949	4178	1780	2708	1630	1265
"C14orf119"	2841	4878	260	0	154	106	0	0	123	22	55	47	0	2395	3876	2290	4303	2457
"C14orf126"	2682	11438	38	0	32	6	0	0	10	0	17	0	241	19	132	79	151	83
"C14orf128"	1281	1281	0	0	0	0	0	0	0	0	0	0	0	0	0	0	0	0
"C14orf129"	2109	23700	45	0	27	18	0	0	31	0	0	0	491	519	592	541	659	449
"C14orf133"	2950	30928	182	33	89	93	16	17	239	66	27	38	608	309	405	260	452	280
"C14orf135"	3941	42904	3521	511	1924	1597	318	193	1605	240	356	178	1535	1793	1836	1654	1762	1374
"C14orf138"	1790	7949	341	68	151	190	32	36	409	124	56	182	202	359	161	173	238	139
"C14orf139"	2823	2823	432	114	426	6	51	63	241	196	598	206	310	1144	379	810	1345	762
"C14orf142"	1178	4224	0	0	0	0	0	0	25	0	0	0	134	185	182	164	188	163
"C14orf143"	1880	31217	691	38	425	266	20	18	789	428	0	42	60	182	88	50	119	51
"C14orf145"	4481	443065	701	606	412	289	349	257	706	495	81	215	161	290	110	119	229	141
"C14orf147"	2535	29325	1308	194	743	565	116	78	584	237	350	266	1103	1116	1216	902	1245	938
"C14orf148"	1783	28957	0	0	0	0	0	0	27	0	0	0	1	1	0	0	0	0
"C14orf149"	1386	11669	457	119	258	199	58	61	198	84	157	34	177	344	362	206	260	183
"C14orf153"	1231	27930	329	39	213	116	19	20	264	76	73	48	223	387	126	248	131	106
"C14orf156"	399	9516	117	198	57	60	131	67	55	121	0	113	257	254	368	321	1111	274
"C14orf159"	3456	111348	11241	2878	6306	4935	1667	1211	5195	1699	8502	3646	2488	2692	3016	2481	4179	2475
"C14orf159 variant protein"	2775	111348	11241	2878	6306	4935	1667	1211	5195	1699	8502	3646	2488	2692	3016	2481	4179	2475
"C14orf165"	945	12320	0	0	0	0	0	0	27	0	0	0	0	0	0	0	0	0
"C14orf166"	1058	15193	22	0	22	0	0	0	120	8	0	0	907	961	925	827	1249	884
"C14orf166B"	1901	43920	9	1	0	9	1	0	124	14	0	0	4	0	14	5	4	0
"C14orf167"	3040	15454	0	0	0	0	0	0	137	12	0	0	360	319	182	255	370	114
"C14orf169"	2462	2463	0	0	0	0	0	0	31	0	0	1	511	314	557	337	691	456
"C14orf174"	2028	13827	0	0	0	0	0	0	0	0	0	0	0	0	0	0	0	0
"C14orf176"	1533	4788	0	0	0	0	0	0	21	0	0	0	0	0	0	0	4	1
"C14orf177"	1287	6149	0	0	0	0	0	0	0	0	0	0	0	0	0	0	0	0
"C14orf178"	895	9194	29	122	29	0	78	44	36	34	0	127	10	11	23	18	16	11
"C14orf179"	1555	98836	15	4	0	15	0	4	134	52	18	0	60	67	42	39	53	55
"C14orf180"	1852	10129	0	0	0	0	0	0	76	36	0	0	0	0	0	0	0	0
"C14orf181"	1728	1728	21	0	0	21	0	0	20	0	0	26	35	0	0	0	63	22
"C14orf182"	2690	25810	38	41	20	18	23	18	23	79	0	1	190	180	69	0	40	0
"C14orf183"	979	8993	44	10	24	20	10	0	115	14	0	0	0	0	0	0	0	0
"C14orf184"	2597	2597	0	0	0	0	0	0	0	0	0	0	0	0	0	0	0	0
"C14orf19"	576	576	0	0	0	0	0	0	0	0	0	0	0	0	0	0	0	0
"C14orf2"	1854	9057	97	17	62	35	0	17	36	60	0	85	1384	1283	780	796	1149	917
"C14orf20"	1395	2551	355	157	174	181	100	57	214	87	0	155	0	68	84	1	0	0
"C14orf21"	2057	5278	2155	235	1174	981	121	114	825	183	1070	283	2937	2568	2483	1785	3081	1841
"C14orf23"	3143	22091	0	0	0	0	0	0	16	0	0	0	0	0	0	0	0	0
"C14orf25"	3585	430192	0	0	0	0	0	0	0	0	0	0	0	0	0	0	0	0
"C14orf28"	3501	6844	0	0	0	0	0	0	21	0	0	0	126	45	82	42	134	36
"C14orf33"	2171	22122	3	0	0	3	0	0	10	0	0	0	13	13	5	0	3	0
"C14orf34"	2072	15540	0	0	0	0	0	0	9	12	0	0	41	31	87	92	58	42
"C14orf37"	3286	294043	11287	11421	6319	4968	6130	5291	4603	4569	5625	8659	4582	6361	4688	4374	5077	3729
"C14orf39"	2780	50091	0	0	0	0	0	0	0	0	0	0	0	0	0	0	0	0
"C14orf4"	4148	4148	75	74	32	43	43	31	11	80	23	0	1299	2243	1145	2623	1099	1687
"C14orf43"	8111	45177	5256	1018	2966	2290	564	454	2411	515	2062	334	2238	871	1966	841	2548	910
"C14orf45"	3116	46736	0	0	0	0	0	0	0	0	0	0	285	318	221	170	234	117
"C14orf48"	1944	10282	0	4	0	0	4	0	26	0	0	0	0	0	0	0	0	0
"C14orf49"	3291	58343	3682	1763	2090	1592	997	766	1654	2518	969	3259	265	757	753	887	980	538
"C14orf50"	1687	3272	0	0	0	0	0	0	0	0	0	0	19	16	11	11	23	0
"C14orf53"	1144	12164	0	0	0	0	0	0	0	0	0	0	0	0	0	0	0	0
"C14orf64"	2473	20196	0	0	0	0	0	0	0	0	0	0	0	0	0	0	0	0
"C14orf68"	1799	7037	0	306	0	0	163	143	73	112	0	0	0	1	0	0	0	0
"C14orf70"	1629	15478	0	0	0	0	0	0	86	47	0	0	0	0	0	0	0	0
"C14orf72"	644	2088	0	0	0	0	0	0	12	0	0	0	0	0	0	0	0	0
"C14orf73"	2588	10413	3	0	3	0	0	0	124	81	0	1	0	5	0	0	0	0
"C14orf79"	1895	9241	36	612	0	36	81	531	56	701	0	241	12	272	20	169	47	95
"C14orf80"	1925	8000	125	691	54	71	420	271	159	1608	0	2672	153	260	198	631	331	410
"C14orf83"	1875	61407	9	0	9	0	0	0	347	114	52	0	342	267	347	202	323	202
"C14orf86"	2413	21644	0	0	0	0	0	0	17	17	0	0	0	0	0	0	0	0
"C14orf93"	2367	23251	43	1	30	13	0	1	136	4	0	0	135	104	125	81	178	79
"C14orf94"	1136	8949	622	108	299	323	58	50	213	36	377	20	1073	1625	1829	759	1906	1089
"C15orf17"	3554	7135	476	185	438	38	99	86	448	137	399	231	931	731	1254	661	1533	603
"C15orf2"	8053	8053	0	0	0	0	0	0	0	0	0	0	0	0	0	0	0	0
"C15orf21"	1933	45596	613	24	366	247	24	0	275	33	282	53	333	282	224	111	310	163
"C15orf23"	2041	11568	17	0	17	0	0	0	52	0	15	3	241	174	170	84	185	99
"C15orf24"	1056	17829	0	0	0	0	0	0	70	27	0	38	699	750	915	347	924	784
"C15orf26"	1581	14873	0	0	0	0	0	0	8	0	0	0	0	0	0	0	0	0
"C15orf27"	2409	145006	1632	1745	843	789	1011	734	1111	2567	236	1235	418	1231	551	612	600	524
"C15orf28"	3282	3282	3038	932	709	2329	477	455	1833	814	3147	1956	57	29	67	103	112	0
"C15orf29"	2749	69423	2762	903	1640	1122	520	383	1768	612	456	693	619	695	633	596	827	598
"C15orf32"	1767	29442	0	0	0	0	0	0	26	0	0	0	0	0	0	0	0	0
"C15orf33"	2010	292528	692	99	401	291	67	32	515	145	97	54	788	979	142	132	159	138
"C15orf34"	2677	2677	156	0	62	94	0	0	116	49	113	0	623	534	754	700	1036	653
"C15orf37"	2085	2085	0	0	0	0	0	0	0	0	0	0	23	12	11	32	11	20
"C15orf38"	6265	82392	4234	661	2209	2025	424	237	2250	258	516	77	6639	6619	2676	1722	6555	3174
"C15orf39"	4518	13277	491	30	256	235	19	11	518	237	621	27	1205	287	807	299	1853	309
"C15orf40"	1703	7249	119	0	53	66	0	0	83	11	0	0	217	206	677	507	678	556
"C15orf41"	2901	230638	0	0	0	0	0	0	24	0	0	0	32	66	0	0	12	0
"C15orf42"	6689	52435	0	0	0	0	0	0	10	0	0	0	0	0	0	0	0	0
"C15orf43"	1277	22518	0	0	0	0	0	0	0	0	0	0	0	0	0	0	0	0
"C15orf44"	2676	32341	131	7	88	43	4	3	122	20	20	25	740	750	858	640	569	717
"C15orf45"	1822	1822	0	0	0	0	0	0	0	0	0	0	0	0	0	0	0	0
"C15orf48"	919	2884	3	778	0	3	420	358	0	277	0	577	81	865	318	1801	292	1352
"C15orf49"	419	419	0	0	0	0	0	0	0	0	0	0	0	0	0	0	0	0
"C15orf5"	1496	1496	0	0	0	0	0	0	0	0	0	17	0	0	0	0	0	0
"C15orf50"	1334	7734	0	0	0	0	0	0	13	0	0	0	0	0	0	0	0	0
"C15orf52"	5337	9516	21	23	18	3	23	0	195	131	3	0	73	20	116	22	290	141
"C15orf53"	2045	3442	0	0	0	0	0	0	0	0	0	0	0	0	0	0	0	0
"C15orf54"	3082	4165	0	0	0	0	0	0	0	0	0	0	0	0	0	0	0	0
"C15orf55"	4110	14415	0	0	0	0	0	0	13	0	0	0	0	0	0	0	0	0
"C15orf56"	2127	2244	0	0	0	0	0	0	0	0	0	0	0	0	0	0	0	0
"C15orf57"	1734	11956	1052	449	559	493	236	213	633	520	199	303	802	785	548	408	786	573
"C15orf58"	1354	7826	33	0	11	22	0	0	45	0	0	0	23	18	82	19	63	0
"C15orf59"	1344	11675	0	0	0	0	0	0	41	44	0	0	0	0	0	0	0	0
"C15orf60"	929	116854	2219	506	1216	1003	303	203	999	263	522	240	0	0	0	0	0	1
"C15orf61"	1296	6118	10	0	0	10	0	0	13	0	0	0	120	19	95	58	163	71
"C15orf62"	2488	2488	363	0	228	135	0	0	202	15	239	0	96	13	133	0	188	0
"C15orf63"	2398	3213	1420	1119	781	639	586	533	648	602	1166	910	11139	10904	16823	16236	19192	14700
"C16orf10"	562	562	18	0	0	18	0	0	39	31	0	0	0	0	0	0	0	0
"C16orf11"	2219	5108	0	0	0	0	0	0	0	0	0	0	0	1	0	0	0	0
"C16orf13"	846	1920	27	12	27	0	12	0	35	15	0	0	267	159	271	289	318	294
"C16orf14"	1421	6025	532	317	289	243	147	170	287	274	339	898	551	432	937	1224	1025	976
"C16orf3"	995	995	0	0	0	0	0	0	27	0	0	0	0	0	0	0	0	0
"C16orf35"	3029	54401	1319	30	876	443	4	26	1011	184	676	7	1226	161	1155	820	1572	963
"C16orf38"	1424	2529	2	0	2	0	0	0	42	18	0	0	0	1	0	0	0	0
"C16orf42"	1208	2632	57	4	31	26	0	4	35	21	0	0	83	248	220	337	417	168
"C16orf45"	2236	153792	1	0	0	1	0	0	59	10	0	0	19	14	0	0	4	0
"C16orf46"	1914	23771	0	0	0	0	0	0	13	0	0	0	23	36	3	0	6	0
"C16orf48"	1545	3780	0	0	0	0	0	0	12	0	0	0	195	125	127	114	289	128
"C16orf5"	2821	4179	994	980	538	456	561	419	613	892	407	443	674	699	817	917	958	737
"C16orf52"	952	68741	1631	440	866	765	246	194	895	404	75	620	70	60	47	28	44	24
"C16orf53"	3826	6288	1090	146	735	355	103	43	397	170	485	113	1278	913	1121	621	1534	856
"C16orf54"	2598	3556	71	0	44	27	0	0	58	0	0	0	820	187	674	92	885	282
"C16orf55"	3373	3671	41	0	22	19	0	0	125	34	0	0	56	21	45	15	58	30
"C16orf57"	2260	20218	551	94	318	233	67	27	402	55	298	0	1732	1757	1443	974	1856	1123
"C16orf58"	2773	18893	151	60	100	51	31	29	268	96	91	24	734	751	431	422	1147	350
"C16orf59"	2168	4850	29	0	0	29	0	0	46	18	0	0	0	0	0	0	0	0
"C16orf61"	732	30803	2274	1051	1344	930	562	489	1043	728	338	1098	508	619	240	389	466	416
"C16orf62"	3581	145406	2625	1493	1504	1121	852	641	1601	828	455	1362	1398	1494	1926	1572	2183	1596
"C16orf63"	2255	22872	53	0	15	38	0	0	200	18	0	0	1049	1097	747	580	852	574
"C16orf65"	1033	16944	94	0	49	45	0	0	57	0	0	37	0	0	0	0	0	1
"C16orf67"	1783	6811	0	35	0	0	21	14	18	5	0	13	0	0	1	3	9	12
"C16orf68"	1579	24552	1185	361	656	529	204	157	755	201	835	424	225	379	533	423	630	357
"C16orf7"	3144	12576	1983	1835	1018	965	953	882	488	1033	882	1528	1084	1217	829	1338	2756	1874
"C16orf70"	2855	38527	1144	71	715	429	31	40	640	83	422	75	1158	500	1241	427	1477	683
"C16orf71"	2714	15108	11	0	11	0	0	0	81	17	0	0	0	0	0	0	0	0
"C16orf72"	3973	28010	6704	5065	3767	2937	2808	2257	2899	2387	4201	5386	5106	5036	4744	3779	5104	3020
"C16orf73"	1898	38197	13	1	0	13	1	0	0	0	0	0	0	2	8	4	0	0
"C16orf74"	899	43565	62	0	24	38	0	0	316	149	0	0	2	7	0	4	17	0
"C16orf75"	1875	102113	2115	1093	1184	931	599	494	1176	814	2355	1448	2163	1553	3097	1946	4090	1836
"C16orf78"	974	25511	0	0	0	0	0	0	0	12	0	0	0	0	0	0	0	0
"C16orf79"	979	1759	26	21	12	14	21	0	8	86	71	0	1540	224	414	250	598	355
"C16orf80"	1297	15801	16	0	0	16	0	0	35	11	0	0	146	305	308	278	375	215
"C16orf81"	2247	4457	0	0	0	0	0	0	0	0	0	0	0	0	0	0	0	0
"C16orf82"	2269	2269	0	0	0	0	0	0	0	0	0	0	0	0	0	0	0	0
"C16orf85"	447	12942	0	0	0	0	0	0	13	28	0	0	0	2	0	0	0	0
"C16orf86"	1718	1940	0	0	0	0	0	0	64	17	0	0	100	66	89	58	151	74
"C16orf87"	1387	29117	212	38	118	94	17	21	140	46	18	26	75	111	265	173	335	66
"C16orf88"	1953	11818	59	0	37	22	0	0	29	27	0	0	264	144	175	48	338	134
"C16orf89"	1879	21989	154	28	78	76	28	0	399	64	0	0	72	57	0	0	0	0
"C16orf90"	906	1938	0	0	0	0	0	0	20	0	0	0	0	0	0	0	0	0
"C16orf91"	1074	9401	1	0	1	0	0	0	97	40	0	0	168	122	175	134	219	128
"C16orf92"	899	1370	0	0	0	0	0	0	10	13	0	0	0	0	0	0	0	0
"C16orf93"	1836	4791	65	43	65	0	43	0	36	22	0	0	29	25	38	30	650	18
"C17orf1"	2099	5469	1866	1391	997	869	581	810	787	1387	1826	7472	4470	3902	4259	6799	6616	5390
"C17orf100"	1559	1560	1311	0	676	635	0	0	525	31	222	31	381	232	181	1	213	0
"C17orf101"	1458	26364	143	8	88	55	5	3	187	86	0	0	252	51	185	219	68	277
"C17orf102"	3999	5248	0	0	0	0	0	0	0	0	0	0	0	0	0	0	0	0
"C17orf103"	4785	14394	254	24	153	101	10	14	250	99	115	2	475	344	608	364	762	431
"C17orf104"	4168	14610	37	0	18	19	0	0	40	0	0	0	0	517	0	1	1	1
"C17orf105"	833	4253	0	0	0	0	0	0	0	0	0	0	0	0	0	0	0	0
"C17orf106"	1953	22323	76	104	40	36	66	38	105	134	8	78	113	340	334	338	522	250
"C17orf107"	3085	3281	19	146	9	10	88	58	103	199	0	284	68	566	17	273	36	197
"C17orf108"	2221	15025	0	0	0	0	0	0	10	0	0	0	39	39	24	32	58	0
"C17orf28"	3360	22062	1	0	0	1	0	0	101	57	0	0	2	0	0	0	0	0
"C17orf37"	756	1379	5	27	0	5	12	15	0	4	0	0	396	339	586	140	195	124
"C17orf39"	4238	29109	16	0	16	0	0	0	88	24	0	0	320	217	386	135	508	226
"C17orf42"	1695	6834	284	12	165	119	12	0	145	0	0	0	141	123	108	86	250	145
"C17orf44"	2096	3414	164	18	78	86	0	18	106	47	206	31	351	212	335	131	360	184
"C17orf45"	1260	3039	649	461	260	389	229	232	553	443	95	190	2556	2462	994	1822	2050	1083
"C17orf46"	1932	7721	27	0	27	0	0	0	67	106	0	34	1	0	0	0	0	0
"C17orf47"	2079	2737	0	0	0	0	0	0	11	0	0	0	0	0	0	0	0	0
"C17orf48"	1521	13949	12	0	12	0	0	0	15	0	0	0	98	105	88	59	104	62
"C17orf49"	2036	5042	518	510	256	262	269	241	173	350	92	210	192	5040	5218	5745	7059	5355
"C17orf50"	1033	4183	0	0	0	0	0	0	12	23	0	0	0	0	0	0	0	0
"C17orf51"	7913	23371	0	0	0	0	0	0	29	0	0	0	101	44	117	33	196	43
"C17orf53"	2683	20520	0	2	0	0	0	2	86	28	0	0	3	13	0	8	6	6
"C17orf54"	1553	79269	0	0	0	0	0	0	61	12	0	0	0	0	0	0	0	0
"C17orf55"	2974	6426	0	0	0	0	0	0	46	42	0	0	0	0	0	0	0	0
"C17orf56"	3653	10126	1078	419	575	503	243	176	517	323	758	498	358	465	551	470	1328	374
"C17orf57"	3950	117327	1546	242	889	657	129	113	1729	160	136	123	266	339	318	153	253	94
"C17orf58"	1566	2549	17	216	0	17	73	143	0	49	0	169	119	1857	158	433	156	181
"C17orf59"	1914	1914	8	0	0	8	0	0	50	12	0	0	643	210	816	242	1051	383
"C17orf60"	635	3192	581	345	309	272	195	150	202	456	511	2632	1763	2375	276	203	257	171
"C17orf61"	449	1123	0	0	0	0	0	0	0	0	0	0	94	280	253	236	199	244
"C17orf62"	2484	5619	4458	1188	2354	2104	636	552	1131	517	5186	1428	5160	3864	5691	3595	8288	4259
"C17orf63"	4251	56459	1389	60	782	607	36	24	857	184	510	342	395	342	494	301	578	328
"C17orf64"	965	8923	0	0	0	0	0	0	0	0	0	0	0	0	10	3	10	5
"C17orf65"	2247	10730	372	18	204	168	18	0	294	159	237	79	331	240	256	142	516	172
"C17orf66"	1984	13937	12	45	0	12	14	31	33	401	0	99	0	5	0	2	0	2
"C17orf67"	2019	41983	72	12	31	41	12	0	105	0	0	0	111	75	20	83	65	28
"C17orf68"	7094	23275	1486	511	810	676	292	219	776	319	620	488	381	869	1012	833	1157	580
"C17orf69"	2463	3330	0	0	0	0	0	0	0	0	0	0	0	0	0	0	0	0
"C17orf70"	3855	12517	524	97	300	224	44	53	414	238	523	271	1116	989	1124	680	940	615
"C17orf71"	3269	5241	20	0	20	0	0	0	24	0	0	0	666	374	851	261	859	382
"C17orf72"	3111	5933	0	0	0	0	0	0	122	15	0	0	60	55	47	66	82	52
"C17orf73"	1026	10159	21	0	21	0	0	0	11	0	0	0	0	0	0	0	0	0
"C17orf74"	1650	1951	0	0	0	0	0	0	0	0	0	0	1	0	0	0	0	0
"C17orf75"	1622	10799	3	0	0	3	0	0	0	0	0	0	114	115	104	70	158	75
"C17orf76"	2789	50154	240	22	39	201	0	22	440	199	0	0	1923	1838	82	273	88	297
"C17orf77"	2528	9293	0	0	0	0	0	0	0	9	0	0	0	0	0	0	0	0
"C17orf78"	1867	16677	8	0	8	0	0	0	15	7	0	20	0	0	0	0	0	0
"C17orf79"	1088	7443	0	0	0	0	0	0	18	8	0	0	199	187	703	577	766	598
"C17orf80"	3708	16721	68	0	49	19	0	0	60	0	0	0	438	248	523	105	548	227
"C17orf81"	2260	7701	57	399	31	26	253	146	133	215	28	849	826	1414	671	1005	1172	717
"C17orf82"	1531	1531	0	0	0	0	0	0	14	0	0	0	0	0	0	0	0	0
"C17orf85"	4545	18204	997	455	583	414	229	226	519	312	381	371	443	1228	524	773	1141	387
"C17orf86"	2171	6344	189	203	70	119	85	118	120	181	67	193	176	320	112	148	108	137
"C17orf87"	2125	21778	7269	3320	2979	4290	1729	1591	2456	1057	9255	2630	2056	17408	2440	1442	3268	2151
"C17orf89"	563	1989	91	11	51	40	11	0	91	16	0	0	143	12	248	247	296	165
"C17orf90"	1560	1560	157	0	96	61	0	0	88	52	0	25	369	151	13	83	591	237
"C17orf91"	1371	4703	512	944	261	251	500	444	286	437	212	1008	490	1225	548	1547	672	871
"C17orf95"	1107	7013	162	8	52	110	4	4	86	571	286	662	649	539	516	494	698	487
"C17orf96"	3228	3228	155	334	110	45	185	149	14	174	0	346	2057	9578	2083	9174	2296	6538
"C17orf97"	1752	4251	0	0	0	0	0	0	50	25	0	0	55	33	0	0	9	0
"C17orf98"	569	6303	0	0	0	0	0	0	9	14	0	0	0	0	0	0	0	0
"C17orf99"	2407	6093	0	0	0	0	0	0	37	14	0	0	0	1	0	0	0	0
"C18orf1"	8950	41090	44402	32044	24582	19820	17264	14780	22772	18089	21783	28844	1933	1781	1604	955	2223	1046
"C18orf10"	2072	33126	218	13	138	80	13	0	209	50	0	25	613	615	533	429	716	487
"C18orf16"	2400	70640	0	0	0	0	0	0	13	0	0	0	0	0	0	0	0	0
"C18orf18"	1306	1306	0	0	0	0	0	0	0	0	0	0	327	313	354	277	458	243
"C18orf19"	4385	63243	387	145	170	217	87	58	509	208	0	0	132	345	355	176	453	238
"C18orf2"	2238	91320	0	0	0	0	0	0	0	0	0	0	70	75	0	0	0	0
"C18orf20"	873	69019	0	0	0	0	0	0	0	0	0	0	0	0	0	0	0	0
"C18orf21"	1043	6654	84	0	44	40	0	0	81	9	0	17	294	179	267	121	437	205
"C18orf22"	1609	5087	224	0	145	79	0	0	250	9	0	14	376	330	347	310	473	284
"C18orf23"	2410	2410	0	0	0	0	0	0	0	0	0	0	0	0	0	0	0	0
"C18orf25"	5469	92968	1724	798	1001	723	441	357	1092	860	437	1282	877	947	949	743	995	673
"C18orf26"	2030	8336	0	0	0	0	0	0	0	0	0	0	0	0	0	0	0	0
"C18orf30"	1800	31144	0	0	0	0	0	0	0	0	0	0	0	0	0	0	0	0
"C18orf32"	1131	5573	88	25	51	37	12	13	58	8	31	0	1551	1529	1269	1029	1540	1087
"C18orf34"	3450	502681	0	0	0	0	0	0	0	0	0	0	0	0	0	0	0	0
"C18orf45"	3005	141946	195	119	100	95	55	64	491	61	0	46	218	196	194	253	214	133
"C18orf54"	5442	21508	0	0	0	0	0	0	12	0	0	0	0	8	0	9	10	0
"C18orf55"	1540	10460	174	0	99	75	0	0	129	0	0	0	508	393	495	298	540	309
"C18orf56"	845	8721	0	0	0	0	0	0	0	0	0	0	0	2	4	2	1	0
"C18orf58"	1420	93320	0	0	0	0	0	0	0	0	0	0	0	0	0	0	0	0
"C18orf62"	2509	11618	0	0	0	0	0	0	0	0	0	0	0	0	0	0	0	0
"C18orf8"	2192	28282	1303	1145	720	583	587	558	633	336	401	507	1104	1455	1677	1664	1751	1556
"C19orf10"	1048	12851	189	44	88	101	18	26	177	161	162	212	817	846	1524	1528	1212	1049
"C19orf12"	4684	16659	1159	191	566	593	115	76	452	129	1044	381	1002	844	665	311	818	364
"C19orf15"	3550	35147	387	109	188	199	62	47	412	227	94	27	30	8	7	0	50	22
"C19orf18"	919	16097	0	0	0	0	0	0	17	0	0	0	0	5	0	0	0	0
"C19orf2"	2284	73188	3710	400	2085	1625	238	162	2001	259	593	551	850	953	924	875	1491	988
"C19orf20"	1115	12158	354	56	194	160	44	12	252	240	223	246	16	178	267	218	234	254
"C19orf21"	2857	13175	0	0	0	0	0	0	105	43	0	0	0	0	0	0	0	0
"C19orf22"	1817	16724	403	157	204	199	60	97	233	413	357	1251	1288	1310	1387	1209	1892	1238
"C19orf23"	1357	2790	333	27	290	43	0	27	71	103	5	61	1113	255	359	268	410	184
"C19orf24"	897	3724	40	0	23	17	0	0	56	25	0	0	68	55	661	129	746	485
"C19orf25"	2404	5918	382	399	228	154	210	189	263	265	690	666	504	107	87	69	705	392
"C19orf26"	2573	8045	1	0	0	1	0	0	50	43	0	0	0	1	26	18	23	3
"C19orf28"	2293	19308	15567	18992	8445	7122	12152	6840	3102	14643	15373	49124	15390	19113	22658	35466	23506	24768
"C19orf29"	3632	16186	177	180	85	92	92	88	268	334	44	646	458	647	713	888	971	698
"C19orf31"	2279	2279	330	108	263	67	38	70	151	23	437	129	69	42	45	38	142	32
"C19orf33"	465	844	35	0	8	27	0	0	62	0	63	0	11	23	28	21	26	21
"C19orf34"	1258	2022	846	469	487	359	232	237	259	202	919	1148	23	12	0	0	0	0
"C19orf35"	2574	7552	263	0	67	196	0	0	147	162	14	0	62	74	188	17	210	26
"C19orf36"	1754	2717	12	0	4	8	0	0	45	36	0	25	28	0	8	25	26	23
"C19orf38"	1096	21256	31	5	16	15	5	0	102	22	0	0	454	446	383	330	658	472
"C19orf39"	1664	2246	0	0	0	0	0	0	42	12	0	0	126	43	152	65	196	90
"C19orf40"	1138	4809	0	0	0	0	0	0	0	0	0	0	47	23	34	17	32	0
"C19orf41"	821	10735	0	0	0	0	0	0	15	0	0	0	0	0	0	0	0	0
"C19orf42"	1392	29395	3274	1230	1815	1459	698	532	1388	534	2814	1944	2376	1834	1138	1033	1743	1047
"C19orf43"	912	4076	691	464	446	245	234	230	237	247	638	480	1176	1839	2056	981	3026	1446
"C19orf44"	3355	24960	112	47	33	79	34	13	88	113	42	134	604	566	703	703	845	538
"C19orf45"	1688	10893	0	0	0	0	0	0	62	0	0	0	0	1	0	0	0	0
"C19orf46"	1549	5672	0	0	0	0	0	0	60	14	0	0	0	0	0	0	0	0
"C19orf47"	2138	20826	23	0	16	7	0	0	164	25	0	13	56	105	215	62	87	135
"C19orf48"	1848	6172	79	0	35	44	0	0	49	35	0	22	190	118	225	153	240	215
"C19orf50"	1813	7854	449	144	277	172	78	66	281	145	28	243	1335	1225	1835	1552	2099	1573
"C19orf51"	2256	7989	1	0	1	0	0	0	13	0	0	0	1	0	0	0	0	0
"C19orf52"	1482	1578	31	0	0	31	0	0	62	12	0	49	0	120	302	133	406	142
"C19orf53"	910	4329	55	0	0	55	0	0	163	42	0	0	568	123	267	812	252	756
"C19orf54"	2759	9069	49	6	23	26	0	6	158	164	7	0	219	172	197	164	315	169
"C19orf55"	2158	11035	196	43	110	86	21	22	264	105	198	224	355	318	256	142	347	184
"C19orf56"	865	1586	287	521	206	81	270	251	3	331	69	690	1481	1051	1670	1546	2202	1786
"C19orf57"	2428	23743	0	3	0	0	0	3	84	67	0	0	0	0	0	0	0	0
"C19orf59"	1315	2778	0	0	0	0	0	0	103	0	0	0	17	0	34	34	52	48
"C19orf6"	2719	11493	1439	896	786	653	437	459	511	578	1815	1566	2497	2403	2456	4310	6587	2611
"C19orf60"	2391	3653	239	30	143	96	12	18	123	80	151	0	1222	863	1356	990	1728	1060
"C19orf61"	2428	22722	1538	2680	708	830	1377	1303	820	1314	692	2449	882	1186	821	1227	881	1013
"C19orf62"	1495	10102	397	22	205	192	7	15	174	149	184	119	773	853	1295	833	1655	1080
"C19orf63"	2041	6873	316	65	157	159	20	45	267	115	0	109	2170	1774	2598	2346	2884	2383
"C19orf66"	2157	6401	272	33	125	147	17	16	98	90	58	21	590	478	864	558	947	697
"C19orf68"	2283	26930	107	0	46	61	0	0	56	0	0	1	68	34	105	0	118	47
"C19orf69"	947	1608	0	0	0	0	0	0	17	0	0	0	0	0	0	0	0	0
"C19orf70"	904	2480	38	19	19	19	19	0	84	37	0	41	349	266	497	391	632	595
"C19orf71"	674	4874	11171	2032	6073	5098	1945	87	1903	10323	8511	49124	22	17	901	17831	55	3598
"C19orf73"	744	744	0	0	0	0	0	0	44	29	0	0	26	3	41	4	74	29
"C19orf75"	1712	11620	0	0	0	0	0	0	0	0	0	0	0	0	0	0	0	0
"C19orf76"	2114	2307	0	0	0	0	0	0	60	97	0	31	0	0	0	0	0	3
"C19orf77"	912	6137	0	2	0	0	2	0	101	84	0	0	0	0	0	0	0	0
"C1D"	1276	20828	585	669	372	213	381	288	307	412	123	515	350	388	574	485	645	548
"C1GALT1"	1940	61735	1453	264	970	483	80	184	950	216	202	169	670	820	386	308	408	293
"C1GALT1C1"	1836	4407	0	0	0	0	0	0	0	0	0	0	630	740	705	576	639	504
"C1QA"	1100	3058	117	24	58	59	0	24	163	71	0	0	6450	5315	9431	9968	11381	7620
"C1QB"	1046	8348	1160	378	656	504	192	186	575	526	294	437	10914	10289	15091	16154	13759	8380
"C1QBP"	1169	6374	22	0	10	12	0	0	96	37	0	0	1367	1698	1451	600	1629	1233
"C1QC"	1314	4458	466	126	219	247	64	62	261	141	68	113	9686	7982	16352	15173	18081	9371
"C1QL1"	1501	8584	0	0	0	0	0	0	0	0	0	0	0	0	0	0	0	0
"C1QL2"	2051	2654	0	0	0	0	0	0	0	0	0	0	0	0	0	0	0	0
"C1QL3"	2495	8264	124	9	65	59	9	0	29	22	0	0	781	683	116	59	198	91
"C1QL4"	2067	4773	0	0	0	0	0	0	0	0	0	0	0	0	0	0	0	0
"C1QTNF1"	2924	6196	0	0	0	0	0	0	129	167	0	0	0	2	0	0	0	0
"C1QTNF2"	2388	22863	0	0	0	0	0	0	14	0	0	0	0	0	0	0	0	0
"C1QTNF3"	3777	25355	31	1	10	21	0	1	41	0	0	0	48	38	24	15	32	0
"C1QTNF4"	1416	4747	7	0	0	7	0	0	11	0	0	0	0	0	0	0	0	0
"C1QTNF6"	5013	18137	19	1	17	2	0	1	215	81	0	0	0	0	4	0	0	3
"C1QTNF7"	4520	106232	0	0	0	0	0	0	58	8	0	45	0	0	0	0	0	0
"C1QTNF8"	3411	8020	0	0	0	0	0	0	89	61	0	0	0	0	0	0	0	0
"C1QTNF9"	1826	12951	0	0	0	0	0	0	9	0	0	0	0	0	0	0	0	0
"C1QTNF9B"	1073	5767	0	0	0	0	0	0	0	0	0	0	3	0	0	0	0	3
"C1R"	2271	57528	0	0	0	0	0	0	17	0	0	0	0	0	0	0	0	3
"C1RL"	3370	14644	191	0	105	86	0	0	130	20	20	0	391	318	94	73	182	95
"C1S"	3179	82075	1433	148	849	584	100	48	974	212	235	92	34	72	105	99	137	94
"C1orf100"	582	36456	0	0	0	0	0	0	25	0	0	0	0	0	0	0	0	0
"C1orf101"	3214	178989	0	0	0	0	0	0	42	0	0	0	6	3	0	0	6	0
"C1orf103"	3338	16755	364	234	237	127	141	93	231	157	0	89	272	449	305	380	917	303
"C1orf104"	1840	4683	1049	626	559	490	359	267	379	299	136	647	1151	1685	1416	1290	1811	1133
"C1orf105"	986	48137	105	0	36	69	0	0	93	1	0	17	404	382	448	323	582	357
"C1orf106"	4164	20866	0	0	0	0	0	0	13	2	0	0	0	0	0	0	0	0
"C1orf107"	8510	29577	62	20	18	44	20	0	145	25	32	21	688	608	605	337	818	522
"C1orf109"	2456	8927	38	0	25	13	0	0	119	41	21	0	254	177	251	137	265	115
"C1orf110"	1556	14520	0	0	0	0	0	0	0	0	0	0	0	0	0	0	0	0
"C1orf111"	1176	3131	0	0	0	0	0	0	8	0	0	0	0	0	0	0	0	0
"C1orf112"	3879	190984	209	27	121	88	15	12	229	3	57	23	614	549	569	431	466	175
"C1orf113"	3201	17778	12	6	12	0	4	2	94	102	0	24	223	126	388	349	442	198
"C1orf114"	2213	65795	0	0	0	0	0	0	23	0	0	0	0	0	0	2	0	0
"C1orf115"	2974	8873	10	0	10	0	0	0	20	0	0	0	217	169	171	89	524	361
"C1orf116"	5506	14237	0	0	0	0	0	0	0	0	0	0	0	0	0	0	0	0
"C1orf120"	742	7194	0	0	0	0	0	0	0	0	0	0	0	0	0	0	0	0
"C1orf122"	2233	2477	12	0	0	12	0	0	26	85	0	173	2404	1006	193	237	94	2858
"C1orf123"	1090	6517	123	21	53	70	15	6	80	0	0	0	240	237	228	147	674	157
"C1orf124"	3841	16308	182	55	95	87	29	26	204	94	0	26	332	363	295	204	397	203
"C1orf125"	3406	188755	191	632	101	90	374	258	21	29	0	35	20	0	0	0	0	0
"C1orf126"	7105	40650	46	0	19	27	0	0	156	26	0	0	25	0	8	53	31	3
"C1orf127"	2325	17727	0	0	0	0	0	0	74	11	0	0	0	0	20	0	0	0
"C1orf128"	1626	9846	98	42	65	33	4	38	57	8	75	0	802	734	858	770	993	653
"C1orf129"	3186	129295	0	0	0	0	0	0	0	0	0	0	0	0	0	0	0	0
"C1orf130"	3957	53216	0	0	0	0	0	0	16	14	0	0	0	0	0	0	0	0
"C1orf131"	2650	4484	16	21	16	0	9	12	70	44	10	44	226	220	293	206	311	245
"C1orf133"	802	2664	0	0	0	0	0	0	0	0	0	0	0	0	0	0	0	0
"C1orf135"	2064	25353	4	0	0	4	0	0	9	0	0	0	11	0	0	0	3	0
"C1orf14"	2441	53554	0	0	0	0	0	0	0	0	0	0	113	0	0	0	0	0
"C1orf140"	4494	6370	0	0	0	0	0	0	0	0	0	0	0	0	0	0	0	0
"C1orf141"	2355	42796	0	0	0	0	0	0	0	0	0	0	0	0	0	0	0	0
"C1orf142"	2378	5815	299	10	175	124	10	0	145	7	179	49	186	155	283	191	305	212
"C1orf144"	3637	31058	3060	5323	1784	1276	2753	2570	1027	2932	958	5190	4160	5120	4387	4603	4966	4307
"C1orf146"	781	27795	0	0	0	0	0	0	0	0	0	0	0	0	0	0	0	0
"C1orf149"	2744	21693	693	93	388	305	52	41	481	87	371	68	846	1625	1688	1160	2305	1246
"C1orf150"	3037	69454	0	0	0	0	0	0	0	0	0	0	260	356	138	172	56	26
"C1orf151"	2593	31709	2465	3996	1458	1007	2090	1906	929	2328	1154	3752	2075	2814	1295	2017	1962	1333
"C1orf156"	1442	2358	0	0	0	0	0	0	0	0	0	0	122	47	103	11	96	0
"C1orf157"	1895	8819	0	0	0	0	0	0	0	0	0	0	0	0	0	0	0	0
"C1orf158"	1022	14940	0	0	0	0	0	0	0	0	0	0	0	0	0	0	0	0
"C1orf159"	2749	10358	564	244	336	228	121	123	706	687	42	639	103	126	169	69	237	150
"C1orf161"	3236	23487	0	0	0	0	0	0	0	0	0	0	0	0	0	0	0	0
"C1orf162"	922	4531	543	0	293	250	0	0	242	0	319	0	4703	4228	6272	4391	6545	3726
"C1orf163"	1617	11526	72	0	24	48	0	0	15	15	0	24	753	19	77	47	82	29
"C1orf167"	2677	17504	6	438	5	1	252	186	791	210	171	156	1743	0	0	1	2763	0
"C1orf168"	3479	100893	0	0	0	0	0	0	0	0	0	0	0	0	0	0	0	0
"C1orf170"	3045	6896	0	0	0	0	0	0	74	50	0	0	24	16	0	0	0	0
"C1orf172"	1789	10838	0	0	0	0	0	0	9	0	0	0	0	0	0	0	0	0
"C1orf173"	7173	105628	0	0	0	0	0	0	0	0	0	0	4	0	0	0	0	0
"C1orf174"	2511	11156	164	0	70	94	0	0	167	59	0	23	24	185	558	290	518	315
"C1orf175"	4399	68514	23	111	0	23	55	56	253	205	25	9	8	62	83	62	171	108
"C1orf177"	1799	36202	0	0	0	0	0	0	85	31	0	0	0	0	0	0	0	0
"C1orf180"	2887	6792	0	0	0	0	0	0	0	0	0	0	0	0	0	0	0	0
"C1orf182"	752	9680	0	30	0	0	30	0	53	34	124	166	163	366	231	301	174	143
"C1orf183"	2274	13654	80	0	32	48	0	0	136	17	107	0	278	135	256	35	185	86
"C1orf185"	914	45848	0	0	0	0	0	0	0	0	0	0	0	0	0	0	0	0
"C1orf186"	1671	49777	4	0	0	4	0	0	22	0	0	0	57	70	110	87	67	43
"C1orf187"	1780	28557	0	0	0	0	0	0	97	68	0	0	0	0	0	0	0	0
"C1orf189"	391	6963	0	0	0	0	0	0	3	0	0	0	0	0	0	0	0	0
"C1orf190"	1850	17923	0	0	0	0	0	0	35	0	0	0	0	2	0	0	0	0
"C1orf192"	778	3144	435	46	242	193	17	29	91	23	180	0	1446	1604	2526	2479	3068	242
"C1orf194"	735	7907	0	0	0	0	0	0	0	0	0	0	0	0	0	0	0	0
"C1orf198"	3824	32471	0	0	0	0	0	0	11	0	0	0	121	116	130	66	114	64
"C1orf2"	2017	8279	23	0	11	12	0	0	72	44	0	0	461	233	307	235	499	335
"C1orf200"	1824	1977	661	193	314	347	97	96	239	231	397	1236	0	0	0	8	0	0
"C1orf201"	2837	56742	0	0	0	0	0	0	11	0	0	0	20	6	7	3	9	0
"C1orf203"	1870	13910	891	3589	459	432	1974	1615	231	3514	231	2292	3147	5833	5259	9419	3098	6161
"C1orf204"	2507	20875	3057	616	1660	1397	349	267	1498	159	1527	1013	13467	9048	10944	5944	16204	7667
"C1orf21"	10314	242007	20	33	11	9	18	15	9	0	0	0	9	23	7	4	9	0
"C1orf210"	1476	3693	0	0	0	0	0	0	22	10	0	0	0	0	0	0	0	0
"C1orf211"	1250	1621	0	0	0	0	0	0	19	0	0	0	0	0	0	0	0	0
"C1orf212"	2577	6270	178	53	111	67	28	25	135	49	100	26	33	0	983	771	1372	770
"C1orf213"	2816	2816	0	0	0	0	0	0	23	0	0	0	0	0	1	0	0	0
"C1orf216"	2936	5315	255	0	153	102	0	0	95	19	61	28	930	660	1105	738	1256	670
"C1orf220"	2580	6095	0	0	0	0	0	0	13	0	0	0	22	0	0	0	0	0
"C1orf222"	2765	5973	28	0	28	0	0	0	67	25	0	0	0	0	0	0	0	0
"C1orf223"	851	1751	17	1	0	17	1	0	29	39	0	1	0	0	0	0	0	0
"C1orf226"	4128	5090	0	0	0	0	0	0	0	10	0	0	0	0	0	3	0	0
"C1orf227"	505	17506	0	0	0	0	0	0	0	0	0	0	0	0	0	0	1	0
"C1orf228"	1697	50871	0	0	0	0	0	0	10	17	0	0	23	0	45	47	61	29
"C1orf229"	2259	2259	0	0	0	0	0	0	12	0	0	0	0	0	0	0	0	0
"C1orf230"	1781	19175	0	0	0	0	0	0	31	36	0	0	0	0	0	0	0	0
"C1orf231"	1087	5067	0	0	0	0	0	0	18	0	0	0	8	11	0	0	5	4
"C1orf25"	4421	38899	450	13	223	227	0	13	397	16	40	0	1127	915	1371	599	1529	795
"C1orf26"	3864	134623	3059	16207	1659	1400	8846	7361	330	5468	0	1688	210	287	239	185	193	163
"C1orf27"	3907	45614	966	1207	562	404	637	570	484	890	73	1092	648	1065	605	595	635	406
"C1orf31"	643	10363	79	31	22	57	19	12	24	44	0	26	263	79	540	453	579	400
"C1orf35"	1478	2595	50	4	27	23	4	0	40	25	5	0	270	161	225	167	346	187
"C1orf37"	2217	16665	390	146	203	187	99	47	251	127	270	164	515	713	1917	1639	2252	1276
"C1orf38"	2725	14139	2958	388	1601	1357	210	178	1283	241	3872	527	2905	1362	4644	2447	5421	2359
"C1orf43"	1905	14092	875	458	582	293	279	179	339	282	681	580	5306	5791	3755	4495	7034	4253
"C1orf49"	2437	9574	0	0	0	0	0	0	0	0	0	0	0	0	0	0	0	0
"C1orf50"	1021	8500	91	38	47	44	22	16	79	24	39	60	168	187	159	103	226	157
"C1orf51"	1748	4275	39	0	26	13	0	0	24	14	34	33	21	3257	65	147	59	54
"C1orf52"	3264	9718	301	434	125	176	200	234	248	141	35	265	704	1083	613	660	788	581
"C1orf53"	684	4815	0	0	0	0	0	0	0	0	0	0	6	9	4	4	7	0
"C1orf54"	552	8554	1080	1303	578	502	766	537	333	590	449	730	2162	3695	1661	1899	1729	1338
"C1orf55"	4015	16664	59	84	48	11	47	37	69	146	0	220	514	615	339	310	324	195
"C1orf56"	2028	3612	1481	755	804	677	428	327	0	323	1027	701	4347	5428	2220	6	0	2021
"C1orf57"	1758	26881	126	0	74	52	0	0	243	0	0	0	181	316	441	359	426	319
"C1orf58"	1694	20202	360	97	196	164	33	64	138	33	26	55	2121	2283	1151	937	1092	591
"C1orf59"	2064	13238	3	0	3	0	0	0	29	7	0	9	156	154	233	153	137	146
"C1orf61"	2818	17717	14	1355	0	14	715	640	155	1164	0	1469	0	428	0	646	0	83
"C1orf62"	3057	41186	3356	1306	1871	1485	658	648	1304	787	1056	912	1323	1313	1080	798	1198	721
"C1orf63"	1469	5246	2370	1651	1315	1055	914	737	976	730	1313	1147	2681	2719	3424	2873	3372	2409
"C1orf64"	919	2451	0	0	0	0	0	0	0	0	0	0	0	0	0	0	0	0
"C1orf65"	2099	2099	0	0	0	0	0	0	0	0	0	0	0	0	0	0	0	0
"C1orf66"	2276	8490	496	183	234	262	98	85	225	230	10	68	1203	983	528	380	1415	430
"C1orf68"	908	908	0	0	0	0	0	0	0	0	0	0	0	0	0	0	0	0
"C1orf69"	7906	16530	415	508	219	196	278	230	190	266	164	352	439	598	196	347	365	226
"C1orf70"	1120	5583	0	0	0	0	0	0	17	13	0	0	0	0	0	0	0	0
"C1orf71"	5243	102246	290	44	169	121	16	28	413	30	0	59	480	435	508	352	542	371
"C1orf74"	1563	2230	0	0	0	0	0	0	14	3996	0	30	70	0	565	728	633	453
"C1orf77"	2643	8933	1933	1108	1059	874	577	531	862	563	976	1219	2226	1969	2137	1772	2305	1399
"C1orf81"	2300	37726	0	0	0	0	0	0	9	0	0	0	0	0	0	0	0	0
"C1orf83"	4102	46144	261	17	118	143	0	17	324	0	0	0	707	427	425	145	575	194
"C1orf84"	2218	22908	583	123	353	230	38	85	295	66	328	187	159	183	83	86	102	28
"C1orf85"	1590	2966	178	0	99	79	0	0	134	28	181	0	1009	671	1679	489	1286	533
"C1orf86"	2223	10299	108	0	47	61	0	0	219	64	0	61	416	281	360	199	585	273
"C1orf87"	3266	84604	0	0	0	0	0	0	0	0	0	0	0	0	0	0	0	0
"C1orf88"	2352	6446	0	0	0	0	0	0	0	0	0	0	0	0	0	0	0	0
"C1orf89"	1564	5478	0	0	0	0	0	0	0	0	0	0	53	18	25	3	38	12
"C1orf9"	5677	78713	2258	1239	1302	956	740	499	1545	724	163	1123	934	1306	999	1007	1090	818
"C1orf91"	1921	6654	233	41	136	97	22	19	227	83	283	122	172	158	262	179	324	184
"C1orf92"	2199	12458	0	0	0	0	0	0	40	41	0	0	0	0	0	0	0	0
"C1orf93"	2770	4655	74	0	36	38	0	0	107	55	24	28	675	661	701	621	965	735
"C1orf94"	3009	42178	0	0	0	0	0	0	12	0	0	0	0	0	0	0	0	0
"C1orf95"	4088	56804	4	2132	0	4	1149	983	130	1307	0	194	4	3	10	57	0	14
"C1orf96"	5676	21937	4975	2656	2739	2236	1524	1132	2013	989	2826	1848	539	533	3229	1751	3949	2032
"C1orf97"	1578	16387	17	34	8	9	10	24	110	27	0	23	67	55	61	45	59	48
"C1orf99"	2390	2630	0	0	0	0	0	0	0	0	0	0	0	0	0	0	0	0
"C2"	2883	18184	510	84	309	201	51	33	485	194	357	232	641	579	2922	3253	3927	2772
"C20orf103"	1782	15902	0	0	0	0	0	0	0	0	0	0	0	0	0	0	0	0
"C20orf106"	673	1418	0	19	0	0	19	0	17	0	0	0	0	22	0	1	0	0
"C20orf107"	694	3274	0	19	0	0	19	0	17	0	0	0	11	34	3	8	10	9
"C20orf108"	3027	9728	0	0	0	0	0	0	18	0	0	0	1900	1844	1265	970	1537	942
"C20orf11"	4430	10386	537	262	371	166	122	140	314	214	288	226	2569	2036	2491	1280	2996	1641
"C20orf111"	1575	14296	888	1823	508	380	976	847	356	850	187	1372	1101	502	479	424	575	511
"C20orf112"	6082	40426	1940	463	1153	787	207	256	1656	1047	523	896	675	119	724	415	866	113
"C20orf114"	1743	26745	0	0	0	0	0	0	196	48	0	0	0	0	0	0	0	0
"C20orf117"	4516	32527	10200	2739	5703	4497	1489	1250	3831	1215	9425	2955	2725	2814	2984	2046	4412	2254
"C20orf118"	2048	18064	3518	608	2270	1248	287	321	1234	241	1616	282	15810	13937	16037	12532	16381	11384
"C20orf119"	2253	26979	603	2072	343	260	1112	960	341	658	67	416	548	1036	809	706	975	654
"C20orf12"	3580	83635	0	0	0	0	0	0	15	0	0	1	22	9	14	16	17	7
"C20orf123"	2046	9630	0	33	0	0	0	33	0	54	0	115	220	33	292	442	291	400
"C20orf132"	3461	78346	19	0	0	19	0	0	10	0	0	0	4	23	191	18	81	27
"C20orf134"	2028	2028	107	0	54	53	0	0	65	0	88	0	35	0	59	0	67	2
"C20orf135"	1777	1777	261	0	141	120	0	0	0	69	360	105	331	0	309	342	270	464
"C20orf141"	3894	3984	0	0	0	0	0	0	0	10	0	0	0	0	0	0	0	0
"C20orf144"	543	1602	37	0	25	12	0	0	53	52	0	20	0	0	0	0	0	0
"C20orf151"	2807	17298	0	0	0	0	0	0	185	97	0	0	0	0	0	0	0	0
"C20orf152"	1939	62095	0	0	0	0	0	0	18	8	0	0	0	0	0	0	0	0
"C20orf160"	2541	21741	0	0	0	0	0	0	32	8	10	0	0	3	0	0	0	0
"C20orf161"	3409	9446	191	10	102	89	10	0	101	11	164	0	206	59	152	88	208	81
"C20orf165"	720	1109	0	0	0	0	0	0	30	11	0	0	0	0	0	0	0	0
"C20orf166"	1223	20312	0	0	0	0	0	0	103	51	0	0	0	0	0	0	0	0
"C20orf173"	2129	8911	0	0	0	0	0	0	10	0	0	0	0	0	0	0	0	0
"C20orf177"	3981	13742	68	0	64	4	0	0	103	0	0	0	1296	528	1168	223	1246	380
"C20orf185"	1469	18206	0	0	0	0	0	0	20	50	0	0	0	0	0	0	0	0
"C20orf186"	2189	30240	0	0	0	0	0	0	20	11	0	0	0	0	0	0	0	0
"C20orf191"	420	10626	0	0	0	0	0	0	0	0	0	0	0	0	0	0	0	0
"C20orf194"	6892	158309	10888	3272	6117	4771	1688	1584	5326	2038	3997	2980	1217	1908	1242	1393	1937	1447
"C20orf195"	1147	2528	10	0	0	10	0	0	50	92	0	0	0	0	0	0	0	0
"C20orf196"	1155	113515	213	37	144	69	37	0	299	15	0	0	84	51	69	40	79	45
"C20orf197"	2736	17030	17	0	17	0	0	0	81	10	0	15	6	0	0	0	0	5
"C20orf199"	690	11080	4521	9345	2565	1956	5018	4327	1249	4491	1433	4408	2113	4983	1090	1928	1453	1570
"C20orf20"	1639	4140	131	0	73	58	0	0	49	47	0	0	487	308	491	290	645	349
"C20orf200"	2588	6979	0	0	0	0	0	0	53	24	0	0	0	0	0	0	0	0
"C20orf201"	870	981	31	0	0	31	0	0	58	0	0	0	0	0	0	0	0	0
"C20orf202"	1604	4820	0	0	0	0	0	0	0	0	0	0	0	0	0	0	0	0
"C20orf24"	1198	6793	1130	908	675	455	494	414	519	682	255	2300	4028	4010	4485	4034	4720	3438
"C20orf26"	4112	308155	0	0	0	0	0	0	8	0	0	0	0	0	0	0	0	0
"C20orf27"	2569	14298	478	34	263	215	28	6	325	87	168	0	1627	1112	1318	1058	2292	440
"C20orf29"	1835	4753	124	9	72	52	0	9	72	12	0	0	466	263	326	234	429	261
"C20orf3"	2254	29846	2633	2127	1450	1183	1169	958	1235	1303	981	1209	3848	4505	4696	4416	5040	3527
"C20orf30"	1782	13246	26	0	10	16	0	0	93	11	53	0	1329	1436	1587	1358	1604	1276
"C20orf31"	2098	32003	408	17	206	202	8	9	331	21	308	64	689	551	842	698	741	735
"C20orf4"	2651	20408	194	81	101	93	65	16	131	299	0	153	922	873	993	853	1277	874
"C20orf43"	1749	50297	1230	2938	700	530	1660	1278	856	2377	179	4399	2268	2935	2443	2540	2931	2288
"C20orf44"	3711	67915	1322	277	805	517	166	111	883	379	498	667	276	309	320	248	374	192
"C20orf45"	2477	9702	108	0	39	69	0	0	89	124	0	83	1191	1655	1292	1432	448	1278
"C20orf46"	1722	3904	25	0	25	0	0	0	23	0	0	0	0	0	0	0	0	0
"C20orf54"	3160	8505	0	0	0	0	0	0	10	37	0	0	0	5	0	7	0	8
"C20orf56"	4913	18088	0	0	0	0	0	0	0	10	0	0	0	0	0	0	0	0
"C20orf62"	702	3583	0	0	0	0	0	0	0	0	0	0	0	0	0	0	0	0
"C20orf69"	726	12971	0	0	0	0	0	0	0	0	0	0	0	0	38	38	80	5
"C20orf7"	1197	32192	754	116	444	310	59	57	346	200	0	31	206	194	135	120	175	126
"C20orf70"	1061	13265	0	0	0	0	0	0	0	12	0	0	0	0	0	0	0	0
"C20orf71"	1114	10424	0	0	0	0	0	0	0	0	0	0	0	0	0	0	0	0
"C20orf72"	2129	21999	1403	316	789	614	171	145	501	146	804	279	678	597	683	480	883	408
"C20orf74"	6189	319856	913	1122	509	404	650	472	1010	762	124	515	377	950	394	394	471	247
"C20orf77"	2827	26295	1606	602	843	763	319	283	712	443	625	525	644	715	733	631	874	540
"C20orf79"	665	665	0	0	0	0	0	0	0	0	0	0	0	0	0	0	0	0
"C20orf85"	759	10200	0	0	0	0	0	0	0	0	0	0	0	0	0	0	0	0
"C20orf94"	1413	188076	4120	2366	2354	1766	1350	1016	2752	1624	438	1208	191	444	325	174	391	102
"C20orf96"	1737	14472	19	11	7	12	5	6	90	3	79	22	64	96	190	131	207	112
"C21ORF41"	1076	34709	1453	658	853	600	381	277	880	320	71	448	2	9	0	3	7	0
"C21ORF51"	1254	27327	49	0	30	19	0	0	61	0	33	0	179	152	113	69	118	92
"C21orf100"	871	1038	0	0	0	0	0	0	0	0	0	0	0	0	0	0	0	0
"C21orf105"	2753	8806	242	65	124	118	37	28	162	34	0	58	0	0	0	0	0	0
"C21orf109"	990	94712	0	0	0	0	0	0	0	0	0	0	0	0	0	0	0	0
"C21orf11"	3010	53479	0	0	0	0	0	0	62	17	0	0	0	0	0	0	3	0
"C21orf119"	824	824	12	0	12	0	0	0	25	0	0	0	31	27	42	40	40	29
"C21orf121"	2949	2949	0	0	0	0	0	0	0	0	0	0	0	0	0	0	0	0
"C21orf122"	2255	2255	0	0	0	0	0	0	26	0	0	0	0	0	0	0	0	0
"C21orf123"	3428	5326	0	3	0	0	1	2	12	20	0	0	0	0	0	0	0	0
"C21orf125"	3003	3867	0	0	0	0	0	0	31	17	0	0	0	0	0	0	0	0
"C21orf128"	2143	6402	0	0	0	0	0	0	31	14	0	0	0	0	0	0	0	0
"C21orf129"	2083	4257	0	0	0	0	0	0	45	0	0	0	0	0	0	0	0	0
"C21orf130"	2021	6566	0	0	0	0	0	0	0	0	0	0	0	0	0	0	0	0
"C21orf131"	2132	60514	0	0	0	0	0	0	0	0	0	0	0	0	0	0	0	0
"C21orf15"	1284	5232	0	0	0	0	0	0	8	0	0	0	0	15	0	0	0	0
"C21orf18"	3007	26081	363	0	228	135	0	0	350	13	60	67	225	126	325	102	391	139
"C21orf2"	2597	10460	1351	452	729	622	205	247	348	467	765	995	692	686	1068	2586	1119	2470
"C21orf22"	526	1147	0	0	0	0	0	0	23	0	0	0	0	0	0	0	0	0
"C21orf24"	963	30021	0	0	0	0	0	0	0	0	0	0	0	0	0	0	0	0
"C21orf29"	3979	213722	4	0	0	4	0	0	561	161	0	0	185	194	4	22	0	0
"C21orf33"	1673	12112	3354	2020	1831	1523	1044	976	1414	1039	3935	1960	3573	3146	4046	3238	5647	3593
"C21orf34"	3483	539254	15909	16071	8917	6992	8889	7182	7027	5796	1104	4527	3	8	0	0	3	0
"C21orf4"	2793	31194	135	0	81	54	0	0	81	1	0	48	430	571	564	460	467	400
"C21orf45"	1574	10846	0	0	0	0	0	0	20	0	0	0	104	104	51	92	86	49
"C21orf49"	1204	25605	3	0	3	0	0	0	0	0	0	0	3	0	0	0	0	0
"C21orf54"	598	4766	0	0	0	0	0	0	0	0	0	0	0	0	0	0	0	0
"C21orf56"	2320	23312	0	0	0	0	0	0	59	11	0	0	57	49	42	25	50	0
"C21orf57"	1506	5846	191	90	112	79	38	52	207	445	366	1130	1396	139	97	173	178	179
"C21orf58"	2973	22737	17	0	17	0	0	0	163	0	0	0	62	45	18	0	70	2
"C21orf59"	2135	10548	43	0	28	15	0	0	134	12	21	0	289	334	370	239	428	289
"C21orf60"	2131	11057	5347	1435	3063	2284	756	679	3884	1156	1384	1450	3387	3365	3480	3297	4441	3240
"C21orf62"	4124	23070	0	0	0	0	0	0	10	0	0	0	6	0	0	0	0	0
"C21orf63"	2497	63206	8	13	0	8	13	0	89	3	71	40	0	8	0	0	11	3
"C21orf66"	4010	37958	2178	795	1292	886	403	392	1144	446	678	511	1356	986	1458	812	1039	485
"C21orf67"	1836	6630	3034	3202	3002	32	1662	1540	1184	1100	5726	6416	1766	2	1656	1647	4751	3105
"C21orf7"	2235	98390	0	27	0	0	27	0	21	0	0	0	9	0	3	0	0	0
"C21orf70"	886	36934	1631	289	833	798	119	170	835	484	1510	7333	94	44	106	97	182	147
"C21orf71"	450	450	607	124920	384	223	67340	57580	16	7726	0	5467	0	18913	0	0	0	1222
"C21orf81"	2554	3697	0	0	0	0	0	0	12	0	0	0	0	0	0	0	0	0
"C21orf82"	1271	9244	23	26	23	0	26	0	12	20	0	33	0	0	0	0	0	0
"C21orf84"	583	16131	0	0	0	0	0	0	71	38	0	0	0	0	0	0	0	0
"C21orf88"	1452	15674	0	0	0	0	0	0	0	0	0	0	0	0	0	0	0	0
"C21orf89"	533	24380	0	0	0	0	0	0	32	23	0	0	0	0	0	0	0	0
"C21orf9"	1096	15831	0	0	0	0	0	0	20	0	0	0	0	0	0	0	0	0
"C21orf90"	1047	1763	0	0	0	0	0	0	0	0	0	0	0	0	0	0	0	0
"C21orf91"	5437	30420	169	1441	108	61	794	647	148	641	12	111	540	1123	629	723	624	621
"C21orf94"	585	9848	0	0	0	0	0	0	0	0	0	0	0	0	0	0	0	0
"C21orf96"	1490	1490	1556	1528	4	1552	483	1045	4477	808	951	339	0	0	0	0	0	0
"C21orf99"	3843	14538	0	0	0	0	0	0	0	0	0	0	0	0	0	0	0	0
"C22orf13"	3613	14871	814	517	472	342	309	208	471	395	336	552	2791	2498	2041	2929	2605	2511
"C22orf15"	2023	2841	84	12	70	14	12	0	80	41	102	87	935	0	0	0	0	0
"C22orf23"	1567	10072	92	230	39	53	125	105	66	139	0	259	205	317	148	268	211	176
"C22orf24"	1249	11830	62	0	37	25	0	0	0	20	0	0	0	0	192	133	233	0
"C22orf25"	3139	35133	4575	864	2554	2021	499	365	2285	947	4594	1812	1815	1628	1746	1373	2195	1441
"C22orf26"	1838	3687	62	0	45	17	0	0	92	25	0	0	73	31	11	14	19	15
"C22orf27"	2311	4345	0	0	0	0	0	0	15	11	0	0	56	57	91	26	83	50
"C22orf28"	2078	24714	558	128	311	247	62	66	371	105	30	44	1419	1348	1487	1875	1846	1751
"C22orf29"	6724	8679	502	0	230	272	0	0	220	41	161	36	348	56	582	78	750	170
"C22orf30"	10835	68786	8874	3154	5053	3821	1767	1387	3628	1309	7559	3272	3616	3233	3926	2303	4975	2434
"C22orf31"	1073	3249	0	0	0	0	0	0	23	0	0	0	0	0	0	0	0	0
"C22orf32"	1569	4590	140	41	66	74	19	22	101	40	59	0	482	253	675	403	852	669
"C22orf33"	1054	16718	0	0	0	0	0	0	33	0	0	0	0	1	0	0	0	0
"C22orf34"	1475	37902	3606	913	1862	1744	502	411	2417	1758	7062	4553	70	66	36	43	126	73
"C22orf36"	1491	3640	0	0	0	0	0	0	32	14	0	0	0	0	3	0	0	4
"C22orf39"	1223	4327	529	90	285	244	45	45	242	107	138	338	619	523	492	295	550	246
"C22orf40"	1619	6284	0	0	0	0	0	0	0	10	0	0	57	25	86	7	23	39
"C22orf41"	444	11788	1	0	0	1	0	0	44	2	0	0	1	1	0	0	0	0
"C22orf42"	812	9724	0	0	0	0	0	0	0	0	0	0	0	0	0	0	0	0
"C22orf43"	1290	23849	6	0	0	6	0	0	68	13	0	0	0	0	0	0	0	0
"C22orf46"	4977	7595	24	0	0	24	0	0	32	26	0	0	337	326	488	298	638	401
"C22orf5"	3698	53720	478	139	249	229	89	50	740	875	105	1023	616	666	1031	969	1430	1036
"C22orf9"	6371	20144	21523	2318	11770	9753	1184	1134	3464	1088	20705	1941	17688	13835	25504	19563	30783	21448
"C2CD2"	6360	68781	2772	535	1531	1241	318	217	1707	1119	875	2076	898	1052	1290	728	1039	612
"C2CD2L"	3357	9735	831	55	495	336	38	17	494	54	917	36	748	732	1578	1000	2078	1163
"C2CD3"	6313	136586	296	112	158	138	53	59	312	58	157	80	433	543	463	524	505	441
"C2CD4A"	3440	3935	0	0	0	0	0	0	0	0	0	0	0	0	0	0	0	0
"C2CD4B"	1578	1747	0	0	0	0	0	0	0	0	0	0	0	0	0	0	0	0
"C2CD4C"	3125	3728	0	0	0	0	0	0	0	0	0	0	0	0	0	0	0	0
"C2CD4D"	1715	2696	0	0	0	0	0	0	0	0	0	0	0	0	0	0	0	0
"C2H2 zinc finger protein"	2894	17553	0	0	0	0	0	0	0	0	0	0	0	0	0	0	0	0
"C2orf15"	1410	9743	0	0	0	0	0	0	0	0	0	0	2	0	0	0	0	0
"C2orf16"	6201	6201	0	0	0	0	0	0	16	0	0	0	0	0	0	0	0	0
"C2orf18"	3918	16959	899	71	486	413	42	29	518	117	558	205	1471	1067	1175	668	1347	761
"C2orf24"	2262	6114	311	102	164	147	43	59	200	74	290	201	951	2204	1103	2233	2075	2854
"C2orf27A"	1223	44915	43	0	43	0	0	0	86	0	0	0	347	374	281	120	200	11
"C2orf27B"	1328	6702	0	0	0	0	0	0	0	0	0	0	0	0	0	0	0	0
"C2orf28"	1403	5147	102	19	61	41	13	6	45	31	0	18	1060	1223	1367	1150	1923	825
"C2orf29"	2524	17434	1012	1383	563	449	732	651	439	461	53	307	1350	1457	1232	1032	1770	1067
"C2orf3"	4451	48279	278	57	164	114	33	24	425	59	0	45	409	488	413	336	412	249
"C2orf34"	1564	410688	4481	1139	2520	1961	652	487	3775	1313	303	808	54	76	70	69	87	74
"C2orf37"	5635	50703	383	0	220	163	0	0	241	24	0	0	574	512	589	314	554	250
"C2orf39"	2508	54797	0	0	0	0	0	0	40	7	0	0	0	0	0	0	0	0
"C2orf4"	1484	155983	17814	8237	10054	7760	4573	3664	7663	3675	7687	6272	952	991	1104	885	1131	821
"C2orf40"	778	12490	0	0	0	0	0	0	0	0	0	0	0	0	0	0	0	0
"C2orf42"	2532	41134	45	58	23	22	33	25	48	9	0	56	333	218	365	204	424	245
"C2orf43"	2862	138010	272	0	157	115	0	0	746	26	0	30	460	459	446	345	547	389
"C2orf44"	3898	18092	32	0	16	16	0	0	37	0	0	0	225	106	244	8	293	18
"C2orf47"	1515	8807	17	19	4	13	7	12	78	33	0	0	186	143	282	153	349	219
"C2orf48"	1906	70349	0	0	0	0	0	0	335	98	0	0	0	0	0	0	0	0
"C2orf49"	891	7973	176	9	99	77	9	0	125	6	0	0	343	316	198	82	202	103
"C2orf50"	2687	12973	0	0	0	0	0	0	0	0	0	0	0	0	0	0	0	0
"C2orf51"	799	4935	0	0	0	0	0	0	0	0	0	0	0	0	0	0	0	0
"C2orf52"	1285	5915	0	0	0	0	0	0	24	0	0	0	0	0	0	0	0	0
"C2orf53"	2066	2619	0	0	0	0	0	0	8	10	0	0	0	0	0	0	0	0
"C2orf54"	2529	10109	0	0	0	0	0	0	57	27	0	0	0	0	0	0	0	0
"C2orf55"	3879	142377	0	0	0	0	0	0	37	0	0	0	64	20	34	5	69	12
"C2orf56"	2219	17529	688	259	383	305	148	111	329	177	109	288	441	322	404	209	480	254
"C2orf57"	1382	1382	0	0	0	0	0	0	27	0	0	0	0	0	0	0	0	0
"C2orf58"	1754	50746	724	165	368	356	116	49	769	109	46	116	79	106	0	16	12	6
"C2orf60"	6734	13653	332	275	200	132	181	94	323	285	115	121	351	443	226	265	389	183
"C2orf61"	2144	26932	404	8	269	135	8	0	318	0	0	0	1	0	0	0	0	0
"C2orf62"	1332	11239	0	0	0	0	0	0	70	11	3	0	11	0	0	0	0	0
"C2orf63"	5359	59764	355	82	196	159	60	22	47	12	0	0	14	19	90	48	25	134
"C2orf64"	1664	9091	6347	1264	3586	2761	746	518	3046	518	2706	771	7456	8543	6339	4649	7328	4106
"C2orf65"	2545	90147	24	17	10	14	8	9	69	9	77	0	30	46	67	50	111	66
"C2orf66"	1388	4992	0	0	0	0	0	0	0	0	0	0	0	0	0	0	0	0
"C2orf67"	5423	150616	9066	1994	5096	3970	1174	820	3985	682	2670	615	785	1445	2081	980	2368	1020
"C2orf68"	4269	6805	580	35	330	250	0	35	360	102	675	185	1065	795	934	495	1280	524
"C2orf69"	3728	17017	140	104	119	21	66	38	186	127	0	15	925	1000	922	641	882	541
"C2orf7"	1086	5222	0	0	0	0	0	0	29	16	0	0	316	249	518	448	594	484
"C2orf70"	698	16915	0	0	0	0	0	0	97	33	0	0	0	0	0	0	0	0
"C2orf71"	7046	12571	0	0	0	0	0	0	13	14	0	0	0	0	0	0	0	0
"C2orf72"	3580	12146	0	0	0	0	0	0	0	0	0	0	0	0	0	0	0	0
"C2orf73"	1926	30645	0	0	0	0	0	0	0	0	0	0	0	0	0	0	0	0
"C2orf74"	891	2337	146	0	108	38	0	0	198	3	0	0	229	0	394	245	385	29
"C2orf76"	1054	64300	0	104	0	0	69	35	0	371	0	17	90	132	61	59	84	48
"C2orf77"	2661	7972	51	0	22	29	0	0	50	0	0	0	0	0	0	0	0	0
"C2orf78"	3048	32960	0	0	0	0	0	0	0	0	0	0	0	0	0	0	0	0
"C2orf79"	572	3115	0	0	0	0	0	0	0	1	0	0	309	2	370	45	487	0
"C2orf80"	1213	24694	0	0	0	0	0	0	0	0	0	0	0	0	0	0	3	0
"C2orf81"	2233	3543	0	0	0	0	0	0	18	0	0	0	64	44	0	0	118	25
"C2orf82"	468	6115	8	0	0	8	0	0	0	0	0	0	0	3	7	0	0	0
"C2orf83"	2090	23231	0	0	0	0	0	0	10	0	0	0	0	0	0	0	0	0
"C2orf84"	1979	17037	870	90	452	418	68	22	1085	53	220	62	454	227	789	236	1142	764
"C2orf85"	1800	3598	0	0	0	0	0	0	39	0	0	0	0	0	0	0	0	0
"C2orf86"	5832	321829	10597	5080	6149	4448	2863	2217	7625	3958	1270	3010	443	477	280	282	198	174
"C2orf88"	4035	22621	119	53	61	58	36	17	150	48	0	0	16	0	0	0	0	0
"C2orf89"	3406	45209	3189	334	1800	1389	220	114	1638	239	1840	206	800	672	656	401	919	738
"C2orf90"	3190	3190	0	0	0	0	0	0	11	23	0	0	0	0	0	0	0	0
"C3"	5141	42817	0	0	0	0	0	0	177	25	0	0	25	33	18	31	38	41
"C3AR1"	1957	8038	18	0	16	2	0	0	12	8	0	0	0	0	1776	2221	1057	683
"C3orf1"	1598	25757	5972	20931	3433	2539	11248	9683	1929	10063	2138	11485	3080	10340	3135	7147	3213	3268
"C3orf10"	1178	11542	663	333	387	276	224	109	295	359	385	873	3737	3922	2979	3074	4339	3200
"C3orf14"	961	14602	0	0	0	0	0	0	0	0	0	0	65	59	40	26	79	51
"C3orf15"	4484	64066	0	0	0	0	0	0	0	0	0	0	0	0	0	0	0	0
"C3orf16"	2477	31720	0	0	0	0	0	0	0	0	0	0	0	0	0	0	0	0
"C3orf17"	5322	17263	1577	1145	860	717	653	492	636	390	160	254	1882	2105	1316	780	1680	885
"C3orf18"	2660	9721	1658	367	871	787	307	60	797	411	580	105	1174	1039	1651	371	1659	837
"C3orf19"	2969	20913	380	348	209	171	186	162	225	220	50	451	538	579	656	506	813	388
"C3orf20"	3294	97888	7	0	7	0	0	0	61	23	0	62	62	118	95	48	0	0
"C3orf21"	2723	202882	21729	12067	11994	9735	6560	5507	10081	6786	16588	13060	2322	2147	2241	1903	2414	1499
"C3orf22"	950	9240	0	0	0	0	0	0	76	43	0	0	0	0	0	0	0	0
"C3orf23"	3694	70997	1151	88	755	396	25	63	913	0	68	81	886	997	753	743	728	619
"C3orf24"	1016	26912	20	43	18	2	28	15	38	25	15	2	183	173	104	102	184	119
"C3orf25"	2162	27331	3	0	1	2	0	0	18	29	6	0	1	0	0	0	0	0
"C3orf26"	2222	223558	1195	4478	729	466	2424	2054	762	2383	0	2173	672	1888	472	1371	815	745
"C3orf27"	2699	4087	0	0	0	0	0	0	0	0	0	0	0	0	0	0	0	0
"C3orf30"	1817	5307	0	0	0	0	0	0	0	0	0	0	0	0	0	0	0	0
"C3orf31"	2565	56434	2759	217	1473	1286	116	101	1389	68	997	195	283	204	193	157	354	187
"C3orf32"	2620	125407	0	0	0	0	0	0	52	43	0	0	0	0	0	0	0	0
"C3orf33"	1937	43656	0	0	0	0	0	0	25	0	0	0	88	69	44	16	52	14
"C3orf34"	2162	5976	276	16	138	138	16	0	149	10	178	33	203	72	150	62	147	91
"C3orf35"	1776	18898	54	0	37	17	0	0	44	0	0	0	0	0	0	0	0	0
"C3orf36"	1668	1668	0	0	0	0	0	0	0	0	0	0	0	0	0	0	0	0
"C3orf37"	1798	26318	54	23	32	22	8	15	35	41	0	0	392	437	481	434	687	472
"C3orf38"	2631	8222	418	364	196	222	187	177	187	121	0	119	1104	741	1250	809	1172	756
"C3orf39"	2540	26838	95	0	52	43	0	0	150	7	0	0	170	127	208	138	261	163
"C3orf42"	1328	1328	525	671	305	220	345	326	293	302	207	332	19	37	0	0	21	0
"C3orf43"	1848	8468	0	0	0	0	0	0	0	0	0	0	0	0	0	0	0	0
"C3orf44"	1761	44067	0	0	0	0	0	0	0	0	0	0	0	0	0	0	0	0
"C3orf45"	1437	9028	64	0	29	35	0	0	133	57	0	0	287	1	0	0	0	0
"C3orf46"	881	9860	0	0	0	0	0	0	29	0	0	0	0	0	0	0	0	0
"C3orf47"	2198	8300	0	0	0	0	0	0	93	29	0	0	129	88	0	149	24	0
"C3orf48"	1611	32313	1462	9231	812	650	4918	4313	419	8224	0	2368	1776	5227	1444	2451	1895	2086
"C3orf49"	1294	29271	169	50	97	72	35	15	97	9	38	29	867	947	736	676	881	686
"C3orf50"	2142	20790	0	0	0	0	0	0	0	0	0	0	0	0	0	0	0	0
"C3orf51"	2254	2254	0	0	0	0	0	0	0	0	0	0	0	0	0	0	0	0
"C3orf52"	3340	44671	0	0	0	0	0	0	12	0	0	0	0	0	0	0	0	0
"C3orf54"	1042	1778	9	0	0	9	0	0	19	0	0	0	0	0	0	0	13	0
"C3orf55"	1513	57862	0	0	0	0	0	0	0	0	0	0	0	0	0	0	0	0
"C3orf56"	1739	5053	0	0	0	0	0	0	0	0	0	0	0	0	0	0	0	0
"C3orf57"	2308	27292	0	0	0	0	0	0	0	0	0	0	0	0	0	0	0	0
"C3orf58"	4357	20571	145	0	103	42	0	0	251	0	0	0	862	445	760	326	804	359
"C3orf59"	3367	121345	3833	14287	2332	1501	7662	6625	887	6471	52	6590	296	676	176	420	219	206
"C3orf60"	1506	1852	120	0	68	52	0	0	147	57	102	164	1657	1592	1177	1160	1486	930
"C3orf62"	3593	8480	410	68	252	158	41	27	113	75	203	96	9	258	278	175	324	108
"C3orf63"	8319	62976	6888	1340	3923	2965	780	560	3390	691	2541	1147	4157	3856	3996	2751	4498	2476
"C3orf64"	4407	38407	176	14	90	86	0	14	232	52	22	5	526	580	662	499	634	413
"C3orf65"	1966	4917	12	0	12	0	0	0	0	25	0	0	0	0	0	0	0	0
"C3orf66"	2526	7097	0	0	0	0	0	0	0	0	0	0	0	0	0	0	0	0
"C3orf67"	4138	188805	0	0	0	0	0	0	10	0	0	0	0	0	0	0	0	0
"C3orf70"	5901	74964	0	0	0	0	0	0	0	0	0	0	0	0	0	0	0	0
"C3orf71"	1599	1599	0	0	0	0	0	0	52	30	54	78	76	58	59	40	118	54
"C3orf72"	4078	6756	0	0	0	0	0	0	0	0	0	0	0	0	0	0	0	0
"C3orf74"	3020	3020	0	0	0	0	0	0	0	30	0	0	0	0	0	0	0	0
"C3orf75"	1508	17678	214	0	109	105	0	0	176	31	29	16	146	196	168	186	195	204
"C3orf77"	5353	90213	0	0	0	0	0	0	0	0	0	0	0	0	0	0	0	0
"C3orf79"	580	18201	0	0	0	0	0	0	0	0	0	0	0	0	0	0	0	0
"C4A"	5467	20625	0	0	0	0	0	0	8	11	0	0	0	1	67	67	105	75
"C4A variant protein"	1286	10619	159	303	61	98	196	107	220	607	40	296	105	683	529	381	418	401
"C4B"	5328	20624	0	0	0	0	0	0	0	11	0	0	0	0	60	59	88	73
"C4BPA"	2246	40703	0	0	0	0	0	0	0	0	0	0	0	0	0	0	0	0
"C4BPB"	1300	10753	0	0	0	0	0	0	0	0	0	0	0	0	0	0	0	0
"C4ORF12"	1745	40199	0	0	0	0	0	0	0	18	0	0	0	0	0	0	3	0
"C4orf10"	3858	15517	902	946	495	407	501	445	657	853	349	1083	1546	1420	1352	1543	1500	1146
"C4orf11"	913	8325	0	0	0	0	0	0	0	0	0	0	0	0	0	0	0	0
"C4orf14"	2278	14311	38	0	16	22	0	0	23	21	8	0	492	263	393	247	588	373
"C4orf17"	1604	31260	0	0	0	0	0	0	0	0	0	0	0	0	0	0	0	0
"C4orf18"	4843	47987	2086	0	1202	884	0	0	1837	49	136	0	3248	2865	2480	5540	5247	3444
"C4orf19"	3641	139581	49	10	22	27	0	10	275	75	0	71	1	0	2	1	2	2
"C4orf21"	6767	97663	2	7	2	0	0	7	25	10	0	0	22	107	119	77	83	46
"C4orf22"	939	628024	0	0	0	0	0	0	0	0	0	0	0	0	0	0	0	0
"C4orf23"	5318	38213	854	3542	481	373	1900	1642	656	2408	46	2058	174	696	215	380	259	226
"C4orf26"	753	8671	0	0	0	0	0	0	0	0	0	0	0	0	0	0	0	0
"C4orf27"	1223	28475	0	0	0	0	0	0	9	0	0	0	55	45	165	98	161	116
"C4orf29"	2193	71015	933	71	518	415	52	19	519	91	77	69	348	491	307	196	281	176
"C4orf3"	2840	4395	0	22	0	0	11	11	49	0	0	26	2226	2628	1301	2191	1443	2005
"C4orf31"	2875	36893	0	0	0	0	0	0	0	0	0	0	0	0	0	0	0	0
"C4orf32"	2728	43686	1554	1989	936	618	1074	915	717	697	0	394	850	1298	591	526	909	708
"C4orf33"	1866	19015	175	53	86	89	37	16	148	57	0	13	299	496	161	132	212	113
"C4orf34"	1659	87933	1048	86	581	467	47	39	765	7	261	17	238	190	845	830	857	631
"C4orf35"	1545	2163	0	0	0	0	0	0	0	0	0	0	0	0	0	0	0	0
"C4orf36"	912	16218	5	0	0	5	0	0	13	0	0	0	4	3	0	0	7	0
"C4orf37"	1656	584359	0	0	0	0	0	0	12	0	0	0	0	0	0	0	0	0
"C4orf38"	2180	2180	0	0	0	0	0	0	0	0	0	0	0	0	0	2	0	2
"C4orf39"	2175	2175	0	0	0	0	0	0	0	0	0	0	0	0	0	0	0	0
"C4orf40"	4800	12422	0	0	0	0	0	0	0	0	0	0	0	0	0	0	0	0
"C4orf41"	4555	54300	1793	343	1009	784	195	148	1104	246	415	349	2177	1619	2640	1627	2684	1422
"C4orf42"	2441	2441	0	0	0	0	0	0	45	0	0	0	203	146	228	152	211	120
"C4orf43"	1924	26019	1390	112	754	636	59	53	596	132	0	184	144	163	240	204	230	193
"C4orf44"	1672	7576	188	223	82	106	128	95	137	275	0	148	0	0	0	7	26	1
"C4orf45"	822	141651	4260	20839	2463	1797	11307	9532	1438	10111	1248	8990	4616	8020	4302	5463	5005	3764
"C4orf46"	3527	5373	0	0	0	0	0	0	18	29	0	0	107	216	61	130	127	62
"C4orf47"	981	20278	0	0	0	0	0	0	0	0	0	0	0	0	0	0	0	0
"C4orf48"	487	1922	0	0	0	0	0	0	10	0	0	0	89	49	153	115	155	111
"C4orf49"	1343	14177	0	0	0	0	0	0	0	0	0	0	0	0	0	0	0	0
"C4orf50"	3402	31540	0	0	0	0	0	0	45	23	0	0	0	0	0	0	0	0
"C4orf51"	849	52592	0	0	0	0	0	0	24	0	0	0	0	0	0	0	0	0
"C4orf52"	1016	15688	14	0	0	14	0	0	12	0	0	0	251	207	412	372	357	253
"C4orf6"	873	2644	0	0	0	0	0	0	0	0	0	0	0	0	0	0	0	0
"C4orf7"	541	9153	0	0	0	0	0	0	0	0	0	0	0	0	0	0	0	0
"C5"	5503	97940	33	483	17	16	258	225	62	79	0	253	235	338	218	215	245	138
"C5AR1"	2344	12225	0	0	0	0	0	0	49	34	0	51	933	1054	666	1292	632	833
"C5D"	2485	13033	38	105	10	28	55	50	27	88	0	71	127	1644	199	139	205	140
"C5orf13"	3619	94624	0	0	0	0	0	0	18	0	0	0	48	55	107	25	120	53
"C5orf15"	2283	13209	1216	1386	700	516	797	589	412	783	378	693	2831	4491	2044	2086	2732	1756
"C5orf20"	3135	3135	2625	7509	1506	1119	3916	3593	229	2433	467	6301	2948	11744	430	2787	1733	2096
"C5orf22"	3620	22793	7	15	5	2	9	6	119	10	0	11	658	561	648	338	512	325
"C5orf23"	2876	2876	0	0	0	0	0	0	0	0	0	0	0	0	0	0	0	0
"C5orf24"	5084	13768	793	128	444	349	70	58	323	179	87	366	1255	1253	1583	1222	1478	863
"C5orf25"	3578	107620	1649	151	1000	649	83	68	1446	78	385	121	518	530	478	355	497	417
"C5orf28"	3008	39639	365	118	232	133	89	29	370	22	0	142	295	301	262	256	366	209
"C5orf30"	3225	19238	0	0	0	0	0	0	11	0	0	0	227	104	231	31	249	66
"C5orf32"	1108	108467	797	177	500	297	90	87	536	341	0	96	892	920	1300	1082	1558	1195
"C5orf33"	3892	49207	106	77	51	55	59	18	186	50	0	0	377	362	309	261	374	247
"C5orf34"	2453	28379	0	0	0	0	0	0	10	7	0	0	26	44	116	142	8506	10
"C5orf35"	1557	7909	0	0	0	0	0	0	0	0	0	0	120	209	192	163	116	84
"C5orf36"	7261	467754	366	280	222	144	165	115	847	247	42	135	23	56	18	12	17	15
"C5orf37"	2164	43282	191	10	120	71	10	0	276	0	17	0	312	100	298	73	344	142
"C5orf38"	910	3252	0	0	0	0	0	0	0	0	0	0	0	0	0	0	0	0
"C5orf39"	2070	3773	90	9	51	39	0	9	144	48	0	0	44	3	33	26	49	0
"C5orf4"	3034	3034	2164	79	1182	982	38	41	880	17	536	37	172	92	81	177	224	150
"C5orf40"	2128	4124	0	0	0	0	0	0	16	13	0	0	0	0	0	0	0	0
"C5orf41"	5446	80593	3131	1150	1630	1501	654	496	1582	325	641	892	1726	2099	2087	1281	2233	1601
"C5orf42"	11251	143202	209	23	128	81	20	3	84	59	0	0	262	383	155	137	260	90
"C5orf43"	2893	4768	98	0	48	50	0	0	79	19	0	0	232	137	1614	787	1606	870
"C5orf44"	3115	41397	408	48	213	195	24	24	399	86	35	47	1539	449	826	643	875	557
"C5orf45"	1367	22208	658	1525	353	305	788	737	473	594	481	323	4105	5087	5040	8739	181	6283
"C5orf46"	545	13831	0	0	0	0	0	0	0	0	0	0	0	0	0	0	0	0
"C5orf47"	2526	16982	0	0	0	0	0	0	0	0	0	0	0	0	0	0	0	0
"C5orf48"	462	4562	0	0	0	0	0	0	0	0	0	0	0	0	0	0	0	0
"C5orf49"	1027	19753	0	0	0	0	0	0	0	14	0	0	0	0	0	0	0	0
"C5orf51"	5227	17269	438	114	268	170	49	65	205	112	0	79	1323	1359	1551	1070	1680	967
"C5orf52"	698	8601	0	0	0	0	0	0	0	0	0	0	0	0	0	0	0	0
"C5orf53"	2872	2872	128	24	75	53	12	12	104	0	0	0	175	128	206	44	285	54
"C5orf54"	2884	6907	11	0	11	0	0	0	14	0	0	0	62	0	73	0	58	0
"C5orf55"	1615	1615	100	0	50	50	0	0	27	13	0	0	65	31	64	45	100	1
"C5orf56"	2029	51388	1761	582	965	796	205	377	992	910	416	375	125	128	123	93	209	4
"C5orf58"	1166	19625	7260	59167	6696	564	30175	28992	328	25402	164	18813	2037	1107	1979	4574	2607	2873
"C5orf60"	1211	3489	0	0	0	0	0	0	0	9	0	0	0	0	0	0	0	0
"C5orf62"	1976	18432	0	0	0	0	0	0	18	0	0	0	146	115	252	239	189	179
"C6"	3679	119206	0	0	0	0	0	0	0	0	0	0	0	0	0	0	0	0
"C6orf1"	1210	2748	98	0	49	49	0	0	31	0	0	0	217	237	520	56	747	84
"C6orf10"	2147	78856	0	1	0	0	1	0	2	0	0	0	7	20	0	0	0	0
"C6orf103"	6813	216461	0	0	0	0	0	0	0	0	0	0	166	183	0	0	54	0
"C6orf105"	1946	23059	0	0	0	0	0	0	9	0	0	0	0	13	11	8	6	0
"C6orf106"	4423	109561	7941	2713	4530	3411	1543	1170	3562	1763	4454	3244	5356	5444	6770	4776	8311	536
"C6orf108"	798	3844	7	0	7	0	0	0	0	1	0	0	554	484	347	351	479	386
"C6orf114"	1527	16906	3590	620	1849	1741	327	293	1862	75	2240	231	39	0	75	0	67	34
"C6orf115"	848	14622	34	0	34	0	0	0	92	0	0	0	943	975	873	730	1171	900
"C6orf118"	1855	27215	0	0	0	0	0	0	16	0	0	0	0	0	0	0	0	0
"C6orf120"	4146	4146	166	0	94	72	0	0	133	41	0	0	1552	1592	64	75	78	54
"C6orf122"	2420	10037	0	0	0	0	0	0	23	0	0	0	0	0	0	0	0	0
"C6orf125"	600	10383	204	17	116	88	9	8	228	105	0	18	184	187	220	227	264	188
"C6orf126"	492	2939	0	10	0	0	7	3	0	0	0	0	0	0	0	0	0	0
"C6orf127"	479	7011	0	0	0	0	0	0	49	9	0	0	0	0	0	0	0	0
"C6orf129"	622	17003	138	0	72	66	0	0	183	58	0	0	90	90	100	93	113	86
"C6orf130"	1521	3493	207	96	95	112	64	32	140	37	0	36	174	349	158	107	185	104
"C6orf134"	2686	17835	155	32	83	72	29	3	243	89	12	42	68	125	114	182	189	59
"C6orf136"	1984	6172	121	12	75	46	12	0	81	9	14	0	299	206	356	109	511	188
"C6orf138"	3271	169082	0	0	0	0	0	0	0	0	0	0	0	0	0	0	0	0
"C6orf140"	2135	28107	0	0	0	0	0	0	0	0	0	0	0	0	0	0	0	0
"C6orf141"	1839	11248	0	0	0	0	0	0	0	10	0	0	0	0	0	0	0	0
"C6orf142"	5755	199170	0	0	0	0	0	0	0	0	0	0	0	0	0	0	0	0
"C6orf145"	2199	29412	5057	20103	2679	2378	10611	9492	1118	11676	1097	17696	1396	6898	2072	8447	2222	6960
"C6orf146"	2269	18978	1217	603	616	601	331	272	578	363	391	322	1753	1802	2479	1744	2643	1473
"C6orf147"	1449	36228	0	0	0	0	0	0	20	0	0	0	683	754	0	0	0	0
"C6orf15"	1138	1334	0	0	0	0	0	0	0	0	0	0	0	0	0	0	0	0
"C6orf150"	1807	27189	699	89	432	267	63	26	364	239	516	439	303	289	212	315	204	153
"C6orf153"	1166	7954	122	16	66	56	12	4	103	55	0	107	1188	1099	670	644	862	646
"C6orf154"	2127	3719	0	0	0	0	0	0	31	0	0	0	2	0	0	0	0	1
"C6orf155"	2937	6301	0	0	0	0	0	0	0	0	0	0	0	0	0	0	0	0
"C6orf162"	2438	19739	827	83	488	339	59	24	552	0	33	12	101	166	89	93	135	94
"C6orf164"	1560	2619	37	0	23	14	0	0	0	0	0	0	0	0	0	0	4	0
"C6orf165"	2601	28056	752	0	423	329	0	0	554	16	89	45	62	0	86	72	0	71
"C6orf167"	8667	141016	219	0	184	35	0	0	330	5	0	6	289	402	161	164	258	94
"C6orf168"	9765	76739	0	0	0	0	0	0	0	0	0	0	0	1	0	0	0	0
"C6orf170"	5164	255019	4	0	0	4	0	0	14	0	0	0	0	7	5	9	0	0
"C6orf173"	3228	143214	13	0	13	0	0	0	10	8	0	0	63	98	99	132	135	123
"C6orf174"	11829	80950	0	0	0	0	0	0	0	0	0	0	0	0	0	0	0	0
"C6orf176"	1818	48579	0	0	0	0	0	0	30	10	0	0	0	0	0	0	0	0
"C6orf182"	2913	68759	310	0	227	83	0	0	363	21	91	0	109	103	143	100	199	119
"C6orf184"	859	13919	0	0	0	0	0	0	0	0	0	0	0	0	0	0	0	0
"C6orf185"	1147	16475	0	0	0	0	0	0	0	0	0	0	0	0	0	0	0	0
"C6orf186"	1106	112328	26	0	13	13	0	0	23	0	0	0	0	0	0	0	0	0
"C6orf190"	3931	146989	0	0	0	0	0	0	0	8	0	0	0	0	0	0	0	0
"C6orf191"	548	30027	0	0	0	0	0	0	0	0	0	0	0	0	0	0	0	0
"C6orf192"	2439	29242	0	0	0	0	0	0	0	0	0	0	12	12	32	19	13	9
"C6orf195"	2073	12328	0	0	0	0	0	0	0	0	0	0	0	0	0	0	0	0
"C6orf201"	2599	43417	0	3	0	0	3	0	86	0	0	0	344	258	484	359	695	478
"C6orf203"	1522	23139	113	0	61	52	0	0	123	31	0	15	282	183	271	142	339	172
"C6orf204"	3348	186783	10169	11706	5532	4637	6580	5126	5081	5945	1940	11479	246	338	306	289	313	185
"C6orf206"	973	25936	83	0	33	50	0	0	187	41	30	16	1	0	0	0	0	0
"C6orf208"	2569	12802	0	0	0	0	0	0	42	0	0	0	0	0	0	0	0	0
"C6orf21 variant protein"	2133	14601	2587	1531	1428	1159	848	683	978	1022	1599	1512	5476	4388	5630	4784	8046	4164
"C6orf211"	2577	17812	243	12	133	110	0	12	251	17	0	17	1591	1642	1366	1145	1663	1038
"C6orf214"	2054	17795	0	0	0	0	0	0	25	42	0	0	0	185	0	38	0	0
"C6orf217"	1553	192435	0	0	0	0	0	0	0	0	0	0	0	0	0	0	0	0
"C6orf218"	3021	7039	0	0	0	0	0	0	0	0	0	0	0	0	0	0	0	0
"C6orf221"	1023	1498	0	0	0	0	0	0	0	0	0	0	0	0	0	0	0	0
"C6orf222"	3745	21127	0	0	0	0	0	0	75	0	0	0	0	0	0	0	0	0
"C6orf223"	2817	4549	0	0	0	0	0	0	0	0	0	0	45	43	0	0	4	4
"C6orf224"	1586	13693	0	0	0	0	0	0	0	8	0	20	13	3	11	1	16	0
"C6orf225"	2674	15320	0	0	0	0	0	0	0	0	0	0	2	0	0	0	12	16
"C6orf226"	551	551	0	0	0	0	0	0	19	0	0	0	58	51	68	64	86	82
"C6orf227"	2109	7234	0	0	0	0	0	0	48	43	0	0	0	0	0	0	0	0
"C6orf25"	875	1692	0	0	0	0	0	0	23	0	0	0	0	0	0	0	0	0
"C6orf26"	1122	2058	3	0	3	0	0	0	34	10	0	0	0	17	8	3	29	3
"C6orf27"	2930	11738	0	0	0	0	0	0	43	14	0	0	0	1	4	0	12	8
"C6orf35"	4570	34740	1210	395	747	463	220	175	936	277	463	196	231	232	200	216	274	215
"C6orf41"	979	66982	0	0	0	0	0	0	0	0	0	0	0	0	0	0	0	0
"C6orf47"	2477	2477	205	78	113	92	35	43	44	25	76	77	2	594	1105	644	1369	612
"C6orf48"	845	4848	510	152	283	227	74	78	264	186	118	248	1086	1121	402	817	1129	894
"C6orf52"	690	23379	0	0	0	0	0	0	0	0	0	0	0	0	1	0	0	0
"C6orf57"	528	21983	73	0	57	16	0	0	85	0	64	11	239	197	127	131	157	111
"C6orf58"	1202	14641	0	0	0	0	0	0	0	0	0	0	0	0	0	0	0	0
"C6orf59"	1842	1842	386	675	200	186	675	0	130	4165	161	411	38	282	111	193	47	0
"C6orf60"	1341	16213	0	0	0	0	0	0	0	0	0	0	1	1	0	0	0	0
"C6orf62"	2475	14313	5838	4600	3190	2648	2093	2507	2347	1755	2532	2954	2268	14140	8307	1553	8384	5130
"C6orf64"	1922	11027	0	0	0	0	0	0	10	0	0	0	247	206	218	116	156	103
"C6orf66"	1305	6656	28	0	0	28	0	0	25	0	0	0	323	24	323	200	114	278
"C6orf69"	4745	47771	2592	2273	1401	1191	1199	1074	1343	1566	1385	3747	5511	6634	3663	3528	4348	2597
"C6orf70"	2151	14508	499	93	308	191	44	49	370	35	51	55	349	406	449	266	473	270
"C6orf72"	1117	24541	248	616	170	78	283	333	133	418	17	1068	597	1155	740	754	671	518
"C6orf81"	1171	11824	0	3	0	0	3	0	20	0	0	0	0	0	0	0	0	0
"C6orf89"	6923	57094	777	126	463	314	51	75	575	99	184	167	2360	2119	2579	2053	3122	1858
"C6orf94"	1394	81043	625	260	328	297	131	129	256	234	118	454	1300	1776	856	826	1529	803
"C6orf97"	5293	127154	35	0	35	0	0	0	246	0	0	8	376	448	247	284	184	61
"C7"	4028	73442	0	0	0	0	0	0	0	0	0	0	0	0	0	0	0	0
"C7orf10"	1655	725784	0	0	0	0	0	0	8	0	0	0	9	43	32	120	15	26
"C7orf11"	949	1917	191	11	112	79	5	6	128	54	0	17	278	451	0	233	301	234
"C7orf13"	2288	2288	0	0	0	0	0	0	30	10	0	0	114	62	79	26	128	33
"C7orf16"	1802	21271	0	0	0	0	0	0	0	0	0	0	0	0	0	0	0	0
"C7orf18"	2299	22316	0	0	0	0	0	0	101	0	0	0	0	15	23	14	21	9
"C7orf2"	5104	212333	1656	735	970	686	472	263	1475	744	85	620	837	869	813	605	880	588
"C7orf20"	2097	19882	1901	2424	1174	727	1255	1169	931	2205	593	2329	613	1125	906	1966	1015	801
"C7orf23"	1045	23553	4775	645	2880	1895	330	315	2188	288	1297	451	2232	1320	2274	955	2939	1129
"C7orf25"	2737	22933	379	152	236	143	97	55	120	121	179	138	1345	1321	2076	1705	2080	1705
"C7orf26"	1919	18442	429	134	226	203	65	69	282	195	260	306	727	626	876	570	1106	597
"C7orf27"	3140	4644	542	102	276	266	42	60	218	90	469	38	781	519	1263	987	1313	805
"C7orf28A"	1837	27262	15	0	15	0	0	0	84	0	0	0	162	199	1243	927	1505	888
"C7orf28B"	2081	3510	53	0	53	0	0	0	94	57	25	57	186	279	1397	872	1352	1139
"C7orf29"	2872	2872	0	0	0	0	0	0	18	0	0	0	43	42	119	22	184	44
"C7orf30"	759	10242	124	0	72	52	0	0	85	20	0	0	272	227	206	145	293	148
"C7orf31"	3619	45503	0	0	0	0	0	0	10	0	0	0	147	133	87	60	127	85
"C7orf33"	1356	25296	0	0	0	0	0	0	0	0	0	0	0	0	0	0	0	0
"C7orf34"	770	1356	0	0	0	0	0	0	18	0	0	0	0	0	0	0	0	0
"C7orf36"	858	6463	0	0	0	0	0	0	38	0	0	0	190	118	102	20	130	35
"C7orf38"	2448	5794	8	25	0	8	25	0	36	0	0	0	223	165	164	170	279	168
"C7orf4"	612	612	0	0	0	0	0	0	0	0	0	0	0	0	0	0	0	0
"C7orf40"	3112	3610	472	2251	264	208	1163	1088	83	9	0	1811	241	200	227	1769	286	1857
"C7orf41"	5817	27831	323	218	160	163	119	99	263	185	0	0	284	361	276	265	323	141
"C7orf42"	4244	37336	1211	624	680	531	390	234	650	703	418	1232	2448	2590	2895	2256	3194	2231
"C7orf43"	2523	4259	86	140	33	53	90	50	234	63	772	130	1083	843	1450	1082	1699	681
"C7orf44"	2697	98474	9517	10223	5265	4252	5732	4491	3878	5324	3103	7467	1508	2458	1126	1570	1043	766
"C7orf45"	1158	8981	0	0	0	0	0	0	0	0	0	0	0	0	0	0	0	0
"C7orf46"	4210	22521	185	0	100	85	0	0	39	5	0	0	104	90	62	40	140	61
"C7orf47"	961	1136	90	0	70	20	0	0	36	0	0	63	58	103	148	33	187	158
"C7orf49"	2657	78412	1356	1337	769	587	733	604	704	707	652	805	2633	2269	2510	2132	2938	1948
"C7orf50"	2607	3836	1059	32	554	505	19	13	1580	581	835	0	1636	1179	3741	2567	3249	2021
"C7orf51"	3588	10874	0	0	0	0	0	0	0	13	0	0	0	1	0	0	0	0
"C7orf52"	2976	9781	0	0	0	0	0	0	31	0	0	0	0	0	0	0	0	0
"C7orf53"	1749	10029	0	27	0	0	11	16	0	0	0	0	0	42	6	8	6	0
"C7orf55"	667	4644	9	0	9	0	0	0	19	0	0	2	1	108	143	30	46	71
"C7orf57"	2133	25778	0	1	0	0	1	0	27	0	0	0	6	7	3	0	3	0
"C7orf58"	5342	308748	3	0	0	3	0	0	9	0	0	0	9	10	16	25	12	0
"C7orf59"	616	5305	179	52	98	81	52	0	119	102	639	253	1632	744	751	1597	2309	803
"C7orf60"	4026	120732	4578	14080	2718	1860	7566	6514	1722	7087	850	14144	628	1030	1036	245	822	1056
"C7orf61"	1007	7658	15	0	7	8	0	0	35	50	0	1	7	0	11	0	19	5
"C7orf63"	3923	65889	0	0	0	0	0	0	0	0	0	0	0	0	0	0	0	0
"C7orf64"	1721	8737	52	0	12	40	0	0	70	25	0	0	339	290	304	173	330	122
"C7orf65"	2914	6406	0	0	0	0	0	0	13	0	0	0	0	0	0	0	0	0
"C7orf66"	422	599	0	0	0	0	0	0	0	0	0	0	0	0	0	0	0	0
"C7orf67"	2490	34636	0	0	0	0	0	0	176	127	0	0	0	0	0	0	0	0
"C7orf68"	1413	2589	0	0	0	0	0	0	26	5	0	0	82	46	83	22	112	43
"C7orf69"	664	24555	0	0	0	0	0	0	11	0	0	0	0	0	0	0	0	0
"C7orf70"	2215	19551	0	13	0	0	0	13	31	8	0	0	445	339	393	245	518	312
"C7orf71"	1994	9435	685	132	399	286	75	57	270	35	250	106	0	0	0	0	0	0
"C8A"	2403	63453	0	0	0	0	0	0	0	0	0	0	0	0	0	0	0	0
"C8B"	2270	36805	0	0	0	0	0	0	0	0	0	0	0	0	0	0	0	0
"C8G"	884	1730	0	0	0	0	0	0	90	99	0	0	3	0	0	0	0	0
"C8orf12"	1363	44535	0	0	0	0	0	0	69	23	0	0	0	0	0	0	0	0
"C8orf15"	1438	1438	36	0	11	25	0	0	0	0	0	0	0	0	0	0	0	0
"C8orf16"	1430	2962	152	79	88	64	43	36	28	37	38	48	0	0	0	0	0	0
"C8orf22"	1269	3740	0	0	0	0	0	0	0	0	0	0	0	0	0	0	0	0
"C8orf30A"	2410	2949	0	1	0	0	0	1	0	0	8	0	29	0	703	445	849	441
"C8orf31"	2065	15043	0	0	0	0	0	0	95	27	0	0	4	7	26	0	3	0
"C8orf33"	2621	3593	20	54	0	20	26	28	49	18	0	17	739	680	687	663	710	575
"C8orf34"	3664	381110	0	0	0	0	0	0	11	0	0	0	0	0	0	0	0	0
"C8orf37"	2260	23204	52	23	0	52	12	11	132	48	0	28	26	114	69	29	145	29
"C8orf38"	2142	33718	1064	2684	590	474	1420	1264	796	2075	240	1198	1724	1941	2021	3332	2173	1781
"C8orf39"	710	710	748	236	407	341	132	104	310	64	407	148	55	15	110	4	7	2
"C8orf4"	1834	1834	0	0	0	0	0	0	0	0	0	0	0	0	0	0	0	0
"C8orf40"	1472	11376	165	38	66	99	0	38	180	116	101	74	367	383	443	362	514	360
"C8orf41"	2513	14421	161	25	117	44	25	0	121	12	20	0	904	775	841	566	960	617
"C8orf42"	2786	55372	0	0	0	0	0	0	10	2	0	0	0	0	0	0	0	0
"C8orf44"	1821	4783	1304	129	722	582	104	25	725	114	926	161	416	97	290	41	343	20
"C8orf45"	5110	51300	9	113	0	9	0	113	15	0	0	0	1	413	0	0	0	0
"C8orf46"	3564	25268	0	0	0	0	0	0	11	0	0	0	0	0	0	0	0	0
"C8orf47"	1553	29090	0	0	0	0	0	0	0	0	0	0	0	0	0	0	0	0
"C8orf48"	1446	1446	0	0	0	0	0	0	0	0	0	0	0	0	0	0	0	0
"C8orf49"	1969	1969	0	0	0	0	0	0	0	0	2	0	4	4	0	0	0	0
"C8orf51"	2013	2013	0	0	0	0	0	0	0	9	0	0	44	8	0	0	0	0
"C8orf54"	2321	56647	0	0	0	0	0	0	0	0	0	0	0	0	0	0	0	0
"C8orf55"	2281	2397	0	0	0	0	0	0	79	0	0	0	249	168	388	266	345	247
"C8orf56"	497	8380	0	0	0	0	0	0	0	0	0	0	0	0	0	0	0	0
"C8orf58"	2058	4540	94	0	49	45	0	0	106	14	0	10	311	95	266	77	444	120
"C8orf59"	1050	6357	57	10	30	27	0	10	62	14	28	77	378	379	398	261	513	288
"C8orf73"	3262	6565	55	15	31	24	0	15	94	98	0	8	128	98	253	134	251	151
"C8orf74"	1233	27958	0	0	0	0	0	0	103	48	0	0	0	0	0	0	0	0
"C8orf75"	1400	26849	0	0	0	0	0	0	0	0	0	0	0	0	0	0	0	0
"C8orf76"	1292	21388	3170	1614	1937	1233	903	711	1340	808	1072	1332	2819	2889	2868	2053	3112	1684
"C8orf77"	3236	3236	0	0	0	0	0	0	0	0	0	0	11	2	5	3	7	2
"C8orf79"	9613	17762	161	0	65	96	0	0	145	0	0	0	137	97	7	20	39	9
"C8orf80"	3904	61907	0	0	0	0	0	0	11	0	0	0	0	0	0	0	0	0
"C8orf82"	2170	2857	297	0	154	143	0	0	43	15	227	31	143	356	163	76	719	75
"C8orf83"	3536	82476	39	0	30	9	0	0	173	11	0	0	98	100	90	88	116	56
"C8orf84"	3802	28730	0	0	0	0	0	0	13	0	0	0	12	0	0	0	0	0
"C8orf85"	1786	5775	0	0	0	0	0	0	0	0	0	0	0	0	0	0	0	0
"C8orf86"	2253	17830	0	0	0	0	0	0	0	0	0	0	0	0	0	0	0	0
"C8orfK29"	1603	2384	0	0	0	0	0	0	46	0	0	0	1	0	0	0	108	0
"C8orfK32"	6876	366799	0	0	0	0	0	0	34	0	0	0	0	0	0	0	0	0
"C9"	2702	80278	0	0	0	0	0	0	0	0	0	0	0	0	0	0	0	0
"C9orf10"	691	13599	960	72	503	457	60	12	560	84	198	188	14	349	723	714	976	522
"C9orf100"	4508	16991	86	0	36	50	0	0	112	19	11	1	438	287	493	318	621	325
"C9orf102"	5280	92698	2223	875	1253	970	495	380	1789	775	190	502	775	985	734	765	983	592
"C9orf103"	1620	21074	503	28	289	214	11	17	247	54	41	0	62	83	73	65	81	47
"C9orf106"	845	1589	0	0	0	0	0	0	28	0	0	0	0	0	0	0	0	0
"C9orf109"	5803	6950	0	0	0	0	0	0	0	0	0	0	29	16	294	83	211	34
"C9orf11"	1043	12484	0	0	0	0	0	0	38	4	0	0	0	4	0	0	0	0
"C9orf110"	5806	6953	0	0	0	0	0	0	10	0	0	0	24	0	285	83	196	32
"C9orf114"	1867	7741	218	33	119	99	21	12	194	73	162	9	779	463	251	505	472	224
"C9orf116"	1282	5340	0	0	0	0	0	0	0	10	0	0	0	0	0	0	0	4
"C9orf117"	1835	7034	36	25	19	17	15	10	49	133	0	198	30	123	0	50	21	45
"C9orf119"	1148	10390	0	0	0	0	0	0	122	0	0	0	72	33	46	48	93	51
"C9orf122"	1727	2192	0	0	0	0	0	0	0	29	0	46	9	27	0	29	0	0
"C9orf123"	2486	3308	0	0	0	0	0	0	0	0	0	0	257	169	285	316	321	288
"C9orf125"	2090	11868	0	0	0	0	0	0	0	0	0	0	0	0	0	0	0	0
"C9orf126"	12036	200911	848	62	491	357	22	40	500	26	79	40	308	351	148	42	252	31
"C9orf128"	3145	11732	0	0	0	0	0	0	14	0	0	0	0	0	0	0	0	0
"C9orf129"	1158	28216	0	0	0	0	0	0	27	0	0	0	0	0	350	333	395	210
"C9orf130"	8015	69889	340	275	191	149	109	166	141	94	97	122	66	60	63	7	46	1
"C9orf131"	3392	3766	130	225	98	32	103	122	83	123	0	210	0	0	0	0	0	0
"C9orf135"	881	85418	0	0	0	0	0	0	0	0	0	0	0	0	0	0	0	0
"C9orf138"	1660	105293	0	0	0	0	0	0	0	0	0	0	170	162	0	0	0	0
"C9orf139"	3818	9320	478	52	58	420	23	29	420	133	1128	28	1141	394	1295	356	1711	500
"C9orf14"	2928	37109	21	8	21	0	8	0	73	0	0	0	0	0	4	0	0	0
"C9orf140"	3837	8449	0	11	0	0	11	0	14	41	0	0	76	148	89	303	175	262
"C9orf142"	818	1559	81	0	41	40	0	0	21	35	152	0	311	304	451	334	708	403
"C9orf144A"	6133	8320	0	0	0	0	0	0	0	0	0	0	0	0	0	0	0	0
"C9orf144B"	4300	6485	0	0	0	0	0	0	15	0	0	0	0	0	0	0	0	0
"C9orf150"	2691	48048	0	0	0	0	0	0	0	0	0	0	0	0	0	0	0	0
"C9orf152"	2656	8567	0	0	0	0	0	0	0	0	0	0	0	0	0	0	0	0
"C9orf153"	1875	39340	0	0	0	0	0	0	0	0	0	0	1	0	0	0	0	0
"C9orf156"	3759	18082	586	689	325	261	416	273	309	281	53	160	502	593	415	342	506	452
"C9orf16"	1665	3670	104	0	57	47	0	0	93	32	0	0	525	494	1021	914	904	799
"C9orf163"	2573	2573	0	0	0	0	0	0	12	15	0	0	12	3	9	0	8	2
"C9orf167"	4070	4814	585	178	300	285	97	81	187	198	722	867	2402	2028	2400	2042	3884	2751
"C9orf169"	741	1120	0	0	0	0	0	0	57	72	0	30	0	0	0	0	14	0
"C9orf170"	3411	11084	0	0	0	0	0	0	0	0	0	0	0	0	0	0	0	0
"C9orf171"	1795	163065	2	0	0	2	0	0	290	83	0	0	0	1	0	0	0	0
"C9orf172"	2931	2931	1	0	1	0	0	0	18	0	0	29	0	9	0	0	0	0
"C9orf173"	1179	2206	0	0	0	0	0	0	36	28	0	0	0	0	0	0	0	0
"C9orf21"	1230	14067	123	881	89	34	394	487	75	411	0	797	101	378	437	288	576	636
"C9orf23"	1084	1610	0	0	0	0	0	0	16	0	0	0	269	6	294	252	19	289
"C9orf24"	2344	2580	9	0	0	9	0	0	51	10	0	0	6	0	0	0	9	2
"C9orf25"	3650	60387	2162	407	1320	842	231	176	1273	710	1117	920	469	498	667	491	867	521
"C9orf29"	1564	28460	0	0	0	0	0	0	0	0	0	0	0	0	0	0	0	0
"C9orf3"	3801	206961	1700	302	939	761	166	136	1736	605	117	369	128	155	44	64	188	68
"C9orf30"	2237	9325	468	3494	248	220	1916	1578	62	1202	0	2037	653	2516	464	1644	623	1060
"C9orf37"	1454	3525	1183	198	332	851	115	83	424	116	2367	414	1269	760	888	761	1277	955
"C9orf4"	1194	29992	0	0	0	0	0	0	0	0	0	0	0	0	0	0	0	0
"C9orf40"	2326	6304	0	0	0	0	0	0	0	0	0	0	84	76	142	31	121	89
"C9orf41"	2199	45437	218	14	105	113	14	0	123	0	56	0	74	91	410	288	448	267
"C9orf43"	2057	18857	0	0	0	0	0	0	0	0	0	0	0	0	0	3	0	3
"C9orf44"	2004	18143	0	0	0	0	0	0	33	0	0	0	0	0	166	0	0	0
"C9orf46"	1573	272100	8223	8207	4644	3579	4419	3788	5251	5037	2959	6652	6837	18360	6430	11561	8929	11289
"C9orf47"	4897	5279	0	0	0	0	0	0	21	0	0	0	0	0	7	1	21	1
"C9orf5"	8014	104811	2461	87	1367	1094	44	43	1617	76	173	111	2893	3281	2927	2206	2846	1722
"C9orf50"	1625	8551	0	0	0	0	0	0	0	0	0	0	0	0	0	0	0	0
"C9orf53"	616	616	0	0	0	0	0	0	0	0	0	0	0	0	0	0	0	0
"C9orf57"	1501	9225	0	0	0	0	0	0	0	0	0	0	0	0	0	0	0	0
"C9orf6"	1915	6564	235	60	181	54	33	27	205	29	51	0	120	132	132	50	117	64
"C9orf61"	1594	16720	0	0	0	0	0	0	76	0	0	0	110	99	75	70	131	49
"C9orf62"	1921	3309	0	0	0	0	0	0	18	8	0	0	0	0	0	0	0	0
"C9orf64"	2475	18436	0	0	0	0	0	0	0	0	0	0	396	310	325	161	311	125
"C9orf66"	2786	2786	1376	882	894	482	488	394	789	1750	101	67	71	71	52	39	49	24
"C9orf68"	4174	68145	0	0	0	0	0	0	10	0	0	0	220	147	254	62	284	116
"C9orf69"	2846	4305	166	0	111	55	0	0	96	41	0	0	1372	897	4	911	1993	1245
"C9orf7"	2886	10824	2746	10945	1773	973	5681	5264	146	7224	675	15975	78	8664	99	906	81	601
"C9orf70"	731	2603	0	0	0	0	0	0	0	0	0	0	0	0	0	0	0	0
"C9orf71"	1243	4285	0	0	0	0	0	0	0	0	0	0	1	0	0	0	0	0
"C9orf72"	3244	26939	1335	743	719	616	367	376	591	263	73	478	1326	1990	1165	1350	556	393
"C9orf75"	2535	8913	172	0	70	102	0	0	204	171	0	34	515	253	486	263	801	400
"C9orf78"	2395	6121	15	5	0	15	0	5	40	0	3	9	1183	1512	1657	1120	1321	1222
"C9orf79"	4449	6042	0	0	0	0	0	0	16	0	0	0	0	0	0	0	0	0
"C9orf80"	1522	31596	456	220	260	196	93	127	411	268	70	346	1865	21	530	491	578	665
"C9orf82"	2719	52043	1431	890	782	649	533	357	915	643	178	647	661	274	465	457	568	387
"C9orf84"	4670	108323	7395	738	4143	3252	387	351	4945	368	2287	605	0	0	1	0	0	1
"C9orf85"	2390	72969	685	10	341	344	10	0	724	23	175	11	115	84	105	37	116	59
"C9orf86"	3376	19860	2325	501	1293	1032	281	220	1408	665	2179	809	3285	2826	3082	3375	5340	3620
"C9orf89"	1014	17116	1114	1489	588	526	886	603	418	721	872	1970	832	842	829	1059	1090	864
"C9orf9"	2245	11133	0	0	0	0	0	0	0	0	0	0	10	30	28	14	69	38
"C9orf91"	4572	34992	23	22	21	2	22	0	47	216	0	40	215	293	167	295	181	159
"C9orf93"	4570	418800	11	24	0	11	10	14	37	0	0	0	25	36	15	19	17	15
"C9orf95"	1553	27013	12	0	10	2	0	0	73	9	0	0	61	112	200	146	443	267
"C9orf96"	3365	27937	120	9	82	38	9	0	183	70	28	1	0	0	0	3	0	0
"C9orf97"	4528	33600	786	548	453	333	317	231	630	545	0	666	829	369	784	387	972	453
"C9orf98"	2514	153235	0	0	0	0	0	0	325	75	0	46	25	66	23	25	73	26
"CA1"	1347	49940	0	0	0	0	0	0	0	0	0	0	0	0	0	0	0	0
"CA10"	3379	529488	0	0	0	0	0	0	11	0	0	0	0	0	0	0	0	0
"CA11"	1662	8181	18	0	0	18	0	0	135	73	0	0	196	119	173	237	483	320
"CA12"	3985	58346	0	0	0	0	0	0	20	0	0	0	0	0	0	0	0	0
"CA13"	3862	38588	13	43	0	13	28	15	14	58	0	39	0	78	0	8	0	0
"CA14"	1748	7260	104	127	62	42	67	60	91	303	0	142	0	0	0	0	0	0
"CA2"	1673	17592	81	73	42	39	64	9	67	45	21	22	710	786	1837	2006	1446	1817
"CA3"	1756	10211	13	43	0	13	28	15	45	58	0	39	0	82	0	9	5	0
"CA4"	1160	9604	0	0	0	0	0	0	74	0	0	0	0	0	0	0	0	0
"CA5A"	1091	48489	0	0	0	0	0	0	167	19	0	0	0	0	4	0	10	4
"CA5B"	6039	49337	94	22	85	9	17	5	45	0	0	29	115	156	70	49	112	47
"CA5BP"	999	28437	1214	1055	694	520	590	465	354	407	53	292	311	536	336	362	438	307
"CA6"	1342	29226	0	0	0	0	0	0	8	22	0	0	0	0	0	0	0	0
"CA7"	1705	9208	0	0	0	0	0	0	28	23	0	0	0	0	0	0	0	0
"CA8"	2287	92533	0	0	0	0	0	0	0	0	0	0	7	30	37	29	5	0
"CA9"	1563	7239	0	0	0	0	0	0	28	0	3	0	1	2	0	0	0	0
"CAB2"	2232	13628	47	0	33	14	0	0	314	132	0	34	265	217	403	335	461	353
"CAB39"	3959	107528	12061	3610	6752	5309	2029	1581	6203	2882	4201	4478	5503	4428	5024	3353	5787	3727
"CAB39L"	3684	92950	56	15	40	16	7	8	154	9	0	12	341	344	444	397	500	378
"CABC1"	6191	90659	2456	381	1363	1093	232	149	1479	253	567	175	1631	1003	1978	1132	2185	1484
"CABIN1"	7517	166730	22275	9309	12166	10109	4978	4331	11431	6573	27815	17327	4283	4848	6193	5107	9839	6332
"CABLES1"	5015	124709	0	0	0	0	0	0	252	14	0	0	42	25	147	175	77	95
"CABLES2"	3795	18655	196	0	138	58	0	0	314	186	0	0	280	283	254	205	370	282
"CABP1"	1608	26705	0	0	0	0	0	0	87	30	0	0	0	0	0	0	0	0
"CABP2"	968	4483	0	0	0	0	0	0	37	0	0	0	0	0	0	0	0	0
"CABP4"	1466	3869	40	0	21	19	0	0	146	14	0	0	119	81	182	172	144	77
"CABP5"	1257	14096	0	0	0	0	0	0	13	0	0	0	0	0	0	0	0	0
"CABP7"	2983	11476	3	0	3	0	0	0	60	39	0	0	123	14	173	25	156	125
"CABYR"	2338	22610	324	159	149	175	73	86	284	218	0	97	5	0	8	13	21	16
"CACHD1"	5579	187146	0	0	0	0	0	0	0	0	0	0	0	0	0	0	0	0
"CACNA1A"	8675	300020	0	0	0	0	0	0	164	37	0	0	1	0	0	0	0	5
"CACNA1B"	9829	246836	0	0	0	0	0	0	783	341	0	0	0	0	0	0	0	0
"CACNA1C"	13779	644701	0	0	0	0	0	0	830	136	0	0	3	0	0	0	0	0
"CACNA1D"	7816	317462	144	182	101	43	105	77	2026	1371	0	166	451	596	95	217	1315	675
"CACNA1E"	9768	317999	0	0	0	0	0	0	69	9	0	0	0	0	0	0	0	0
"CACNA1F"	6117	28311	0	0	0	0	0	0	92	31	0	0	4	1	0	0	0	0
"CACNA1G"	7974	66095	14	0	14	0	0	0	674	242	3	14	4	14	29	15	39	49
"CACNA1H"	8122	68532	0	0	0	0	0	0	586	328	0	0	0	0	0	0	0	0
"CACNA1I"	10037	118982	0	0	0	0	0	0	850	400	0	0	0	0	0	0	0	0
"CACNA1S"	6211	73055	0	0	0	0	0	0	288	105	0	0	0	0	0	0	0	0
"CACNA2D1"	3861	493615	0	0	0	0	0	0	0	0	0	0	0	0	0	0	0	0
"CACNA2D2"	5394	140661	11	0	0	11	0	0	1410	905	2	0	4	5	16	5	13	7
"CACNA2D3"	3711	951891	0	0	0	0	0	0	57	0	0	0	0	0	0	0	0	0
"CACNA2D4"	5380	126748	127	82	83	44	40	42	470	306	9	31	170	126	173	139	160	114
"CACNB1"	5665	20429	0	0	0	0	0	0	176	115	0	0	0	0	0	0	0	0
"CACNB2"	4481	281106	129	54	79	50	33	21	133	314	0	67	16	20	8	3	0	0
"CACNB2b"	1228	386818	47	27	23	24	16	11	45	63	0	0	16	14	1	0	0	0
"CACNB3"	4041	14050	0	0	0	0	0	0	164	36	0	0	0	0	0	3	0	0
"CACNB4"	8077	141199	559	258	335	224	123	135	2281	1482	75	110	31	36	85	16	331	232
"CACNG1"	1266	12205	0	0	0	0	0	0	39	11	0	0	0	0	0	0	0	0
"CACNG2"	1552	138801	0	0	0	0	0	0	236	67	0	0	1	0	0	0	0	0
"CACNG3"	2704	106862	1	0	0	1	0	0	0	0	0	0	0	0	0	0	0	0
"CACNG4"	3401	68507	0	0	0	0	0	0	496	195	0	0	1	0	0	0	0	0
"CACNG5"	1070	50123	0	0	0	0	0	0	14	0	0	0	0	0	0	0	0	0
"CACNG6"	1852	20378	0	0	0	0	0	0	0	0	0	0	0	0	10	3	0	0
"CACNG7"	1569	30199	0	0	0	0	0	0	19	16	0	0	0	0	0	0	0	0
"CACNG8"	1421	19847	0	0	0	0	0	0	12	0	0	0	0	0	0	0	0	0
"CACYBP"	3066	12273	535	0	279	256	0	0	347	17	48	0	2345	1780	2150	1521	2493	1671
"CAD"	7151	26397	453	17	250	203	14	3	697	166	146	10	1117	881	1273	1032	2163	942
"CADM1"	4320	330897	0	0	0	0	0	0	17	0	0	0	0	0	0	0	0	0
"CADM2"	3959	1109817	0	0	0	0	0	0	13	0	0	0	0	2	0	0	0	0
"CADM3"	3708	31557	0	0	0	0	0	0	44	20	0	0	0	5	29	24	0	0
"CADM4"	2185	17471	0	0	0	0	0	0	55	55	0	0	6	8	8	5	18	15
"CADPS"	5512	477045	0	0	0	0	0	0	8	0	0	0	0	0	0	0	0	0
"CADPS2"	5801	568077	0	0	0	0	0	0	0	0	0	0	0	0	0	0	0	0
"CAGE1"	3241	63055	0	0	0	0	0	0	0	0	0	0	743	763	0	0	0	868
"CALB1"	2542	24271	51	0	33	18	0	0	41	0	0	0	0	2	0	0	0	0
"CALB2"	1468	31715	0	0	0	0	0	0	0	0	0	0	0	0	0	0	0	0
"CALCA"	1630	4614	0	0	0	0	0	0	0	0	0	0	0	0	0	0	0	0
"CALCB"	2064	8744	0	0	0	0	0	0	12	8	0	0	0	0	0	0	0	0
"CALCOCO1"	4037	16406	826	230	438	388	118	112	566	188	677	82	864	1095	1744	1393	2867	1428
"CALCOCO2"	3367	33858	512	559	345	167	308	251	405	484	86	514	2148	2801	2080	2004	2687	1833
"CALCR"	3672	150021	0	0	0	0	0	0	0	0	0	0	45	36	8	24	8	0
"CALCRL"	5009	105172	16441	37203	9188	7253	20033	17170	7249	14108	3701	23505	3866	7251	2202	5344	3693	2769
"CALD1"	5230	191301	0	0	0	0	0	0	0	7	0	0	0	0	0	0	0	0
"CALHM1"	3058	5506	0	0	0	0	0	0	0	0	0	0	0	0	0	0	0	0
"CALHM2"	2027	3789	376	0	206	170	0	0	198	25	74	0	1770	798	1422	473	2018	884
"CALHM3"	1654	6437	0	0	0	0	0	0	34	14	0	0	0	1	0	0	0	0
"CALL"	2562	50955	0	0	0	0	0	0	0	0	0	0	0	0	0	0	0	0
"CALM/AF10"	1560	78680	3229	557	1768	1461	298	259	1775	425	498	426	530	689	297	205	270	147
"CALM1"	4305	11239	3625	3511	2074	1551	1905	1606	1489	1832	2047	1901	24134	27902	23111	19574	28838	17920
"CALM2"	1308	16521	8731	2139	4909	3822	1133	1006	3449	905	4196	1213	15032	10711	15881	12657	22652	14040
"CALM3"	2264	9528	195	8	108	87	0	8	149	156	99	108	2884	3110	3649	3729	4266	3176
"CALML3"	1303	1303	0	0	0	0	0	0	0	0	0	0	0	0	0	0	0	0
"CALML4"	4639	15406	2781	664	1512	1269	328	336	307	591	1061	567	539	2169	2435	1395	3112	1632
"CALML5"	877	877	0	0	0	0	0	0	0	9	0	0	0	0	0	0	0	0
"CALML6"	1107	2469	0	0	0	0	0	0	55	48	0	0	0	0	0	0	0	0
"CALN1"	9476	557733	0	0	0	0	0	0	66	0	0	0	0	0	0	0	0	0
"CALR"	1920	5892	1589	779	849	740	412	367	389	325	895	676	23421	22039	24974	23022	19958	17606
"CALR3"	1294	17130	0	0	0	0	0	0	0	0	0	0	0	0	0	0	0	0
"CALU"	4232	32186	800	214	481	319	130	84	599	190	82	261	3683	3811	5711	4955	4288	2816
"CALY"	989	11549	2	1	2	0	1	0	396	237	0	0	0	1	0	0	0	0
"CAMK1"	1494	12630	1720	244	1048	672	129	115	651	126	1143	121	3562	2846	3312	3036	4592	2876
"CAMK1D"	2249	480150	88932	107507	49652	39280	57695	49812	31082	46806	55249	87634	4700	4885	2758	2349	4105	2053
"CAMK1G"	2625	30223	0	297	0	0	201	96	0	192	0	321	4	476	11	1004	17	517
"CAMK2A"	4923	70351	0	0	0	0	0	0	449	121	0	0	0	0	0	0	0	0
"CAMK2B"	4610	108483	0	0	0	0	0	0	515	334	0	0	0	0	0	0	0	0
"CAMK2D"	5993	310895	2784	994	1603	1181	530	464	3394	1156	68	213	871	975	1209	1048	1344	899
"CAMK2G"	4597	62086	1358	199	740	618	114	85	1317	141	892	150	892	721	848	554	1369	636
"CAMK2N1"	2352	3845	0	0	0	0	0	0	0	0	0	0	0	0	0	0	0	0
"CAMK2N2"	1362	2250	341	453	192	149	233	220	23	181	0	11	0	1	0	0	0	0
"CAMK4"	2115	261100	0	0	0	0	0	0	0	0	0	0	0	0	0	0	0	0
"CAMKK1"	3562	32714	466	53	253	213	24	29	691	335	126	13	535	310	788	424	773	406
"CAMKK2"	5619	60617	4746	5518	2628	2118	3107	2411	1925	2825	2900	7971	2758	3206	2150	2197	4013	2246
"CAMKV"	3039	11949	0	0	0	0	0	0	15	62	0	0	3	0	0	0	0	0
"CAMLG"	2201	13637	58	0	34	24	0	0	61	30	0	0	488	413	418	262	643	328
"CAMP"	718	2115	0	0	0	0	0	0	35	12	0	0	0	0	0	0	0	0
"CAMSAP1"	7647	98673	4134	226	2326	1808	148	78	2509	235	1322	65	1568	1462	1670	1096	2024	1294
"CAMSAP1L1"	7400	121145	4441	15149	2378	2063	8265	6884	1178	6016	120	15551	1457	2755	1303	2420	1555	1123
"CAMTA1"	8464	984381	9288	7302	5179	4109	3963	3339	6399	4415	2083	6849	320	665	484	548	575	495
"CAMTA2"	4869	19374	1732	706	950	782	356	350	903	670	1311	931	1256	1804	1444	1338	2498	1379
"CAND1"	5923	45329	1824	2504	1118	706	1367	1137	835	694	166	214	3127	3744	2623	1805	3039	1775
"CAND2"	4607	38144	16	33	16	0	20	13	79	85	0	51	0	0	0	0	0	0
"CANT1"	3538	18102	850	1022	385	465	449	573	371	999	134	1719	1557	2056	1636	2347	2106	1841
"CANX"	4966	33211	2160	1600	1156	1004	903	697	843	546	884	1161	19879	18593	20758	18364	17766	12283
"CAP1"	2791	32070	9448	4658	5113	4335	2582	2076	2547	3021	5171	6818	24900	26339	29178	10673	70684	48122
"CAP2"	3038	164287	0	0	0	0	0	0	0	0	0	0	0	0	0	0	0	0
"CAPG"	1452	15807	468	1410	261	207	590	820	295	1058	173	1346	2721	5472	5653	10790	7266	7579
"CAPN1"	3029	30135	1361	258	775	586	124	134	814	189	649	29	4217	3946	3168	2815	5863	3315
"CAPN10"	2638	12377	816	91	418	398	48	43	676	246	827	101	345	240	803	561	999	549
"CAPN11"	2751	25593	9	1	4	5	0	1	82	25	0	1	15	19	46	10	110	61
"CAPN12"	3150	14284	200	200	106	94	100	100	157	75	0	0	1445	1425	1089	1018	441	1679
"CAPN13"	2692	84673	0	0	0	0	0	0	72	28	0	0	0	0	0	0	0	0
"CAPN14"	3842	44489	0	0	0	0	0	0	48	0	0	0	0	0	0	0	0	0
"CAPN2"	3601	18394	6180	48355	3365	2815	25836	22519	2135	9541	2635	12209	7585	8859	4571	4308	6205	4325
"CAPN3"	3529	64216	6991	4305	4021	2970	2247	2058	3192	2222	4030	3961	1365	1748	1744	1352	2727	1531
"CAPN5"	4549	59206	0	0	0	0	0	0	538	252	0	0	59	55	30	44	59	29
"CAPN6"	3581	25422	0	0	0	0	0	0	0	0	0	0	0	0	0	0	0	0
"CAPN7"	4388	46691	1728	266	1061	667	168	98	1515	384	203	305	395	734	928	722	1034	644
"CAPN8"	2118	138466	0	0	0	0	0	0	0	0	0	0	1	0	153	136	188	104
"CAPN9"	2613	54621	0	0	0	0	0	0	24	0	0	0	0	0	0	0	0	0
"CAPNS1"	1660	10335	409	137	258	151	85	52	229	146	326	311	8534	7851	7826	7185	10788	7527
"CAPNS2"	1010	1010	736	0	525	211	0	0	108	15	73	0	10	0	2	1	1	1
"CAPRIN1"	5581	50929	4250	1296	2385	1865	693	603	2105	817	1596	1401	8238	8990	8820	6920	10366	6320
"CAPRIN2"	4543	44963	466	52	270	196	43	9	419	40	68	40	837	759	924	546	809	424
"CAPS"	1613	2030	86	22	25	61	5	17	130	44	168	74	234	275	746	123	974	156
"CAPS2"	3852	113698	0	0	0	0	0	0	40	0	0	0	2	4	5	3	3	0
"CAPSL"	1008	34485	0	0	0	0	0	0	0	1	0	0	0	0	0	0	0	0
"CAPZA1"	2750	52168	7806	8913	4467	3339	4836	4077	2960	3987	3323	7676	10815	13473	7638	9208	10063	7143
"CAPZA2"	2365	56751	5869	5091	3438	2431	2725	2366	2255	2357	1183	3380	4160	4833	4176	3573	5873	3850
"CAPZA3"	1078	1078	0	0	0	0	0	0	0	0	0	0	0	0	0	0	0	0
"CAPZB"	2093	145929	30565	40932	16888	13677	21865	19067	10582	26332	19112	39107	6449	6854	7506	6771	4896	6497
"CARD10"	4862	39997	1146	239	635	511	131	108	809	436	1123	1385	1236	909	1015	774	1575	840
"CARD11"	4397	137812	54	8	36	18	0	8	186	126	0	7	52	87	37	50	88	55
"CARD14"	3937	30572	1266	194	345	921	96	98	437	173	808	115	151	195	907	2561	3828	1944
"CARD15"	671	6353	30	0	29	1	0	0	21	52	0	39	42	33	40	8	49	21
"CARD16"	762	4000	0	3	0	0	2	1	0	0	0	2	64	35	272	261	374	262
"CARD17"	470	8964	0	0	0	0	0	0	0	0	0	0	1	2	0	0	0	0
"CARD18"	426	1138	0	0	0	0	0	0	0	0	0	0	0	0	0	0	0	0
"CARD4"	1675	26643	4793	248	2670	2123	68	180	1857	132	3577	215	1061	190	460	259	445	154
"CARD6"	4098	14046	204	0	127	77	0	0	117	0	0	0	1249	825	1127	541	1355	668
"CARD8"	5635	41762	5109	1145	2735	2374	647	498	2290	418	2434	392	2684	2650	2355	1598	2554	1126
"CARD9"	3103	10694	5612	1559	3053	2559	766	793	1708	591	5700	1522	4522	3576	7686	4065	9786	5383
"CARHSP1"	3017	15448	683	140	393	290	82	58	194	184	206	217	318	355	296	229	632	377
"CARKD"	2669	24334	1131	455	686	445	224	231	514	357	624	414	742	635	1108	788	1285	664
"CARM1"	3027	51196	2160	134	1174	986	71	63	1411	314	1367	128	2406	2001	2230	1824	3576	2195
"CARMA2"	3877	39020	1266	194	345	921	96	98	437	173	808	115	151	195	907	2561	3828	1944
"CARMA3"	2428	4697	0	0	0	0	0	0	50	15	0	0	0	0	0	0	0	0
"CARP"	2337	82346	1609	824	919	690	512	312	1281	734	84	429	330	599	523	584	602	370
"CARS"	2824	56513	1735	1577	876	859	864	713	1120	1753	535	1930	987	996	1028	940	1452	1042
"CARS2"	1877	64725	1870	213	1054	816	107	106	1649	242	680	341	691	635	1144	796	1146	730
"CARTPT"	911	1880	0	0	0	0	0	0	0	0	0	0	0	0	0	0	0	0
"CASC1"	2650	86869	40	0	31	9	0	0	94	0	0	0	0	390	442	0	572	0
"CASC3"	4195	31927	1032	380	552	480	194	186	563	222	497	428	2392	2172	2243	1721	2642	1620
"CASC4"	3974	127031	373	29	211	162	19	10	539	72	151	11	1436	1569	1476	1240	1767	1150
"CASC5"	7712	68436	0	0	0	0	0	0	0	0	0	0	0	0	3	0	0	0
"CASD1"	3895	47158	165	0	69	96	0	0	113	0	9	0	407	453	386	307	451	294
"CASK"	8321	408098	656	311	417	239	180	131	620	333	24	237	512	489	1455	630	444	316
"CASKIN1"	5715	19283	113	1	62	51	1	0	109	13	0	0	717	550	883	722	1041	772
"CASKIN2"	4997	15286	7	0	2	5	0	0	149	70	1	0	258	264	314	274	555	292
"CASP1"	1544	9177	134	172	61	73	94	78	55	122	28	106	1542	1280	1410	1520	1587	1424
"CASP10"	5916	38764	665	90	372	293	77	13	596	280	185	212	1168	1308	682	724	654	640
"CASP12"	1310	11979	0	0	0	0	0	0	0	0	0	0	0	0	0	0	0	0
"CASP14"	1044	6707	0	0	0	0	0	0	8	0	0	0	0	0	0	0	0	0
"CASP2"	4137	19384	1800	105	1026	774	72	33	959	61	1373	105	1832	743	1465	507	1946	509
"CASP3"	2679	21779	1175	699	709	466	378	321	694	205	328	304	2024	1761	707	1923	2899	1878
"CASP4"	1582	19780	767	1133	428	339	674	459	476	885	51	1034	1272	2513	1357	1729	1562	1823
"CASP5"	1498	28930	0	0	0	0	0	0	0	0	0	0	2	10	0	5	16	0
"CASP6"	1668	14846	144	0	65	79	0	0	131	0	0	0	323	240	266	160	379	277
"CASP7"	2702	51238	443	1699	295	148	984	715	387	1938	43	4813	778	1121	1418	1987	1035	1191
"CASP8"	3080	29682	1987	1583	1135	852	881	702	992	799	582	648	1572	1413	791	568	817	511
"CASP8AP2"	6772	44537	938	30	531	407	13	17	509	66	137	48	740	644	781	344	855	288
"CASP9"	4324	33468	394	5	219	175	3	2	316	0	118	38	133	370	594	433	684	450
"CASQ1"	1967	11391	2	0	0	2	0	0	95	69	0	0	3	0	0	0	0	0
"CASQ2"	2709	68800	0	0	0	0	0	0	23	0	0	0	0	0	0	0	0	0
"CASR"	5017	102164	0	0	0	0	0	0	0	0	0	0	0	0	0	0	0	0
"CASS4"	3186	47230	6597	17804	3655	2942	9475	8329	1492	7714	2119	23640	2374	13618	794	4533	1198	3739
"CAST"	4657	112444	10431	7158	5678	4753	3897	3261	5554	4264	2860	5378	9303	11044	8387	7245	10347	6553
"CASZ1"	7952	160041	62	61	44	18	18	43	942	652	0	128	197	262	113	74	242	122
"CAT"	2303	33127	1995	128	1044	951	56	72	1096	36	501	22	6599	4486	7258	5050	8996	4869
"CATSPER1"	2630	9766	8	0	4	4	0	0	42	10	0	0	117	58	80	52	160	127
"CATSPER2"	1946	18267	107	9	60	47	9	0	118	21	0	59	157	163	131	63	173	89
"CATSPER2P1"	1637	10350	0	0	0	0	0	0	37	0	0	0	0	38	5	0	0	4
"CATSPER3"	1345	43773	451	118	275	176	47	71	282	74	134	35	255	80	57	14	59	5
"CATSPER4"	1428	11915	0	0	0	0	0	0	34	0	0	0	2	0	0	0	0	0
"CATSPERB"	3633	151297	0	0	0	0	0	0	0	0	0	0	0	0	0	0	0	0
"CATSPERG"	3752	35147	387	109	188	199	62	47	412	227	94	27	30	8	7	0	50	22
"CATX-11"	5003	17389	190	498	119	71	218	280	102	397	0	468	3143	4217	2567	2831	3292	2850
"CAV1"	3249	271326	0	0	0	0	0	0	0	0	0	0	0	23	0	0	0	0
"CAV2"	3303	9152	0	0	0	0	0	0	0	0	0	0	0	0	0	0	0	0
"CAV3"	1422	12956	0	0	0	0	0	0	29	10	0	0	0	0	0	0	0	0
"CBARA1"	2431	258803	532	411	303	229	242	169	888	549	138	453	821	560	479	821	675	1002
"CBFA2T2"	7749	87668	6042	2217	3326	2716	1335	882	2989	1271	2428	2741	1056	936	914	649	1093	615
"CBFA2T3"	4277	102136	9050	6628	4839	4211	3420	3208	3809	7637	7609	10451	663	183	501	498	713	551
"CBFB"	3137	71908	6280	1226	3486	2794	620	606	2496	488	1921	1244	3572	3972	2958	2265	3328	2138
"CBL"	11242	101870	20901	3836	11510	9391	2110	1726	8149	1513	14339	3830	7692	8920	8810	5404	11423	5964
"CBLB"	3994	210779	4356	2520	2638	1718	1485	1035	3888	1325	405	886	446	713	768	647	567	337
"CBLC"	1601	22778	0	0	0	0	0	0	22	42	0	0	0	0	0	0	0	0
"CBLL1"	4345	17805	551	265	319	232	157	108	342	159	0	89	922	875	885	752	1075	589
"CBLN1"	2028	3506	0	0	0	0	0	0	0	0	0	0	0	0	0	0	0	0
"CBLN2"	2899	7810	0	0	0	0	0	0	0	0	0	0	0	0	0	0	0	0
"CBLN3"	2345	2991	51	0	15	36	0	0	27	12	0	0	64	38	33	38	43	0
"CBLN4"	2510	7517	0	0	0	0	0	0	0	0	0	0	0	0	0	0	0	0
"CBR1"	1881	3181	16	0	16	0	0	0	25	0	0	0	1722	1410	2224	1635	2445	1595
"CBR3"	1113	11597	54	0	20	34	0	0	110	13	0	0	467	268	307	223	655	403
"CBR4"	3458	22680	1176	84	664	512	36	48	717	42	177	46	650	407	612	273	609	265
"CBRC7TM_40"	2256	2940	0	0	0	0	0	0	0	0	0	0	0	0	0	0	0	0
"CBS"	2670	15215	184	19	96	88	14	5	258	108	0	0	142	185	643	624	805	674
"CBWD1"	2945	46568	305	1300	187	118	686	614	258	833	0	461	390	649	856	931	1799	1027
"CBWD2"	1987	58514	188	1057	124	64	574	483	174	535	0	458	171	361	744	779	1407	910
"CBWD3"	2850	58178	0	64	0	0	33	31	18	4	0	0	23	21	523	494	732	455
"CBWD5"	2976	14606	0	64	0	0	33	31	18	4	0	0	28	37	1035	836	1389	837
"CBWD6"	1938	58056	74	0	41	33	0	0	32	10	0	0	30	25	116	98	142	75
"CBX1"	2426	31147	184	10	110	74	0	10	156	0	55	0	709	821	1006	748	369	731
"CBX2"	4183	9387	0	0	0	0	0	0	11	20	0	0	0	0	0	0	4	0
"CBX3"	1855	11652	397	161	223	174	106	55	237	102	65	154	10853	2365	5537	10153	7292	2357
"CBX4"	2653	6259	228	0	125	103	0	0	91	49	0	21	665	432	746	485	911	334
"CBX5"	11706	28599	2265	912	1300	965	528	384	962	515	862	1066	3526	4172	3138	2282	3515	1893
"CBX6"	3257	7996	5761	1756	3097	2664	475	1281	46	34	3636	42	10553	346	284	457	759	461
"CBX7"	3957	21750	1161	133	616	545	65	68	613	154	584	404	226	738	971	717	1373	766
"CBX8"	1526	2716	0	0	0	0	0	0	12	13	0	0	17	6	166	43	221	62
"CBY1"	1275	17197	1	0	0	1	0	0	51	0	0	0	53	39	48	18	98	56
"CC2D1A"	3669	24739	403	95	249	154	33	62	159	62	92	13	867	619	885	825	1297	887
"CC2D1B"	5663	15599	1410	1011	789	621	567	444	619	564	753	1203	926	832	1629	1283	2600	1465
"CC2D2A"	5278	131693	1826	179	952	874	131	48	3135	324	1231	234	0	0	0	0	5	0
"CC2D2B"	2489	58656	325	381	185	140	238	143	356	150	51	111	6	55	7	3	17	6
"CCAR1"	3881	70338	4356	1772	2364	1992	942	830	2181	1124	2705	2462	2363	2631	2169	2024	2421	1378
"CCBE1"	3293	263497	0	0	0	0	0	0	0	0	0	0	0	0	0	0	0	0
"CCBL1"	2512	27420	117	0	54	63	0	0	392	74	293	0	125	92	118	98	143	107
"CCBL2"	2166	57189	3188	3818	1831	1357	2124	1694	1551	1518	243	1745	3669	6003	2728	3529	3067	2556
"CCBP2"	3604	90861	0	0	0	0	0	0	8	9	0	0	0	0	0	0	0	0
"CCDC101"	1160	37863	111	76	55	56	45	31	218	84	42	25	176	194	230	133	154	142
"CCDC102A"	2436	24387	0	0	0	0	0	0	46	31	0	0	0	2	0	0	0	0
"CCDC102B"	2827	339937	4486	756	2438	2048	455	301	886	58	482	132	297	391	174	94	91	111
"CCDC103"	1258	3475	0	0	0	0	0	0	14	11	0	0	10	0	0	4	13	0
"CCDC104"	1385	25478	649	38	374	275	24	14	307	40	0	52	195	231	170	150	264	209
"CCDC105"	1758	12546	0	0	0	0	0	0	0	0	0	0	0	0	0	0	0	0
"CCDC106"	1996	5572	22	0	13	9	0	0	90	43	0	0	299	211	336	244	520	309
"CCDC107"	1113	2874	88	0	39	49	0	0	71	0	24	0	477	326	526	375	697	377
"CCDC108"	5980	38671	0	0	0	0	0	0	113	0	0	0	0	0	0	0	0	0
"CCDC109A"	2955	195563	2845	1110	1593	1252	667	443	1830	730	238	892	405	398	458	404	578	397
"CCDC109B"	1278	127515	101	0	58	43	0	0	376	11	0	20	114	140	222	206	265	228
"CCDC11"	1832	39304	0	0	0	0	0	0	11	0	0	0	0	0	0	0	0	4
"CCDC110"	2902	26576	0	0	0	0	0	0	0	0	0	0	0	0	0	0	0	0
"CCDC111"	2309	45347	184	474	134	50	253	221	190	548	24	199	343	335	153	159	293	206
"CCDC112"	2552	29104	474	37	290	184	16	21	454	52	83	55	559	411	568	279	602	337
"CCDC113"	5273	33894	0	0	0	0	0	0	11	0	0	0	0	0	0	0	0	0
"CCDC114"	3234	23625	0	0	0	0	0	0	86	13	0	0	0	1	3	0	0	0
"CCDC115"	1853	4108	11	0	11	0	0	0	83	31	0	0	1239	264	374	1213	426	412
"CCDC116"	2196	4531	0	0	0	0	0	0	15	26	0	0	0	0	0	0	0	0
"CCDC117"	3989	16622	237	112	129	108	50	62	162	103	9	56	909	891	1161	906	1118	770
"CCDC12"	920	53737	4868	2802	2522	2346	1581	1221	2141	1951	2940	3424	517	259	340	305	755	456
"CCDC120"	4271	16410	0	0	0	0	0	0	70	70	0	0	13	16	12	3	36	0
"CCDC121"	2765	3236	0	0	0	0	0	0	0	0	0	0	59	0	89	0	0	0
"CCDC122"	2013	43337	0	0	0	0	0	0	124	0	0	0	1	12	12	29	27	23
"CCDC123"	2877	3056	14	0	14	0	0	0	76	0	0	0	169	152	146	115	187	100
"CCDC124"	1053	8890	0	15	0	0	0	15	101	81	0	19	391	484	592	599	771	597
"CCDC125"	3624	39890	17	0	7	10	0	0	119	0	0	0	233	101	178	110	172	117
"CCDC126"	2476	47330	33	25	33	0	18	7	135	0	39	0	231	194	212	138	243	153
"CCDC127"	1423	13424	90	0	56	34	0	0	168	14	0	0	287	10	53	185	59	227
"CCDC129"	5002	136327	0	0	0	0	0	0	8	0	0	0	0	0	0	0	0	0
"CCDC13"	2845	64872	0	1	0	0	1	0	26	15	0	0	23	21	18	25	34	11
"CCDC130"	1929	31534	403	174	225	178	84	90	391	222	458	296	600	440	713	576	836	614
"CCDC132"	3669	126686	4250	280	2329	1921	164	116	2792	139	180	144	1055	1094	1255	950	1349	836
"CCDC134"	1282	25627	70	9	40	30	0	9	243	49	7	0	128	27	148	57	147	35
"CCDC135"	3060	36655	0	0	0	0	0	0	80	36	0	0	0	1	0	0	0	0
"CCDC136"	4186	30086	2	0	0	2	0	0	39	11	0	0	0	0	0	0	0	0
"CCDC137"	2112	7175	58	0	17	41	0	0	205	125	0	0	797	432	615	440	714	415
"CCDC138"	2211	89630	7	0	0	7	0	0	0	0	0	0	18	5	14	0	5	0
"CCDC14"	6783	45473	855	356	475	380	153	203	486	138	167	164	679	749	672	478	848	414
"CCDC140"	1701	7072	0	0	0	0	0	0	12	0	0	0	0	0	0	0	0	0
"CCDC141"	6971	177039	1	0	0	1	0	0	0	0	0	0	0	0	0	0	0	0
"CCDC142"	4368	10399	426	28	229	197	9	19	309	130	91	0	387	216	839	630	856	532
"CCDC144A"	5846	84674	0	0	0	0	0	0	67	0	0	0	0	0	352	321	397	64
"CCDC144B"	8626	87731	276	325	151	125	202	123	188	57	0	35	148	282	123	212	200	36
"CCDC144C"	4220	81019	12	8	0	12	0	8	23	22	0	0	34	33	7	0	3	0
"CCDC144NL"	2808	32745	0	0	0	0	0	0	0	0	0	0	0	0	0	0	0	0
"CCDC146"	4565	118610	13411	8783	7549	5862	4806	3977	6421	3499	4669	5258	55752	61066	49841	34540	64620	33264
"CCDC147"	3322	101319	0	0	0	0	0	0	29	0	0	0	0	0	0	0	0	0
"CCDC148"	2199	284737	0	0	0	0	0	0	0	0	0	0	0	0	0	0	0	0
"CCDC149"	5538	153191	0	0	0	0	0	0	0	8	0	0	10	19	25	33	10	6
"CCDC15"	3907	87368	5	0	5	0	0	0	41	0	0	0	30	54	16	25	29	6
"CCDC150"	3713	93176	0	0	0	0	0	0	3	0	0	0	0	2	0	0	0	0
"CCDC151"	2174	14709	0	0	0	0	0	0	0	20	0	0	10	1	23	11	16	0
"CCDC152"	3500	45621	0	0	0	0	0	0	0	0	0	0	108	143	159	297	68	12
"CCDC153"	898	5747	0	0	0	0	0	0	45	15	0	0	15	12	9	12	19	13
"CCDC154"	2207	10102	195	0	115	80	0	0	592	78	115	24	6	11	93	43	108	81
"CCDC155"	2362	29742	3	0	0	3	0	0	289	118	0	0	4	5	0	0	0	0
"CCDC157"	3059	20191	17	0	6	11	0	0	123	91	0	19	121	102	124	104	184	142
"CCDC158"	3649	94267	0	0	0	0	0	0	0	0	0	0	292	289	0	0	0	0
"CCDC159"	1228	5948	48	6	30	18	6	0	80	71	0	36	170	193	250	232	243	210
"CCDC160"	1299	8731	0	0	0	0	0	0	0	0	0	0	0	0	0	0	0	0
"CCDC17"	2358	4014	459	35	237	222	24	11	114	32	162	14	14	0	11	0	58	0
"CCDC18"	4682	98348	2692	1827	1585	1107	1065	762	1588	957	172	1034	883	638	1026	297	946	585
"CCDC19"	2009	27752	191	267	111	80	127	140	127	318	0	571	2529	4423	4259	5677	5024	4800
"CCDC21"	3949	44608	1018	78	587	431	48	30	610	50	339	52	903	780	987	502	2988	657
"CCDC22"	2732	15458	284	3	193	91	3	0	175	121	61	27	490	421	922	805	894	817
"CCDC23"	801	10338	9	0	0	9	0	0	0	14	0	0	3	194	238	206	257	199
"CCDC24"	1572	4724	0	0	0	0	0	0	82	13	0	0	13	0	7	5	30	11
"CCDC25"	3647	39337	57	0	26	31	0	0	41	0	0	0	440	449	465	362	532	346
"CCDC26"	1290	1290	1847	486	452	1395	272	214	342	159	143	269	36	73	0	0	26	21
"CCDC27"	2186	19246	0	0	0	0	0	0	145	44	0	0	0	1	0	0	0	0
"CCDC28A"	1500	19799	11	0	11	0	0	0	0	0	32	0	657	636	879	712	794	605
"CCDC28B"	1450	4786	116	56	63	53	24	32	141	56	0	93	12	25	44	33	43	25
"CCDC29"	787	23195	34	0	34	0	0	0	20	5	0	0	0	6	29	20	0	0
"CCDC3"	2741	105081	0	0	0	0	0	0	15	0	0	0	1	0	0	0	0	0
"CCDC30"	4154	191312	19	8	11	8	0	8	127	0	0	0	7	16	19	1	16284	19
"CCDC33"	2768	99816	0	0	0	0	0	0	427	148	0	0	3	6	0	0	0	0
"CCDC34"	2123	14378	0	0	0	0	0	0	25	0	0	0	5	16	33	25	29	17
"CCDC36"	3004	59678	16	0	16	0	0	0	0	10	0	0	1	0	0	0	0	0
"CCDC37"	2103	41618	77	19	36	41	19	0	218	62	0	18	0	0	0	0	0	0
"CCDC38"	1969	75603	14	0	14	0	0	0	18	0	0	0	0	0	1	1	0	0
"CCDC39"	3873	65488	831	73	316	515	31	42	482	0	0	0	257	731	290	0	369	1
"CCDC40"	4312	63977	0	0	0	0	0	0	160	8	0	0	2	4	5	11	13	7
"CCDC41"	3240	151708	517	1172	275	242	682	490	250	1127	100	414	778	861	522	405	841	448
"CCDC42"	1386	14909	0	0	0	0	0	0	71	0	0	0	0	0	0	0	0	0
"CCDC42B"	1521	9419	44	0	38	6	0	0	2	35	0	0	39	49	481	65	588	40
"CCDC43"	2143	12362	85	15	66	19	6	9	84	16	0	0	619	579	606	426	604	421
"CCDC45"	2707	30904	1868	1146	1087	781	652	494	1135	632	296	887	531	726	641	457	656	372
"CCDC46"	3544	556330	1978	959	1295	683	524	435	1293	550	70	188	564	863	109	86	836	519
"CCDC47"	3519	28479	1173	299	624	549	163	136	581	296	435	469	4214	4666	4771	4475	4889	3875
"CCDC48"	2697	39113	0	0	0	0	0	0	122	20	0	0	0	0	0	0	0	0
"CCDC49"	2457	24144	222	384	109	113	203	181	65	119	45	150	227	358	407	557	471	418
"CCDC50"	8960	69586	423	603	264	159	345	258	392	241	0	38	917	1034	817	721	1023	584
"CCDC51"	1597	7930	13	0	5	8	0	0	70	0	0	0	98	57	194	82	211	111
"CCDC52"	7131	72435	133	15	87	46	5	10	93	10	0	20	162	258	196	232	248	167
"CCDC53"	1020	49183	876	163	499	377	85	78	574	150	78	252	531	375	406	292	548	301
"CCDC54"	1295	1295	0	0	0	0	0	0	0	0	0	0	0	0	0	0	0	0
"CCDC55"	2873	30220	5213	3323	2916	2297	1733	1590	2361	1515	2875	3489	580	875	680	575	740	529
"CCDC56"	1373	3541	11	0	0	11	0	0	72	0	0	0	392	361	390	362	463	380
"CCDC57"	6749	59205	2789	1626	1383	1406	845	781	1783	1385	2070	3035	576	668	905	865	931	695
"CCDC58"	722	23639	19	0	19	0	0	0	37	24	25	13	0	17	119	104	121	76
"CCDC59"	1614	6111	82	113	51	31	54	59	81	69	0	32	321	276	274	330	313	282
"CCDC6"	6223	118298	8417	2197	4724	3693	1197	1000	4980	871	2282	63	545	708	5149	3504	4991	3218
"CCDC60"	2463	206336	0	0	0	0	0	0	10	0	0	0	0	0	0	0	0	0
"CCDC61"	1839	23536	96	0	72	24	0	0	66	0	17	0	150	125	181	138	238	156
"CCDC62"	3546	50822	0	0	0	0	0	0	0	4	0	0	0	0	3	8	9	0
"CCDC63"	1957	60529	0	0	0	0	0	0	11	9	0	0	0	0	0	0	0	0
"CCDC64"	3090	104653	146	0	70	76	0	0	158	83	100	60	13	28	78	47	70	23
"CCDC64B"	3343	5136	0	0	0	0	0	0	85	23	0	0	1	1	0	0	0	0
"CCDC65"	1822	17467	172	12	142	30	0	12	173	182	28	49	0	0	0	6	0	0
"CCDC66"	3223	64664	2366	134	1336	1030	77	57	1253	75	579	75	2179	1816	1997	976	2597	1282
"CCDC67"	2678	107753	0	0	0	0	0	0	0	12	0	0	0	0	0	1	5	0
"CCDC68"	4142	57999	0	0	0	0	0	0	0	0	0	0	0	0	0	0	0	0
"CCDC69"	3407	43042	1199	29	735	464	14	15	840	107	816	126	2962	2594	3639	3325	3651	2418
"CCDC7"	4281	68470	93	15	76	17	15	0	127	0	110	45	26	310	3	0	0	0
"CCDC70"	1155	4256	0	0	0	0	0	0	0	0	0	0	0	0	0	0	0	0
"CCDC71"	1813	3818	43	11	19	24	1	10	112	13	0	0	335	193	401	195	514	234
"CCDC72"	467	3853	56	29	16	40	0	29	23	36	0	52	289	352	596	1363	1675	1323
"CCDC73"	4385	114748	135	0	99	36	0	0	84	50	0	83	467	528	440	426	592	218
"CCDC74A"	1463	5747	0	0	0	0	0	0	36	0	0	0	0	0	0	0	0	0
"CCDC74B"	1495	2927	0	0	0	0	0	0	0	0	0	0	0	0	0	0	0	0
"CCDC75"	1264	12144	0	0	0	0	0	0	121	24	58	0	0	0	453	206	517	239
"CCDC76"	3153	17349	476	30	286	190	15	15	390	36	104	150	521	379	423	221	434	126
"CCDC77"	2378	41065	686	53	378	308	0	53	74	80	337	231	350	320	395	312	493	298
"CCDC78"	3461	3875	128	20	67	61	0	20	121	45	177	31	256	193	265	132	438	263
"CCDC79"	2464	46645	0	0	0	0	0	0	0	0	0	1	1	0	0	0	0	0
"CCDC8"	3334	3334	0	0	0	0	0	0	0	0	0	0	0	0	0	0	0	0
"CCDC80"	4529	36568	0	0	0	0	0	0	0	0	0	0	0	1	0	0	0	0
"CCDC81"	2795	48374	0	0	0	0	0	0	0	0	0	0	0	0	0	0	0	0
"CCDC82"	2875	37155	443	425	233	210	250	175	377	206	42	132	687	778	1011	896	688	455
"CCDC83"	2357	64909	8	5	5	3	5	0	0	0	0	1	3	4	0	0	0	0
"CCDC84"	1212	17604	2340	1778	1316	1024	935	843	1062	885	2067	1845	957	4061	278	162	417	316
"CCDC85A"	3988	202052	0	0	0	0	0	0	0	0	0	0	0	0	7	0	0	0
"CCDC85B"	1232	1232	0	0	0	0	0	0	0	16	0	0	2	784	1780	0	1710	0
"CCDC85C"	5676	93125	88	122	35	53	86	36	1247	781	0	307	638	1043	1035	343	490	395
"CCDC86"	2019	9134	0	0	0	0	0	0	105	33	0	0	300	230	377	317	559	363
"CCDC87"	2915	2915	0	0	0	0	0	0	0	0	0	0	0	0	0	0	0	0
"CCDC88A"	9846	132081	30364	26352	16724	13640	14934	11418	10432	11014	10142	20763	10295	8333	9027	9489	8544	8191
"CCDC88B"	4941	17312	1528	937	922	606	509	428	642	523	1320	872	1528	1672	1529	1049	4125	1798
"CCDC88C"	7516	146466	197	33	132	65	25	8	1173	331	0	25	39	132	74	132	166	102
"CCDC89"	2429	2429	0	0	0	0	0	0	0	0	0	0	0	0	0	0	0	0
"CCDC9"	2088	15479	366	483	170	196	240	243	217	333	223	815	350	740	457	632	565	553
"CCDC90A"	1824	23770	2380	169	1284	1096	92	77	1127	83	191	224	816	2323	998	1049	1327	1029
"CCDC90B"	1583	24873	704	124	392	312	71	53	470	113	191	207	543	618	615	438	578	465
"CCDC91"	2615	370890	11391	8073	6450	4941	4431	3642	6871	4482	1204	3784	363	499	491	452	565	417
"CCDC92"	1798	36210	2286	702	1139	1147	380	322	1157	685	913	760	162	659	828	643	1437	119
"CCDC93"	6816	98550	6036	2085	3352	2684	1152	933	3741	1591	2048	2193	649	718	3491	2685	3815	2161
"CCDC94"	1403	21974	99	11	55	44	11	0	91	251	51	319	253	433	389	506	462	483
"CCDC96"	2154	2154	0	0	0	0	0	0	0	0	0	0	35	0	34	0	70	0
"CCDC97"	3326	14695	1481	576	814	667	337	239	870	713	1370	982	758	689	852	746	1205	824
"CCDC99"	2677	21143	25	0	6	19	0	0	11	0	0	0	125	125	172	96	231	81
"CCHCR1"	2975	15351	0	0	0	0	0	0	59	47	0	0	69	59	98	90	147	92
"CCHL1A2"	587	36688	0	0	0	0	0	0	129	12	0	0	0	0	0	0	0	0
"CCIN"	1942	1942	0	0	0	0	0	0	27	0	0	0	0	0	0	0	0	0
"CCK"	1494	8346	0	0	0	0	0	0	0	0	0	0	0	0	0	0	0	0
"CCK1"	1354	35740	0	0	0	0	0	0	0	0	0	0	0	0	0	0	3	0
"CCKAR"	1687	9026	3	0	0	3	0	0	0	0	0	0	0	0	0	0	0	0
"CCKBR"	2330	12391	0	0	0	0	0	0	15	10	0	0	0	0	0	0	0	0
"CCL1"	545	2855	25	1772	25	0	958	814	17	703	0	529	0	28425	0	36491	0	25000
"CCL11"	928	2514	0	0	0	0	0	0	0	0	0	0	1	1	0	0	0	0
"CCL13"	853	2159	417	652	216	201	552	100	232	703	105	212	19257	28722	41014	45334	31899	27002
"CCL14"	558	3074	0	0	0	0	0	0	0	0	0	0	54	68	61	51	139	41
"CCL15"	1495	18410	0	0	0	0	0	0	0	0	0	13	73	99	78	112	177	51
"CCL16"	1499	4989	0	0	0	0	0	0	11	8	0	0	0	0	0	0	0	0
"CCL17"	622	11297	307	985	181	126	515	470	95	493	231	1201	2620	4737	4772	15112	12037	13328
"CCL18"	772	7199	22	89	0	22	68	21	177	289	0	30	1892	2352	2850	4538	3657	2377
"CCL19"	686	1707	0	0	0	0	0	0	19	16	0	0	0	0	27	20	0	3
"CCL2"	748	1924	0	0	0	0	0	0	0	25	0	112	302	1221	647	4380	320	1743
"CCL20"	846	3724	0	334	0	0	188	146	0	127	0	47	0	2987	0	6263	3	2366
"CCL21"	880	1145	0	0	0	0	0	0	11	13	0	0	0	0	0	0	0	0
"CCL22"	2895	7383	2342	6290	1340	1002	3403	2887	471	2699	2219	9055	29593	44965	39935	64033	32792	44188
"CCL23"	629	4910	0	0	0	0	0	0	39	160	0	19	1138	2024	3116	5058	3286	2488
"CCL24"	420	1978	3	0	3	0	0	0	0	11	8	0	5000	590	8460	15183	1014	5279
"CCL25"	1004	9902	0	0	0	0	0	0	0	0	0	0	0	0	0	0	0	0
"CCL26"	566	20224	0	0	0	0	0	0	20	11	0	0	370	566	1282	1623	1131	833
"CCL27"	449	798	0	0	0	0	0	0	0	0	0	0	0	0	0	0	0	0
"CCL28"	818	30889	0	0	0	0	0	0	0	0	0	0	0	0	0	0	3	0
"CCL3"	797	1903	833	7514	447	386	3988	3526	45	4229	0	4384	94	63183	1829	106178	1995	64666
"CCL3L1"	786	1890	31	603	17	14	323	280	0	334	0	269	0	2733	0	1085	123	3982
"CCL3L3"	964	1876	31	603	17	14	323	280	0	334	0	269	0	2733	0	1081	91	3982
"CCL4"	670	1796	806	7668	446	360	4125	3543	0	3299	0	3323	1106	89154	1818	137362	2593	112814
"CCL4L"	856	1814	108	648	55	53	334	314	0	353	0	234	0	6507	358	28912	946	50701
"CCL4L2"	659	1806	108	648	55	53	334	314	0	353	0	234	0	6507	358	28912	946	50701
"CCL5"	1230	8881	1044	8100	623	421	4364	3736	11	3329	0	2864	257	9127	159	4847	312	2801
"CCL7"	807	2017	0	0	0	0	0	0	0	0	0	0	0	1	0	0	0	0
"CCL8"	1251	2355	0	0	0	0	0	0	0	0	0	0	83	950	149	1541	73	591
"CCM2"	2139	49085	8829	5900	4910	3919	3286	2614	3759	3415	3864	8114	1826	1434	1688	1543	2716	1615
"CCNA1"	1973	10611	6	0	0	6	0	0	0	0	0	0	114	155	138	96	191	104
"CCNA2"	2805	7490	0	0	0	0	0	0	0	14	0	0	178	506	26	21	72	45
"CCNB1"	2096	11155	3	0	0	3	0	0	26	2	0	0	100	274	109	175	144	83
"CCNB1IP1"	1665	18004	138	50	112	26	35	15	43	39	0	148	231	215	227	167	353	231
"CCNB2"	1521	19925	509	282	249	260	161	121	152	133	0	165	24	79	45	53	66	65
"CCNB3"	4706	125495	0	0	0	0	0	0	0	0	0	0	2	0	0	3	6	0
"CCNC"	2407	26428	966	430	590	376	246	184	616	288	97	218	1088	1193	387	376	1038	707
"CCND1"	4293	13370	0	0	0	0	0	0	15	67	0	0	136	253	311	324	450	396
"CCND2"	6526	31621	3721	492	2036	1685	207	285	1521	535	3349	708	3401	2497	2321	1156	3627	2247
"CCND3"	2147	6474	1161	244	684	477	85	159	600	340	384	589	1725	1750	2108	1951	3062	471
"CCNDBP1"	2572	10764	371	51	199	172	31	20	225	5	57	55	1477	1376	2036	1708	2296	1456
"CCNE1"	1962	12319	17	0	11	6	0	0	51	0	0	0	124	104	217	87	254	158
"CCNE2"	2735	15028	51	12	20	31	0	12	58	18	0	0	93	125	18	283	53	92
"CCNF"	4304	29466	21	0	11	10	0	0	53	62	7	0	62	32	41	4	99	12
"CCNG1"	2929	10624	17	14	11	6	0	14	91	30	0	0	1239	1028	1119	796	1366	910
"CCNG2"	5479	12855	1162	21	636	526	0	21	651	44	586	151	2862	1694	2515	834	4858	1355
"CCNH"	2450	17931	35491	9998	19782	15709	2652	7346	10853	4474	10726	6614	3815	1588	3532	1852	3962	3342
"CCNI"	1878	27948	4781	5976	3219	1562	3263	2713	1505	2187	1902	4344	11290	2185	3908	3715	4934	2347
"CCNI2"	2409	6721	0	0	0	0	0	0	18	0	0	0	125	132	108	96	220	132
"CCNJ"	4142	17466	1519	330	826	693	187	143	641	189	145	150	760	335	787	379	851	263
"CCNJL"	3381	87930	0	0	0	0	0	0	31	0	0	0	0	0	0	0	0	0
"CCNK"	2616	30114	2029	5687	1044	985	3110	2577	860	3090	109	4052	1034	3141	1367	2484	1191	1114
"CCNL1"	3846	6869	7011	12205	3873	3138	6573	5632	3304	5783	2842	7518	4496	10434	5291	9652	5888	7327
"CCNL2"	5282	13629	2615	1661	1463	1152	921	740	1072	931	1767	1774	1969	2110	2933	2467	3797	1947
"CCNO"	1726	2444	0	0	0	0	0	0	0	0	0	0	0	0	0	0	0	0
"CCNT1"	2577	24031	567	587	347	220	317	270	144	318	113	752	469	180	127	145	139	85
"CCNT2"	5007	38193	5056	6163	2813	2243	3294	2869	2256	2845	1132	3447	2231	3237	2316	2209	2637	1341
"CCNY"	4027	235045	44024	20198	24626	19398	10935	9263	20501	10598	28439	18423	5817	5435	5389	4602	6874	4583
"CCNYL1"	3764	44632	2015	1818	1179	836	1007	811	1033	1053	451	1004	1715	2107	1479	1255	1912	1320
"CCPG1"	6990	17714	1739	194	938	801	117	77	1151	39	118	36	3817	4578	3052	3037	3755	2325
"CCR1"	2678	6634	408	305	222	186	152	153	589	51	819	103	12354	36	62	0	1	2
"CCR10"	1244	2425	0	0	0	0	0	0	15	0	0	0	0	0	0	0	0	0
"CCR2"	2674	7179	197	0	124	73	0	0	149	0	14	0	12872	6127	2004	991	5144	1630
"CCR3"	2646	24271	1643	305	912	731	152	153	667	51	890	103	12508	7250	10552	4828	13284	6397
"CCR4"	1659	3339	0	0	0	0	0	0	0	0	0	0	0	0	0	0	0	0
"CCR5"	3657	6059	1281	779	696	585	412	367	425	211	633	255	11602	12178	7628	8233	13080	9823
"CCR6"	5398	139813	558	43	349	209	30	13	467	52	0	30	576	559	507	276	401	238
"CCR7"	2174	11703	0	0	0	0	0	0	85	75	0	22	152	227	294	239	527	166
"CCR8"	1489	3976	0	0	0	0	0	0	0	0	0	0	0	0	0	0	0	0
"CCR9"	2634	16650	0	0	0	0	0	0	0	0	0	0	0	0	0	0	0	0
"CCRK"	2371	8308	4	0	0	4	0	0	12	0	0	0	0	2	21	11	17	6
"CCRL1"	2401	2401	0	0	0	0	0	0	13	0	0	0	0	0	0	0	0	0
"CCRL2"	1730	2294	29	1160	15	14	635	525	10	283	0	400	530	3364	709	8506	607	4322
"CCRN4L"	1955	30150	4074	15641	2316	1758	8417	7224	748	7795	175	7466	469	4723	249	1806	214	679
"CCS"	1039	12801	169	34	96	73	12	22	168	50	0	0	362	357	455	380	578	424
"CCT1"	2299	11206	257	2288	152	105	1203	1085	184	1558	0	990	2012	3733	3210	4912	3176	3202
"CCT2"	2201	15897	221	274	126	95	145	129	98	153	57	149	1720	1885	1772	2046	1706	1649
"CCT3"	2273	29445	427	347	216	211	210	137	370	513	239	866	1913	2578	2720	3223	3076	2498
"CCT4"	2582	20530	382	392	230	152	226	166	257	441	121	503	3141	3090	2752	2912	2839	1833
"CCT5"	3492	15851	523	547	246	277	342	205	256	469	0	876	2722	2422	5028	5926	5451	3660
"CCT6A"	2678	12306	331	374	193	138	237	137	332	311	134	410	3311	3605	4085	4351	4467	3326
"CCT6B"	1828	33568	0	13	0	0	7	6	24	17	0	0	39	65	52	48	38	29
"CCT6P1"	1777	12571	159	0	125	34	0	0	84	31	0	0	107	225	225	173	363	99
"CCT7"	1998	18741	268	155	105	163	55	100	257	146	68	98	2148	1565	2394	1970	2081	1428
"CCT8"	1907	17362	726	1287	432	294	696	591	323	515	18	526	2307	3964	4417	3869	4780	3544
"CCT8L2"	2054	2054	0	0	0	0	0	0	0	0	0	0	0	0	0	0	0	0
"CD109"	9485	132534	99	57	44	55	28	29	162	30	0	7	1229	1584	1374	1267	927	646
"CD14"	1608	1695	0	0	0	0	0	0	0	0	0	0	202	16	428	631	185	195
"CD151"	1557	5884	272	102	149	123	48	54	109	53	308	26	3437	2702	2481	1746	2233	764
"CD160"	3343	19634	433	34	210	223	17	17	196	126	65	120	30	27	3	5	15	0
"CD163"	4222	33004	0	0	0	0	0	0	0	0	0	0	444	397	1028	1455	744	487
"CD163L1"	4630	89192	8	5	0	8	5	0	0	0	0	0	9	13	3	16	4	0
"CD164"	3117	16046	2123	2711	1164	959	1554	1157	508	879	885	1195	10292	10807	12005	8678	12036	8263
"CD164L2"	1543	4210	0	0	0	0	0	0	42	0	0	0	0	0	0	0	0	0
"CD177"	2518	9656	0	0	0	0	0	0	0	0	0	0	0	0	0	0	0	0
"CD180"	2718	14515	0	0	0	0	0	0	41	0	50	0	1963	138	2536	1588	1576	40
"CD19"	1963	7403	44	0	19	25	0	0	125	73	0	0	14	3	6	8	23	12
"CD1A"	2099	4131	3828	1218	2128	1700	722	496	941	366	1286	498	16270	17748	10403	6640	47664	24000
"CD1B"	1400	3581	3924	1849	2181	1743	1006	843	1450	484	2673	1554	19528	20087	18539	15835	29855	23352
"CD1C"	2597	5002	3877	2366	2114	1763	1285	1081	1277	709	1474	1383	21279	22310	20959	18138	30072	19933
"CD1D"	3788	6479	104	0	57	47	0	0	107	8	111	0	91	40	855	507	190	261
"CD1E"	2067	3803	1358	419	746	612	214	205	324	92	944	503	11726	12764	11629	8668	14503	9001
"CD2"	1625	11000	0	0	0	0	0	0	19	15	0	0	38	26	27	33	108	67
"CD200"	2295	29742	0	0	0	0	0	0	0	0	0	0	16	45	11	0	23	17
"CD200R1"	2280	52407	14621	860	8089	6532	449	411	6614	106	4468	140	633	2060	4368	3179	5935	2682
"CD200R1L"	1471	30243	0	0	0	0	0	0	0	0	0	0	11	0	3	114	0	0
"CD207"	1873	5607	4	0	0	4	0	0	0	0	0	0	30	70	13	0	50	0
"CD209"	4333	7585	6414	1304	3573	2841	483	821	2212	845	1907	2424	33375	34206	30752	26741	34808	23114
"CD22"	3297	18185	0	0	0	0	0	0	162	48	85	0	268	194	872	890	487	528
"CD226"	2819	84896	19035	6873	10668	8367	3715	3158	7855	1637	8252	4084	6707	1057	599	928	782	480
"CD24"	2181	2181	36	0	17	19	0	0	19	12	0	0	186	218	36	0	131	21
"CD244"	2615	32696	4	33	0	4	12	21	35	0	0	0	44	81	193	150	152	92
"CD247"	1688	87971	2181	1018	1291	890	610	408	240	193	84	608	116	129	72	47	152	93
"CD248"	2559	2559	0	0	0	0	0	0	94	55	0	0	0	0	0	0	0	0
"CD27"	1325	6834	87	19	59	28	19	0	123	57	0	0	263	298	138	93	201	90
"CD274"	1545	17918	5338	6935	2943	2395	3718	3217	2303	3614	2233	5314	4971	15551	5114	10243	6961	10209
"CD276"	3411	30239	8742	17267	4836	3906	9218	8049	2047	9120	3681	15796	5621	9747	9733	15019	10990	12332
"CD28"	3810	31360	0	0	0	0	0	0	0	0	0	0	0	10	13	5	5	0
"CD2AP"	5425	149471	9	0	9	0	0	0	17	3	0	0	313	405	398	293	316	242
"CD2BP2"	3503	4169	409	402	169	240	214	188	194	180	136	399	2964	2625	1550	1502	1801	1212
"CD300A"	1894	18411	144	16	75	69	5	11	170	74	0	0	241	259	610	611	357	403
"CD300C"	1521	5037	95	6	44	51	6	0	166	37	0	7	468	242	247	243	371	354
"CD300E"	743	11091	0	0	0	0	0	0	16	0	0	0	0	0	0	0	0	0
"CD300LB"	2298	10302	0	0	0	0	0	0	14	0	0	0	41	84	694	686	184	268
"CD300LD"	648	12261	0	0	0	0	0	0	0	0	0	0	0	0	0	0	0	0
"CD300LF"	1826	18657	0	0	0	0	0	0	134	13	0	0	58	74	446	449	211	197
"CD300LG"	2759	16449	0	0	0	0	0	0	70	29	0	0	0	0	0	0	0	0
"CD302"	3983	29627	5654	3297	3200	2454	1801	1496	2769	1539	1445	1126	7642	8117	2625	2374	6041	3653
"CD320"	1255	6230	0	0	0	0	0	0	29	17	0	0	35	12	41	59	46	13
"CD33"	4887	14660	1793	173	985	808	100	73	1033	135	1146	178	2666	2219	2127	1370	3959	2276
"CD34"	2819	24802	1	0	1	0	0	0	22	0	0	0	6	57	0	29	0	4
"CD36"	4741	40762	9312	2524	5180	4132	1402	1122	2656	404	541	200	8577	6550	3423	2790	5882	3172
"CD37"	2775	4787	64	31	43	21	16	15	102	68	45	6	441	394	504	481	770	710
"CD38"	1679	47780	264	5705	166	98	3046	2659	345	4530	7	1327	214	1005	214	363	278	193
"CD39L2"	2820	31023	1766	842	949	817	438	404	1207	1082	841	320	1732	1734	1960	1755	3291	1817
"CD3D"	746	3672	0	0	0	0	0	0	0	0	0	0	9	11	0	9	28	9
"CD3E"	1521	11596	1	0	1	0	0	0	0	0	0	0	48	45	22	25	89	91
"CD3EAP"	3289	4559	76	28	43	33	12	16	124	14	31	0	348	243	374	180	394	171
"CD3G"	1318	9440	0	0	0	0	0	0	0	0	0	0	6	4	5	0	8	0
"CD4"	3155	31327	2152	362	1163	989	201	161	1366	201	1177	101	12658	10797	13235	11788	16338	10116
"CD40"	2028	6035	15026	50009	8383	6643	49927	82	1293	42627	4137	89277	4112	55693	3734	54999	5421	39640
"CD40LG"	1837	12214	11	0	0	11	0	0	41	0	0	0	0	0	0	0	0	0
"CD44"	5747	93531	73140	243758	40472	32668	131969	111789	23592	163810	37390	222228	50219	96725	31071	67919	45022	42539
"CD46"	3384	43457	2947	1023	1759	1188	614	409	2196	794	1638	899	6021	7061	6639	5619	7104	4885
"CD47"	5357	47996	3845	1166	2125	1720	697	469	2240	552	1273	500	4101	4045	4959	3617	4965	2989
"CD48"	1771	28262	413	419	231	182	245	174	302	485	118	558	344	834	269	362	298	277
"CD5"	3166	25393	1690	829	900	790	456	373	930	580	460	413	17	11	0	0	78	9
"CD52"	826	1281	240	96	129	111	49	47	171	32	190	29	10911	4525	2907	16175	3870	6930
"CD53"	1580	28738	10039	11938	5130	4909	6536	5402	3215	5887	4168	12447	18461	24247	19727	22404	23045	19626
"CD55"	2923	39494	33	403	33	0	225	178	93	225	0	288	479	666	727	978	611	723
"CD58"	1399	52394	12384	67957	7000	5384	36492	31465	2381	32889	1790	48191	1554	12901	1412	7581	1810	3585
"CD59"	7786	19717	338	186	171	167	103	83	385	98	70	39	2400	2979	2409	2317	4736	2509
"CD5L"	2241	10930	0	0	0	0	0	0	0	0	0	0	0	0	0	0	0	0
"CD6"	3299	48733	76	61	31	45	25	36	136	81	0	0	15	54	12	9	142	67
"CD63"	1229	4215	498	324	284	214	183	141	124	170	205	314	11111	11451	14082	14143	13491	8566
"CD68"	1861	2625	833	415	447	386	238	177	316	225	317	175	25997	22561	45570	42826	36781	27572
"CD69"	1679	8415	20	21	12	8	12	9	33	11	0	0	26	386	22	594	42	150
"CD7"	1412	2069	2	1	1	1	1	0	91	12	0	0	24	19	15	16	21	25
"CD70"	957	8030	0	0	0	0	0	0	0	0	0	0	0	0	0	0	0	0
"CD72"	1813	8436	52	35	41	11	18	17	151	47	0	0	584	474	610	581	751	626
"CD74"	1800	11100	32864	57304	18209	14655	30078	27226	8289	29801	19358	59841	416150	491840	413955	408704	556135	434774
"CD79A"	1262	4250	1	0	1	0	0	0	91	31	0	0	55	50	32	57	92	61
"CD79B"	1270	3608	0	0	0	0	0	0	13	16	26	0	93	108	106	106	153	103
"CD80"	2762	35341	11740	49716	6562	5178	26859	22857	2288	28394	1195	31801	2668	13479	2345	9307	2237	2654
"CD81"	1744	11319	3819	4529	2073	1746	2369	2160	859	2656	1959	9079	9216	10939	12941	13774	16360	14947
"CD82"	1699	54174	33	436	26	7	229	207	381	1485	16	1320	426	383	1020	1547	517	560
"CD83"	2480	19283	27631	154434	15382	12249	83075	71359	4667	84076	9398	149868	4814	135959	9134	147962	8335	106920
"CD84"	3323	33460	6871	7885	3897	2974	4238	3647	2813	3860	2993	2204	1584	2431	8126	9077	7323	5306
"CD86"	2727	43234	8824	29701	4870	3954	16078	13623	3111	9363	2330	10103	4011	6899	7562	7191	6435	5771
"CD8A"	3062	23792	0	0	0	0	0	0	11	0	0	0	118	109	50	118	104	37
"CD8B"	1487	20350	0	0	0	0	0	0	0	0	0	0	0	4	3	0	0	0
"CD9"	1573	38556	347	51	218	129	19	32	379	219	0	250	2645	2515	3102	2879	2300	2274
"CD93"	6702	6985	647	197	391	256	67	130	184	123	461	743	2907	2718	2647	2290	2790	1780
"CD94 alt"	3213	9434	15	10	9	6	10	0	18	0	0	0	50	64	21	22	56	47
"CD96"	4495	110281	10	16	0	10	16	0	0	0	0	0	11	40	10	10	43	20
"CD97"	3251	27322	1091	89	659	432	58	31	906	225	607	575	1615	867	1827	1622	2961	1543
"CD99"	1261	50122	0	0	0	0	0	0	0	0	0	0	0	0	3618	3928	4915	3811
"CD99L2"	3615	132371	784	135	391	393	67	68	720	96	112	61	1448	1392	1898	1579	2258	1513
"CDA"	961	29956	2285	223	1276	1009	108	115	1139	281	2788	1957	1163	1037	972	300	1237	340
"CDA14"	1786	40565	222	0	172	50	0	0	191	0	30	30	311	349	635	581	371	262
"CDADC1"	3352	45518	19	0	6	13	0	0	71	0	0	0	157	106	156	56	162	84
"CDAN1"	4756	13657	438	19	234	204	19	0	278	158	141	82	397	266	574	268	728	298
"CDC10L"	673	19782	0	0	0	0	0	0	18	0	0	0	0	0	0	0	11	0
"CDC123"	1596	54628	968	186	482	486	105	81	506	101	100	130	1174	1213	921	773	1154	841
"CDC14A"	4410	167811	1216	2807	669	547	1534	1273	911	2128	41	1038	171	188	160	134	194	129
"CDC14B"	5746	119717	0	0	0	0	0	0	0	0	0	0	0	0	0	0	0	0
"CDC16"	2311	37790	1782	404	911	871	243	161	1148	278	656	90	1663	1478	2180	1290	2094	1238
"CDC2"	2885	9867	0	0	0	0	0	0	9	0	0	0	6	6	0	0	3	3
"CDC20"	1776	4181	0	0	0	0	0	0	81	25	0	0	0	0	0	0	38	14
"CDC20B"	2970	60182	0	0	0	0	0	0	8	0	0	0	0	9	0	0	0	8
"CDC23"	3167	25693	50	0	34	16	0	0	17	11	0	0	391	384	410	362	1169	685
"CDC25A"	3721	31135	0	0	0	0	0	0	9	12	0	0	0	0	0	0	0	0
"CDC25B"	3688	10360	599	239	314	285	149	90	502	240	399	227	1248	1303	1142	1217	1435	888
"CDC25C"	2296	53087	0	0	0	0	0	0	8	0	0	223	0	0	0	3	1	3
"CDC26"	874	8581	31	0	19	12	0	0	42	9	0	0	91	106	278	132	366	250
"CDC27"	5627	71354	3946	1519	2114	1832	808	711	2195	1082	731	1247	723	753	1109	1570	2210	1399
"CDC2L1"	2521	84677	1457	958	883	574	567	391	1017	962	826	820	2674	2490	5908	4434	7103	4437
"CDC2L2"	2645	21621	374	540	242	132	296	244	174	350	133	339	373	617	1272	899	1521	1078
"CDC2L5"	5401	145188	11263	5731	6343	4920	3137	2594	5124	2300	4311	4481	2244	1889	2389	1756	2724	1467
"CDC2L6"	6152	205233	8696	5744	4928	3768	3228	2516	3908	2427	1972	4743	1635	1827	1536	1294	1797	1040
"CDC34"	1449	10355	272	0	142	130	0	0	198	202	125	488	460	462	823	776	933	671
"CDC37"	1769	12464	595	1617	300	295	762	855	266	1177	228	1779	1647	2726	3701	5481	4028	6225
"CDC37L1"	1704	27029	116	52	49	67	29	23	164	37	0	53	317	314	363	238	365	204
"CDC40"	3902	51835	620	78	325	295	38	40	544	7	38	40	876	707	1210	809	1171	841
"CDC42"	2350	40317	6185	8182	3524	2661	4451	3731	2217	3485	2984	7978	7731	11591	10193	8968	11493	10331
"CDC42BPA"	10541	328261	85	34	39	46	23	11	111	52	0	19	383	454	512	456	466	276
"CDC42BPB"	6738	125028	6480	2511	3670	2810	1322	1189	4179	3116	4090	4498	3906	4229	4650	4073	6050	4457
"CDC42BPG"	4974	20379	1	0	0	1	0	0	201	180	0	0	2	1	0	0	0	0
"CDC42EP1"	2163	8939	55	10	31	24	1	9	174	43	81	132	15	6	1132	805	863	520
"CDC42EP2"	1982	7570	15	0	15	0	0	0	28	32	0	0	93	107	71	192	144	166
"CDC42EP3"	3983	28585	667	4158	347	320	2268	1890	333	1931	24	1090	790	41	651	694	835	1027
"CDC42EP4"	3102	28381	0	12	0	0	0	12	314	203	0	19	331	206	304	202	441	197
"CDC42EP5"	878	8214	0	0	0	0	0	0	0	0	0	0	0	0	0	0	3	0
"CDC42SE1"	3187	8678	3407	1787	1918	1489	995	792	739	741	2973	2134	6308	7580	8052	4500	6789	5899
"CDC42SE2"	4446	130658	12883	4961	7491	5392	2662	2299	5611	2521	5964	4980	4004	4475	4239	3372	4674	3035
"CDC45L"	2025	40720	0	0	0	0	0	0	79	13	0	0	0	7	3	0	8	5
"CDC5L"	3015	59479	1332	997	742	590	575	422	602	807	149	844	1273	1306	1827	1367	1859	1208
"CDC6"	3065	15269	0	0	0	0	0	0	17	15	0	0	2	12	0	0	0	4
"CDC7"	3324	24657	0	0	0	0	0	0	17	0	0	0	21	38	42	28	3	0
"CDC73"	5954	132854	4441	2889	2492	1949	1595	1294	2315	1865	382	1400	1390	1812	1419	1368	1503	1012
"CDCA2"	3817	48914	0	0	0	0	0	0	17	0	0	0	0	0	0	4	0	0
"CDCA3"	2782	6495	0	0	0	0	0	0	8	0	0	0	0	0	4	0	7	0
"CDCA4"	2455	11517	443	3350	247	196	739	2611	102	2279	0	3078	164	1159	225	812	269	357
"CDCA5"	2582	6690	0	0	0	0	0	0	16	18	0	0	0	26	11	0	10	0
"CDCA7"	2820	14159	0	0	0	0	0	0	0	0	0	0	0	9	0	0	4	3
"CDCA7L"	2972	45026	92	0	67	25	0	0	236	4	0	0	827	757	847	703	1210	839
"CDCA8"	2408	17232	0	0	0	0	0	0	0	26	0	0	22	18	23	9	21	4
"CDCP1"	6015	64146	551	101	295	256	62	39	1185	98	312	61	1084	944	770	595	1061	712
"CDCP2"	2727	14777	0	0	0	0	0	0	28	14	0	0	0	0	0	0	0	0
"CDD"	1083	29956	2285	223	1276	1009	108	115	1139	281	2788	1957	1163	1037	972	300	1237	340
"CDGAP"	8090	125104	40047	88648	21428	18619	45703	42945	12384	45893	15066	51511	8655	18034	5404	9543	10277	6876
"CDH1"	4831	98251	1	0	1	0	0	0	0	10	0	0	39	13	7	0	59	27
"CDH10"	3273	157703	0	0	0	0	0	0	0	0	0	0	0	0	0	0	0	0
"CDH11"	3839	175236	0	0	0	0	0	0	0	0	0	0	0	0	0	0	0	0
"CDH12"	4360	1102760	0	0	0	0	0	0	0	0	0	0	536	594	0	397	0	138
"CDH13"	3945	1169621	0	0	0	0	0	0	42	9	0	0	19	47	0	0	6	6
"CDH15"	2872	23738	0	0	0	0	0	0	270	84	0	0	1	0	0	0	0	0
"CDH16"	2850	10742	0	0	0	0	0	0	152	86	0	0	0	0	0	0	0	0
"CDH17"	3717	90139	0	0	0	0	0	0	0	0	0	0	0	0	0	0	0	0
"CDH18"	3052	515152	0	0	0	0	0	0	0	0	0	0	0	0	0	0	0	0
"CDH19"	3197	99897	0	0	0	0	0	0	0	0	0	0	0	0	0	0	0	0
"CDH2"	4383	226517	6938	3212	4048	2890	1823	1389	3275	1355	2000	3165	1564	1750	1407	1100	1707	981
"CDH20"	3080	221379	0	0	0	0	0	0	0	13	0	0	0	0	0	0	0	0
"CDH22"	3911	134763	2	70	1	1	67	3	462	159	0	0	0	2	0	0	0	0
"CDH23"	11168	419000	31434	102046	22217	9217	54071	47975	11010	10099	11722	103757	7187	7233	5479	93702	8268	8161
"CDH24"	3566	10478	0	0	0	0	0	0	29	22	0	0	0	0	0	3	0	0
"CDH26"	3396	54687	64	0	30	34	0	0	70	12	0	6	12	15	26	7	41	6
"CDH28"	6314	73221	0	0	0	0	0	0	35	10	0	0	0	0	0	0	0	0
"CDH29"	2485	9081	0	0	0	0	0	0	58	34	0	0	0	3	0	0	0	0
"CDH3"	4292	54808	0	0	0	0	0	0	24	0	0	0	0	23	0	0	0	0
"CDH4"	3107	337467	0	0	0	0	0	0	3499	1040	0	0	0	0	0	0	0	0
"CDH5"	4139	38165	0	0	0	0	0	0	143	70	0	0	0	0	0	0	3	3
"CDH6"	4533	131443	0	0	0	0	0	0	0	0	0	0	0	0	0	0	0	0
"CDH7"	3508	113205	0	0	0	0	0	0	0	0	0	0	0	0	0	0	0	0
"CDH8"	2941	382803	0	0	0	0	0	0	4	0	0	0	0	0	0	0	0	0
"CDH9"	3087	157982	0	0	0	0	0	0	0	0	0	0	0	0	0	0	0	0
"CDIE"	1069	1726	1358	237	746	612	129	108	170	40	369	252	11705	12743	11229	8308	14086	7052
"CDIPT"	1919	4848	161	0	111	50	0	0	70	21	0	0	1248	1077	1496	1349	1889	1413
"CDK10"	1810	9697	923	326	534	389	199	127	455	363	373	703	673	1124	1318	1011	1303	1241
"CDK2"	2299	6013	29	14	12	17	7	7	39	44	0	0	322	392	245	259	280	232
"CDK2AP1"	1615	11147	86	0	43	43	0	0	169	36	0	0	1594	1690	540	509	540	1283
"CDK2AP2"	1381	2135	20	22	20	0	0	22	90	26	0	0	778	558	996	271	1073	692
"CDK3"	3338	26782	160	183	77	83	113	70	115	176	8	117	188	437	471	449	675	367
"CDK4"	1449	4161	49	10	25	24	10	0	50	72	0	22	1298	1567	742	1406	1316	988
"CDK5"	1149	4099	1	0	1	0	0	0	125	102	0	0	23	19	540	410	675	523
"CDK5R1"	3855	4167	0	0	0	0	0	0	0	0	0	0	9	15	0	0	0	0
"CDK5R2"	2480	2480	0	0	0	0	0	0	34	14	0	0	0	0	0	0	0	0
"CDK5RAP1"	3330	42692	1049	116	638	411	48	68	690	120	274	193	457	432	649	603	859	689
"CDK5RAP2"	6475	191291	1228	310	647	581	193	117	1304	418	291	448	847	705	916	797	1157	702
"CDK5RAP3"	2733	10420	1529	790	782	747	384	406	535	341	572	391	1073	1122	3008	2125	5028	2464
"CDK6"	11723	231706	5285	26848	3014	2271	14650	12198	1762	8462	0	10182	1476	1925	1382	1198	1313	813
"CDK7"	1616	42636	427	1809	268	159	960	849	65	1037	0	2573	111	226	354	596	353	382
"CDK8"	1782	149815	2570	270	1439	1131	160	110	1982	162	342	64	408	434	460	342	530	386
"CDK9"	2479	4749	832	445	429	403	243	202	319	286	437	478	1748	1283	1295	907	1786	1180
"CDKAL1"	3107	697946	5963	3366	3595	2368	1871	1495	5277	3632	597	2870	419	449	381	320	375	263
"CDKL1"	3001	80469	157	152	45	112	106	46	201	197	0	0	168	210	59	1	100	0
"CDKL2"	4959	54018	0	0	0	0	0	0	0	0	0	0	0	0	0	0	0	0
"CDKL3"	2137	68651	1665	4313	876	789	2722	1591	885	2596	597	3631	164	550	514	837	190	570
"CDKL4"	1573	50985	0	0	0	0	0	0	7	0	0	0	0	0	0	0	0	0
"CDKL5"	3450	228024	1015	41	625	390	9	32	513	88	68	62	463	635	312	287	512	245
"CDKN1A"	2264	8623	5953	9593	3254	2699	5006	4587	1536	4788	5242	16673	22300	72494	20566	47620	24943	54018
"CDKN1B"	2416	5005	431	108	245	186	64	44	165	23	125	95	1675	458	1309	337	1731	479
"CDKN1C"	1931	2547	1	0	0	1	0	0	0	14	0	0	1	0	0	0	0	0
"CDKN2A"	1436	7288	0	1679	0	0	944	735	24	697	0	128	0	967	0	91	1	0
"CDKN2AIP"	2377	3262	85	0	50	35	0	0	82	14	0	0	718	296	959	386	1022	442
"CDKN2AIPNL"	1328	1328	9	0	9	0	0	0	16	0	0	30	96	132	78	64	87	58
"CDKN2B"	3982	6408	0	464	0	0	233	231	0	227	0	30	0	743	0	342	0	151
"CDKN2BAS"	3851	126303	14	1322	0	14	722	600	16	909	0	307	0	780	0	342	3	151
"CDKN2C"	2850	6701	0	0	0	0	0	0	0	0	0	0	122	115	61	46	61	0
"CDKN2D"	1400	2494	0	0	0	0	0	0	0	0	0	0	62	72	65	66	73	65
"CDKN3"	897	23261	0	0	0	0	0	0	0	11	0	0	0	2	0	0	0	0
"CDNF"	1496	19325	1	0	0	1	0	0	12	0	0	0	11	29	36	23	18	17
"CDO1"	1617	11975	0	0	0	0	0	0	0	0	0	0	0	0	0	0	0	0
"CDON"	8134	106474	0	0	0	0	0	0	0	0	0	0	0	0	0	0	0	0
"CDP-diacylglycerol synthase 1"	562	13508	0	0	0	0	0	0	0	0	0	0	0	14	20	26	0	14
"CDR1"	1300	1300	0	0	0	0	0	0	0	0	0	0	0	0	0	0	0	0
"CDR2"	2705	28681	617	32	353	264	16	16	261	64	170	81	723	612	142	78	164	125
"CDR2L"	3535	18164	1661	140	822	839	70	70	506	37	650	11	3884	2116	1248	556	3169	1298
"CDRT1"	2774	31042	0	0	0	0	0	0	0	0	0	0	0	0	0	0	0	0
"CDRT15"	568	977	0	0	0	0	0	0	0	0	0	0	0	0	0	0	23	0
"CDRT15P"	1102	1102	0	0	0	0	0	0	30	0	0	0	23	0	25	0	50	0
"CDRT4"	2493	31589	52	13	0	52	13	0	154	25	0	65	79	87	56	57	92	27
"CDS1"	4550	68437	0	0	0	0	0	0	0	0	0	0	12	31	30	52	0	60
"CDS2"	2890	61045	4792	332	2758	2034	179	153	2433	169	2293	234	3905	4473	2754	2139	3323	2100
"CDSN"	2551	5355	0	0	0	0	0	0	32	0	0	0	0	0	0	0	0	0
"CDT1"	2684	5481	2	1	1	1	1	0	69	39	0	24	5	16	0	19	9	18
"CDV3"	4200	16684	1723	2768	944	779	1495	1273	525	1235	155	2064	5599	7780	7341	8423	7661	6481
"CDX1"	1774	17778	5	0	5	0	0	0	84	46	4	0	0	0	0	0	0	0
"CDX2"	2092	7040	0	0	0	0	0	0	0	0	0	0	0	0	0	0	0	0
"CDX4"	857	7332	0	0	0	0	0	0	0	0	0	0	0	0	0	0	0	0
"CDY1"	2365	2784	0	0	0	0	0	0	0	0	0	0	0	0	0	0	0	0
"CDY2A"	1962	1962	0	0	0	0	0	0	0	0	0	0	0	0	0	0	0	0
"CDY2B"	1962	1962	0	0	0	0	0	0	0	0	0	0	0	0	0	0	0	0
"CDYL"	3467	179099	19387	30612	10920	8467	16650	13962	8048	12839	7178	23160	778	695	854	715	1067	816
"CDYL2"	2240	200499	803	515	465	338	276	239	652	1075	52	609	319	81	221	146	101	58
"CE5B3 alpha"	2802	7777	0	0	0	0	0	0	36	0	0	0	0	0	0	0	0	0
"CEACAM1"	3505	21182	0	0	0	0	0	0	22	11	0	0	0	0	12	0	1	0
"CEACAM16"	1803	11628	0	0	0	0	0	0	17	27	0	0	0	0	0	0	0	0
"CEACAM18"	1202	6775	0	0	0	0	0	0	13	0	0	0	0	0	0	0	0	0
"CEACAM19"	2254	12903	0	0	0	0	0	0	27	18	0	0	1	3	0	0	0	0
"CEACAM20"	1822	23339	0	0	0	0	0	0	13	0	0	0	0	0	0	0	0	0
"CEACAM21"	1365	10667	0	0	0	0	0	0	21	0	0	0	25	20	27	13	29	23
"CEACAM3"	1544	15059	0	2	0	0	0	2	9	19	0	0	1	0	0	0	0	0
"CEACAM4"	1212	8100	0	0	0	0	0	0	20	0	0	0	0	0	20	16	10	4
"CEACAM5"	3609	21908	0	0	0	0	0	0	22	8	0	0	0	0	0	0	0	0
"CEACAM6"	2637	16717	0	0	0	0	0	0	0	0	0	0	0	0	0	0	0	0
"CEACAM7"	2294	14863	0	0	0	0	0	0	0	0	0	0	0	0	0	0	0	0
"CEACAM8"	2309	14689	0	0	0	0	0	0	12	12	0	0	0	0	0	0	0	0
"CEBPA"	2590	2590	481	54	279	202	0	54	96	20	241	33	9438	2413	11471	2379	13960	4606
"CEBPB"	1838	1838	0	0	0	0	0	0	10	0	0	0	939	1122	1931	5716	1447	2917
"CEBPD"	1252	1252	0	11	0	0	0	11	0	16	0	0	468	158	489	480	506	498
"CEBPE"	1203	1961	1	0	1	0	0	0	60	36	0	0	0	0	0	6	6	0
"CEBPG"	3737	8984	837	384	460	377	191	193	354	173	97	289	1632	1498	1643	1080	2064	1184
"CEBPZ"	3340	29964	789	886	422	367	503	383	391	336	51	465	2681	3081	2011	1635	1871	1345
"CECR1"	3991	40273	7473	2179	3743	3730	1144	1035	2638	533	6476	627	20902	22104	12615	8484	12122	6715
"CECR2"	5665	193008	87	9	62	25	9	0	112	10	5	0	159	212	19	3	127	28
"CECR4"	627	6057	0	0	0	0	0	0	28	0	0	0	0	1	0	0	0	0
"CECR5"	1808	21760	1250	200	647	603	113	87	558	76	340	14	1077	607	1238	873	1521	773
"CECR6"	5026	5026	96	0	37	59	0	0	639	0	0	0	308	185	463	194	466	241
"CECR7"	2730	22224	109	38	69	40	16	22	84	73	0	22	0	19	0	0	0	0
"CEI"	852	3252	0	0	0	0	0	0	0	0	0	0	0	0	0	0	0	0
"CEL"	2395	9885	0	0	0	0	0	0	59	0	0	0	0	0	0	3	3	0
"CELA1"	960	18238	0	0	0	0	0	0	22	0	0	0	0	0	0	0	0	0
"CELA2A"	927	15364	0	0	0	0	0	0	63	31	0	0	0	0	0	0	0	0
"CELA2B"	930	15300	0	0	0	0	0	0	27	0	0	0	0	271	27	0	22	21
"CELA3A"	913	10886	0	0	0	0	0	0	15	0	0	0	0	0	0	0	0	0
"CELA3B"	1009	12429	0	0	0	0	0	0	14	0	0	0	0	0	0	0	0	0
"CELL"	990	4554	0	0	0	0	0	0	0	0	0	0	0	1	0	0	0	0
"CELSR1"	11424	176338	4	0	0	4	0	0	947	365	0	0	25	38	86	134	90	148
"CELSR2"	10573	25738	30	0	11	19	0	0	148	73	0	8	182	170	243	113	487	269
"CELSR3"	12617	47152	2104	544	1152	952	289	255	1467	691	2038	770	951	746	1758	1222	2676	1257
"CEMP1"	1385	1385	1138	417	660	478	232	185	352	93	569	511	480	210	1068	570	1157	564
"CEND1"	1648	3018	104	0	20	84	0	0	61	46	0	0	0	1	0	0	0	0
"CENPA"	1432	8573	23	0	11	12	0	0	0	0	0	0	0	0	0	0	0	0
"CENPB"	2839	2839	150	23	76	74	23	0	52	0	0	41	2780	1866	2720	1928	3684	2197
"CENPBD1"	2742	2742	91	0	50	41	0	0	81	27	0	0	687	386	457	110	683	222
"CENPC1"	3722	73269	1038	320	543	495	195	125	976	307	30	191	360	221	546	451	580	397
"CENPE"	8661	92605	11	0	5	6	0	0	6	0	0	0	60	109	44	29	99	30
"CENPE variant protein"	260	2065	0	0	0	0	0	0	0	0	0	0	3	2	0	0	9	3
"CENPF"	10314	61382	0	0	0	0	0	0	0	0	0	0	29	30	141	91	174	100
"CENPH"	1397	20810	0	0	0	0	0	0	11	0	0	0	112	124	100	70	104	84
"CENPI"	2582	63180	0	0	0	0	0	0	0	0	0	0	8	21	7	8	8	6
"CENPJ"	5306	40673	168	0	75	93	0	0	131	2	0	0	278	267	216	156	348	169
"CENPK"	1741	45403	1	0	0	1	0	0	0	0	0	12	15	28	0	9	0	3
"CENPL"	2928	25338	47	0	28	19	0	0	47	0	15	0	217	210	302	266	72	142
"CENPM"	1430	2969	0	0	0	0	0	0	54	0	0	0	0	4	0	0	0	0
"CENPN"	4655	24989	35	8	23	12	0	8	112	55	0	71	595	589	401	449	443	307
"CENPO"	1697	26536	129	66	101	28	47	19	119	43	23	34	700	419	721	56	1117	487
"CENPP"	3419	289696	10924	9127	6116	4808	5005	4122	4249	3236	1031	4740	86	121	78	78	420	55
"CENPQ"	1737	29726	0	0	0	0	0	0	0	0	0	0	113	116	100	77	103	68
"CENPT"	2357	19299	290	198	151	139	100	98	321	169	130	46	1225	822	1507	888	2043	1043
"CENPV"	1168	10965	31	18	9	22	18	0	13	26	0	0	69	71	154	122	87	76
"CENTB2"	1835	107172	9265	1098	5258	4007	672	426	4025	451	3631	952	389	527	378	315	371	190
"CENTG3"	3760	4870	1013	662	651	362	371	291	572	649	435	1024	753	981	1660	1801	1913	2093
"CEP110"	7473	89314	2840	266	1682	1158	134	132	2179	252	462	326	1336	1575	1729	1071	1687	1093
"CEP120"	4874	78674	1162	37	622	540	10	27	1024	99	75	115	753	980	903	788	1132	800
"CEP135"	5695	84491	275	125	172	103	54	71	243	59	0	134	510	577	480	412	564	334
"CEP152"	5291	72837	66	0	25	41	0	0	45	7	0	0	129	157	177	63	218	80
"CEP164"	5706	26106	2145	619	1249	896	279	340	1897	724	737	641	958	878	1487	1135	2398	1292
"CEP170"	7203	130979	12235	10534	6907	5328	5764	4770	5694	6117	2245	4183	2385	3564	5638	6051	4748	3430
"CEP170L"	1076	37864	0	0	0	0	0	0	0	0	0	0	0	0	404	561	170	320
"CEP192"	8019	133690	9030	2645	5069	3961	1410	1235	4885	1078	3580	3470	1094	1228	1430	1178	1367	903
"CEP250"	8383	56654	1549	137	898	651	74	63	978	68	583	29	1351	1113	1643	1297	2144	1213
"CEP290"	8008	93204	18	0	0	18	0	0	36	0	10	0	288	352	270	200	397	169
"CEP350"	13493	160108	7007	6046	3906	3101	3388	2658	3634	3237	963	3919	3571	3977	3971	3164	4243	2252
"CEP55"	2645	32460	0	0	0	0	0	0	0	0	0	0	3	12	3	4	12	7
"CEP57"	3169	42214	607	1662	363	244	995	667	291	907	0	559	886	1124	905	1094	1051	711
"CEP63"	6070	78825	1013	64	607	406	28	36	700	51	53	11	509	643	633	430	606	374
"CEP68"	5868	30648	2711	1750	1673	1038	962	788	1998	1390	1169	1596	4042	4153	4470	4127	778	3588
"CEP70"	2678	99942	0	0	0	0	0	0	0	0	0	0	0	0	0	0	0	0
"CEP72"	2424	41261	17	15	4	13	8	7	226	110	60	22	0	14	14	19	26	28
"CEP76"	2880	30073	0	0	0	0	0	0	37	8	0	0	144	92	129	87	190	88
"CEP78"	2983	14374	178	19	105	73	5	14	90	0	0	0	363	446	366	271	444	193
"CEP97"	4422	42689	10	0	0	10	0	0	39	0	0	0	132	174	121	31	94	14
"CEPT1"	2281	44893	5049	1611	2917	2132	898	713	2552	706	945	1075	1572	1739	2709	1210	1985	1582
"CER1"	1205	2983	0	0	0	0	0	0	0	0	0	0	0	0	0	0	0	0
"CERCAM"	4784	17163	0	5	0	0	3	2	73	22	0	6	276	276	343	285	429	290
"CERK"	4457	53846	8527	1222	4700	3827	645	577	2724	692	6976	1117	5747	4639	4134	2605	7112	2955
"CERKL"	3301	120434	15	0	0	15	0	0	34	0	0	0	492	591	476	227	555	489
"CES hBr1"	1001	14110	0	0	0	0	0	0	0	0	0	0	20	17	13	11	93	75
"CES1"	2024	30311	0	0	0	0	0	0	17	0	0	8	38	39	28	23	184	141
"CES2"	4186	10620	279	7	177	102	4	3	264	126	30	79	558	699	838	571	1041	478
"CES3"	3901	13915	0	0	0	0	0	0	85	51	0	0	0	9	0	0	5	0
"CES4"	2251	14315	0	0	0	0	0	0	13	0	0	0	0	0	0	0	8	10
"CES5"	2113	79308	0	0	0	0	0	0	9	8	0	0	0	0	0	0	0	0
"CES7"	2235	79308	0	0	0	0	0	0	9	8	0	0	0	0	0	0	0	0
"CES8"	2191	9203	252	30	107	145	0	30	176	44	46	6	149	202	222	171	412	212
"CETN1"	1157	1157	0	0	0	0	0	0	0	0	0	0	194	219	116	209	141	113
"CETN2"	1083	3430	0	0	0	0	0	0	0	0	0	0	194	219	116	209	141	113
"CETN3"	984	16074	0	0	0	0	0	0	28	0	0	0	204	203	144	109	217	140
"CETP"	1733	21923	0	0	0	0	0	0	108	0	0	0	0	0	0	0	0	0
"CEZANNE"	3795	10312	0	0	0	0	0	0	12	0	0	0	5	6	0	0	0	2
"CFB"	4148	24596	964	3889	565	399	2074	1815	545	2971	28	2893	730	5110	3421	4560	4081	3256
"CFC1"	1184	6918	0	0	0	0	0	0	0	0	0	0	0	0	0	0	0	0
"CFC1B"	1184	6918	0	0	0	0	0	0	0	0	0	0	0	0	0	0	0	0
"CFD"	1162	3945	0	9	0	0	7	2	0	40	0	0	216	0	174	608	400	292
"CFDP1"	1285	139780	3370	1557	1906	1464	932	625	1890	1031	410	1203	252	385	809	760	582	726
"CFH"	4146	95625	0	32	0	0	16	16	0	68	0	20	261	362	330	367	226	117
"CFHR1"	1300	12457	0	0	0	0	0	0	0	0	0	0	8	1	11	15	8	8
"CFHR2"	1041	15424	0	0	0	0	0	0	0	0	0	0	0	0	0	0	0	0
"CFHR3"	1982	15223	0	0	0	0	0	0	0	0	0	0	8	1	0	4	0	1
"CFHR4"	2042	30552	0	0	0	0	0	0	0	0	0	0	0	0	0	0	0	0
"CFHR5"	2836	32136	0	0	0	0	0	0	0	0	0	0	0	0	0	0	0	0
"CFI"	2378	21899	0	0	0	0	0	0	70	13	0	0	210	245	263	226	747	431
"CFL1"	1942	3795	1375	1116	784	591	604	512	420	531	1015	2196	971	28729	22376	2978	11454	2845
"CFL2"	3271	4443	60	26	37	23	15	11	35	23	0	0	315	111	334	139	317	107
"CFLAR"	4734	23786	29976	152713	15808	14168	82027	70686	4686	61934	10498	131939	7899	78962	3689	34278	4302	18924
"CFLP1"	2120	27297	0	0	0	0	0	0	11	0	0	0	1	0	0	0	0	0
"CFP"	4061	5352	8	33	0	8	20	13	13	143	0	556	327	381	740	1428	585	988
"CFTR"	6156	188701	0	0	0	0	0	0	0	0	0	0	0	0	0	0	0	0
"CG030"	4889	4889	1313	1294	714	599	774	520	0	401	483	524	71	40	0	0	42	1
"CGA"	708	9604	0	0	0	0	0	0	0	0	0	0	0	0	0	0	0	0
"CGB"	1650	2386	2	0	1	1	0	0	74	23	0	0	1	0	0	0	0	0
"CGB1"	734	1366	0	0	0	0	0	0	0	14	0	0	0	0	0	0	0	0
"CGB2"	861	1327	1	0	0	1	0	0	0	0	0	0	0	0	0	0	0	0
"CGB5"	882	1467	0	0	0	0	0	0	13	0	0	0	1	0	0	0	0	0
"CGB7"	1954	3478	3	0	2	1	0	0	74	23	0	0	0	0	0	0	0	0
"CGB8"	1737	33727	7	0	3	4	0	0	118	24	0	0	2	0	0	0	0	0
"CGEF2"	983	70603	0	0	0	0	0	0	0	0	0	0	0	0	0	0	0	0
"CGGBP1"	4537	7042	5805	5591	3216	2589	3080	2511	2788	1846	648	2144	5682	6004	5543	4260	6198	3673
"CGN"	5120	27305	0	53	0	0	26	27	44	127	0	40	0	117	0	273	0	30
"CGNL1"	7352	174217	0	0	0	0	0	0	19	21	0	0	0	0	0	0	5	0
"CGREF1"	1956	4138	0	1	0	0	0	1	58	47	0	0	32	24	19	10	20	19
"CGRRF1"	1864	28747	57	0	45	12	0	0	70	9	36	0	189	146	178	95	223	111
"CH1"	5458	78656	2258	1239	1302	956	740	499	1545	724	163	1123	934	1306	999	1007	1090	818
"CH25H"	1377	1377	0	0	0	0	0	0	38	0	0	0	614	760	1414	1262	1051	982
"CHAC1"	1563	3083	0	0	0	0	0	0	20	0	0	0	41	35	0	0	8	0
"CHAC2"	1278	7360	61	0	53	8	0	0	84	0	0	0	28	19	0	4	0	0
"CHAD"	1709	4375	618	49	352	266	11	38	210	56	779	66	84	29	248	17	614	107
"CHADL"	2538	11422	125	38	70	55	23	15	30	42	53	23	417	364	477	368	738	414
"CHAF1A"	3357	40735	104	13	81	23	0	13	297	174	0	0	205	204	253	195	257	146
"CHAF1B"	2292	31437	0	23	0	0	23	0	10	0	0	0	0	11	5	5	15	0
"CHAK1"	2549	22177	1558	681	946	612	374	307	738	222	346	347	554	754	955	350	279	878
"CHAK2"	1700	20106	0	0	0	0	0	0	0	0	0	0	0	1	29	28	0	0
"CHAT"	2544	51069	0	0	0	0	0	0	132	31	0	0	0	0	0	0	0	0
"CHCHD1"	1201	1323	45	0	22	23	0	0	25	0	0	0	577	564	741	575	892	565
"CHCHD10"	685	2121	77	0	52	25	0	0	18	5	177	58	935	566	1333	947	1364	510
"CHCHD2"	817	4921	104	52	72	32	38	14	47	126	0	237	513	1482	2092	1412	1610	1870
"CHCHD3"	1981	297206	9056	4519	5306	3750	2443	2076	5226	3275	902	2847	13267	12662	11149	11603	15511	11139
"CHCHD4"	1607	12795	29	7	0	29	0	7	74	10	0	16	355	281	309	278	392	260
"CHCHD5"	3409	4816	9	0	9	0	0	0	51	0	0	0	0	160	182	132	255	157
"CHCHD6"	1132	253660	6	309	2	4	144	165	309	264	0	0	15	12	34	13	30	25
"CHCHD7"	1733	6861	922	237	492	430	91	146	405	130	451	332	2008	2185	3233	2269	3394	2110
"CHCHD8"	817	4178	91	0	68	23	0	0	113	14	66	30	5	35	50	642	887	7
"CHCR"	1277	82807	246	26	161	85	18	8	361	126	0	0	136	125	73	74	67	20
"CHD1"	6491	71331	5941	5205	3420	2521	2794	2411	2896	2762	1262	3412	2066	3232	1598	1812	1749	1189
"CHD1L"	3031	53152	4195	743	2372	1823	413	330	1391	343	1977	1009	2116	2308	1623	1065	2189	1188
"CHD2"	9402	127687	20734	30625	11458	9276	16592	14033	8195	14977	7380	23608	2696	4188	3635	5031	4089	2971
"CHD3"	7394	27954	1488	479	814	674	259	220	801	638	648	606	1001	1175	1333	1124	1490	962
"CHD4"	6610	37304	1962	3071	1187	775	1682	1389	871	1649	581	3175	4670	6991	6355	7118	7580	5104
"CHD5"	9688	78332	5	9	5	0	7	2	770	352	2	1	7	5	0	0	0	1
"CHD6"	10426	215965	6462	3567	3744	2718	1965	1602	3466	1964	811	2263	1314	929	1096	988	920	1045
"CHD7"	10480	188126	2316	378	1292	1024	226	152	1486	268	165	346	713	807	1030	892	872	607
"CHD8"	7750	45999	2036	369	1067	969	186	183	981	321	398	199	2013	1710	2321	1482	2858	1643
"CHD9"	11502	171577	25025	9609	13880	11145	5303	4306	10977	3474	10233	3413	3022	3540	4009	3119	3462	2100
"CHDH"	3650	30033	4	0	2	2	0	0	53	28	0	0	34	8	96	58	54	23
"CHEK1"	2760	30605	14	0	14	0	0	0	6	11	0	0	19	53	22	21	25	19
"CHEK2"	2084	54093	841	133	466	375	80	53	614	35	775	225	750	551	559	475	708	545
"CHERP"	4112	24565	273	159	110	163	96	63	264	496	182	706	943	838	742	1266	1562	1006
"CHFR"	3299	47268	6758	4802	3750	3008	2675	2127	2831	2658	6671	6079	2928	2455	2059	1807	4157	1633
"CHGA"	2049	12193	724	181	393	331	68	113	466	449	724	478	0	0	0	0	0	2
"CHGB"	2653	14031	0	0	0	0	0	0	0	0	0	0	0	0	0	0	0	0
"CHI3L1"	1847	7865	0	0	0	0	0	0	70	72	0	0	746	515	863	853	1183	1006
"CHI3L2"	1508	13729	0	0	0	0	0	0	0	0	0	0	5	8	3	0	16	26
"CHIA"	1696	29702	0	0	0	0	0	0	0	0	0	0	0	0	0	0	0	0
"CHIC1"	6996	123953	0	0	0	0	0	0	10	0	0	0	0	0	0	0	0	0
"CHIC2"	1129	54832	3925	1796	2384	1541	1008	788	2058	847	794	1529	182	255	215	242	198	222
"CHID1"	3550	47200	2740	295	1478	1262	181	114	2085	643	1699	327	1198	1165	1523	1504	2121	1254
"CHIT1"	2318	13655	0	0	0	0	0	0	0	0	0	0	0	0	0	0	0	0
"CHKA"	2727	68532	7097	2761	3424	3673	1457	1304	2092	1210	1230	2412	2262	802	2881	2189	5058	513
"CHKB"	2024	4042	763	477	456	307	251	226	333	234	530	427	957	1024	1644	1117	1665	1006
"CHL1"	7675	212447	0	0	0	0	0	0	0	0	0	0	0	0	0	0	0	0
"CHLR1"	1669	2372	0	0	0	0	0	0	16	0	27	0	2	26	68	40	40	115
"CHM"	5456	186382	3308	2937	1851	1457	1561	1376	1782	1261	110	1357	920	1223	993	874	1016	670
"CHML"	7065	7065	1126	2485	538	588	1378	1107	655	1180	0	647	178	322	174	222	100	115
"CHMP1A"	2359	13285	505	355	303	202	200	155	331	158	492	876	1785	1621	1793	1892	2641	1883
"CHMP1B"	3060	3060	207	102	121	86	53	49	99	25	0	0	2296	2252	2556	1702	3059	1917
"CHMP2A"	1182	3073	239	211	130	109	99	112	187	533	0	238	1555	1729	1240	980	1945	1659
"CHMP2B"	2633	28286	213	9	151	62	9	0	132	31	0	0	1435	1657	1488	1388	1662	1267
"CHMP4A"	2242	6454	444	170	264	180	98	72	272	66	298	170	1248	1017	1210	1018	1705	1375
"CHMP4B"	1639	43052	4825	14252	2708	2117	7688	6564	1552	6706	1880	12355	2104	2772	2568	4279	4154	3381
"CHMP4C"	1848	27060	0	0	0	0	0	0	0	0	0	0	0	0	5	0	0	0
"CHMP5"	1681	17349	242	208	111	131	104	104	171	165	0	195	1200	1041	2106	1675	2318	1625
"CHMP6"	1671	8293	171	16	88	83	0	16	150	18	208	68	495	392	515	395	648	452
"CHMP7"	3421	18364	315	168	181	134	78	90	171	130	91	144	1162	1209	1224	942	1577	952
"CHN1"	2725	206130	0	0	0	0	0	0	0	0	0	10	3	12	0	0	4	0
"CHN2"	3489	319824	107698	73233	59921	47777	39506	33727	40370	27145	54308	46005	1173	1536	1061	1143	1066	823
"CHODL"	2549	22537	0	0	0	0	0	0	7	0	0	0	0	0	0	0	0	0
"CHORDC1"	3396	22937	1648	2240	920	728	1238	1002	741	1277	472	1654	797	1547	793	1291	671	1103
"CHP"	3233	50646	1026	4787	582	444	2616	2171	328	2848	44	4867	3268	4937	2906	3375	3679	3095
"CHP2"	2373	4310	0	0	0	0	0	0	0	0	0	0	0	0	0	0	0	0
"CHPF"	2994	4819	0	0	0	0	0	0	0	0	0	0	7	26	0	3	4	0
"CHPF2"	3974	6322	1294	332	678	616	159	173	570	186	1453	371	2469	1958	3016	1525	1756	2365
"CHPT1"	4649	32009	35	0	27	8	0	0	41	1	0	16	408	474	424	382	423	303
"CHRAC1"	2503	5853	15	0	0	15	0	0	14	16	0	0	709	743	379	371	513	320
"CHRD"	3573	9760	0	1	0	0	1	0	18	12	0	0	0	2	0	0	4	0
"CHRDL1"	4112	122203	0	0	0	0	0	0	0	0	0	0	0	0	0	0	0	0
"CHRDL2"	1689	34713	0	0	0	0	0	0	126	36	0	0	0	0	0	0	0	0
"CHRFAM7A"	3043	32423	0	0	0	0	0	0	0	0	0	0	13	13	82	38	265	123
"CHRM1"	2824	12862	8	1	8	0	1	0	50	23	0	0	0	0	0	0	0	0
"CHRM2"	2786	148374	0	0	0	0	0	0	0	0	0	0	0	0	0	0	0	0
"CHRM3"	2748	280344	0	0	0	0	0	0	0	10	0	0	0	0	0	0	0	0
"CHRM4"	1469	1469	0	0	0	0	0	0	0	0	0	0	0	0	0	0	0	0
"CHRM5"	3042	96200	223	57	129	94	38	19	178	62	0	9	18	36	19	18	26	11
"CHRNA1"	2066	16879	2	0	0	2	0	0	1	0	0	0	0	0	0	0	0	0
"CHRNA10"	2011	5798	28	132	14	14	97	35	54	227	0	272	0	76	6	81	0	22
"CHRNA2"	4073	19536	1	0	1	0	0	0	72	0	0	0	2	2	0	0	0	0
"CHRNA3"	3004	25672	0	0	0	0	0	0	0	0	0	0	0	0	0	0	0	0
"CHRNA4"	6106	34826	0	0	0	0	0	0	374	217	0	0	0	2	0	0	0	0
"CHRNA5"	2432	28554	0	0	0	0	0	0	0	0	0	0	3	1	2	0	0	0
"CHRNA6"	2077	15839	0	0	0	0	0	0	12	0	0	0	0	0	0	0	0	0
"CHRNA7"	2165	138509	0	0	0	0	0	0	0	0	0	0	0	3	46	15	174	92
"CHRNA7-2"	554	81840	0	0	0	0	0	0	0	0	0	0	0	0	0	0	0	0
"CHRNA9"	1897	19506	0	0	0	0	0	0	0	0	0	0	0	0	0	0	0	0
"CHRNB1"	2447	12527	0	0	0	0	0	0	89	26	0	0	128	44	78	33	100	39
"CHRNB2"	5722	12096	245	194	146	99	100	94	120	169	0	271	0	0	0	0	0	0
"CHRNB3"	1959	39649	0	0	0	0	0	0	0	0	0	0	0	0	0	0	0	0
"CHRNB4"	2478	31567	0	0	0	0	0	0	27	0	0	0	0	0	0	0	0	0
"CHRND"	1752	9284	688	0	407	281	0	0	434	58	113	0	0	0	0	0	0	0
"CHRNE"	2472	5307	700	356	374	326	88	268	569	711	272	1247	1490	2071	1064	1988	1347	1243
"CHRNG"	2274	6678	1295	70	798	497	45	25	1125	167	793	61	0	0	0	0	0	0
"CHST1"	2722	16747	0	0	0	0	0	0	55	41	0	0	0	0	0	0	0	0
"CHST10"	2821	25770	6	0	3	3	0	0	18	0	0	0	25	5	52	0	8	0
"CHST11"	1790	301136	132143	125747	73060	59083	67326	58421	52697	50553	115900	114121	2772	3572	4781	9117	6887	6963
"CHST12"	2077	30993	212	9	131	81	8	1	254	62	121	0	360	323	451	331	565	441
"CHST13"	1741	18959	0	0	0	0	0	0	60	22	0	0	222	164	117	137	430	328
"CHST14"	2142	2142	11	0	0	11	0	0	0	0	0	0	222	144	163	102	338	182
"CHST15"	4907	86022	3490	4918	1904	1586	2711	2207	1750	3155	671	5666	859	540	1201	3427	454	1207
"CHST2"	3043	3144	11	0	11	0	0	0	0	0	0	0	422	363	402	413	424	440
"CHST3"	6975	49203	0	0	0	0	0	0	125	46	0	0	0	0	0	0	0	0
"CHST4"	2008	12354	0	0	0	0	0	0	0	0	0	0	0	0	0	0	0	0
"CHST5"	3251	6640	0	0	0	0	0	0	15	0	0	0	9	0	0	0	11	0
"CHST6"	6887	21905	1	0	0	1	0	0	10	9	0	0	0	0	0	0	0	0
"CHST7"	2312	24647	297	3438	168	129	1793	1645	51	2033	0	2682	171	2545	455	1013	462	802
"CHST8"	2482	88981	0	0	0	0	0	0	388	225	0	0	0	0	0	0	0	0
"CHST9"	11401	278845	0	0	0	0	0	0	13	0	0	0	0	0	0	0	0	0
"CHSY1"	4539	76196	3886	400	2124	1762	272	128	2266	329	1780	311	166	1166	1121	719	1231	816
"CHSY3"	3494	281805	0	0	0	0	0	0	0	0	0	0	0	0	0	0	0	0
"CHTF18"	4526	9452	31	8	13	18	4	4	83	57	0	0	26	66	119	102	153	63
"CHTF8"	2918	14573	521	238	188	333	101	137	364	290	651	706	4136	3766	3985	3098	5229	3346
"CHUK"	3544	41221	690	265	391	299	135	130	640	272	155	196	1027	1945	1430	1294	1259	844
"CHURC1"	3385	20775	1386	505	808	578	305	200	987	350	541	327	1778	2257	1068	828	1031	793
"CIAO1"	4035	8010	1098	283	744	354	158	125	516	143	557	103	2096	1998	1766	1306	1888	1385
"CIAPIN1"	2114	19284	323	83	179	144	41	42	233	123	52	357	525	554	834	717	1029	863
"CIB1"	983	3803	157	44	95	62	25	19	85	39	255	140	1937	1420	2783	2331	2717	1520
"CIB2"	1553	26889	1	0	0	1	0	0	106	25	0	0	0	0	0	3	0	3
"CIB3"	666	12108	0	1	0	0	1	0	0	14	0	0	1	0	0	0	0	0
"CIB4"	751	60139	0	0	0	0	0	0	182	85	0	0	0	0	0	0	0	0
"CIC"	5493	11134	1186	596	654	532	305	291	493	474	538	701	1899	1836	1652	1762	2455	1585
"CICE"	1602	11896	1608	995	844	764	576	419	1390	740	94	944	4029	4310	4110	2938	4732	2721
"CIDE-A"	1546	22966	0	0	0	0	0	0	10	0	0	0	0	0	0	0	0	0
"CIDEA"	1278	22966	0	0	0	0	0	0	10	0	0	0	0	0	0	0	0	0
"CIDEB"	2390	6183	2202	469	1214	988	255	214	744	286	1201	557	3060	2451	3507	2413	4188	2355
"CIDEC"	1282	12343	0	0	0	0	0	0	22	0	0	0	0	0	0	0	0	0
"CIITA"	4676	47786	62743	17640	34816	27927	9245	8395	26307	6741	60358	15514	24845	18596	9130	4789	14101	5460
"CILP"	4477	15505	0	0	0	0	0	0	14	25	0	0	0	0	0	0	0	0
"CILP2"	4223	8394	0	0	0	0	0	0	46	49	0	0	0	0	0	0	0	0
"CIN85"	3326	35523	320	303	161	159	155	148	241	276	0	181	1520	1501	1512	1588	2032	1373
"CINP"	1787	16978	19	0	9	10	0	0	43	14	0	27	477	422	438	366	543	342
"CIR"	1830	47565	1445	83	881	564	49	34	822	80	257	277	774	699	352	225	291	259
"CIR1"	1801	47565	1445	83	881	564	49	34	822	80	257	277	774	699	352	225	291	259
"CIRBP"	3046	5174	2192	1102	1264	928	549	553	616	391	1460	713	4031	527	4394	3032	5687	2635
"CIRH1A"	4260	35248	137	326	69	68	197	129	146	281	39	750	508	693	602	680	675	525
"CIRIP"	8368	45110	22	1432	22	0	816	616	47	2449	0	857	153	550	223	1705	175	78
"CISD1"	2077	20125	106	0	71	35	0	0	69	0	0	0	267	240	368	278	503	318
"CISD2"	1844	19780	315	0	203	112	0	0	113	7	0	17	954	723	918	698	915	627
"CISD3"	2640	5350	0	1	0	0	1	0	64	43	0	0	255	214	315	169	391	118
"CISH"	2271	5378	4255	2176	2430	1825	1101	1075	1610	1321	3548	4229	264	6426	12477	7281	13233	8260
"CIT"	8750	191496	0	0	0	0	0	0	40	12	0	0	2	4	0	0	0	0
"CITED1"	1244	5349	0	0	0	0	0	0	39	0	0	0	2	0	3	0	0	1
"CITED2"	1931	2390	381	256	226	155	149	107	109	146	93	51	4831	2802	5117	2272	5233	2502
"CITED4"	1291	1291	0	0	0	0	0	0	0	0	0	0	0	0	0	0	20	0
"CIZ1"	3179	26040	585	187	268	317	101	86	518	248	200	92	1695	1521	1961	1717	2645	1550
"CKAP2"	3745	21270	74	0	30	44	0	0	104	0	18	0	998	819	1046	572	1414	831
"CKAP2L"	3282	26812	0	0	0	0	0	0	9	0	0	0	8	26	4	4	9	0
"CKAP4"	3037	10055	0	0	0	0	0	0	0	12	0	0	329	262	322	265	432	343
"CKAP5"	6742	102761	1400	215	830	570	116	99	986	230	154	111	2571	2413	2679	2052	3071	2103
"CKB"	1439	3176	269	160	149	120	103	57	47	207	115	140	1610	1429	6054	6788	3736	5384
"CKId"	1479	7163	3805	3933	1991	1814	2046	1887	2440	3260	5928	4563	3428	3744	5163	4521	6242	3975
"CKIe"	1029	96067	2021	287	1092	929	159	128	1632	373	419	381	140	126	143	141	337	173
"CKLF"	672	13506	4802	553	2644	2158	334	219	2059	70	3560	0	3340	967	2177	593	3266	903
"CKLFSF1"	1183	12688	720	0	544	176	0	0	2238	15	241	0	3264	716	820	269	1260	612
"CKLFSF2"	904	8826	0	0	0	0	0	0	15	0	0	0	0	0	0	0	0	4
"CKLFSF3"	2006	9161	376	37	182	194	37	0	176	130	220	108	2030	2018	2024	1658	2747	1823
"CKLFSF5"	1050	2965	0	0	0	0	0	0	33	25	0	0	0	0	0	0	0	0
"CKLFSF8"	997	131642	3822	86	2208	1614	35	51	1982	143	1582	221	210	164	127	85	162	121
"CKM"	1564	16464	0	0	0	0	0	0	104	0	0	0	0	0	0	0	0	0
"CKMT1A"	2386	5362	0	0	0	0	0	0	0	0	0	0	0	0	0	0	0	0
"CKMT1B"	1881	6353	0	0	0	0	0	0	0	0	0	0	0	0	0	0	0	0
"CKMT2"	1652	33079	78	16	21	57	16	0	169	32	18	34	15	56	28	0	0	0
"CKS1B"	926	4608	0	0	0	0	0	0	0	0	0	0	52	55	178	156	275	169
"CKS2"	615	5506	0	26	0	0	26	0	18	15	0	34	63	107	253	317	242	362
"CLASP1"	8126	311700	10020	3303	5769	4251	1766	1537	6301	2794	2145	3069	1490	850	1767	1519	1961	1388
"CLASP2"	7292	222109	11030	8610	6255	4775	4538	4072	5829	4888	2087	6077	2832	3953	3167	2939	3567	2441
"CLC"	633	6774	0	0	0	0	0	0	0	0	0	0	588	748	713	784	285	185
"CLCA1"	3263	31579	0	0	0	0	0	0	0	0	0	0	0	0	0	0	0	0
"CLCA2"	4036	32471	0	0	0	0	0	0	0	0	0	0	0	0	0	0	0	0
"CLCA3"	3426	21101	0	0	0	0	0	0	0	0	0	0	0	0	0	0	0	0
"CLCA4"	3220	33673	0	0	0	0	0	0	0	0	0	0	0	0	0	0	0	0
"CLCC1"	4837	33983	2504	1089	1359	1145	552	537	1008	665	988	853	1231	1248	1048	777	1166	710
"CLCF1"	1843	9567	33	873	33	0	494	379	171	573	0	651	1	983	6	2519	14	903
"CLCN1"	3116	35880	0	0	0	0	0	0	54	0	0	0	24	21	10	0	50	9
"CLCN2"	2899	15053	140	12	96	44	10	2	300	78	18	68	60	36	70	34	115	55
"CLCN3"	4079	100436	1053	152	549	504	79	73	694	103	80	92	1644	1907	1737	1620	1739	1115
"CLCN4"	6799	80714	4	0	4	0	0	0	21	53	0	0	294	332	184	110	284	150
"CLCN5"	10123	176669	6652	7126	3699	2953	3959	3167	3765	4595	1181	7636	2614	2971	2705	2583	3001	1948
"CLCN6"	5666	36995	3266	1963	1733	1533	1086	877	1522	890	1258	1143	851	857	1404	888	1618	877
"CLCN7"	4250	30152	6662	2692	3347	3315	1418	1274	3082	1261	11459	3877	4358	3947	8759	7157	11601	7475
"CLCNKA"	3083	15176	0	0	0	0	0	0	119	60	0	0	0	0	0	0	0	0
"CLCNKB"	2611	13557	0	0	0	0	0	0	306	177	0	0	0	0	0	0	0	0
"CLCP1"	1076	52303	0	0	0	0	0	0	0	0	0	0	0	8	3	0	0	0
"CLDN1"	3423	16714	43	4438	31	12	2496	1942	0	636	0	193	333	2022	117	154	190	4
"CLDN10"	2663	146159	0	0	0	0	0	0	0	0	0	0	0	0	0	0	0	0
"CLDN11"	2763	15827	0	0	0	0	0	0	17	35	0	0	0	0	0	0	0	0
"CLDN12"	3917	32233	37	0	18	19	0	0	32	0	0	0	330	275	310	204	299	151
"CLDN14"	1944	19470	0	0	0	0	0	0	82	12	0	0	0	0	0	0	15	20
"CLDN15"	2136	6729	93	55	59	34	53	2	124	161	260	335	110	106	323	672	552	372
"CLDN16"	1498	22493	0	0	0	0	0	0	0	0	0	0	0	0	0	0	0	0
"CLDN17"	674	674	0	0	0	0	0	0	0	0	0	0	0	0	0	0	0	0
"CLDN18"	3364	23490	72	0	40	32	0	0	369	11	0	0	0	0	1	0	64	6
"CLDN19"	3606	7163	0	0	0	0	0	0	31	0	0	0	0	0	0	0	0	0
"CLDN2"	3154	30699	0	0	0	0	0	0	0	0	0	0	0	0	0	0	0	0
"CLDN20"	1208	12534	601	73	322	279	55	18	255	72	0	55	18	8	0	0	0	0
"CLDN22"	2709	2709	0	0	0	0	0	0	12	0	0	0	228	341	350	361	333	207
"CLDN23"	1952	1952	0	0	0	0	0	0	0	0	0	0	128	43	239	107	270	185
"CLDN25"	691	691	0	0	0	0	0	0	0	0	0	0	0	0	0	0	0	0
"CLDN3"	1274	1274	0	0	0	0	0	0	0	0	0	0	0	0	0	0	0	0
"CLDN4"	1823	1823	0	0	0	0	0	0	0	0	0	0	0	0	0	0	0	0
"CLDN5"	2315	2315	0	0	0	0	0	0	11	0	0	0	0	0	0	0	0	0
"CLDN6"	1371	3476	0	0	0	0	0	0	31	0	0	0	0	0	0	0	0	0
"CLDN7"	1543	2574	8	100	8	0	53	47	14	123	0	0	259	521	260	4	290	320
"CLDN8"	1990	1990	0	0	0	0	0	0	0	0	0	0	0	0	0	0	0	0
"CLDN9"	2051	2051	1	0	1	0	0	0	66	18	0	0	0	0	0	0	40	0
"CLDND1"	2832	7042	420	267	264	156	149	118	226	110	0	67	968	1602	951	1132	1235	901
"CLDND2"	978	1907	59	0	59	0	0	0	28	19	0	0	0	0	0	5	0	0
"CLEC10A"	1839	5487	3263	577	1683	1580	391	186	1410	257	2288	364	10623	11922	8986	12667	37527	10518
"CLEC11A"	1409	2376	0	0	0	0	0	0	77	20	0	0	375	316	524	493	543	444
"CLEC12A"	1661	14018	82	43	46	36	13	30	116	25	122	151	704	461	295	227	273	123
"CLEC12B"	3034	7318	0	0	0	0	0	0	0	0	0	0	10	0	3	0	0	0
"CLEC14A"	2257	2257	0	0	0	0	0	0	0	0	0	0	31	0	0	0	0	0
"CLEC16A"	6906	237701	12624	6781	7015	5609	3757	3024	6720	5106	5155	7359	1760	2246	2318	2257	2965	1926
"CLEC17A"	2234	28057	0	0	0	0	0	0	9	0	0	8	17	0	0	3	0	0
"CLEC18A"	1980	12873	4198	2257	2203	1995	1242	1015	2583	1527	2826	3048	4463	3967	3604	2839	7469	3863
"CLEC18B"	2546	10936	0	0	0	0	0	0	23	0	1	0	0	0	48	23	77	26
"CLEC18C"	1980	12870	0	0	0	0	0	0	16	0	0	0	0	4	0	0	93	0
"CLEC1A"	1882	28525	392	518	273	119	252	266	341	132	66	0	194	134	99	265	157	358
"CLEC1B"	974	6237	0	0	0	0	0	0	0	1	0	0	1	13	7	1	0	3
"CLEC2A"	921	19156	0	0	0	0	0	0	0	0	0	0	0	0	0	0	0	0
"CLEC2B"	2039	17488	651	64	323	328	22	42	457	0	0	0	629	348	523	344	588	353
"CLEC2D"	5255	29732	6640	8541	4288	2352	4533	4008	2445	2738	1775	4525	1131	1901	799	889	809	774
"CLEC2L"	1292	21058	0	0	0	0	0	0	26	53	0	0	0	0	0	0	0	0
"CLEC3A"	1937	9556	0	0	0	0	0	0	0	0	0	0	0	0	0	0	0	0
"CLEC3B"	854	9805	0	0	0	0	0	0	11	33	0	0	66	39	36	23	54	25
"CLEC4A"	1287	14977	14861	5351	8267	6594	2792	2559	5806	1019	7118	2757	15290	14581	9741	5962	17146	8711
"CLEC4C"	1321	20060	0	0	0	0	0	0	0	0	0	0	0	0	0	0	0	0
"CLEC4D"	1938	8824	0	18	0	0	18	0	0	41	0	87	46	116	25	57	22	90
"CLEC4E"	2164	7659	0	0	0	0	0	0	17	7	0	0	0	55	9	109	0	73
"CLEC4F"	2478	11955	24	0	12	12	0	0	44	0	110	0	77	20	211	111	72	18
"CLEC4G"	1368	3215	269	109	226	43	80	29	160	122	335	72	1938	1644	2586	2378	3353	2135
"CLEC4GP1"	1942	3530	1	0	0	1	0	0	0	0	0	0	3	4	0	0	0	0
"CLEC4M"	4432	7585	6417	1309	3574	2843	485	824	2212	845	1907	2424	33476	34298	30752	26741	34858	23114
"CLEC5A"	3518	19628	10	0	7	3	0	0	0	0	0	0	0	48	0	0	0	0
"CLEC6A"	1619	22337	10	0	0	10	0	0	24	0	0	60	47	75	8	8	11	0
"CLEC7A"	2618	13494	14030	14473	7872	6158	7889	6584	5038	3961	7208	5689	20450	23273	7966	5493	9839	4986
"CLEC9A"	1681	35290	8	0	8	0	0	0	10	0	0	0	0	0	0	0	6	3
"CLECL1"	636	10770	4783	837	2602	2181	454	383	2250	299	695	624	133	15	210	252	115	42
"CLECSF6"	1034	14977	14861	5351	8267	6594	2792	2559	5806	1019	7118	2757	15290	14581	9741	5962	17146	8711
"CLGN"	2836	39208	0	0	0	0	0	0	0	0	0	0	0	0	0	0	0	0
"CLIC1"	1567	6743	344	459	195	149	271	188	199	279	0	742	1798	7847	5530	6780	8850	4121
"CLIC2"	2690	58486	9134	18051	5007	4127	9626	8425	4280	8905	3752	9860	838	8434	3054	2896	4322	2987
"CLIC3"	819	1966	0	0	0	0	0	0	12	0	0	0	24	29	20	8	68	30
"CLIC4"	4440	99057	13522	71291	7532	5990	38643	32648	3325	31677	3285	57087	7809	14051	6406	12794	8452	7981
"CLIC5"	5980	181897	0	0	0	0	0	0	8	0	0	0	0	0	0	0	3	0
"CLIC6"	3861	48833	0	0	0	0	0	0	46	0	0	0	0	0	0	0	0	0
"CLINT1"	3491	72873	4934	22237	2747	2187	12140	10097	1823	10037	353	19548	3312	7287	4047	6687	2507	3777
"CLIP-170"	919	13577	662	484	360	302	271	213	491	98	359	130	61	91	105	104	116	77
"CLIP1"	5905	151137	3924	1143	2059	1865	640	503	2249	853	902	1434	3094	3804	2274	2995	3687	1582
"CLIP2"	5579	116469	2807	4534	1583	1224	2476	2058	1302	5742	506	5390	1639	1705	1442	1376	3052	1994
"CLIP3"	3436	17980	0	0	0	0	0	0	122	62	0	0	0	0	4	0	0	0
"CLIP4"	4292	68372	1576	328	932	644	173	155	1120	159	776	489	790	768	1638	1211	1287	954
"CLK1"	3344	11737	2722	2983	1493	1229	1555	1428	391	1056	1113	1821	3134	3408	4216	3587	4818	3044
"CLK2"	2152	10623	778	433	435	343	219	214	369	324	413	306	712	492	1218	763	1583	625
"CLK3"	3695	11005	1783	1333	960	823	682	651	868	1055	773	1902	980	1280	1254	1456	1833	1366
"CLK4"	4094	24391	1322	1585	698	624	799	786	707	868	450	1217	829	1257	825	1110	1090	706
"CLLD6"	2921	23785	116	28	84	32	17	11	89	23	0	0	403	426	384	283	451	333
"CLLU1"	3947	7045	0	0	0	0	0	0	0	0	0	0	0	0	0	0	0	0
"CLLU1OS"	690	8056	0	0	0	0	0	0	0	0	0	0	0	0	0	0	0	0
"CLMN"	12763	137971	9	0	9	0	0	0	815	209	0	0	377	395	719	593	620	492
"CLN3"	1928	15024	507	453	247	260	236	217	323	547	224	293	875	1106	779	681	1041	840
"CLN5"	2803	10594	304	26	167	137	0	26	235	55	0	0	1337	1403	1140	125	1313	781
"CLN6"	2424	50115	877	75	514	363	55	20	569	123	258	19	561	552	1105	1017	1219	814
"CLN8"	7171	22867	2496	701	1434	1062	417	284	971	260	1389	234	1632	1161	2102	1188	2849	1587
"CLNK"	1695	194549	0	0	0	0	0	0	35	22	0	0	0	0	0	0	0	0
"CLNS1A"	1379	21656	2102	173	1174	928	83	90	875	64	363	144	673	116	2488	2075	2821	2079
"CLOCK"	6413	113441	4263	11754	2446	1817	2781	8973	2520	1394	683	9918	1370	557	1423	463	453	279
"CLP1"	1848	4122	64	0	52	12	0	0	15	14	0	0	556	305	560	235	751	286
"CLPB"	3130	142098	305	71	185	120	36	35	723	167	32	125	229	219	379	414	480	320
"CLPP"	1157	7454	13	0	7	6	0	0	18	0	0	0	460	460	670	564	865	586
"CLPS"	542	2344	0	0	0	0	0	0	46	0	0	0	0	0	0	0	0	0
"CLPTM1"	2512	38758	414	141	220	194	88	53	507	534	74	402	2155	2097	2182	2307	2864	1926
"CLPTM1L"	2157	26997	1343	504	704	639	280	224	575	630	977	1066	1266	1351	1764	1692	1904	1290
"CLPX"	2364	34780	674	28	405	269	28	0	481	28	97	42	506	683	1126	510	1286	585
"CLR"	2616	10367	2200	4857	656	1544	2602	2255	1566	1889	629	2091	395	1089	186	363	144	176
"CLRN1"	2362	46434	0	0	0	0	0	0	0	0	0	0	0	0	0	0	0	0
"CLRN2"	826	11941	0	0	0	0	0	0	0	0	0	0	0	0	0	0	0	0
"CLRN3"	1425	6699	0	0	0	0	0	0	0	0	0	0	0	0	0	0	0	0
"CLSPN"	4402	33733	0	0	0	0	0	0	0	0	0	0	0	0	3	14	3	0
"CLSTN1"	5210	95472	3529	460	1953	1576	253	207	1837	643	1790	699	3343	4694	2871	4720	5246	5153
"CLSTN2"	4897	632892	0	0	0	0	0	0	16	0	0	0	0	0	10	8	0	0
"CLSTN3"	4313	26548	42	0	22	20	0	0	149	40	0	0	36	27	164	177	247	217
"CLTA"	1934	113888	3534	2262	2001	1533	1272	990	1600	1623	1366	1946	2693	3183	3247	3840	5391	3522
"CLTB"	1688	24085	492	158	252	240	69	89	508	117	183	317	374	957	589	1342	2247	687
"CLTC"	8619	77269	10712	6870	6099	4613	3601	3269	4701	3842	3076	5351	17191	15558	17470	13646	19836	11095
"CLTCL1"	5543	112252	0	3	0	0	0	3	54	45	0	0	0	12	0	0	6	6
"CLU"	2971	14489	0	0	0	0	0	0	22	26	0	0	23	45	69	62	49	26
"CLUAP1"	5192	35864	12	0	5	7	0	0	73	0	0	0	231	222	182	99	196	96
"CLUL1"	2192	53295	0	0	0	0	0	0	0	0	0	0	0	0	0	0	0	0
"CLYBL"	1456	271527	2961	531	1714	1247	304	227	2582	565	808	640	334	375	239	225	431	293
"CMA1"	789	2761	0	0	0	0	0	0	0	0	0	0	0	0	0	0	0	0
"CMAP"	2189	17014	11843	7781	6405	5438	4077	3704	1069	3054	9477	7450	6440	6886	6654	6317	8741	6048
"CMAR"	1276	11841	819	428	445	374	218	210	444	324	289	600	317	272	414	310	427	158
"CMAS"	1748	19444	225	0	149	76	0	0	261	0	0	0	605	570	768	750	1042	878
"CMBL"	4052	30462	2	0	0	2	0	0	0	0	0	0	0	6	5	0	0	3
"CMC1"	627	78139	5424	954	3084	2340	556	398	2570	549	920	614	306	194	262	268	425	309
"CMIP"	4376	266592	103003	46557	56468	46535	24994	21563	38106	21266	78631	43157	5304	6023	3303	2803	5165	2961
"CMKLR1"	5499	51274	440	187	274	166	95	92	512	1103	0	47	954	1125	786	1265	771	561
"CMPK1"	2935	45043	834	88	492	342	30	58	455	59	81	298	3836	3713	3725	3266	4212	2880
"CMPK2"	2992	17485	62	0	41	21	0	0	55	20	0	0	269	212	676	118	467	277
"CMT4B2"	2609	9308	222	54	102	120	45	9	210	111	0	4	489	639	576	590	795	530
"CMTM1"	2375	2375	720	0	544	176	0	0	2238	15	241	0	3264	716	820	269	1260	612
"CMTM2"	1064	8826	0	0	0	0	0	0	15	0	0	0	0	0	0	0	0	4
"CMTM3"	2129	9582	376	37	182	194	37	0	176	143	220	108	2030	2019	2024	1658	2751	1825
"CMTM4"	8120	81958	861	122	503	358	57	65	740	67	260	97	696	726	543	490	979	595
"CMTM5"	1406	2965	0	0	0	0	0	0	33	25	0	0	0	0	0	0	0	0
"CMTM6"	3370	21601	6445	14983	3596	2849	8167	6816	2019	5744	2241	12989	18164	30967	14643	17447	17370	15483
"CMTM7"	1356	63172	13767	2171	7578	6189	1292	879	5126	761	9117	1236	2483	1843	2858	2177	3451	2603
"CMTM8"	1172	131642	3822	86	2208	1614	35	51	1982	143	1582	221	210	164	127	85	162	121
"CMYA3"	1206	2655	0	0	0	0	0	0	0	0	0	0	0	0	0	0	0	0
"CMYA5"	12904	110391	13	0	13	0	0	0	0	0	7	0	5	4	0	0	1	0
"CNBD1"	1470	516281	0	0	0	0	0	0	8	0	0	0	0	0	0	0	0	0
"CNBP"	3382	16153	2958	1378	1613	1345	777	601	1239	613	1408	1418	10014	9537	7751	6307	10259	7068
"CNDP1"	2208	50569	0	0	0	0	0	0	0	25	0	0	0	0	0	0	0	0
"CNDP2"	2655	24761	2286	860	1288	998	438	422	1039	551	884	905	3602	2872	3460	2816	5320	2975
"CNFN"	610	3272	0	0	0	0	0	0	36	16	0	0	4	0	0	0	0	0
"CNGA1"	2873	45556	104	1	36	68	0	1	80	8	0	0	0	3	0	0	0	0
"CNGA2"	3292	10820	0	0	0	0	0	0	9	15	0	0	0	0	0	0	0	0
"CNGA3"	3849	52441	5	0	0	5	0	0	17	11	0	0	0	0	0	0	0	0
"CNGA4"	4023	9585	0	0	0	0	0	0	57	15	0	0	0	0	0	0	0	0
"CNGB1"	5678	88778	6	0	3	3	0	0	199	24	0	0	35	39	21	16	11	7
"CNGB3"	4364	169741	0	0	0	0	0	0	0	0	0	0	0	0	0	0	0	0
"CNIH"	1428	14503	114	22	72	42	12	10	165	75	0	113	501	457	687	612	667	462
"CNIH2"	1492	5968	3	0	0	3	0	0	24	45	0	0	0	0	0	0	3	0
"CNIH3"	2378	124072	9661	5348	5189	4472	2965	2383	3721	2213	2828	4181	219	244	877	735	417	559
"CNIH4"	3156	21630	553	122	260	293	73	49	198	8	232	0	389	266	372	243	408	278
"CNKSR1"	2601	9588	0	0	0	0	0	0	51	29	0	0	1	2	0	3	0	0
"CNKSR2"	3949	267872	0	0	0	0	0	0	9	0	0	0	0	0	0	0	0	0
"CNKSR3"	3240	105321	0	0	0	0	0	0	8	0	0	0	39	54	10	36	8	19
"CNN1"	1869	11561	0	0	0	0	0	0	82	22	0	0	0	0	0	0	0	0
"CNN2"	2527	12767	1287	1012	723	564	548	464	232	775	360	2218	3409	3540	2960	3360	5274	4015
"CNN3"	2071	30228	0	0	0	0	0	0	0	0	0	0	0	0	0	0	0	0
"CNNM1"	6032	65231	0	0	0	0	0	0	13	0	0	0	0	0	0	0	0	0
"CNNM2"	4061	160126	400	8	189	211	8	0	373	64	46	30	116	85	162	141	173	29
"CNNM3"	4923	19131	324	28	183	141	3	25	233	35	80	0	509	411	429	323	575	298
"CNNM4"	4805	50989	338	58	190	148	28	30	515	187	44	76	578	693	825	864	1112	836
"CNO"	1547	1547	0	0	0	0	0	0	0	0	0	0	405	167	430	109	432	179
"CNOT1"	8648	109896	7108	8551	4053	3055	4675	3876	2775	4486	2439	8701	6319	6704	8375	7483	9576	6290
"CNOT10"	2762	78315	823	1104	405	418	576	528	806	813	84	1601	1021	1135	825	662	1028	657
"CNOT2"	3645	111280	8671	3344	4835	3836	1922	1422	4188	1902	1469	2487	1781	1627	1579	1165	1782	1253
"CNOT3"	4164	14317	872	314	503	369	113	201	597	356	903	680	868	798	1182	970	1804	1031
"CNOT4"	3536	148300	6263	5739	3646	2617	3216	2523	3022	3588	1045	5012	710	907	667	498	887	562
"CNOT6"	6264	83921	1760	202	1008	752	120	82	1000	215	244	333	1545	1715	1646	1258	1689	1188
"CNOT6L"	8854	105982	3751	287	2016	1735	163	124	1930	217	445	674	1760	1623	2082	1350	2110	1348
"CNOT7"	2653	17649	651	24	335	316	24	0	368	29	68	0	2531	1671	680	1456	526	458
"CNOT8"	2718	18544	1858	193	1030	828	154	39	1006	187	896	189	3013	2043	2995	1460	4032	2194
"CNP"	5226	10997	894	387	474	420	242	145	335	312	389	460	2011	1789	2324	1728	2224	1776
"CNPY1"	2238	32588	0	0	0	0	0	0	30	0	0	0	0	0	0	0	0	0
"CNPY2"	1215	5905	172	50	90	82	0	50	147	64	44	49	622	403	484	642	455	278
"CNPY3"	1949	10149	1387	291	758	629	168	123	607	172	578	61	2411	1661	3394	2719	3683	2825
"CNPY4"	1471	5863	70	11	28	42	10	1	123	22	0	0	106	111	133	101	170	106
"CNR1"	8972	11297	0	0	0	0	0	0	0	0	0	0	0	0	0	0	0	0
"CNR2"	1776	39358	13	0	0	13	0	0	80	0	0	0	12	28	0	0	0	0
"CNRIP1"	1999	27041	0	0	0	0	0	0	0	0	0	0	4	16	32	39	82	67
"CNT3"	1446	48203	0	0	0	0	0	0	0	0	0	0	25	28	64	67	39	43
"CNTD1"	3283	12752	85	32	17	68	29	3	86	57	0	20	1234	56	928	96	142	782
"CNTD2"	1826	4483	0	0	0	0	0	0	16	0	0	0	0	0	0	0	0	0
"CNTF"	1893	3059	224	20	116	108	0	20	118	31	65	0	13	25	3	0	0	0
"CNTFR"	2048	38293	0	0	0	0	0	0	258	97	0	0	0	0	0	0	0	0
"CNTLN"	5538	368879	5378	10328	3001	2377	5595	4733	3173	6497	471	8277	739	1013	512	587	721	390
"CNTN1"	3451	377738	0	0	0	0	0	0	0	0	0	0	0	0	0	0	0	0
"CNTN2"	7658	34798	0	0	0	0	0	0	228	38	0	0	0	0	0	0	0	0
"CNTN3"	5019	258623	0	0	0	0	0	0	0	0	0	0	0	0	0	0	0	0
"CNTN4"	5066	957399	0	0	0	0	0	0	11	9	0	0	0	0	0	0	0	0
"CNTN5"	4321	1288562	0	0	0	0	0	0	0	0	0	0	0	0	0	0	0	0
"CNTN6"	3552	310659	0	0	0	0	0	0	0	0	0	0	0	0	0	0	0	0
"CNTNAP1"	5477	17380	0	0	0	0	0	0	343	75	0	0	0	0	0	0	15	0
"CNTNAP2"	9914	2304635	0	0	0	0	0	0	44	11	0	0	0	0	0	0	0	0
"CNTNAP3"	5357	203333	0	0	0	0	0	0	0	0	0	0	0	0	0	0	0	0
"CNTNAP3B"	2810	134782	0	0	0	0	0	0	0	0	0	0	0	0	0	0	0	0
"CNTNAP4"	4889	281961	0	0	0	0	0	0	0	0	0	0	0	0	0	0	0	0
"CNTNAP5"	5308	889999	0	0	0	0	0	0	0	0	0	0	0	0	0	0	0	0
"CNTROB"	3784	17424	356	110	186	170	63	47	289	247	259	277	490	622	612	653	651	564
"CO9"	504	504	0	0	0	0	0	0	0	0	0	0	0	154	0	0	0	0
"COAS3"	705	705	0	0	0	0	0	0	16	0	0	0	13	10	12	0	15	0
"COASY"	2561	4204	279	39	144	135	18	21	173	75	7	0	1593	1115	1780	927	1867	1089
"COBL"	8769	19744	0	0	0	0	0	0	39	0	0	0	0	0	0	0	0	0
"COBLL1"	6416	40259	0	13	0	0	13	0	0	10	0	3	2	13	4	4	0	4
"COBRA1"	2578	18242	532	30	286	246	20	10	355	151	96	129	1138	766	1075	805	1833	994
"COCH"	2893	16083	94	79	52	42	30	49	19	0	0	31	2	25	130	0	202	12
"COG1"	4102	15472	677	21	388	289	8	13	369	41	268	52	1605	1288	1582	887	1829	994
"COG2"	3211	51530	769	79	475	294	50	29	654	87	102	16	725	674	1044	833	1027	763
"COG3"	4504	71690	1872	537	1045	827	298	239	1221	635	387	878	956	989	1074	775	1013	641
"COG4"	3000	42986	539	130	321	218	66	64	446	102	173	91	941	826	1132	1008	1449	926
"COG5"	5687	356663	6293	3269	3701	2592	1680	1589	4979	2962	840	2010	2455	2785	996	908	966	553
"COG6"	5276	136040	387	13	211	176	13	0	333	2	0	0	291	365	432	374	530	337
"COG7"	2943	64689	780	89	408	372	53	36	521	118	355	150	526	478	575	517	697	414
"COG8"	2501	11004	333	1	140	193	1	0	190	28	114	0	2851	2270	473	322	1316	361
"COIL"	2638	22850	23	0	0	23	0	0	42	23	0	0	351	265	394	166	486	264
"COL10A1"	3292	7212	274	0	152	122	0	0	53	11	0	111	0	0	0	0	1	0
"COL11A1"	7393	232030	0	0	0	0	0	0	0	0	0	0	0	0	0	0	0	0
"COL11A2"	6491	29778	0	0	0	0	0	0	133	135	0	0	8	12	5	0	0	0
"COL12A1"	11644	121582	0	0	0	0	0	0	0	0	0	0	0	0	0	0	0	0
"COL13A1"	3176	157261	0	0	0	0	0	0	686	238	0	0	0	0	7	0	0	0
"COL14A1"	6500	246916	0	0	0	0	0	0	0	0	0	0	7	24	42	24	0	0
"COL15A1"	5315	126932	0	0	0	0	0	0	131	32	0	0	0	0	3	0	7	3
"COL16A1"	5655	51922	0	0	0	0	0	0	401	153	0	0	0	0	0	0	0	0
"COL17A1"	5664	54592	41	16	41	0	16	0	128	56	0	18	0	0	0	0	0	0
"COL18A1"	6648	58211	598	90	341	257	30	60	1499	561	233	40	643	448	461	398	1610	759
"COL19A1"	8776	345711	0	0	0	0	0	0	0	0	0	0	0	0	0	0	0	0
"COL1A1"	5976	17543	1	0	0	1	0	0	139	14	0	0	0	0	0	0	0	0
"COL1A2"	5463	36673	0	0	0	0	0	0	0	0	0	0	0	0	0	0	0	0
"COL20A1"	4207	37748	1	0	1	0	0	0	187	94	0	0	0	0	0	0	0	0
"COL21A1"	4202	190991	0	0	0	0	0	0	0	0	0	0	0	0	0	0	0	0
"COL22A1"	6410	325759	0	0	0	0	0	0	217	47	0	10	0	0	10	4	0	0
"COL23A1"	3092	352941	309	103	161	148	53	50	3473	1902	62	152	31	35	54	98	236	150
"COL24A1"	6677	427238	0	4	0	0	4	0	9	0	21	0	43	112	32	15	9	4
"COL25A1"	4120	199655	0	0	0	0	0	0	10	0	0	0	0	0	0	0	0	0
"COL27A1"	5643	154745	4	0	0	4	0	0	691	256	0	0	0	0	0	0	0	0
"COL28"	1763	100205	0	0	0	0	0	0	0	0	0	0	0	0	0	0	0	0
"COL28A1"	3736	177218	0	0	0	0	0	0	0	3	0	0	0	0	0	0	0	0
"COL29A1"	9268	139331	0	0	0	0	0	0	0	0	0	0	0	0	0	0	0	0
"COL2A1"	5140	31538	0	0	0	0	0	0	80	105	0	0	0	0	0	0	0	0
"COL3A1"	5541	38375	0	0	0	0	0	0	0	0	0	0	0	0	0	0	0	0
"COL4A1"	6583	158187	0	0	0	0	0	0	55	10	0	0	0	0	0	0	0	0
"COL4A2"	6309	205742	0	0	0	0	0	0	311	115	0	0	0	0	0	44	0	0
"COL4A3"	8148	150228	0	0	0	0	0	0	0	10	0	0	0	0	0	0	3	0
"COL4A3BP"	5512	140879	3101	1260	1885	1216	695	565	2268	893	358	583	1212	1560	1997	1646	1496	1457
"COL4A4"	10371	161842	0	14	0	0	14	0	36	0	0	0	0	0	0	0	0	0
"COL4A5"	6485	257623	0	0	0	0	0	0	0	0	0	0	0	0	0	0	0	0
"COL4A6"	6742	282822	0	0	0	0	0	0	0	0	0	0	0	0	0	0	0	0
"COL5A1"	8502	203036	0	0	0	0	0	0	1239	532	0	0	0	0	0	0	0	0
"COL5A2"	6983	147965	0	0	0	0	0	0	0	0	0	0	0	0	0	0	3	0
"COL5A3"	6241	50912	0	0	0	0	0	0	148	19	0	0	17	18	0	8	8	25
"COL6A1"	4260	23302	54	0	19	35	0	0	174	75	0	0	518	484	376	412	436	361
"COL6A2"	3474	31688	3	0	3	0	0	0	152	80	0	0	234	195	126	110	145	184
"COL6A3"	10625	90197	0	0	0	0	0	0	0	0	0	0	0	0	0	0	0	0
"COL6A4P2"	9178	60987	0	0	0	0	0	0	0	0	0	0	0	0	0	0	0	0
"COL6A6"	8505	116711	0	0	0	0	0	0	23	0	0	0	0	0	0	0	0	0
"COL7A1"	9287	31089	1	5	0	1	4	1	624	362	1	0	23	31	0	9	0	0
"COL8A1"	2663	157706	0	0	0	0	0	0	0	0	0	0	0	0	0	0	0	0
"COL8A2"	4445	5006	1	0	0	1	0	0	30	13	0	0	96	57	131	138	244	235
"COL9A1"	3819	87044	0	0	0	0	0	0	0	0	0	0	0	0	0	0	0	0
"COL9A2"	3095	16899	0	0	0	0	0	0	46	29	0	0	56	75	91	54	313	96
"COL9A3"	2516	24098	0	0	0	0	0	0	147	86	0	0	53	82	15	8	0	3
"COLA1L"	2305	35072	0	0	0	0	0	0	0	0	0	0	0	0	0	0	0	0
"COLEC10"	1702	39773	0	0	0	0	0	0	0	0	0	0	0	0	0	0	0	0
"COLEC11"	1388	49410	0	0	0	0	0	0	97	70	0	0	0	0	0	0	0	0
"COLEC12"	3143	181375	0	13	0	0	0	13	63	0	0	0	56	98	111	88	119	36
"COLQ"	3150	48740	144	0	110	34	0	0	261	18	0	0	266	258	507	435	342	415
"COMMD1"	715	230403	2995	4924	1781	1214	2718	2206	1664	4020	116	5502	395	156	297	312	418	281
"COMMD10"	1431	208253	13025	8889	7209	5816	5044	3845	6092	5187	1546	4483	659	761	830	751	1013	714
"COMMD2"	1428	11748	50	0	14	36	0	0	28	0	0	0	130	125	756	488	765	176
"COMMD3"	1374	2910	101	0	78	23	0	0	67	15	0	0	908	862	899	468	1209	621
"COMMD4"	1980	5896	7	10	7	0	0	10	42	11	0	0	643	620	559	460	867	515
"COMMD5"	2380	12625	2241	1698	1281	960	865	833	1372	919	1652	2001	1612	1355	1946	1371	2490	1434
"COMMD6"	1727	12643	61	0	51	10	0	0	28	0	0	0	614	661	658	607	757	697
"COMMD7"	2471	41311	269	0	168	101	0	0	93	29	58	43	451	503	452	422	582	446
"COMMD8"	1412	12863	8	0	8	0	0	0	0	0	0	0	527	626	640	428	339	265
"COMMD9"	2979	17158	114	0	64	50	0	0	109	0	0	0	1151	952	1518	1331	1721	1239
"COMP"	2693	8501	0	0	0	0	0	0	40	36	0	0	0	0	0	0	0	0
"COMT"	2602	28235	1578	131	825	753	90	41	898	293	937	686	2033	1459	1653	1773	2876	2471
"COMTD1"	981	2042	23	0	23	0	0	0	36	17	42	63	99	170	262	170	168	212
"COPA"	5698	54978	7823	3483	4351	3472	1865	1618	2889	1867	2441	2207	11210	11312	8906	7142	11767	5593
"COPB1"	3512	42357	789	495	424	365	250	245	511	501	217	522	2413	2424	3439	3053	3618	2517
"COPB2"	3544	9655	703	383	451	252	239	144	502	362	156	461	3244	3932	4382	3383	4299	3340
"COPE"	1213	19877	1183	812	682	501	410	402	706	732	1465	1608	2451	2430	2406	2248	2758	1919
"COPG"	3276	28163	1133	602	574	559	301	301	580	491	188	722	3216	3176	3551	3610	4137	2670
"COPG2"	1747	207520	37	0	19	18	0	0	90	0	0	22	317	341	401	354	540	369
"COPS2"	4119	30383	535	633	326	209	337	296	379	457	124	426	1638	1939	1473	1256	1735	1173
"COPS3"	1704	33952	330	110	182	148	52	58	173	86	46	71	1075	1061	1121	1227	1567	1019
"COPS4"	1906	40733	74	20	52	22	11	9	90	0	0	7	387	518	601	470	765	468
"COPS5"	3598	18943	412	133	234	178	77	56	256	125	0	46	847	739	1023	688	1293	766
"COPS6"	1433	3239	72	3	41	31	3	0	94	32	0	0	863	638	1093	933	1101	858
"COPS7A"	2043	7592	289	177	164	125	103	74	203	102	74	102	1341	1055	1475	1164	1843	1229
"COPS7B"	3307	19072	2587	120	1369	1218	52	68	1282	55	1806	91	1187	652	1605	670	2295	831
"COPS8"	2330	13405	50	26	35	15	15	11	69	0	0	0	431	515	603	517	656	482
"COPZ1"	1990	26724	288	40	168	120	11	29	411	165	211	389	2810	2930	2826	2583	3466	2420
"COPZ2"	910	11619	0	0	0	0	0	0	86	40	0	0	24	16	20	0	13	0
"COQ10A"	1657	4108	23	0	11	12	0	0	14	22	0	0	33	34	77	67	56	51
"COQ10B"	1979	21622	240	135	124	116	57	78	136	97	0	148	702	1139	708	910	675	827
"COQ2"	1543	20987	116	34	60	56	20	14	88	27	0	0	320	203	304	261	337	208
"COQ3"	1271	24735	0	0	0	0	0	0	2	0	0	0	45	42	55	35	59	48
"COQ4"	1577	11560	495	100	243	252	52	48	326	185	380	95	714	518	538	415	745	397
"COQ5"	1606	25883	35	5	16	19	5	0	38	6	0	0	471	438	411	509	495	548
"COQ6"	1608	12857	135	0	64	71	0	0	27	10	11	0	371	217	459	299	446	242
"COQ7"	3347	12041	69	106	35	34	61	45	88	74	0	51	544	663	266	210	324	257
"COQ9"	1765	6816	333	68	197	136	47	21	294	38	43	67	1017	652	930	608	1355	750
"CORIN"	5310	158502	7326	364	6633	693	229	135	5247	41	942	56	318	49	33	1	1254	3
"CORL2"	893	18061	0	0	0	0	0	0	0	0	0	0	0	0	0	0	0	0
"CORO1A"	2819	5472	1148	375	612	536	192	183	246	121	824	214	3040	2514	2700	2403	4531	2090
"CORO1B"	2010	5420	874	266	542	332	125	141	321	159	363	159	3998	3125	5098	2919	7587	5436
"CORO1C"	3934	57887	10402	1141	5873	4529	579	562	4188	837	4585	1109	9330	2307	3652	3174	11940	2569
"CORO2A"	5654	51918	3	18	3	0	8	10	427	116	0	0	342	366	820	876	844	752
"CORO2B"	3793	15042	0	0	0	0	0	0	200	35	0	0	0	0	0	0	0	0
"CORO6"	2407	6669	0	0	0	0	0	0	51	0	0	0	0	0	0	0	0	0
"CORO7"	3864	62420	8210	1897	4342	3868	1041	856	3520	1870	6704	3134	4188	3953	4773	4407	7116	4779
"CORT"	1186	2239	0	0	0	0	0	0	14	13	0	0	1	0	0	0	1	0
"COTL1"	1827	52465	16467	13985	9050	7417	7460	6525	6172	10537	17503	24816	3566	26733	20607	5230	6275	5125
"COX10"	3005	139275	1603	399	845	758	190	209	1300	630	134	499	542	450	591	405	610	421
"COX11"	2722	16807	64	0	40	24	0	0	135	7	0	0	472	351	590	315	519	353
"COX15"	7696	23918	417	8	237	180	8	0	344	21	92	0	1718	1375	1208	716	1262	692
"COX16"	1716	34647	184	59	88	96	37	22	104	19	0	0	359	595	517	601	666	617
"COX17"	426	7873	337	800	157	180	443	357	236	353	0	265	178	369	321	399	434	364
"COX18"	4533	15058	167	41	107	60	9	32	220	41	0	0	801	723	504	372	595	373
"COX19"	4894	10751	869	954	479	390	521	433	550	551	725	747	915	138	641	825	867	511
"COX4I1"	2303	7411	617	663	331	286	366	297	247	348	148	545	4019	4074	5320	5451	6855	5001
"COX4I2"	1183	6374	0	3	0	0	1	2	36	13	0	0	0	0	0	0	0	0
"COX4NB"	1966	20917	355	46	196	159	23	23	329	250	290	125	168	779	514	468	782	492
"COX5A"	772	17878	171	0	107	64	0	0	207	62	134	98	400	425	1337	1603	1362	1660
"COX5B"	508	2137	75	0	40	35	0	0	22	0	0	21	3711	3111	3591	2196	5093	3150
"COX6A1"	548	2627	0	0	0	0	0	0	28	20	0	0	693	743	826	1592	2211	836
"COX6A2"	412	668	1	0	0	1	0	0	0	0	0	0	0	1	0	0	0	0
"COX6B1"	561	10530	25	26	7	18	17	9	49	38	0	25	1558	1012	1551	1607	1993	1537
"COX6B2"	2108	4833	0	0	0	0	0	0	30	59	0	0	0	0	0	0	0	0
"COX6C"	429	15525	564	122	286	278	87	35	404	116	94	179	722	850	1641	1571	2265	1918
"COX7A1"	766	1949	243	102	156	87	51	51	113	20	0	0	0	0	0	0	0	0
"COX7A2"	474	6024	57	16	42	15	16	0	11	18	0	49	1009	1154	1214	1033	1352	992
"COX7A2L"	1891	18505	306	210	156	150	129	81	209	39	0	94	1256	196	1261	1106	395	257
"COX7B"	459	5922	246	152	114	132	102	50	75	116	0	114	2047	2314	2329	1874	1763	1918
"COX7B2"	644	174405	0	0	0	0	0	0	0	0	0	0	0	0	0	0	0	0
"COX7C"	408	2799	78	0	54	24	0	0	69	20	0	0	3261	1721	2725	2682	6389	4474
"COX8A"	508	1937	32	28	32	0	13	15	26	53	0	0	1913	227	2107	1997	3245	2014
"COX8C"	533	1165	0	0	0	0	0	0	0	0	0	0	0	0	0	0	0	0
"CP"	4679	49542	572	25	337	235	16	9	657	0	150	7	1149	790	871	526	1077	480
"CP110"	5514	29549	8	0	8	0	0	0	118	0	0	0	416	429	380	212	390	252
"CPA1"	1438	7660	0	0	0	0	0	0	0	0	0	0	0	0	0	0	0	0
"CPA2"	1338	22934	0	0	0	0	0	0	9	0	0	0	0	0	0	0	0	0
"CPA3"	1693	31829	0	0	0	0	0	0	0	0	0	0	409	654	740	866	284	156
"CPA4"	2827	31047	0	0	0	0	0	0	52	0	0	0	0	0	0	0	0	0
"CPA5"	2585	23886	0	0	0	0	0	0	0	29	0	0	0	0	0	0	0	0
"CPA6"	1914	324216	0	0	0	0	0	0	11	0	0	0	0	0	119	0	202	0
"CPAMD8"	6029	133864	1	0	0	1	0	0	184	34	0	0	10	1	0	12	4	0
"CPAP"	5340	40673	168	0	75	93	0	0	131	2	0	0	278	267	216	156	348	169
"CPB1"	1469	32384	0	0	0	0	0	0	0	0	0	0	0	1	0	0	0	0
"CPB2"	1776	51890	0	0	0	0	0	0	0	2	0	0	1	4	0	0	0	0
"CPD"	8046	89717	256	82	145	111	28	54	215	33	55	73	2492	2799	3096	2574	2922	1944
"CPE"	2436	119386	0	0	0	0	0	0	0	0	0	0	437	525	0	0	0	0
"CPEB1"	4912	87003	4	0	4	0	0	0	51	67	0	0	10	80	214	218	272	248
"CPEB2"	5663	66254	5637	4831	3190	2447	2635	2196	2758	3273	431	606	711	1556	1307	1374	990	850
"CPEB3"	5850	242447	2154	795	1214	940	506	289	1521	765	217	413	209	273	180	261	235	118
"CPEB4"	7778	71983	10725	16324	5994	4731	8765	7559	3889	6268	3040	8426	3064	6368	3125	5684	2699	2929
"CPGL"	1237	10288	1412	619	778	634	308	311	562	323	428	533	3174	2336	2658	2288	4416	2413
"CPLX1"	2143	41201	1	2	0	1	1	1	152	80	0	0	0	0	0	0	0	0
"CPLX2"	4731	87415	0	0	0	0	0	0	135	88	0	0	0	0	0	0	0	0
"CPLX3"	3149	6321	0	0	0	0	0	0	81	27	0	0	0	0	0	0	0	0
"CPLX4"	1965	23245	0	0	0	0	0	0	0	0	0	0	0	0	0	0	0	0
"CPM"	6675	112064	5210	1310	2911	2299	817	493	2944	798	1536	1483	397	2325	4153	3447	3425	2664
"CPN1"	1765	39579	0	0	0	0	0	0	0	0	0	0	0	0	0	0	0	0
"CPN2"	3029	11564	0	0	0	0	0	0	13	0	0	0	0	0	0	0	0	0
"CPNE1"	2222	38882	6189	3627	3461	2728	1954	1673	2293	1611	2946	3084	4180	4757	4840	4665	5064	3727
"CPNE2"	2340	55368	379	5	231	148	4	1	845	257	106	16	954	726	839	757	1098	874
"CPNE3"	4881	47072	202	0	135	67	0	0	157	0	0	0	2192	2891	1995	1650	2303	1327
"CPNE4"	4276	750672	2	0	0	2	0	0	0	0	0	0	344	419	0	0	0	0
"CPNE5"	3360	98667	0	0	0	0	0	0	351	69	0	0	0	8	0	0	0	0
"CPNE6"	2788	7139	9	0	0	9	0	0	126	52	0	0	2	0	0	0	9	0
"CPNE7"	2673	21479	0	0	0	0	0	0	170	81	0	0	0	0	0	0	0	0
"CPNE8"	3481	253420	3526	37979	1950	1576	20540	17439	2079	19155	122	14365	539	1104	621	651	665	508
"CPNE9"	2065	26083	39	36	37	2	15	21	97	99	15	19	14	7	18	25	33	7
"CPO"	1218	29922	0	0	0	0	0	0	0	0	0	0	0	0	0	0	0	0
"CPOX"	2700	14151	451	0	225	226	0	0	265	14	84	0	753	623	682	378	514	497
"CPPED1"	6146	144089	18727	3572	10412	8315	2044	1528	8363	1781	12112	3261	5424	137	4064	3600	5234	3019
"CPS1"	5793	122505	0	0	0	0	0	0	0	0	0	0	0	0	0	0	0	0
"CPSF1"	4531	16288	1167	395	727	440	224	171	450	261	663	335	2402	2328	2121	1813	4742	3089
"CPSF2"	5057	42216	1045	292	663	382	175	117	765	159	225	150	2048	2370	2123	1643	2422	1507
"CPSF3"	3181	49216	253	232	131	122	126	106	241	73	84	144	1145	983	1092	792	1378	943
"CPSF3L"	2893	5867	1022	250	568	454	144	106	523	365	884	585	682	991	1569	1512	1776	1395
"CPSF4"	1832	18433	1246	117	772	474	63	54	644	300	612	381	998	927	663	459	925	457
"CPSF4L"	653	13433	10	0	10	0	0	0	38	0	0	0	174	121	251	43	250	102
"CPSF6"	6737	34822	3431	2007	1907	1524	1051	956	1679	1143	1093	1703	1912	2265	2504	2178	2517	1628
"CPSF7"	3697	27264	2181	1464	1170	1011	871	593	900	978	868	2037	2002	2385	2321	2187	3274	1892
"CPT1A"	5270	87048	1756	83	1036	720	57	26	1231	90	1430	68	3220	3221	2438	1900	3658	2146
"CPT1B"	2952	9807	313	162	170	143	96	66	215	148	15	84	172	243	568	344	817	344
"CPT1C"	3782	21201	1	0	0	1	0	0	21	17	0	0	2	2	0	0	0	0
"CPT2"	3097	17768	42	0	30	12	0	0	111	11	0	0	1129	830	1522	1001	2382	1225
"CPVL"	2234	199645	41420	17368	22300	19120	9615	7753	18310	6130	23677	14218	11427	12960	10483	11545	11583	6865
"CPXCR1"	1630	7559	0	0	0	0	0	0	0	0	0	0	0	0	0	0	0	0
"CPXM1"	2403	6568	0	0	0	0	0	0	15	26	0	0	0	0	0	0	5	0
"CPXM2"	3738	146350	0	0	0	0	0	0	23	21	0	0	0	0	0	0	0	0
"CPZ"	2501	27053	0	0	0	0	0	0	157	96	0	0	0	0	0	0	0	0
"CQ819101"	1467	13546	0	0	0	0	0	0	0	0	0	0	0	0	0	0	0	0
"CQ819111"	1540	13546	0	0	0	0	0	0	0	0	0	0	0	0	0	0	0	0
"CR1"	10012	145638	31	37	29	2	17	20	596	219	107	171	769	746	3992	4161	2764	2505
"CR1L"	1925	72580	0	0	0	0	0	0	2	0	0	0	1	1	71	36	28	5
"CR2"	4163	35570	0	0	0	0	0	0	0	1	0	0	0	0	0	0	0	0
"CR53"	5972	7749	47	0	17	30	0	0	47	19	0	0	409	231	516	263	707	318
"CR590020"	1664	8095	574	203	305	269	96	107	204	94	76	222	4331	4119	4168	2841	7431	4380
"CR590073"	1289	4203	378	233	227	151	110	123	202	116	0	92	71	120	34	18	25	22
"CR590086"	1375	1375	59	0	29	30	0	0	32	32	0	84	35	42	71	65	63	27
"CR590209"	1649	2320	0	0	0	0	0	0	0	0	0	0	0	0	0	0	0	0
"CR590356"	1435	40143	3232	20023	1816	1416	10873	9150	756	7729	95	11128	45	1719	21	1215	22	562
"CR590505"	866	1861	110	0	55	55	0	0	0	16	0	0	279	176	109	70	115	84
"CR590598"	1659	2225	0	0	0	0	0	0	23	36	0	0	0	0	0	2	6	0
"CR590645"	1704	13455	0	0	0	0	0	0	0	14	0	0	1	0	0	0	0	0
"CR590796"	1099	1099	0	0	0	0	0	0	11	0	0	0	0	0	0	0	0	0
"CR590976"	1584	16906	0	0	0	0	0	0	0	0	0	0	0	0	0	0	0	0
"CR591034"	2179	2179	3452	2163	1861	1591	0	2163	1466	2316	153	1029	383	603	206	242	373	155
"CR591173"	2287	2287	10	0	0	10	0	0	24	0	0	0	0	0	593	375	492	505
"CR591280"	820	1114	678	282	403	275	157	125	370	63	877	288	1836	0	856	139	196	16
"CR591289"	1560	1560	0	0	0	0	0	0	0	0	0	0	74	44	30	24	51	0
"CR591356"	1411	7313	0	0	0	0	0	0	12	0	0	0	3	0	19	22	5	7
"CR591360"	1301	87182	0	0	0	0	0	0	0	0	0	0	0	0	0	0	0	0
"CR591392"	1336	54149	0	0	0	0	0	0	11	0	0	0	0	0	0	0	0	0
"CR591448"	2067	2067	0	0	0	0	0	0	0	0	0	0	0	0	0	0	0	0
"CR591483"	2040	2040	0	0	0	0	0	0	0	0	0	0	0	0	0	0	0	0
"CR591575"	1295	20839	530	202	236	294	107	95	369	145	14	64	1507	1335	911	966	1270	1108
"CR591805"	1489	1489	40	0	40	0	0	0	26	37	0	0	355	378	924	780	1107	781
"CR591858"	1021	1048	0	0	0	0	0	0	0	0	0	0	0	0	0	0	0	0
"CR592128"	912	912	0	0	0	0	0	0	0	0	0	0	0	0	0	0	0	0
"CR592140"	1532	1532	0	0	0	0	0	0	0	0	0	0	0	0	0	0	0	0
"CR592260"	458	27183	309	147	180	129	86	61	138	39	0	0	474	327	444	261	544	224
"CR592318"	1153	134929	4471	1785	2479	1992	1075	710	2254	1155	1361	1533	92	278	698	646	616	249
"CR592342"	907	1262	0	0	0	0	0	0	0	0	0	0	0	1	4	0	0	0
"CR592586"	872	8820	14	0	14	0	0	0	33	0	0	0	0	0	0	0	0	0
"CR592614"	1646	25613	0	0	0	0	0	0	0	0	0	0	0	0	0	0	0	0
"CR592675"	932	59656	0	0	0	0	0	0	0	0	0	0	0	0	0	0	0	0
"CR592733"	2066	2801	0	0	0	0	0	0	11	23	0	0	0	0	0	0	0	0
"CR592782"	2569	5641	0	0	0	0	0	0	0	0	0	0	0	0	0	0	0	0
"CR593014"	1968	44664	0	3	0	0	0	3	13	0	0	0	0	0	0	0	0	0
"CR593175"	1996	91637	0	0	0	0	0	0	0	0	0	0	0	0	0	0	0	0
"CR593328"	1018	24787	3880	2366	2172	1708	1281	1085	1192	688	242	633	0	25	0	5	37	29
"CR593374"	3498	15041	0	0	0	0	0	0	7	0	0	0	0	0	0	0	0	0
"CR593447"	3837	213346	0	0	0	0	0	0	0	0	0	8	0	0	0	0	0	0
"CR593740"	3200	7683	468	175	254	214	100	75	235	33	172	27	725	438	914	290	999	374
"CR593775"	520	7159	0	0	0	0	0	0	9	0	0	0	0	0	0	0	0	0
"CR593779"	2041	19488	0	0	0	0	0	0	0	0	0	0	0	0	0	0	0	0
"CR593784"	1085	3025	0	0	0	0	0	0	0	0	0	0	0	0	0	0	0	0
"CR593817"	2964	2964	0	0	0	0	0	0	0	0	0	0	0	0	0	0	0	0
"CR593845"	883	883	0	0	0	0	0	0	0	0	0	0	0	0	0	0	0	0
"CR593862"	2574	12588	0	0	0	0	0	0	0	0	0	0	0	0	0	0	0	0
"CR593993"	1170	1867	0	0	0	0	0	0	0	10	0	0	0	0	0	0	0	0
"CR594125"	1449	1449	177	45	93	84	26	19	141	0	63	0	1857	0	1225	0	0	931
"CR594287"	1573	85433	0	0	0	0	0	0	9	0	0	0	0	0	0	0	0	0
"CR594506"	1868	1868	0	0	0	0	0	0	0	0	0	0	0	0	0	0	0	0
"CR594591"	1480	1480	0	0	0	0	0	0	0	11	0	0	2034	1867	4820	5014	4774	3757
"CR594687"	1930	4252	0	102	0	0	102	0	36	74	0	74	2175	2988	3883	4157	4683	3647
"CR594710"	1689	53753	0	0	0	0	0	0	0	0	0	0	0	0	0	0	0	0
"CR594732"	1578	24542	83	0	37	46	0	0	209	37	0	0	467	295	746	621	1435	779
"CR594735"	1563	9936	0	0	0	0	0	0	0	0	0	0	0	0	0	0	0	0
"CR594785"	2117	2117	0	0	0	0	0	0	19	0	0	0	54	51	77	0	80	0
"CR595071"	1361	7281	0	0	0	0	0	0	0	0	0	0	0	0	0	0	0	0
"CR595224"	1656	18415	0	0	0	0	0	0	0	0	0	0	0	0	3	0	0	1
"CR595267"	1015	1114	6	0	4	2	0	0	0	0	0	0	14	20	12	8	13	3
"CR595314"	2365	2365	0	0	0	0	0	0	0	0	0	0	0	0	0	0	0	0
"CR595360"	1579	13117	0	0	0	0	0	0	0	24	0	0	3	1	27	19	1	0
"CR595588"	1733	19700	0	0	0	0	0	0	28	0	0	0	0	0	0	0	0	0
"CR595591"	609	47072	1620	796	847	773	430	366	971	334	301	277	1533	1477	1691	1362	1973	1202
"CR595619"	844	844	136	41	62	74	0	41	146	44	0	29	0	0	0	0	0	0
"CR595720"	1279	1521	807717	772074	447922	359795	417207	354867	317361	329928	339409	438049	8033	14811	12226	18488	16658	14693
"CR595731"	1181	17308	2693	646	1513	1180	361	285	3928	374	1170	163	139	144	0	0	2	0
"CR595965"	2842	9466	0	0	0	0	0	0	0	0	0	0	0	0	0	0	0	0
"CR596042"	1697	1909	67	0	27	40	0	0	38	32	0	51	0	1	0	0	0	0
"CR596118"	1637	1637	1152	248	579	573	142	106	73	93	40	30	94	430	422	444	4300	0
"CR596412"	1261	10839	0	0	0	0	0	0	0	0	0	0	0	0	0	0	0	0
"CR596421"	2587	2753	584	163	334	250	91	72	1152	219	318	203	271	1152	370	0	191	111
"CR596471"	1336	10376	0	0	0	0	0	0	0	0	0	0	0	0	0	0	0	0
"CR596502"	1418	12221	0	0	0	0	0	0	0	11	0	0	0	0	0	0	0	0
"CR596518"	696	45265	0	0	0	0	0	0	0	0	0	0	0	0	0	0	0	0
"CR596530"	1673	1802	0	27	0	0	12	15	0	0	0	0	0	1	4	0	0	0
"CR596670"	1870	1897	1448	11103	801	647	6016	5087	335	8979	96	4293	1829	3448	0	0	231	235
"CR596789"	1888	2743	0	0	0	0	0	0	32	30	0	27	0	0	0	0	0	0
"CR596832"	1411	13424	99	10	34	65	10	0	184	116	127	21	0	0	0	1	0	0
"CR597099"	1444	1444	0	0	0	0	0	0	13	0	0	0	6	11	3	9	8	5
"CR597184"	747	38735	1139	566	655	484	300	266	477	351	319	652	92	57	42	36	53	20
"CR597260"	1017	9977	0	0	0	0	0	0	0	0	0	0	0	0	0	0	0	0
"CR597335"	2412	2412	159	0	92	67	0	0	88	240	0	0	0	0	0	0	0	0
"CR597433"	1502	5203	0	0	0	0	0	0	0	0	0	0	0	2	30	7	17	0
"CR597563"	1747	78362	0	0	0	0	0	0	75	29	0	0	0	0	0	0	0	0
"CR597597"	1835	4554	0	0	0	0	0	0	17	0	0	0	0	0	0	0	0	0
"CR597739"	1008	8117	0	0	0	0	0	0	0	0	0	0	0	0	0	0	0	0
"CR597807"	1606	34477	173	69	48	125	55	14	166	142	34	104	562	1106	386	297	510	311
"CR597873"	1675	2352	0	0	0	0	0	0	0	0	0	0	0	0	0	0	0	0
"CR597916"	1531	1531	0	0	0	0	0	0	0	0	0	0	52	51	0	0	0	0
"CR598098"	1542	2230	0	0	0	0	0	0	15	0	0	0	0	0	0	0	0	0
"CR598129"	2711	53028	1018	237	533	485	177	60	756	334	83	96	739	981	818	741	1045	682
"CR598144"	1946	5618	0	1	0	0	0	1	0	0	0	0	12	39	46	55	41	39
"CR598155"	1362	2514	0	0	0	0	0	0	26	5	0	0	82	46	83	22	112	43
"CR598484"	8470	22004	166	14	90	76	14	0	349	85	44	42	25	40	0	4	13	6
"CR598488"	2884	2884	0	0	0	0	0	0	11	0	0	0	0	0	0	0	0	0
"CR598521"	1123	1823	0	0	0	0	0	0	0	0	0	0	29	32	392	222	415	239
"CR598614"	651	32847	177	67	94	83	12	55	262	0	78	89	277	167	377	305	441	304
"CR598625"	1583	5949	0	0	0	0	0	0	71	22	0	0	81	12	46	30	70	12
"CR598724"	1157	3691	5168	20147	529	4639	19373	774	95	477	112	375	0	0	0	0	0	0
"CR598849"	704	18250	0	0	0	0	0	0	0	0	0	0	0	0	0	0	0	0
"CR598865"	767	767	0	0	0	0	0	0	0	0	0	19	0	0	0	0	0	0
"CR598940"	1343	9040	0	0	0	0	0	0	0	0	0	0	0	0	0	0	0	0
"CR598956"	1596	13218	96	0	56	40	0	0	181	0	0	0	62	40	0	0	0	0
"CR599065"	2150	30332	115	16	86	29	16	0	107	44	0	17	208	222	73	43	87	41
"CR599144"	1397	7767	0	0	0	0	0	0	0	0	0	0	0	0	0	0	0	0
"CR599196"	1095	5361	0	0	0	0	0	0	16	0	0	0	0	0	0	0	0	0
"CR599306"	440	4365	0	0	0	0	0	0	0	19	0	0	0	0	0	0	0	0
"CR599439"	719	3125	168	0	99	69	0	0	106	16	0	0	0	0	0	0	0	0
"CR599671"	1148	1148	124	0	80	44	0	0	61	8	48	0	0	0	0	0	0	0
"CR599842"	1904	11994	0	0	0	0	0	0	35	0	0	0	17	9	5	0	3	0
"CR599924"	2373	3741	0	0	0	0	0	0	13	0	0	0	0	0	0	0	0	0
"CR600271"	1168	24787	3880	2366	2172	1708	1281	1085	1192	688	242	633	0	25	0	5	37	29
"CR600291"	609	20427	0	0	0	0	0	0	0	0	0	0	0	0	0	0	0	0
"CR600327"	1154	1154	51	12	23	28	0	12	38	14	0	0	868	756	1177	1109	1348	1088
"CR600416"	988	6566	1057	543	607	450	262	281	357	242	532	460	54	82	25	21	25	6
"CR600419"	2638	13378	0	0	0	0	0	0	14	0	0	0	0	0	0	0	0	0
"CR600473"	3513	3513	0	0	0	0	0	0	12	0	0	0	72	53	0	0	0	0
"CR600703"	2162	11692	0	0	0	0	0	0	13	0	0	0	0	0	0	0	0	0
"CR600749"	1825	66644	0	0	0	0	0	0	0	0	0	0	0	0	0	0	0	0
"CR600797"	1494	5327	0	0	0	0	0	0	0	0	0	0	0	0	0	0	0	0
"CR600952"	3076	22077	0	0	0	0	0	0	0	0	0	0	0	0	17	16	60	46
"CR601042"	1677	3533	606	769	210	396	412	357	300	367	737	711	6450	1122	2749	2868	3178	2839
"CR601100"	1692	1692	230	129	147	83	64	65	100	69	40	250	2805	0	0	0	0	0
"CR601322"	846	27735	5621	21855	820	4801	20355	1500	295	690	112	1117	1	113	0	0	2	0
"CR601361"	2515	2515	0	0	0	0	0	0	13	0	0	0	0	0	454	271	461	244
"CR601808"	709	16245	0	0	0	0	0	0	0	0	0	0	0	0	0	0	0	0
"CR601907"	397	1098	0	0	0	0	0	0	0	0	0	0	0	0	0	0	0	0
"CR601950"	1969	7506	13	349	0	13	202	147	62	184	0	222	16	76	381	567	643	679
"CR602022"	526	4541	0	0	0	0	0	0	0	0	0	0	11	0	1	3	7	0
"CR602075"	792	5060	0	0	0	0	0	0	61	3	0	0	54	17	15	0	71	11
"CR602481"	1294	1294	116	15	62	54	15	0	60	14	0	48	0	0	0	310	290	193
"CR602684"	1513	14631	69	3	40	29	2	1	175	77	0	43	265	207	207	199	336	151
"CR602790"	1131	9645	0	0	0	0	0	0	10	0	0	0	0	0	0	0	0	0
"CR602836"	1114	2213	0	0	0	0	0	0	0	0	0	0	0	0	0	0	0	0
"CR602880"	2082	45162	1723	594	933	790	277	317	761	210	1657	4541	134	935	8	44	220	48
"CR602933"	908	908	0	0	0	0	0	0	0	7	0	0	0	0	12072	18225	10772	13797
"CR603183"	1597	1860	0	0	0	0	0	0	0	0	0	0	34	30	61	30	68	27
"CR603215"	1177	1177	0	0	0	0	0	0	0	0	0	0	0	0	0	195	281	187
"CR603237"	1821	4038	104	0	57	47	0	0	57	9	0	0	12	30	1	7	41	2
"CR603272"	1879	1964	10	0	0	10	0	0	23	0	0	0	0	0	521	170	0	240
"CR603327"	2459	83733	0	0	0	0	0	0	0	0	0	0	0	0	0	0	0	0
"CR603438"	1664	1664	132	381	0	132	202	179	29	157	0	129	2014	3033	3788	5342	4346	4423
"CR603473"	291	291	35	57	0	35	22	35	0	38	0	0	192	0	226	234	307	205
"CR603486"	1423	1423	70	20	46	24	8	12	62	23	0	0	518	453	168	104	276	152
"CR603661"	1544	1875	249	120	140	109	81	39	81	114	0	243	488	40	159	661	167	124
"CR603722"	556	739	0	0	0	0	0	0	0	0	0	0	0	0	0	0	0	0
"CR603982"	5265	5265	352	1002	235	117	546	456	385	928	0	1169	0	4405	0	2896	3122	0
"CR604031"	2260	6157	0	0	0	0	0	0	0	0	0	0	0	0	0	0	0	0
"CR604036"	1000	1859	0	70	0	0	40	30	18	22	0	40	3	0	53	27	19	15
"CR604228"	1462	16999	0	0	0	0	0	0	0	0	0	0	0	0	0	0	0	0
"CR604242"	899	30585	237	36	114	123	18	18	285	27	0	41	165	101	125	34	82	29
"CR604262"	1529	3693	380	48	191	189	33	15	251	35	420	24	27	0	0	0	0	0
"CR604304"	1538	2474	83	309	69	14	173	136	11	167	0	114	952	1757	1148	1569	810	836
"CR604408"	954	15143	2195	673	997	1198	303	370	1030	906	2123	3666	0	2	0	0	0	0
"CR604456"	1572	2595	0	0	0	0	0	0	0	0	0	0	0	0	0	0	0	0
"CR604543"	1607	13287	0	0	0	0	0	0	0	0	0	0	0	0	0	0	0	0
"CR604707"	1488	27760	0	0	0	0	0	0	0	0	0	0	0	0	0	0	0	0
"CR604709"	2239	2873	1516	733	838	678	42	691	384	1177	1651	4774	1287	2868	1115	2818	2750	1753
"CR604798"	1696	1696	680	797	454	226	431	366	348	695	26	51	3589	3606	2593	1707	4413	2840
"CR604974"	1496	1788	689	350	380	309	217	133	397	349	246	165	225	220	238	260	248	177
"CR605149"	1475	24360	0	0	0	0	0	0	0	35	0	0	0	19	3	0	0	0
"CR605189"	1206	14888	0	0	0	0	0	0	18	0	0	0	0	0	0	0	0	0
"CR605298"	2608	21125	0	0	0	0	0	0	0	12	0	0	0	0	0	0	0	0
"CR605427"	1201	7424	366	452	180	186	234	218	201	389	184	368	4381	5403	3887	3633	5479	3960
"CR605438"	1825	4387	0	0	0	0	0	0	0	0	0	0	0	0	3	10	7	0
"CR605611"	1819	12426	0	0	0	0	0	0	0	0	0	0	0	0	0	0	0	0
"CR605662"	1735	3978	0	0	0	0	0	0	0	0	0	0	0	0	0	0	0	0
"CR605703"	811	9775	0	0	0	0	0	0	0	0	0	0	0	0	0	0	0	0
"CR605783"	2841	2841	0	0	0	0	0	0	42	7	0	0	0	0	1877	1517	1424	895
"CR605995"	2542	6680	0	0	0	0	0	0	0	0	0	0	61	79	7	4	0	0
"CR606158"	1573	1573	0	0	0	0	0	0	0	0	0	0	111	107	384	264	303	226
"CR606168"	923	1204	0	0	0	0	0	0	0	30	0	0	0	0	0	0	0	0
"CR606171"	1461	2822	0	0	0	0	0	0	0	0	0	0	0	0	0	0	0	0
"CR606685"	685	2337	0	0	0	0	0	0	0	0	0	0	0	0	0	4	5	0
"CR606964"	1723	25613	0	0	0	0	0	0	0	0	0	0	0	0	0	0	0	0
"CR607080"	1948	9958	103	0	66	37	0	0	192	16	64	0	136	90	16	5	16	12
"CR607309"	1429	5869	0	0	0	0	0	0	0	0	0	0	0	0	0	0	0	0
"CR607430"	1313	59313	0	0	0	0	0	0	0	0	0	0	0	0	0	0	0	0
"CR607463"	1175	11769	444	479	16	428	248	231	265	215	672	390	3750	3415	3012	2150	4539	2789
"CR607557"	1746	1988	172756	220951	95567	77189	118637	102314	77858	100518	75482	138109	4440	6757	11463	16948	6301	9939
"CR607568"	1945	2586	0	0	0	0	0	0	0	0	0	0	0	0	0	0	0	0
"CR607597"	2187	102392	0	0	0	0	0	0	0	0	0	0	0	0	0	0	0	0
"CR607754"	1972	2185	0	0	0	0	0	0	0	0	0	0	322	327	125	94	116	69
"CR607811"	513	5018	0	0	0	0	0	0	0	0	0	0	0	0	0	0	0	0
"CR607939"	1717	1717	0	0	0	0	0	0	0	0	0	0	0	0	0	0	0	0
"CR607950"	1605	162029	0	0	0	0	0	0	126	48	0	0	0	0	0	0	0	0
"CR607999"	3609	3609	340	278	158	182	213	65	242	305	0	75	1740	2223	548	490	709	620
"CR608006"	2776	3155	0	0	0	0	0	0	0	0	0	0	0	0	0	0	0	0
"CR608203"	2590	2590	48	25	48	0	17	8	97	26	0	20	637	521	637	422	831	435
"CR608563"	4000	71675	511	9	302	209	9	0	616	37	0	0	14	42	131	90	1	11
"CR608644"	2034	115973	0	0	0	0	0	0	0	0	0	0	46	61	42	34	49	26
"CR608740"	1742	43574	108	42	67	41	42	0	142	64	0	0	5	3	3	0	0	1
"CR609070"	1393	4662	0	0	0	0	0	0	0	0	0	0	0	0	0	0	0	0
"CR609342"	1014	81173	2698	614	1550	1148	415	199	1524	499	456	571	604	548	312	186	330	126
"CR609701"	3989	3989	51	0	34	17	0	0	42	0	0	0	467	554	297	260	389	225
"CR609725"	3291	15147	8	0	0	8	0	0	35	0	0	0	86	54	111	99	115	48
"CR609843"	1206	61410	48	10	40	8	0	10	177	7	0	0	18	35	66	39	44	20
"CR609866"	2534	2534	0	0	0	0	0	0	0	10	0	0	11	13	16	22	11	11
"CR609936"	1787	1938	1	0	0	1	0	0	0	0	0	0	23	0	41	11	25	16
"CR609970"	1380	5756	0	0	0	0	0	0	0	0	0	0	0	0	0	0	0	0
"CR610073"	1722	27036	0	0	0	0	0	0	0	0	0	0	0	0	0	0	5	0
"CR610292"	990	63382	678	232	363	315	142	90	1025	241	39	78	293	179	38	35	116	40
"CR610404"	1573	2436	39	0	13	26	0	0	122	12	21	0	34	43	36	14	3	9
"CR610533"	1336	1336	0	0	0	0	0	0	0	0	0	0	1151	1422	1565	1947	2205	1742
"CR610619"	2489	118787	0	0	0	0	0	0	227	65	0	0	2	2	0	0	0	0
"CR610699"	1718	1756	0	0	0	0	0	0	0	0	0	0	0	129	186	171	28	136
"CR610784"	466	91427	0	0	0	0	0	0	0	0	0	0	0	0	0	0	0	0
"CR610863"	2081	2081	149	193	99	50	117	76	83	55	0	61	942	997	628	504	857	637
"CR610949"	5091	5091	0	0	0	0	0	0	0	0	0	0	0	0	0	0	0	0
"CR611074"	1980	1980	216	0	87	129	0	0	102	0	0	0	956	0	0	0	518	0
"CR611098"	1402	4654	0	0	0	0	0	0	0	0	0	0	42	55	1	0	0	0
"CR611239"	1091	1561	30	0	30	0	0	0	0	0	0	0	981	717	766	512	942	553
"CR611440"	787	21249	0	0	0	0	0	0	0	0	0	0	0	0	0	0	10	0
"CR611653"	1589	46135	0	0	0	0	0	0	92	0	0	0	0	0	0	0	0	0
"CR611781"	543	543	0	0	0	0	0	0	0	0	0	0	0	0	0	0	0	0
"CR611797"	1799	5366	0	0	0	0	0	0	32	0	0	0	0	0	0	0	1	0
"CR611911"	2382	2382	0	22	0	0	0	22	193	0	234	33	0	0	0	0	0	0
"CR612090"	1257	1257	0	0	0	0	0	0	59	11	0	0	517	495	0	0	392	0
"CR612190"	1495	27959	0	0	0	0	0	0	0	0	0	0	0	0	0	0	0	0
"CR612203"	1416	12949	0	0	0	0	0	0	25	0	0	0	0	0	0	0	0	0
"CR612236"	2483	2483	101	78	48	53	41	37	94	36	0	120	35	9	23	21	19	19
"CR612296"	1606	1606	10	0	0	10	0	0	14	18	0	32	33	7	316	257	519	241
"CR612338"	1991	2559	362	65	206	156	27	38	231	45	319	193	577	360	0	360	1045	435
"CR612485"	2164	13992	0	0	0	0	0	0	0	0	0	0	0	0	0	0	0	0
"CR612522"	3598	3598	0	68	0	0	68	0	50	121	0	58	0	60	0	124	0	47
"CR612557"	1626	46399	0	0	0	0	0	0	0	0	0	0	0	0	0	0	0	0
"CR612573"	2055	44664	0	3	0	0	0	3	13	0	0	0	0	0	0	0	0	0
"CR612603"	2571	2571	0	0	0	0	0	0	0	0	0	0	8	7	0	0	0	0
"CR612700"	2353	2353	0	0	0	0	0	0	0	15	0	0	0	0	0	0	0	0
"CR613092"	709	709	0	0	0	0	0	0	0	0	0	0	3279	3070	2316	2369	3382	2356
"CR613267"	2280	12751	0	2	0	0	2	0	63	0	0	0	20	36	0	0	45	0
"CR613587"	2086	15207	0	0	0	0	0	0	0	0	0	0	0	0	0	0	0	0
"CR613620"	1278	1278	204	122	90	114	69	53	87	16	0	0	4659	5003	1277	0	1984	0
"CR613685"	1953	3740	52	0	32	20	0	0	55	11	0	0	0	0	72	35	137	0
"CR613718"	1756	12102	848	633	501	347	410	223	421	677	638	937	2251	2114	3428	3078	3902	2977
"CR613732"	1864	11276	359	10	211	148	1	9	288	36	125	4	138	100	45	34	45	22
"CR613749"	1798	4082	2	2	1	1	2	0	315	0	0	0	5	5	11	17	18	20
"CR613795"	1123	11758	2134	1257	1556	578	656	601	974	476	1659	1199	2676	3056	4113	3399	5652	3549
"CR613825"	971	2575	0	0	0	0	0	0	0	0	0	0	0	0	0	0	0	0
"CR613891"	1965	2565	0	0	0	0	0	0	0	0	0	0	801	669	461	279	612	340
"CR613944"	3387	3387	39	288	21	18	202	86	48	66	0	0	584	828	235	55	531	113
"CR614076"	1004	1004	0	0	0	0	0	0	0	0	0	0	0	316	0	0	0	1190
"CR614238"	1497	44878	0	0	0	0	0	0	0	0	0	0	0	0	0	0	0	0
"CR614284"	835	35106	0	0	0	0	0	0	0	0	0	0	0	0	0	0	0	0
"CR614418"	1590	10046	184	82	84	100	54	28	100	19	0	0	847	1101	370	214	662	418
"CR614419"	1802	132406	1781	291	978	803	154	137	1117	285	475	410	64	4	0	3	58	0
"CR614561"	2246	69945	1154	449	633	521	236	213	698	516	199	303	705	866	422	324	580	442
"CR614646"	590	1879	0	0	0	0	0	0	0	0	0	0	0	0	0	0	0	0
"CR614705"	1943	4811	0	0	0	0	0	0	0	0	0	7	0	0	0	0	0	0
"CR614802"	1385	65847	0	0	0	0	0	0	0	0	0	0	0	0	0	0	0	0
"CR614803"	1719	34741	0	0	0	0	0	0	3	0	0	0	32	50	0	0	36	0
"CR614956"	1201	26237	0	0	0	0	0	0	0	0	0	0	0	0	0	0	0	0
"CR615184"	2123	3496	0	0	0	0	0	0	0	0	0	0	0	0	0	0	0	0
"CR615453"	1050	21887	127	0	71	56	0	0	125	0	0	29	36	35	302	163	294	167
"CR615613"	1024	1024	0	0	0	0	0	0	95	0	0	0	5348	5461	40695	51608	266135	50784
"CR615666"	894	47926	0	0	0	0	0	0	0	0	0	0	0	0	0	0	0	0
"CR616081"	1774	1774	110	0	27	83	0	0	84	11	0	48	62	58	101	38	107	43
"CR616088"	1926	36133	0	0	0	0	0	0	0	0	0	0	0	0	0	0	0	0
"CR616254"	447	792	0	0	0	0	0	0	0	0	0	0	0	0	0	0	0	0
"CR616551"	2016	31809	0	0	0	0	0	0	0	0	0	0	0	0	0	0	0	0
"CR616794"	1093	15221	0	0	0	0	0	0	0	11	0	0	0	0	3	0	0	0
"CR616826"	1669	1669	0	0	0	0	0	0	0	0	0	0	0	0	0	0	0	0
"CR616845"	1721	2530	0	0	0	0	0	0	9	0	0	0	0	0	0	0	0	0
"CR617006"	1427	33617	0	0	0	0	0	0	0	0	0	0	0	0	0	1	0	0
"CR617033"	1346	45216	0	0	0	0	0	0	0	0	0	0	0	0	0	0	0	0
"CR617046"	2552	5724	0	0	0	0	0	0	40	0	0	0	25	14	6	0	3	15
"CR617081"	1670	3920	0	0	0	0	0	0	0	0	0	0	0	0	0	0	0	0
"CR617196"	730	730	0	0	0	0	0	0	0	0	0	0	0	0	8	0	0	0
"CR617227"	2706	2706	155	0	83	72	0	0	83	38	0	0	520	578	275	317	761	555
"CR617371"	336	336	0	0	0	0	0	0	0	0	0	0	0	0	0	0	0	0
"CR617375"	1499	6248	0	0	0	0	0	0	0	0	0	0	0	0	0	0	0	0
"CR617556"	584	584	0	0	0	0	0	0	0	0	0	0	0	0	0	0	0	0
"CR617637"	3331	3331	266	21	160	106	12	9	116	43	0	22	111	117	110	30	92	0
"CR617890"	2156	5697	0	0	0	0	0	0	0	0	0	0	0	0	0	0	0	0
"CR617952"	1539	2588	0	0	0	0	0	0	0	0	0	0	34	30	61	30	69	28
"CR618043"	1721	1721	1831	1205	1163	668	656	549	753	0	294	944	5073	6646	0	0	0	0
"CR618071"	496	1458	0	0	0	0	0	0	0	0	0	0	0	0	0	0	0	0
"CR618332"	1564	18643	0	0	0	0	0	0	35	0	0	0	17	9	5	0	3	0
"CR618371"	2806	9184	0	0	0	0	0	0	19	0	0	0	0	0	0	0	0	0
"CR618431"	1623	74931	12552	22857	7246	5306	12330	10527	3343	6229	5998	15517	0	117	0	41	0	0
"CR618492"	1193	57656	0	0	0	0	0	0	9	0	0	0	0	0	0	0	0	0
"CR618537"	1693	14952	175	151	117	58	81	70	143	68	61	96	1088	1089	955	819	1089	759
"CR618717"	2272	2272	0	0	0	0	0	0	0	0	0	0	0	0	0	0	0	0
"CR618817"	968	2765	154	0	89	65	0	0	150	0	0	0	855	810	502	225	582	242
"CR618830"	612	31629	0	0	0	0	0	0	0	0	0	0	0	0	0	0	0	0
"CR618966"	1068	6432	88	158	58	30	99	59	63	125	0	91	83	103	82	38	98	40
"CR619051"	2644	12189	0	0	0	0	0	0	83	10	0	0	0	0	0	0	0	0
"CR619383"	818	4717	0	0	0	0	0	0	0	0	0	0	70	62	47	0	37	0
"CR619479"	1255	12532	0	0	0	0	0	0	0	19	0	26	0	0	0	1	0	0
"CR619482"	711	711	0	0	0	0	0	0	0	0	0	0	0	0	0	0	0	0
"CR619492"	1714	3710	0	0	0	0	0	0	49	13	0	0	0	0	0	0	0	0
"CR619557"	2139	2139	0	0	0	0	0	0	11	0	0	22	223	336	211	255	263	229
"CR619760"	1119	1950	0	0	0	0	0	0	0	0	0	0	167	0	45	0	22	0
"CR619813"	1458	1602	0	0	0	0	0	0	0	0	0	0	13	0	0	0	0	0
"CR619941"	1755	1755	46	143	8	38	77	66	28	84	56	363	175	192	0	236	218	204
"CR620010"	866	988	0	0	0	0	0	0	0	7	0	0	0	0	12072	18225	10772	13797
"CR620279"	1533	8527	0	0	0	0	0	0	43	15	0	0	0	0	0	0	0	0
"CR620402"	1685	4083	4304	1193	2382	1922	627	566	2527	534	3734	1147	46547	10352	49778	8339	53167	10406
"CR620444"	2103	2103	234	20	115	119	0	20	83	55	0	0	0	769	236	140	272	188
"CR620484"	1546	12300	0	0	0	0	0	0	18	0	0	0	0	0	0	0	0	0
"CR620525"	2646	372075	2106	1111	1164	942	628	483	1357	707	782	1124	0	78	13	11	17	4
"CR620532"	2438	2438	123	156	55	68	72	84	117	74	0	37	775	952	599	492	809	605
"CR620567"	1128	3099	0	0	0	0	0	0	0	0	0	0	0	0	0	0	0	0
"CR620595"	1563	3230	0	0	0	0	0	0	14	28	0	0	25	7	4	0	8	5
"CR620692"	1530	1530	0	0	0	0	0	0	0	0	0	0	0	0	0	0	0	0
"CR620892"	1812	16085	1889	1875	1075	814	1030	845	657	844	374	1619	1765	2294	2299	1987	2631	1752
"CR621005"	661	24770	175	248	100	75	139	109	216	100	221	110	413	410	385	298	397	259
"CR621159"	1294	6995	0	0	0	0	0	0	0	0	0	0	0	0	0	0	0	0
"CR621436"	2353	2353	0	0	0	0	0	0	0	0	0	0	0	0	0	0	0	0
"CR621467"	1034	24217	0	0	0	0	0	0	34	13	0	0	0	0	0	0	0	0
"CR621498"	1352	5162	0	0	0	0	0	0	0	2	0	0	0	0	0	0	0	0
"CR621577"	2794	6773	0	0	0	0	0	0	35	0	0	0	17	9	5	0	3	0
"CR621610"	2458	2458	642	164	394	248	145	19	208	114	232	131	3464	3738	2206	1622	2715	1608
"CR621911"	1496	16468	0	0	0	0	0	0	0	21	0	0	0	0	0	0	0	0
"CR621912"	1505	12442	0	0	0	0	0	0	7	0	0	0	0	0	0	0	0	0
"CR622423"	1955	86181	6377	5501	3658	2719	2947	2554	2956	1946	3490	21542	4852	4721	5388	4286	6759	4451
"CR622439"	2771	2771	280	65	182	98	47	18	188	0	173	0	1126	882	1073	607	1071	665
"CR622584"	870	8816	0	0	0	0	0	0	62	14	0	0	0	0	0	0	0	0
"CR622587"	592	779	0	0	0	0	0	0	0	0	0	0	0	0	0	0	0	0
"CR622643"	566	13696	0	0	0	0	0	0	0	0	0	0	0	0	0	0	0	0
"CR622909"	832	832	0	0	0	0	0	0	0	0	0	0	0	0	0	0	0	0
"CR622974"	1095	4240	38	0	19	19	0	0	0	13	0	0	0	0	0	0	0	0
"CR623026"	1575	1575	5	0	0	5	0	0	0	3	0	0	107	90	238	210	0	0
"CR623134"	1731	14942	0	0	0	0	0	0	0	0	0	0	38	0	0	0	11	0
"CR623142"	1766	1766	0	0	0	0	0	0	12	0	0	0	0	0	0	0	0	0
"CR623189"	999	1146	33	0	1	32	0	0	21	0	0	0	969	59	1108	655	1397	916
"CR623415"	1385	7962	0	0	0	0	0	0	0	0	0	0	0	0	0	0	0	0
"CR623475"	2408	2992	0	0	0	0	0	0	0	0	0	0	68	59	41	29	50	33
"CR623477"	1071	59124	0	0	0	0	0	0	0	0	0	0	0	0	0	0	0	0
"CR623509"	1241	1241	0	0	0	0	0	0	11	0	0	0	0	0	6	3	6	0
"CR623576"	1633	1633	622	187	332	290	92	95	333	57	93	106	0	0	2542	1643	2507	1565
"CR623706"	1673	1673	0	0	0	0	0	0	0	0	0	0	0	0	0	0	0	0
"CR623725"	2349	112646	0	0	0	0	0	0	0	0	0	0	0	0	0	0	0	0
"CR623750"	1710	1796	0	0	0	0	0	0	0	0	0	0	0	0	0	0	0	0
"CR623802"	1676	4934	362	375	221	141	210	165	263	235	690	666	504	107	86	69	122	41
"CR624169"	418	518	0	0	0	0	0	0	108	0	0	588	0	846	139	67	218	91
"CR624170"	1892	49378	287	17	186	101	0	17	115	36	61	53	0	29	852	0	0	0
"CR624291"	2514	2514	500	496	500	0	261	235	991	138	583	146	5283	0	2176	1444	2778	1649
"CR624471"	1451	1451	0	0	0	0	0	0	0	0	0	0	20	14	23	0	39	0
"CR624487"	1545	2927	0	0	0	0	0	0	0	0	0	0	0	0	0	0	0	0
"CR624517"	1860	82254	0	0	0	0	0	0	0	0	0	0	0	0	0	0	0	0
"CR624623"	839	839	0	0	0	0	0	0	0	0	0	0	0	10	0	0	0	0
"CR624711"	3012	3161	200	135	84	116	71	64	172	46	130	142	1388	1	1538	1	0	0
"CR624826"	1567	1567	1768	432	1000	768	265	167	628	362	401	168	6348	6496	6527	5587	7891	5293
"CR624880"	2207	2207	20	0	0	20	0	0	71	32	0	0	34	0	0	0	38	0
"CR624983"	1034	26982	0	0	0	0	0	0	0	0	0	0	1	0	0	0	0	0
"CR625002"	1738	5187	0	0	0	0	0	0	10	0	0	0	164	0	157	0	178	0
"CR625050"	1768	1877	99	0	66	33	0	0	37	27	0	0	49	0	0	0	0	59
"CR625109"	876	13740	0	0	0	0	0	0	0	0	0	0	0	0	0	0	0	0
"CR625155"	2440	6444	0	0	0	0	0	0	33	32	0	0	0	0	0	1	0	0
"CR625276"	2098	2213	0	0	0	0	0	0	0	0	0	0	77	0	47	0	0	0
"CR625347"	1600	15139	0	0	0	0	0	0	43	0	0	0	54	41	79	10	92	19
"CR625372"	600	1790	47	8	33	14	8	0	78	45	0	20	0	0	0	0	0	0
"CR625477"	444	444	0	0	0	0	0	0	0	0	0	0	0	0	0	0	0	0
"CR625520"	1526	10641	0	0	0	0	0	0	0	0	0	0	0	0	0	0	0	0
"CR625615"	920	6854	0	0	0	0	0	0	0	0	0	0	0	0	0	0	0	0
"CR625713"	2376	2376	418	1520	215	203	804	716	104	663	0	4436	2277	5882	2175	2677	2221	2345
"CR625718"	3678	3678	16	10	0	16	10	0	76	0	49	0	547	414	299	157	99	71
"CR625733"	1684	2241	0	0	0	0	0	0	19	0	0	0	0	0	0	0	0	0
"CR625735"	993	17689	0	0	0	0	0	0	0	0	0	0	0	0	0	0	0	0
"CR625825"	1437	17415	0	0	0	0	0	0	0	0	0	0	0	0	0	0	0	0
"CR625898"	1732	4480	1180	723	668	512	429	294	500	354	256	555	2715	3147	236	559	48	14
"CR625971"	3520	3520	113	3969	42	71	2112	1857	33	2401	0	1945	618	13408	625	9136	665	6494
"CR625980"	1388	87062	95	12	59	36	12	0	178	0	21	20	12	0	0	0	0	0
"CR626060"	1391	15752	47	0	47	0	0	0	259	96	40	32	23	21	67	108	74	105
"CR626194"	929	83413	204	0	140	64	0	0	417	37	0	0	0	0	0	4	0	0
"CR626319"	1532	1624	0	0	0	0	0	0	0	0	0	0	0	0	0	0	0	0
"CR626360"	2660	40063	6	0	6	0	0	0	47	0	0	0	16	9	0	0	64	37
"CR626459"	1517	21887	203	19	126	77	19	0	241	19	0	29	67	52	352	176	327	181
"CR626610"	2098	7703	0	0	0	0	0	0	0	0	0	0	0	0	0	0	0	0
"CR627053"	1630	5292	84	12	70	14	12	0	104	34	48	33	73	188	426	172	334	329
"CR627086"	1985	25729	9249	9038	5168	4081	4776	4262	3650	3475	3020	2026	3047	4380	510	436	524	286
"CR627093"	1724	1724	0	0	0	0	0	0	0	0	0	0	0	0	0	0	0	0
"CR627135"	4676	11830	0	0	0	0	0	0	0	0	0	0	0	0	0	0	0	0
"CR627148"	2881	12022	1032	104	585	447	52	52	997	315	293	33	179	160	538	113	621	66
"CR627203"	4876	48669	0	0	0	0	0	0	0	0	0	0	4	0	0	0	0	0
"CR627206"	4395	8080	0	0	0	0	0	0	0	0	0	0	0	0	0	0	0	0
"CR627225"	5954	11100	72	14	39	33	14	0	0	0	0	0	0	0	0	0	0	0
"CR627240"	4832	171697	0	0	0	0	0	0	15	0	0	0	0	0	0	0	0	0
"CR627346"	1482	3498	79	16	41	38	9	7	38	14	0	0	374	147	218	313	270	253
"CR627362"	5319	6290	25	134	0	25	134	0	131	86	106	71	0	12	48	63	43	19
"CR627394"	6667	81744	0	0	0	0	0	0	0	0	0	0	0	0	0	0	0	0
"CR749517"	4602	12301	0	0	0	0	0	0	0	0	0	0	0	0	0	0	0	0
"CR749668"	4153	4153	271	79	162	109	51	28	165	68	0	99	345	593	469	333	513	295
"CR749689"	1088	1088	0	0	0	0	0	0	13	0	0	0	10	0	0	0	0	0
"CR749704"	2291	13540	0	0	0	0	0	0	0	0	0	0	0	0	0	0	0	0
"CR933660"	2209	26303	0	0	0	0	0	0	0	0	0	0	0	0	0	0	0	0
"CR933665"	5641	12066	0	0	0	0	0	0	48	26	0	0	0	0	0	0	0	0
"CR933670"	4660	67567	0	0	0	0	0	0	25	12	0	0	0	0	0	0	0	0
"CR936602"	2591	4120	0	0	0	0	0	0	0	0	0	0	0	0	0	3	34	32
"CR936633"	5053	6806	0	0	0	0	0	0	13	0	0	0	0	0	0	0	0	0
"CR936677"	3352	84871	0	0	0	0	0	0	29	0	0	0	86	126	0	0	0	0
"CR936688"	3789	3789	1196	744	721	475	424	320	503	326	1174	1122	2120	1751	620	232	732	51
"CR936711"	1344	3135	0	0	0	0	0	0	0	0	0	0	0	0	0	0	0	0
"CR936784"	3771	3771	314	113	208	106	75	38	122	32	0	25	3318	3050	1022	893	1533	1377
"CR936796"	4104	638966	825	13	553	272	13	0	2283	386	2577	1145	0	0	4	8	11	0
"CR936832"	2042	7294	0	0	0	0	0	0	0	0	0	0	0	0	0	0	0	0
"CR936874"	4944	5025	447	138	423	24	76	62	289	42	401	122	632	659	446	494	1378	502
"CRABP1"	776	7908	0	0	0	0	0	0	0	0	0	0	0	0	0	0	0	0
"CRABP2"	966	5967	0	0	0	0	0	0	87	13	0	0	351	166	736	762	446	500
"CRADD"	1321	217467	1648	562	996	652	330	232	1355	442	238	256	142	103	123	136	141	120
"CRAMP1L"	7691	63268	2395	348	1342	1053	195	153	1875	668	1548	906	803	580	1054	587	1340	607
"CRAT"	2878	15997	39	6	16	23	0	6	189	61	15	0	551	372	373	623	634	339
"CRB1"	9029	30992	2	0	0	2	0	0	0	0	0	1	181	221	0	0	0	0
"CRB2"	5654	22586	575	114	254	321	66	48	378	216	96	38	106	98	229	132	262	227
"CRB3"	1443	3442	23	0	21	2	0	0	0	7	0	0	0	0	0	0	0	0
"CRBN"	2210	29694	1075	465	664	411	238	227	908	175	224	246	1462	1195	1234	676	1339	429
"CRCP"	2928	39748	1365	482	784	581	272	210	535	510	688	1014	1152	764	434	331	508	277
"CRCT1"	696	1504	0	0	0	0	0	0	0	0	0	0	0	0	0	0	0	0
"CREB1"	9786	75668	4201	8973	2389	1812	4944	4029	1985	4340	589	7643	1827	3021	1771	2859	2046	1527
"CREB3"	1929	4689	1700	757	1009	691	388	369	90	471	0	625	480	783	1599	1869	2005	1777
"CREB3L1"	2678	43744	0	0	0	0	0	0	187	46	0	0	0	0	0	0	0	0
"CREB3L2"	7465	127121	1085	124	499	586	77	47	930	67	65	0	1152	1367	1590	1466	1162	1041
"CREB3L3"	2593	19420	0	1	0	0	1	0	68	50	0	0	0	0	0	0	0	0
"CREB3L4"	1757	6437	17	0	0	17	0	0	31	13	14	0	1073	1147	1080	968	1197	946
"CREB5"	8541	413367	12920	16333	7123	5797	9055	7278	5702	4655	4664	7871	2058	3146	712	545	1666	580
"CREBBP"	10225	155065	16048	18468	8892	7156	9954	8514	6426	9028	5409	15892	2905	3278	3727	2914	4879	2737
"CREBL2"	3752	33212	4241	6275	2244	1997	3352	2923	1423	2560	1058	5137	8639	13625	6633	7699	11135	7720
"CREBZF"	7576	7576	1671	929	924	747	534	395	742	423	813	397	1498	1303	1964	1203	2225	977
"CREG1"	2027	12805	1415	503	740	675	288	215	736	184	448	306	824	11965	2567	12221	2539	10428
"CREG2"	3492	39151	0	0	0	0	0	0	0	0	0	0	0	0	0	0	0	0
"CRELD1"	2715	11584	179	23	86	93	11	12	209	103	21	16	344	388	582	444	662	434
"CRELD2"	2099	7870	69	1	25	44	0	1	111	125	0	34	246	145	364	311	427	329
"CREM"	2689	86086	224	1669	115	109	915	754	163	914	0	671	316	1094	508	726	459	466
"CRFG"	2528	29357	514	1972	298	216	1090	882	288	1180	63	1579	852	1714	961	1612	963	960
"CRH"	1281	2081	0	0	0	0	0	0	0	0	0	0	30	31	33	53	8	5
"CRH2R"	680	13716	3	0	0	3	0	0	50	18	0	0	0	0	0	0	0	0
"CRHBP"	1844	16620	0	0	0	0	0	0	0	0	0	0	2	0	0	0	0	0
"CRHR1"	2710	216137	0	0	0	0	0	0	576	209	0	0	0	36	0	0	0	0
"CRHR2"	1817	29279	4	3	0	4	0	3	245	120	0	0	0	1	0	0	0	0
"CRIM1"	5600	194882	13847	55173	7537	6310	29785	25388	2947	24725	1361	50260	1540	1132	1535	1840	976	698
"CRIP1"	482	1867	109	291	33	76	142	149	49	365	22	595	539	541	901	1216	1877	1493
"CRIP2"	1986	4306	0	0	0	0	0	0	48	32	0	0	3	0	0	0	3	0
"CRIP3"	964	3321	0	0	0	0	0	0	37	18	0	0	0	0	0	0	0	0
"CRIPAK"	4444	4444	846	416	501	345	246	170	1331	324	655	352	319	423	155	115	480	255
"CRIPT"	1922	8557	0	0	0	0	0	0	13	0	11	0	244	221	184	137	177	142
"CRISP1"	1887	32241	0	0	0	0	0	0	0	0	0	0	0	0	0	0	0	0
"CRISP2"	1460	21229	0	0	0	0	0	0	0	0	0	0	0	0	0	0	0	0
"CRISP3"	2112	16966	0	0	0	0	0	0	0	0	0	0	0	0	0	0	0	0
"CRISPLD1"	4207	49950	0	0	0	0	0	0	0	0	0	0	0	0	0	0	0	0
"CRISPLD2"	4604	89531	0	0	0	0	0	0	231	165	0	0	6	10	0	10	10	0
"CRK"	2398	34086	4031	3705	2267	1764	2025	1680	1421	2334	4423	9033	1897	495	2052	2368	2415	1784
"CRKL"	5328	36325	680	35	373	307	22	13	415	137	211	209	2386	1629	2414	1317	2820	1284
"CRKRS"	8303	73062	2774	1803	1527	1247	1016	787	1100	1324	494	3025	2102	2748	2427	2557	2392	1980
"CRLF1"	1801	13615	0	0	0	0	0	0	38	24	0	0	1	0	0	0	0	0
"CRLF2"	783	16645	0	0	0	0	0	0	0	0	0	0	0	0	0	20	0	0
"CRLF3"	2948	42077	9604	1564	7722	1882	783	781	3732	442	7070	937	1992	1474	1030	833	1509	750
"CRLS1"	3957	33957	1289	89	806	483	55	34	521	2	90	0	1001	808	704	552	897	598
"CRMP1"	3256	69428	715	215	407	308	113	102	804	430	0	37	1269	1514	336	245	971	534
"CRNKL1"	4420	21679	282	112	154	128	73	39	152	46	0	38	1492	724	581	489	680	426
"CRNN"	1916	5033	0	0	0	0	0	0	0	0	0	0	0	0	0	0	0	0
"CROCC"	6693	51031	385	36	217	168	9	27	615	250	209	44	378	409	803	762	933	642
"CROP"	1075	25199	1741	1458	982	759	798	660	793	867	447	1487	424	479	440	375	610	334
"CROP/Luc7A"	1620	31390	3031	2200	1737	1294	1170	1030	1468	1220	582	1830	1924	1922	2246	1664	2946	1307
"CROT"	3342	54166	16	0	9	7	0	0	8	0	0	0	140	132	196	120	121	94
"CRP"	2016	2301	0	0	0	0	0	0	0	0	0	0	0	0	0	0	0	0
"CRTAC1"	2904	165829	0	0	0	0	0	0	338	77	0	0	0	0	48	22	0	0
"CRTAM"	2430	34092	0	0	0	0	0	0	0	0	0	0	20	4	14	5	19	4
"CRTAP"	6657	33816	471	3	261	210	0	3	286	0	45	7	2746	2659	2304	1974	2448	1600
"CRTC1"	7006	98719	2904	620	1605	1299	353	267	1711	821	1704	749	554	486	736	506	1032	504
"CRTC2"	2597	10891	1153	503	665	488	256	247	407	431	825	814	1124	1110	1411	1316	2091	1259
"CRTC3"	5185	115380	4753	1490	2437	2316	771	719	2384	1172	912	2057	1625	1504	1781	1305	1829	1187
"CRX"	4468	21487	2	0	2	0	0	0	40	13	0	0	0	0	0	0	0	0
"CRY1"	3270	102457	30	37	15	15	27	10	66	27	10	20	276	344	357	367	328	264
"CRY2"	4214	35842	664	146	418	246	96	50	650	553	0	295	508	543	747	746	902	632
"CRYAA"	1117	3774	0	0	0	0	0	0	26	0	0	0	0	0	0	0	0	0
"CRYAB"	916	1989	0	0	0	0	0	0	0	20	0	0	0	0	0	0	0	0
"CRYBA1"	794	7627	115	0	62	53	0	0	1477	0	0	0	0	0	0	0	0	0
"CRYBA2"	889	3217	0	0	0	0	0	0	8	0	0	0	0	0	0	0	0	0
"CRYBA4"	816	8709	0	0	0	0	0	0	0	0	0	0	0	0	0	0	0	0
"CRYBB1"	927	18631	0	0	0	0	0	0	85	42	1	0	0	0	0	0	0	0
"CRYBB2"	769	12226	0	0	0	0	0	0	16	14	0	0	0	0	0	4	12	0
"CRYBB3"	859	7501	45	0	22	23	0	0	43	20	0	0	0	0	0	0	0	0
"CRYBG3"	4805	67994	5950	2423	3370	2580	1373	1050	2896	905	491	979	4310	5484	3511	2755	5114	2482
"CRYGA"	608	2834	0	0	0	0	0	0	0	0	0	0	0	0	0	0	0	0
"CRYGB"	628	3581	0	0	0	0	0	0	0	0	0	0	0	0	0	0	0	0
"CRYGC"	630	1693	0	0	0	0	0	0	0	0	0	0	0	0	0	0	0	0
"CRYGD"	709	2983	0	0	0	0	0	0	0	0	0	0	0	0	0	0	0	0
"CRYGN"	1235	10844	0	0	0	0	0	0	39	21	0	0	0	0	0	0	0	0
"CRYGS"	1133	8260	350	58	170	180	47	11	232	92	64	0	258	244	260	48	281	56
"CRYL1"	1738	122205	6	0	0	6	0	0	480	42	0	0	426	503	558	371	833	596
"CRYM"	1525	44576	191	44	130	61	29	15	106	4	0	0	13	10	0	0	0	0
"CRYZ"	2310	27919	229	5	149	80	5	0	298	10	0	0	1290	823	697	539	908	571
"CRYZL1"	1721	52512	408	15	239	169	15	0	396	21	88	95	439	456	266	258	487	294
"CS"	3075	28694	2008	1514	1102	906	840	674	866	988	794	3244	4610	4553	5427	5523	6745	5042
"CS1"	2380	15525	2669	27236	1482	1187	14609	12627	262	13940	382	12796	1341	12896	2397	20926	2118	9461
"CS548307"	25	25	0	0	0	0	0	0	0	9	0	0	0	0	0	0	0	0
"CS548341"	65	65	0	0	0	0	0	0	0	17	0	0	0	0	0	0	0	0
"CS548410"	92	92	0	0	0	0	0	0	0	0	0	0	0	0	0	0	0	0
"CS548413"	95	95	1640	0	1385	255	0	0	0	0	90	0	0	0	0	0	0	0
"CS548455"	84	84	0	0	0	0	0	0	0	0	0	0	0	0	0	0	0	0
"CS548484"	71	71	0	128	0	0	81	47	28	41	0	65	0	0	0	0	0	0
"CS548529"	23	23	0	0	0	0	0	0	0	0	0	0	0	0	0	0	0	0
"CS706497"	87	87	0	0	0	0	0	0	0	0	0	0	0	0	0	0	0	0
"CSAD"	3168	20934	1136	632	641	495	383	249	537	339	1040	761	559	719	617	468	804	438
"CSAG1"	878	6290	0	0	0	0	0	0	0	0	0	0	0	0	0	0	0	0
"CSAG1a"	668	6290	0	0	0	0	0	0	0	0	0	0	0	0	0	0	0	0
"CSAG2"	848	1005	0	0	0	0	0	0	0	0	0	0	0	0	0	0	0	0
"CSAG3"	848	1005	0	0	0	0	0	0	0	0	0	0	0	0	0	0	0	0
"CSDA"	1982	24277	1459	4335	784	675	2319	2016	634	1365	460	1626	2209	3651	2081	1828	2643	2231
"CSDAP1"	1759	1759	0	0	0	0	0	0	0	0	0	0	446	536	0	0	0	0
"CSDC2"	2534	15658	27	0	16	11	0	0	80	33	0	1	0	0	0	0	0	0
"CSDE1"	4236	41135	6380	6983	3564	2816	3810	3173	2466	3003	1677	4396	11347	20130	16352	15642	20084	15214
"CSE1L"	3584	50648	837	228	464	373	103	125	450	116	157	111	2027	1922	1882	1202	2321	1365
"CSF1"	2981	19123	2958	22792	1642	1316	12007	10785	191	8287	0	24465	3351	21868	4070	33147	4433	19441
"CSF1R"	4010	60082	19567	3629	10703	8864	1938	1691	5074	690	16315	1040	22752	37179	38687	28260	57885	33367
"CSF2"	784	2375	0	0	0	0	0	0	0	13	0	0	0	0	0	7	0	0
"CSF2RA"	1995	41137	0	0	0	0	0	0	0	0	0	0	0	0	2009	4051	2631	2540
"CSF2RB"	4858	26804	7802	2862	4232	3570	1482	1380	2317	951	4780	1750	13532	16431	13761	11417	16746	9579
"CSF3"	1688	2379	0	0	0	0	0	0	25	25	0	0	0	0	0	3	0	0
"CSF3R"	3101	16867	83	25	51	32	21	4	290	185	205	135	421	525	721	686	689	617
"CSGALNACT1"	4291	198385	0	0	0	0	0	0	0	0	0	0	13	19	0	0	10	0
"CSGALNACT2"	3729	46815	8241	4807	4616	3625	2645	2162	3610	2283	3232	5322	3549	4588	5062	5447	5147	4691
"CSH1"	1606	1698	29	37	29	0	17	20	0	21	0	0	0	0	0	0	0	0
"CSH2"	1139	1718	0	0	0	0	0	0	0	0	0	0	0	0	0	0	0	0
"CSHL1"	1289	1642	0	0	0	0	0	0	0	0	0	0	0	0	0	0	0	0
"CSK"	2753	21116	6243	2428	3487	2756	1232	1196	2233	1397	5718	3790	5650	4455	5280	3843	8254	4971
"CSMD1"	14389	2059454	0	0	0	0	0	0	7	8	0	0	68	96	67	61	0	44
"CSMD2"	13759	651268	0	0	0	0	0	0	147	57	0	0	0	0	0	0	0	0
"CSMD3"	13193	1214083	0	0	0	0	0	0	0	0	0	0	0	0	0	0	0	0
"CSN1S1"	997	15491	0	0	0	0	0	0	0	0	0	0	0	0	0	0	0	0
"CSN1S2A"	788	17885	0	0	0	0	0	0	0	0	0	0	0	0	0	0	0	0
"CSN1S2B"	440	13102	0	0	0	0	0	0	0	0	0	0	0	0	0	0	0	0
"CSN2"	1073	5753	0	0	0	0	0	0	0	0	0	0	0	0	0	0	0	0
"CSN3"	811	8812	0	0	0	0	0	0	0	0	0	0	0	0	0	0	0	0
"CSNK1A1"	3160	56164	8561	13178	4785	3776	7203	5975	3494	5571	3185	10843	5595	1492	3316	3644	3494	2622
"CSNK1A1L"	2406	2406	0	0	0	0	0	0	0	0	0	0	163	200	0	0	0	0
"CSNK1A1P"	1693	19407	0	0	0	0	0	0	0	0	0	0	54	62	0	0	4	0
"CSNK1D"	3112	10594	5814	7391	3985	1829	3860	3531	2928	3574	7093	10337	8318	8286	12008	11367	12799	9876
"CSNK1E"	2802	26717	2464	409	1316	1148	202	207	1907	573	725	613	800	740	859	784	1774	1073
"CSNK1G1"	8173	190726	3331	622	1908	1423	380	242	2388	656	779	833	1242	1375	1315	1067	1496	928
"CSNK1G2"	2914	40175	6147	3018	3417	2730	1599	1419	1939	2249	6534	6671	3570	3427	3820	3604	5266	3596
"CSNK1G3"	4473	104671	7640	1537	4274	3366	859	678	4327	1339	2471	2556	4472	4229	4707	4180	6183	4321
"CSNK2A1"	2850	61146	6598	3429	3838	2760	1895	1534	3370	2327	1142	5504	3384	3510	1544	1495	1909	1191
"CSNK2A2"	1666	39968	1119	857	565	554	479	378	639	613	212	645	1886	1844	1761	1560	2281	1433
"CSNK2B"	1622	6573	1701	1669	976	725	911	758	695	675	1212	1441	4755	5214	4423	4582	6261	4496
"CSPG3 variant protein"	3299	12194	0	0	0	0	0	0	18	0	0	0	0	0	0	0	0	0
"CSPG4"	8299	38527	68	0	39	29	0	0	347	227	126	27	0	0	0	0	23	0
"CSPG4LYP1"	797	3799	0	0	0	0	0	0	0	0	0	0	0	0	0	0	0	0
"CSPG5"	2321	18003	0	0	0	0	0	0	0	0	0	0	0	0	0	0	0	0
"CSPP1"	4499	131893	1659	845	876	783	460	385	1013	478	20	396	329	412	263	159	296	160
"CSRNP1"	3191	11760	2428	12329	1343	1085	6340	5989	185	5989	181	10469	1103	20029	593	13027	233	11122
"CSRNP2"	4474	22345	1141	209	644	497	109	100	427	149	298	332	837	616	973	560	1122	631
"CSRNP3"	3081	211048	0	0	0	0	0	0	0	0	0	0	0	0	0	0	0	0
"CSRP1"	4212	9371	1305	604	661	644	350	254	639	725	383	535	4482	4855	4236	4226	5968	3821
"CSRP2"	907	20305	70	0	32	38	0	0	32	0	0	0	0	0	0	0	0	0
"CSRP2BP"	3894	50490	290	0	146	144	0	0	278	0	15	0	693	495	721	338	846	462
"CSRP3"	1347	20013	0	0	0	0	0	0	0	0	0	0	0	0	0	0	0	0
"CST1"	762	3385	0	0	0	0	0	0	9	0	0	0	0	0	0	0	0	0
"CST11"	556	2443	0	0	0	0	0	0	0	0	0	0	0	0	0	0	0	0
"CST2"	697	2910	0	0	0	0	0	0	12	0	0	0	0	0	0	0	0	0
"CST3"	2089	10040	4127	779	2272	1855	418	361	1817	254	3979	334	82371	63054	103300	47448	81616	88762
"CST4"	739	3387	0	0	0	0	0	0	0	1	0	0	10	6	0	0	7	1
"CST5"	752	3810	0	0	0	0	0	0	0	0	0	0	0	0	0	0	0	0
"CST6"	611	1515	0	0	0	0	0	0	0	11	0	0	25	12	5	0	18	14
"CST7"	932	10698	230	193	128	102	72	121	128	309	0	232	314	340	135	164	265	214
"CST8"	894	4891	0	0	0	0	0	0	0	0	0	0	0	0	0	0	0	0
"CST9"	1689	3563	0	0	0	0	0	0	16	15	0	0	0	0	0	0	0	0
"CST9L"	959	4016	0	0	0	0	0	0	0	0	0	0	0	0	0	0	0	0
"CSTA"	828	16804	0	25	0	0	17	8	0	32	0	57	398	298	233	288	331	265
"CSTB"	660	2429	406	420	214	192	235	185	78	303	206	604	13187	12988	15892	6566	21332	19115
"CSTF1"	2336	11877	57	9	24	33	9	0	94	60	0	30	443	457	406	570	409	555
"CSTF2"	2089	20575	23	0	16	7	0	0	33	8	0	0	425	250	454	348	454	329
"CSTF2T"	4110	4110	104	71	48	56	44	27	84	50	0	85	1330	1529	1318	1246	1733	1207
"CSTF3"	2839	76904	3983	2347	2266	1717	1336	1011	1817	1208	944	1653	583	571	699	586	934	715
"CSTL1"	740	4787	0	0	0	0	0	0	0	11	0	0	0	0	0	0	0	0
"CSTT"	1159	22872	0	0	0	0	0	0	0	0	0	0	0	0	0	0	0	0
"CT45A1"	1012	9804	0	0	0	0	0	0	9	0	0	0	0	0	0	0	0	0
"CT45A2"	1012	8035	0	0	0	0	0	0	0	0	0	0	0	0	0	0	0	0
"CT45A3"	1012	8032	0	0	0	0	0	0	0	0	0	0	0	0	0	0	0	0
"CT45A4"	1012	25306	0	0	0	0	0	0	0	0	0	0	0	0	0	0	0	0
"CT45A5"	1012	8031	0	0	0	0	0	0	0	0	0	0	0	0	0	0	0	0
"CT45A6"	1012	8030	0	0	0	0	0	0	0	0	0	0	0	0	0	0	0	0
"CT47A1"	1294	54806	0	0	0	0	0	0	0	0	0	0	0	0	0	0	0	0
"CT47A11"	1296	3319	0	0	0	0	0	0	0	0	0	0	0	0	0	0	0	0
"CT47A6"	1294	3317	0	0	0	0	0	0	0	0	0	0	0	0	0	0	0	0
"CT47A7"	1294	3317	0	0	0	0	0	0	0	0	0	0	0	0	0	0	0	0
"CT47B1"	1330	3327	0	0	0	0	0	0	0	0	0	0	0	0	0	0	0	0
"CT62"	1835	5258	0	0	0	0	0	0	0	0	0	0	0	0	0	0	0	0
"CTA-221G9.5"	6148	127235	14623	16334	8154	6469	8572	7762	4035	7743	3324	10493	1444	2190	538	259	2592	976
"CTAG1A"	751	1659	0	0	0	0	0	0	0	0	0	0	0	0	0	0	0	0
"CTAG2"	979	1593	0	0	0	0	0	0	0	0	0	0	0	0	0	0	0	0
"CTAGE1"	4316	4316	0	0	0	0	0	0	0	0	0	0	0	48	0	0	0	0
"CTAGE4"	2625	2625	0	0	0	0	0	0	0	0	0	0	0	0	0	0	0	0
"CTAGE5"	4010	74967	1135	48	672	463	48	0	769	10	0	54	464	518	1028	919	1173	931
"CTAGE6"	2661	2661	0	0	0	0	0	0	0	0	0	0	0	0	0	0	0	0
"CTBP1"	2493	37682	8624	2830	4654	3970	1514	1316	3008	1560	9552	4346	3128	2230	4207	2886	6962	3099
"CTBP2"	4760	40036	15723	11033	8671	7052	5960	5073	8755	13649	9806	19060	1502	1351	1323	444	2249	386
"CTBS"	3381	21311	732	59	447	285	41	18	279	25	61	32	454	567	696	826	549	340
"CTCF"	3798	76625	2523	569	1377	1146	294	275	1247	390	1337	1184	1581	1163	1653	904	2076	1065
"CTCFL"	4046	27701	0	0	0	0	0	0	20	0	0	0	0	0	0	0	0	0
"CTDP1"	3763	74708	4461	1093	2468	1993	605	488	2239	1388	1458	2819	1126	648	1645	828	1905	956
"CTDSP1"	2644	6187	751	313	395	356	164	149	291	147	575	236	2316	1761	2341	1466	3328	1721
"CTDSP2"	5026	27037	1774	894	657	1117	498	396	530	667	1699	654	6955	654	6022	3965	784	476
"CTDSPL"	4462	122292	138	0	103	35	0	0	517	22	0	0	277	271	280	253	605	312
"CTDSPL2"	4885	99850	1686	429	991	695	204	225	1004	355	85	723	1317	1442	1154	844	1261	767
"CTF1"	1666	6954	1	0	0	1	0	0	0	0	0	0	0	0	0	0	0	0
"CTGF"	2346	3201	0	0	0	0	0	0	0	0	0	0	0	0	0	0	0	0
"CTH"	1816	28299	0	0	0	0	0	0	7	0	0	0	7	14	3	4	0	4
"CTHRC1"	1222	11431	14	0	0	14	0	0	108	0	56	20	0	0	0	0	0	0
"CTL4/NEU1 fusion"	2084	3882	179	162	94	85	109	53	142	131	0	77	1539	1822	3424	848	1348	2285
"CTLA4"	1981	6176	0	0	0	0	0	0	0	0	0	0	0	3	180	3	50	11
"CTMP"	2445	36055	12	0	12	0	0	0	12	9	0	0	44	58	45	33	44	34
"CTNNA1"	3778	181617	12710	11989	7293	5417	6447	5542	5805	8222	3987	11000	7899	8048	12179	10942	15464	10601
"CTNNA2"	4371	1463549	0	0	0	0	0	0	21	0	0	0	2	0	0	0	0	0
"CTNNA3"	3266	1776226	0	0	0	0	0	0	26	0	0	0	0	0	0	0	0	0
"CTNNAL1"	2501	70915	17647	3030	9812	7835	1657	1373	8359	1239	9277	1588	11978	9588	13775	9772	15402	9316
"CTNNB1"	3735	40999	10385	11758	5713	4672	6311	5447	3978	4727	4438	8377	6265	8635	7104	7889	8095	5030
"CTNNBIP1"	3001	61984	2338	152	1246	1092	81	71	1383	309	1128	417	960	737	583	469	1041	578
"CTNNBL1"	2994	122268	5088	706	3119	1969	382	324	3200	995	600	926	931	1041	1342	1141	1903	1336
"CTNND1"	6370	57419	15876	14845	8787	7089	7999	6846	5623	8088	9105	17514	5751	6867	6630	6933	9275	6192
"CTNND2"	5458	932160	0	0	0	0	0	0	46	26	0	0	0	0	0	0	0	0
"CTNS"	4442	26636	4712	1318	2693	2019	692	626	2187	577	5829	957	8062	6338	9072	6758	12310	7998
"CTPS"	3214	33226	2588	437	1526	1062	256	181	1181	243	1184	399	739	970	1083	886	2065	1365
"CTPS2"	4340	124218	20	34	20	0	15	19	94	39	0	16	150	189	123	103	185	103
"CTR9"	4335	28482	180	39	96	84	21	18	166	59	83	16	2076	1567	2173	1305	2208	1238
"CTRB1"	878	5939	0	0	0	0	0	0	0	0	0	0	0	0	0	0	0	0
"CTRB2"	896	3079	0	0	0	0	0	0	28	15	0	0	0	0	0	0	0	0
"CTRC"	907	8217	0	0	0	0	0	0	38	28	0	0	0	0	0	0	0	0
"CTRL"	1175	2293	514	64	312	202	29	35	187	206	84	45	896	769	49	766	1159	769
"CTS9"	1348	169470	0	0	0	0	0	0	12	0	0	0	0	0	0	0	0	0
"CTSA"	2299	7867	345	18	191	154	7	11	192	126	298	25	4114	2730	7894	7065	6955	6082
"CTSB"	3954	25612	25487	27438	13991	11496	14746	12692	9071	22028	23145	43394	103659	101569	178029	201306	166789	142815
"CTSC"	6138	16961	44893	12813	25071	19822	6992	5821	21595	1720	21530	5310	70644	28110	57335	36807	41830	24513
"CTSD"	2129	11239	1172	232	567	605	111	121	423	144	1097	132	3786	8093	57000	22131	15293	11244
"CTSE"	2236	14646	0	0	0	0	0	0	0	0	0	0	0	0	0	0	0	0
"CTSF"	2026	5113	0	0	0	0	0	0	0	0	0	0	20	33	101	67	59	56
"CTSG"	928	2743	0	0	0	0	0	0	0	0	0	0	0	2	0	3	3	0
"CTSH"	2171	23330	1345	990	699	646	534	456	1448	1555	1109	1822	7558	8391	5021	4103	5747	6581
"CTSK"	1710	12127	168	9	98	70	4	5	102	21	13	34	1158	87	123	89	123	60
"CTSL"	1143	5410	4	13	1	3	6	7	18	9	0	4	767	405	3030	3615	2959	2090
"CTSL1"	1720	5410	4	13	1	3	6	7	18	9	0	4	767	405	3030	3615	2959	2090
"CTSL2"	1833	27229	0	0	0	0	0	0	0	0	0	0	11	9	11	9	57	26
"CTSL3"	662	13971	11	8	2	9	0	8	0	18	0	5	0	0	1	0	1	0
"CTSO"	2935	29774	255	0	125	130	0	0	145	7	11	0	1459	1426	1049	1001	1599	1153
"CTSS"	4105	35753	5524	4128	3152	2372	2353	1775	2613	2038	2582	3480	10903	28581	29206	23705	23554	21292
"CTSU"	1464	2937	0	0	0	0	0	0	0	0	0	0	4	0	11	4	33	23
"CTSW"	1326	3868	116	0	61	55	0	0	81	50	6	0	316	274	176	158	46	32
"CTSZ"	1506	12069	11784	8390	6446	5338	4383	4007	3268	5271	11791	15282	41094	44092	71420	68011	74376	70242
"CTTN"	3298	38079	13	0	0	13	0	0	183	63	0	0	173	216	206	96	212	109
"CTTNBP2"	5990	162855	24138	8653	13472	10666	4813	3840	10830	3174	3017	3173	3035	3900	2596	1733	3796	1341
"CTTNBP2NL"	5905	64987	4372	798	2479	1893	448	350	2098	571	1545	823	2055	1943	1687	1073	2641	1294
"CTU1"	2109	10785	2	0	2	0	0	0	81	46	0	0	71	12	100	66	109	57
"CTU2"	1949	8895	1039	26	977	62	26	0	1000	189	0	56	2707	2951	1678	1844	1580	120
"CTXN1"	1264	1671	0	0	0	0	0	0	0	0	0	0	15	0	0	0	0	0
"CTXN2"	2697	12086	0	0	0	0	0	0	0	0	0	0	0	0	0	0	0	0
"CTXN3"	1685	9610	0	0	0	0	0	0	0	0	0	0	0	0	0	0	0	0
"CUBN"	11999	305852	0	1	0	0	0	1	6	0	21	0	50	47	58	51	59	47
"CUEDC1"	2204	40415	5830	640	3152	2678	323	317	3256	902	4905	568	779	739	1068	865	1200	849
"CUEDC2"	1205	9423	79	14	42	37	10	4	162	14	34	0	262	393	459	432	282	472
"CUGBP1"	3670	82807	25901	16496	16158	9743	9918	6578	11187	9923	21733	22302	6008	1289	1036	1129	10115	772
"CUGBP2"	9251	331413	42950	25200	23933	19017	13701	11499	17478	12247	24039	17939	4332	5149	4333	3334	5398	3446
"CUL1"	3406	103197	7471	9547	4184	3287	5174	4373	3856	5692	2442	9310	1691	2144	2375	2143	2834	1848
"CUL2"	2996	64362	797	275	509	288	176	99	700	221	90	163	966	1202	829	848	1156	1001
"CUL3"	6800	115243	10066	6810	5542	4524	3737	3073	4490	3935	3102	5373	1344	1688	2171	1698	2273	1659
"CUL4A"	3807	55462	4632	8298	2615	2017	4475	3823	2006	6648	1352	10060	1720	3429	2350	3531	2573	2194
"CUL4B"	5369	51238	228	20	117	111	12	8	65	20	0	6	1163	670	1311	972	1416	946
"CUL5"	6402	99078	5388	2010	2963	2425	1073	937	2191	957	1279	1709	1936	2399	1704	1447	2054	1180
"CUL7"	5496	16300	244	16	162	82	3	13	367	113	45	31	707	597	523	440	761	513
"CUL9"	8189	42404	870	219	445	425	156	63	916	332	210	212	535	622	1015	944	1095	864
"CUTA"	1204	1748	20	0	2	18	0	0	34	81	0	0	450	624	832	289	532	615
"CUTC"	1376	23937	259	7	159	100	3	4	192	11	141	0	370	251	402	160	501	272
"CUX1"	5595	434033	25906	28428	14304	11602	15352	13076	10999	17055	14487	34845	3312	3833	3643	3443	4494	2929
"CUX2"	6863	316529	0	7	0	0	0	7	484	228	0	0	0	0	3	0	0	0
"CUZD1"	2905	18637	94	0	55	39	0	0	231	12	0	0	73	24	56	13	152	15
"CWC15"	1579	10989	192	32	98	94	32	0	117	44	14	37	829	941	900	645	982	691
"CWC22"	3299	62178	455	181	216	239	95	86	395	278	0	221	800	863	949	494	626	430
"CWF19L1"	2647	35384	792	575	508	284	309	266	458	156	340	450	1016	1061	692	599	643	549
"CWF19L2"	3295	131500	497	162	270	227	78	84	547	118	44	62	423	377	383	387	434	295
"CWH43"	2484	75830	0	0	0	0	0	0	0	0	0	0	0	0	0	0	0	0
"CX3CL1"	3274	12542	0	1	0	0	1	0	45	13	0	0	0	0	0	7	0	4
"CX3CR1"	3109	16543	10	0	10	0	0	0	0	0	0	11	182	247	22	77	163	132
"CXADR"	2477	53936	0	95	0	0	55	40	0	32	0	58	0	0	0	0	0	0
"CXADRP3"	1611	20751	0	0	0	0	0	0	22	0	0	0	0	0	0	0	0	0
"CXCL1"	1107	1846	14	91	14	0	39	52	0	85	0	0	0	5636	0	3881	0	1308
"CXCL10"	1177	2379	23	817	23	0	436	381	0	415	0	111	0	16365	13	5532	7	2217
"CXCL11"	1486	2393	0	0	0	0	0	0	0	36	0	0	0	1689	6	111	0	51
"CXCL12"	3544	14937	0	0	0	0	0	0	42	0	0	0	0	0	0	0	0	0
"CXCL13"	1206	100081	1496	760	923	573	405	355	1222	729	1840	3255	12	27	0	0	10	611
"CXCL14"	1975	8598	0	0	0	0	0	0	11	0	0	0	0	0	0	0	0	0
"CXCL16"	2328	6395	195	205	77	118	119	86	34	194	35	176	1635	2071	3212	4799	3946	3228
"CXCL17"	856	14442	0	0	0	0	0	0	0	0	0	0	0	0	0	0	0	0
"CXCL2"	1197	2235	32	409	20	12	219	190	0	43	0	130	0	3196	0	4345	5	2665
"CXCL3"	1155	2178	10	113	10	0	77	36	0	86	0	0	0	3731	0	6793	0	2539
"CXCL5"	2461	3058	0	0	0	0	0	0	0	0	0	0	0	0	0	0	0	0
"CXCL6"	1662	2205	0	0	0	0	0	0	0	0	0	0	0	0	0	0	0	0
"CXCL9"	2549	6020	0	63	0	0	26	37	0	96	0	0	0	329	3	341	11	206
"CXCR3"	1869	2602	0	0	0	0	0	0	34	0	0	0	24	27	0	0	13	24
"CXCR4"	1895	1895	69	38	39	30	0	38	12	40	0	0	628	1018	1072	1160	918	579
"CXCR5"	2871	2871	0	0	0	0	0	0	48	17	0	0	9	13	0	495	121	86
"CXCR6"	2029	3306	0	0	0	0	0	0	0	0	0	0	0	0	0	0	0	0
"CXCR7"	2117	21570	0	0	0	0	0	0	41	0	0	0	0	0	0	0	0	0
"CXXC1"	2979	5979	389	114	231	158	58	56	28	77	105	61	1127	923	1387	928	1674	1002
"CXXC4"	748	19124	0	0	0	0	0	0	0	0	0	0	0	0	0	0	0	0
"CXXC5"	1450	34381	5095	1050	2811	2284	564	486	2107	1400	5097	3407	2293	1086	2631	1294	2756	1393
"CXorf1"	2442	2442	0	0	0	0	0	0	0	0	0	0	0	0	0	0	0	0
"CXorf15"	2055	55738	183	16	121	62	5	11	221	39	0	19	400	382	426	237	456	144
"CXorf21"	1811	18975	1268	217	735	533	142	75	619	65	126	23	62	77	770	203	897	463
"CXorf22"	3621	70412	0	0	0	0	0	0	0	0	0	0	0	0	0	0	0	0
"CXorf23"	3409	50650	277	191	121	156	104	87	304	72	17	131	281	249	220	191	229	128
"CXorf26"	1201	5264	145	145	86	59	99	46	61	102	0	0	817	575	962	809	1032	738
"CXorf27"	501	501	0	0	0	0	0	0	0	0	0	0	0	0	0	0	0	0
"CXorf30"	2880	149384	0	0	0	0	0	0	0	0	0	0	0	0	0	0	0	0
"CXorf36"	4661	52530	0	0	0	0	0	0	15	0	0	0	0	0	0	0	0	0
"CXorf38"	2788	18523	896	236	399	497	145	91	257	187	145	138	213	930	436	488	810	446
"CXorf39"	3005	24826	866	0	442	424	0	0	468	65	153	56	2026	1975	2161	1293	2238	645
"CXorf40A"	2089	9514	23	13	0	23	7	6	17	0	0	0	287	200	631	329	664	367
"CXorf40B"	1540	5481	66	111	23	43	76	35	86	64	100	76	449	311	702	544	806	492
"CXorf41"	1658	37612	0	0	0	0	0	0	0	0	0	0	0	0	0	0	0	0
"CXorf42"	2421	8813	13	0	0	13	0	0	58	0	0	0	5	10	0	3	5	0
"CXorf48"	2166	15292	0	0	0	0	0	0	0	0	0	0	0	0	0	0	0	0
"CXorf49"	1856	3912	0	0	0	0	0	0	0	0	0	0	0	0	0	0	0	0
"CXorf50"	2022	2022	0	0	0	0	0	0	0	0	0	0	0	0	0	0	0	0
"CXorf51"	436	625	0	0	0	0	0	0	0	0	0	0	0	0	0	0	0	0
"CXorf56"	990	25837	14	0	0	14	0	0	26	10	0	0	122	188	198	171	210	141
"CXorf57"	3915	67512	0	0	0	0	0	0	0	0	0	0	0	0	0	0	0	0
"CXorf58"	1556	31503	0	0	0	0	0	0	0	0	0	0	0	0	0	0	0	0
"CXorf59"	1967	98136	0	0	0	0	0	0	0	0	0	0	0	0	0	0	0	0
"CXorf61"	520	1287	0	0	0	0	0	0	0	0	0	0	0	0	0	0	0	0
"CXorf62"	2178	30369	0	0	0	0	0	0	99	0	0	0	0	0	0	0	0	0
"CXorf64"	1227	2021	0	0	0	0	0	0	0	0	0	0	0	0	0	0	0	0
"CXorf65"	570	2583	0	0	0	0	0	0	11	22	0	52	1	26	1	21	6	5
"CXorf66"	1281	9794	0	0	0	0	0	0	0	0	0	0	0	0	0	0	0	0
"CXorf67"	1922	1922	0	0	0	0	0	0	0	0	0	0	0	0	0	0	0	0
"CYB561"	3260	5646	33	1	18	15	1	0	71	55	0	0	296	16	440	282	455	257
"CYB561D1"	5117	6363	536	0	305	231	0	0	216	42	335	68	1492	992	1592	662	1896	764
"CYB561D2"	1567	3207	142	75	102	40	46	29	78	128	101	119	648	765	1034	947	1480	813
"CYB5A"	837	38695	12	192	0	12	138	54	41	509	0	658	93	310	279	505	215	202
"CYB5B"	4291	41671	839	700	492	347	402	298	497	355	3	132	1890	2077	1452	1160	2046	1356
"CYB5D1"	3748	4536	1792	34413	777	1015	18114	16299	51	16763	0	42580	179	4344	162	2608	261	5632
"CYB5D2"	2000	14529	73	0	37	36	0	0	116	35	0	0	347	305	280	189	354	264
"CYB5R1"	1652	5405	324	116	232	92	48	68	173	33	358	21	1315	715	1524	979	1572	821
"CYB5R2"	1356	8496	310	387	176	134	189	198	119	448	0	332	26	84	0	8	0	0
"CYB5R3"	2208	28183	582	217	270	312	145	72	275	567	0	636	2360	828	1180	3307	3619	2901
"CYB5R4"	2261	100776	4368	500	2502	1866	306	194	2878	197	661	249	1529	1870	1715	1642	1817	1447
"CYB5RL"	3539	27719	0	0	0	0	0	0	82	38	0	0	68	65	39	38	90	32
"CYBA"	1439	5964	2776	246	2598	178	122	124	1427	2446	4779	7610	5190	6895	7929	11169	9471	9895
"CYBASC3"	3217	13535	371	550	172	199	274	276	161	357	193	1129	1440	1726	1790	2085	2538	1858
"CYBB"	4331	33446	783	5099	478	305	2650	2449	368	2406	0	5086	3162	7511	5452	11425	2910	4105
"CYBRD1"	4362	35780	18	0	0	18	0	0	175	0	0	0	1065	1135	1215	1184	1623	1033
"CYC1"	1837	2487	570	374	318	252	202	172	138	175	259	245	2484	2392	2217	2876	2240	1881
"CYCS"	5509	6680	511	1005	298	213	555	450	245	467	213	879	4508	6992	4236	5056	4358	4443
"CYCSP52"	309	309	100	8692	100	0	5014	3678	53	5634	0	4899	16	0	0	385	0	195
"CYFIP1"	4579	110920	9442	9626	5341	4101	5186	4440	4195	6451	6432	14261	6902	7424	13780	12466	10639	8596
"CYFIP2"	6818	129419	358	124	235	123	61	63	273	160	41	141	1011	1174	832	782	1218	764
"CYGB"	1955	10344	0	0	0	0	0	0	112	68	0	0	5	0	20	19	29	50
"CYHR1"	1736	15166	2003	411	1068	935	161	250	843	403	2431	1001	1008	899	2305	1165	2997	1355
"CYLC1"	2016	25458	0	0	0	0	0	0	0	0	0	0	0	0	0	0	0	0
"CYLC2"	2179	23179	0	0	0	0	0	0	0	0	0	0	0	0	0	0	0	0
"CYLD"	8723	59887	4242	14168	2377	1865	7581	6587	1488	5489	392	6812	3202	7175	3119	4662	3278	3133
"CYMP"	1250	10505	0	0	0	0	0	0	13	0	0	0	0	0	0	0	0	0
"CYP 2C"	1642	30602	0	0	0	0	0	0	0	0	0	0	0	0	0	0	0	0
"CYP1"	1142	1309	7	14	4	3	14	0	58	124	0	53	12	37	37	37	42	53
"CYP11A1"	2013	28452	0	0	0	0	0	0	21	32	0	0	0	0	3	0	0	0
"CYP11B1"	3758	7464	0	0	0	0	0	0	53	16	0	0	0	0	0	0	0	0
"CYP11B2"	2945	7286	0	0	0	0	0	0	30	30	0	0	0	0	0	0	0	0
"CYP17A1"	1876	7002	0	0	0	0	0	0	15	0	0	0	0	0	0	0	0	0
"CYP19A1"	4524	130542	0	0	0	0	0	0	11	10	0	0	11	13	7	5	0	4
"CYP1A1"	2774	5995	0	0	0	0	0	0	0	0	0	0	0	0	0	0	0	0
"CYP1A2"	3134	7759	0	0	0	0	0	0	9	0	0	0	0	0	0	0	0	0
"CYP1B1"	5156	8579	3852	3754	2035	1817	2051	1703	3	1305	1445	2277	29510	36735	21940	24745	21790	14339
"CYP20A1"	10979	67400	675	613	347	328	356	257	508	205	271	489	1054	1209	496	420	465	346
"CYP21A2"	2124	3339	0	0	0	0	0	0	17	0	0	0	0	0	0	0	0	0
"CYP24A1"	3278	20530	0	0	0	0	0	0	0	0	0	0	0	0	0	0	0	0
"CYP26A1"	2252	4411	0	0	0	0	0	0	0	0	0	0	0	0	0	0	0	0
"CYP26B1"	4534	18598	0	0	0	0	0	0	82	8	0	0	0	0	0	0	0	0
"CYP26C1"	2918	7434	0	0	0	0	0	0	0	0	0	0	0	0	0	0	0	0
"CYP27A1"	2301	33545	715	63	452	263	34	29	455	130	613	758	1542	1121	2078	2491	1134	1929
"CYP27B1"	2580	4861	66	157	28	38	108	49	74	136	0	53	66	131	98	112	160	116
"CYP27C1"	4693	21933	0	0	0	0	0	0	46	8	0	0	0	0	0	0	0	0
"CYP2A13"	1755	7732	0	0	0	0	0	0	57	0	0	0	0	0	0	0	0	0
"CYP2A6"	1772	6910	0	0	0	0	0	0	31	21	0	0	0	0	0	0	0	0
"CYP2A7"	2289	7314	0	0	0	0	0	0	0	0	0	0	0	0	0	0	0	0
"CYP2B"	1045	15254	0	0	0	0	0	0	0	0	0	0	0	0	0	0	0	0
"CYP2B6"	3061	27099	0	0	0	0	0	0	0	0	0	0	0	0	0	0	0	0
"CYP2B7"	2917	26395	0	0	0	0	0	0	0	0	0	0	0	0	0	0	0	0
"CYP2C18"	2552	52696	0	0	0	0	0	0	0	0	0	0	0	0	0	0	0	0
"CYP2C19"	2278	164790	0	0	0	0	0	0	0	0	0	0	0	0	0	0	0	0
"CYP2C8"	2140	32726	0	0	0	0	0	0	0	0	0	0	0	0	0	0	0	0
"CYP2C9"	1869	50734	0	0	0	0	0	0	0	0	0	0	0	0	0	0	0	0
"CYP2D6"	1687	4361	73	26	54	19	13	13	112	110	92	49	0	0	26	30	159	44
"CYP2D7P1"	1744	4361	0	0	0	0	0	0	36	7	0	0	0	0	22	18	87	34
"CYP2E1"	7924	29646	0	0	0	0	0	0	0	12	0	0	0	0	0	0	0	0
"CYP2F1"	2072	11371	7738	2294	4414	3324	1253	1041	5262	2926	4890	4960	16858	13982	18019	14750	21497	14928
"CYP2J2"	1865	33444	0	0	0	0	0	0	0	0	0	0	0	0	0	0	0	0
"CYP2R1"	2194	7200	1174	186	622	552	105	81	584	91	314	175	793	516	518	171	841	235
"CYP2S1"	2629	14330	302	58	195	107	26	32	240	50	161	176	1846	1419	1329	863	2396	1258
"CYP2U1"	4955	21896	3	0	0	3	0	0	0	0	0	0	32	11	12	3	0	8
"CYP2W1"	2528	6443	0	0	0	0	0	0	76	20	0	0	2	0	0	0	0	0
"CYP39A1"	2284	103080	0	0	0	0	0	0	9	0	0	0	0	0	0	0	0	0
"CYP3A4"	2781	27206	0	0	0	0	0	0	0	0	0	0	0	0	0	0	0	0
"CYP3A43"	2299	38539	0	0	0	0	0	0	0	0	0	0	0	0	0	0	0	0
"CYP3A5"	2220	31790	809	104	496	313	76	28	629	81	63	86	163	133	99	42	106	68
"CYP3A7"	2092	30162	0	0	0	0	0	0	0	0	0	0	11	0	0	0	0	0
"CYP46A1"	6503	29021	0	0	0	0	0	0	36	48	0	0	0	0	0	0	0	0
"CYP4A11"	2678	9977	0	0	0	0	0	0	0	0	0	0	0	0	0	0	0	0
"CYP4A22"	2752	10046	0	0	0	0	0	0	0	0	0	0	0	0	0	0	0	0
"CYP4B1"	2169	20352	0	0	0	0	0	0	0	0	0	0	0	0	0	0	0	0
"CYP4F11"	3407	22498	0	0	0	0	0	0	13	0	0	0	0	0	7	0	0	0
"CYP4F12"	1738	24100	0	0	0	0	0	0	0	0	0	0	0	0	3	0	0	0
"CYP4F2"	2373	20052	0	0	0	0	0	0	15	0	0	0	0	0	0	0	3	0
"CYP4F22"	2622	43793	0	0	0	0	0	0	71	21	0	0	0	0	0	0	0	0
"CYP4F3"	3000	19864	0	0	0	0	0	0	28	0	0	0	0	0	0	0	0	0
"CYP4F8"	2027	4545	0	0	0	0	0	0	29	0	0	0	0	0	0	0	0	0
"CYP4V2"	4714	21944	900	58	494	406	30	28	487	44	200	120	573	566	753	664	1092	729
"CYP4X1"	2368	27184	0	0	0	0	0	0	0	8	0	0	0	0	0	0	0	0
"CYP4Z1"	1919	50834	0	0	0	0	0	0	0	0	0	0	0	0	10	4	0	0
"CYP4Z2P"	2618	42243	0	0	0	0	0	0	11	0	0	0	0	0	4	0	0	0
"CYP51A1"	3551	67383	704	1397	502	202	794	603	261	596	0	612	3510	5165	2141	2063	3175	2000
"CYP7A1"	2880	9984	0	0	0	0	0	0	0	0	0	0	0	0	0	0	0	0
"CYP7B1"	2401	202821	683	29905	380	303	16233	13672	0	27783	0	38199	4	118	0	0	0	0
"CYP8B1"	3950	3950	0	0	0	0	0	0	0	0	0	0	0	0	0	0	0	0
"CYR61"	2296	3204	0	0	0	0	0	0	0	0	0	0	0	0	0	0	0	0
"CYS1"	2722	23614	0	0	0	0	0	0	28	31	0	0	0	0	0	0	0	0
"CYSLTR1"	1600	54958	12	0	12	0	0	0	88	0	0	0	9	15	68	22	41	48
"CYSLTR2"	3234	55635	0	0	0	0	0	0	87	8	25	0	181	77	115	31	68	34
"CYTH1"	3320	108247	30055	44538	16716	13339	24132	20406	10629	15555	20468	49811	5986	3060	6882	9707	9429	8282
"CYTH2"	4615	13107	762	432	420	342	254	178	456	305	367	614	1043	1390	874	1152	1488	1231
"CYTH3"	4478	110830	100	14	26	74	0	14	119	48	18	0	274	230	260	265	323	246
"CYTH4"	3169	32895	24502	23111	13447	11055	12151	10960	4924	18409	15680	9075	8807	11732	8034	5060	11206	5834
"CYTIP"	2314	74344	5958	2077	3352	2606	1090	987	2359	561	1553	797	724	830	683	584	928	565
"CYTL1"	1002	4883	0	0	0	0	0	0	0	0	0	0	56	37	76	62	76	58
"CYTOR4"	2739	42077	9604	1564	7722	1882	783	781	3732	442	7070	937	1992	1474	1030	833	1509	750
"CYTSA"	6794	146923	7907	2357	4442	3465	1289	1068	4043	1704	2014	1787	1857	1996	1896	1689	2285	1510
"CYTSB"	4054	305453	11616	3194	6567	5049	1879	1315	7039	2408	4790	3187	2257	2104	1678	1545	1898	1442
"CYYR1"	3082	107054	0	0	0	0	0	0	0	0	0	0	0	2	0	0	13	0
"CYorf15A"	2106	23074	76	93	76	0	59	34	129	75	0	0	466	634	386	291	0	0
"CYorf15B"	6475	12414	288	128	187	101	74	54	116	20	0	0	833	1001	873	329	0	0
"CYorf16"	942	25884	0	0	0	0	0	0	0	0	0	0	0	0	0	0	0	0
"CaSm"	786	13310	104	18	34	70	18	0	116	27	0	82	101	121	228	203	319	525
"Cap43"	2947	60135	2244	887	1197	1047	473	414	1533	921	845	1033	3828	4445	3697	3871	5198	3462
"CatE"	1935	14646	0	0	0	0	0	0	0	0	0	0	0	0	0	0	0	0
"Cezanne 2"	3440	314792	0	0	0	0	0	0	23	0	0	51	0	0	3	0	9	3
"ChGn"	3960	278590	0	0	0	0	0	0	0	0	0	0	13	19	0	0	10	0
"Chk2"	1743	46986	512	52	273	239	28	24	386	26	284	176	517	437	421	380	564	459
"Ciz1"	2891	25525	585	187	268	317	101	86	477	248	200	81	1694	1521	1960	1717	2640	1550
"ClC-2"	1600	10544	132	12	92	40	10	2	212	69	0	68	36	25	52	23	74	36
"ClpX"	2318	34780	674	28	405	269	28	0	481	28	97	42	506	683	1126	510	1286	585
"Cort"	1404	22051	0	0	0	0	0	0	46	13	0	27	46	43	20	33	64	23
"D1"	1174	221960	22	7	22	0	7	0	131	20	0	0	39	48	44	44	58	29
"D2-2"	3288	3288	33	0	19	14	0	0	55	13	0	0	0	352	161	219	162	240
"D28359"	2421	2421	38	0	20	18	0	0	0	0	0	0	16	19	48	0	83	0
"D28376"	125	125	0	19604	0	0	10527	9077	410	6736	0	12643	0	6091	224	616	0	236
"D29"	1339	90229	2206	2707	1252	954	1470	1237	926	1009	153	1251	462	666	476	333	462	359
"D2HGDH"	2596	34203	2976	1119	1620	1356	616	503	1203	511	2148	1056	588	694	789	610	1247	542
"D43770"	1803	8867	0	0	0	0	0	0	0	0	0	0	0	0	0	0	0	0
"D4S234E"	3528	33202	81	13	33	48	13	0	230	64	0	0	240	283	0	0	0	0
"D56494"	1684	2901	0	0	0	0	0	0	0	0	0	0	0	0	0	0	0	0
"D56495"	1689	2901	0	0	0	0	0	0	0	0	0	0	0	0	0	0	0	0
"D63785"	187	607	0	0	0	0	0	0	0	0	0	0	0	96	0	37	75	116
"DAAM1"	4282	181074	2538	228	1596	942	110	118	2040	387	342	194	866	1042	573	546	745	458
"DAAM2"	6239	111849	0	0	0	0	0	0	41	40	0	0	0	0	0	0	0	3
"DAB1"	2722	1548869	49	0	30	19	0	0	213	24	48	0	162	284	207	232	194	155
"DAB2"	4612	53557	7448	506	4214	3234	277	229	4338	164	2414	153	5759	3944	6200	4939	8317	4483
"DAB2IP"	5468	218410	0	0	0	0	0	0	760	280	0	0	0	0	0	0	0	0
"DACH1"	5245	429234	0	0	0	0	0	0	21	0	0	0	0	0	1480	0	1517	1292
"DACH2"	4892	117255	0	0	0	0	0	0	0	0	0	0	0	0	0	0	0	0
"DACT1"	3863	10281	0	0	0	0	0	0	0	0	0	0	83	0	645	255	118	81
"DACT2"	2944	12818	0	0	0	0	0	0	46	0	0	0	0	0	0	0	0	0
"DACT3"	3084	10988	0	0	0	0	0	0	14	31	0	0	0	16	0	4	0	0
"DAD1"	700	24338	77	0	45	32	0	0	169	17	33	37	867	863	994	375	1640	1096
"DAD1L"	632	632	0	0	0	0	0	0	0	0	0	0	0	0	0	0	0	0
"DAF"	2719	39494	33	403	33	0	225	178	93	225	0	288	479	666	727	978	611	723
"DAG1"	5523	65483	580	36	326	254	36	0	463	95	265	30	1178	803	1333	714	1867	888
"DAGK1"	1799	8407	363	31	198	165	25	6	305	111	102	28	298	283	286	214	405	216
"DAGLA"	5771	66564	13836	16284	7451	6385	8617	7667	3804	12046	10349	19597	2093	2023	2643	2187	3926	1805
"DAGLB"	2924	38897	3374	1206	1819	1555	659	547	1459	1798	2797	2050	2624	2423	2979	2567	3735	2321
"DAK"	4258	15578	164	4	113	51	2	2	230	104	0	49	402	437	569	452	777	565
"DALRD3"	2493	6034	1206	450	237	969	245	205	908	507	566	620	179	180	1126	1016	2868	1899
"DAMS"	1809	5376	25	0	25	0	0	0	24	0	0	0	6	9	5	4	11	4
"DAND5"	1964	9596	0	0	0	0	0	0	93	24	0	0	1	0	0	0	0	0
"DAO"	2124	21372	0	0	0	0	0	0	20	0	1	0	0	0	0	0	0	0
"DAOA"	1014	25168	0	0	0	0	0	0	0	0	0	0	0	0	0	0	0	0
"DAP"	2345	82046	10455	8595	5753	4702	4754	3841	5807	4846	4644	2548	283	3895	5478	4896	6595	4785
"DAP3"	1687	49445	1782	1184	1001	781	648	536	739	867	955	1861	1608	1694	1621	1669	1890	1445
"DAPK1"	5963	210794	145377	223454	80805	64572	119701	103753	45686	128328	98973	252281	10364	12456	12617	12521	15162	10032
"DAPK2"	3648	132034	0	0	0	0	0	0	60	7	0	0	0	0	6	0	0	0
"DAPK3"	2235	12588	100	28	55	45	28	0	88	147	16	151	486	341	606	468	789	285
"DAPL1"	545	20667	0	0	0	0	0	0	0	0	0	0	0	0	0	0	0	0
"DAPP1"	3007	53365	3213	16487	1771	1442	8841	7646	641	7179	7	7380	662	4150	660	1940	998	1547
"DARC"	1301	1780	0	0	0	0	0	0	16	0	0	0	0	0	0	0	0	0
"DARS"	2338	78970	1196	3401	701	495	1876	1525	696	1954	284	2216	1119	1634	1754	1659	1378	1327
"DARS2"	3204	33726	187	39	98	89	27	12	142	41	0	18	989	1139	1099	913	849	656
"DAXX"	2624	4463	282	478	195	87	269	209	105	6	12	537	1644	3045	1447	2830	1899	2084
"DAZ1"	4447	69739	0	0	0	0	0	0	0	0	0	0	0	0	0	0	0	0
"DAZ2"	3998	71876	0	0	0	0	0	0	0	0	0	0	0	0	0	0	0	0
"DAZ3"	3487	71876	0	0	0	0	0	0	0	0	0	0	0	0	0	0	0	0
"DAZ4"	3947	69739	0	0	0	0	0	0	0	0	0	0	0	0	0	0	0	0
"DAZAP1"	2284	28098	8188	4584	4346	3842	2408	2176	2985	2406	8018	6839	2656	2471	4639	3722	5087	2504
"DAZAP2"	2168	5209	615	598	371	244	339	259	292	261	208	398	10934	12259	11035	10501	13181	9467
"DAZL"	3111	17996	0	0	0	0	0	0	0	0	0	0	0	0	0	0	0	0
"DBC1"	3204	202833	0	0	0	0	0	0	0	0	0	0	0	0	0	0	0	0
"DBCCR1L"	2551	378147	0	0	0	0	0	0	0	0	0	0	0	0	0	0	0	0
"DBF4"	3919	33314	206	94	104	102	48	46	261	41	0	50	340	326	461	326	468	317
"DBF4B"	3099	41632	32	4	12	20	4	0	166	26	0	12	96	80	75	15	154	60
"DBH"	2773	22984	0	0	0	0	0	0	195	83	0	0	0	0	0	0	0	0
"DBI"	757	5516	253	630	132	121	341	289	120	423	31	707	963	3486	3017	2601	5574	5588
"DBN1"	3073	16259	0	0	0	0	0	0	99	47	0	0	26	6	67	60	90	87
"DBNDD1"	2133	14660	0	0	0	0	0	0	33	22	0	1	2	3	0	0	0	0
"DBNDD2"	1453	47546	761	1478	370	391	803	675	491	636	120	998	2405	2713	2396	2541	2881	2116
"DBNL"	2229	17076	11843	7781	6405	5438	4077	3704	1069	3054	9477	7450	6440	6886	6654	6317	8741	6048
"DBP"	5827	6691	344	0	189	155	0	0	179	17	70	0	349	81	248	89	887	133
"DBR1"	2657	13922	52	0	11	41	0	0	68	0	37	0	527	344	491	157	619	255
"DBT"	11013	62932	127	0	108	19	0	0	189	0	0	0	820	692	643	231	685	262
"DBX1"	1153	4112	0	0	0	0	0	0	0	0	0	0	0	0	0	0	0	0
"DBX2"	2726	36345	0	0	0	0	0	0	0	0	0	0	0	0	0	0	0	0
"DBY"	4067	15693	600	1384	315	285	772	612	153	934	0	0	2969	8079	4184	8667	4	0
"DC13"	770	30803	2274	1051	1344	930	562	489	1043	728	338	1098	508	619	240	389	466	416
"DCAF10"	7919	66875	2133	381	1262	871	188	193	969	325	209	187	1119	1153	909	615	890	541
"DCAF11"	4318	10466	530	199	303	227	120	79	369	144	440	71	2732	2613	2583	2238	3450	2319
"DCAF12"	3680	40392	0	0	0	0	0	0	23	10	0	0	94	127	744	421	747	482
"DCAF12L1"	3390	3476	0	0	0	0	0	0	0	0	0	0	0	0	0	0	0	0
"DCAF12L2"	1422	1422	0	0	0	0	0	0	0	0	0	0	0	0	0	0	0	0
"DCAF13"	2650	28738	251	73	168	83	59	14	190	24	0	52	517	535	593	594	641	544
"DCAF15"	2269	8937	443	79	236	207	41	38	257	95	164	168	459	536	674	597	1159	530
"DCAF16"	4549	10103	720	469	398	322	237	232	382	348	242	336	757	896	534	544	558	339
"DCAF17"	5742	50703	383	0	220	163	0	0	241	24	0	0	574	512	589	314	554	250
"DCAF4"	2926	20143	17	0	4	13	0	0	95	21	0	0	160	96	154	79	330	173
"DCAF4L1"	4773	4773	0	0	0	0	0	0	0	0	0	0	0	0	0	0	0	0
"DCAF4L2"	3325	3325	0	0	0	0	0	0	0	0	0	0	0	0	0	0	0	0
"DCAF5"	5993	102278	3647	228	2025	1622	132	96	2193	184	638	262	1589	1519	2033	1472	2543	1463
"DCAF6"	3526	139173	4065	1457	2330	1735	787	670	2513	817	885	775	950	1055	1226	1133	1604	1176
"DCAF7"	6359	43819	4009	997	2283	1726	547	450	1821	567	1280	991	7171	6648	8428	5873	8169	4806
"DCAF8"	4423	69438	5103	2930	2588	2515	1605	1325	2154	889	2578	2126	4922	5214	6259	5047	5409	4643
"DCAF8L1"	3458	3458	0	0	0	0	0	0	0	0	0	0	0	0	0	0	0	0
"DCAF8L2"	2013	2013	0	0	0	0	0	0	0	0	0	0	0	0	0	0	0	0
"DCAKD"	2128	37769	821	47	417	404	19	28	717	169	240	306	281	268	259	240	362	233
"DCBLD1"	3642	67142	1207	99	711	496	55	44	494	37	48	67	1156	1096	1217	761	1567	919
"DCBLD2"	6150	105720	252	109	112	140	75	34	140	9	0	0	123	135	53	4	24	5
"DCC"	5719	1191213	0	0	0	0	0	0	10	0	0	0	0	0	0	0	0	0
"DCD"	586	3775	0	0	0	0	0	0	0	0	0	0	0	0	0	0	0	0
"DCDC1"	1714	107151	0	0	0	0	0	0	11	10	0	0	0	0	0	0	0	0
"DCDC2"	4717	186298	0	0	0	0	0	0	0	0	0	0	0	0	0	0	0	0
"DCDC2B"	1358	7104	251	10	117	134	0	10	300	66	256	108	21	29	76	28	105	31
"DCDC5"	3966	426574	0	0	0	0	0	0	11	10	0	0	0	0	0	0	0	0
"DCHS1"	10771	34518	3	0	2	1	0	0	57	26	0	0	4	6	0	3	3	0
"DCHS2"	8937	156924	0	0	0	0	0	0	10	0	0	0	0	0	0	0	0	0
"DCI"	1033	11706	194	5	129	65	0	5	266	92	204	81	350	429	551	486	857	489
"DCK"	2686	37349	1184	64	665	519	43	21	919	31	489	63	1657	1661	1600	1183	1968	1142
"DCLK1"	8097	362343	0	0	0	0	0	0	33	7	0	0	0	0	0	0	0	0
"DCLK2"	3705	178528	21	7	10	11	0	7	64	0	0	23	62	63	53	39	84	40
"DCLK3"	5349	27441	16	0	16	0	0	0	0	0	0	0	33	25	0	0	122	24
"DCLRE1A"	4477	19377	0	0	0	0	0	0	0	0	0	0	133	143	144	72	192	64
"DCLRE1B"	3653	8656	58	11	26	32	0	11	54	17	0	0	1149	633	816	441	1387	461
"DCLRE1C"	4167	47223	3146	663	1809	1337	368	295	1722	401	828	346	1416	908	1210	359	1382	481
"DCN"	2295	37772	0	0	0	0	0	0	0	0	0	0	0	0	0	0	0	0
"DCP1"	2398	8701	3844	1123	2058	1786	649	474	3783	279	2808	559	4623	3370	6421	4490	8618	3302
"DCP1A"	5994	64189	1859	2053	1025	834	1079	974	1022	1477	193	2195	1207	2257	1056	1826	1352	1324
"DCP1B"	2326	62922	95	4	57	38	0	4	186	0	0	2	225	134	247	98	280	136
"DCP2"	8957	44235	6781	3075	3743	3038	1697	1378	3135	1366	2502	3289	5267	5788	5846	4004	6567	3887
"DCPS"	1484	41998	190	3	123	67	2	1	291	169	0	75	351	170	141	238	346	149
"DCST1"	2296	17108	3	0	0	3	0	0	186	53	0	1	81	13	46	30	70	35
"DCST2"	2501	15254	401	0	358	43	0	0	216	78	0	0	10	12	3	0	5	3
"DCT"	2405	40095	0	0	0	0	0	0	0	0	0	0	0	0	0	0	0	0
"DCTD"	2047	27387	603	57	374	229	26	31	289	31	250	32	1559	331	543	1560	2038	1421
"DCTN1"	4524	19195	1127	211	622	505	98	113	654	247	234	226	3691	3185	2859	2284	4919	2644
"DCTN2"	1836	16886	1090	504	633	457	271	233	651	378	246	521	1701	1818	1642	1585	2202	1820
"DCTN3"	931	6950	53	0	25	28	0	0	152	25	30	0	588	366	651	555	645	382
"DCTN4"	4067	49774	2380	1911	1312	1068	1041	870	1169	1190	455	1777	337	343	576	461	544	254
"DCTN5"	3329	28377	596	235	366	230	140	95	371	356	118	173	2004	1771	1747	1509	2824	1777
"DCTN6"	1037	27248	76	75	54	22	52	23	134	32	60	57	325	405	405	368	461	415
"DCTPP1"	1121	6354	1	0	1	0	0	0	107	10	0	0	901	122	784	573	270	762
"DCUN1D1"	3159	37769	2357	1639	1366	991	955	684	922	1068	495	1587	1747	1853	449	400	435	262
"DCUN1D2"	3189	34891	4159	1081	2249	1910	618	463	1823	547	1821	720	791	571	1008	427	1023	493
"DCUN1D3"	2864	42160	7196	13894	4016	3180	6165	7729	1404	11249	730	29019	1036	6478	875	1111	864	3234
"DCUN1D4"	4937	73727	457	79	248	209	56	23	677	34	61	49	449	429	406	196	545	271
"DCUN1D5"	1256	30049	175	12	85	90	7	5	293	37	37	72	227	277	185	179	243	163
"DCX"	9427	117368	0	0	0	0	0	0	0	0	0	0	0	0	0	0	0	0
"DCXR"	836	1817	63	14	25	38	14	0	50	27	0	0	503	679	826	823	983	796
"DDA1"	4080	13769	116	156	42	74	118	38	86	118	0	308	563	523	718	726	996	748
"DDAH1"	4024	259879	158	1450	90	68	863	587	18	320	0	536	0	3	0	0	0	0
"DDAH2"	1691	2753	110	0	39	71	0	0	49	56	0	18	622	547	430	846	648	315
"DDB1"	4364	33748	1031	361	616	415	223	138	821	491	304	713	4264	4368	5300	4619	7320	4712
"DDB2"	2205	24125	3794	975	2081	1713	529	446	1533	315	3048	648	2330	2123	1568	2434	3040	801
"DDC"	2083	107020	0	0	0	0	0	0	11	12	0	0	0	0	0	0	0	0
"DDEF1IT1"	1180	1180	24	130890	9	15	130882	8	24762	3	0	8	0	0	0	0	0	0
"DDHD1"	13246	56925	823	708	389	434	389	319	775	300	73	164	707	873	716	751	607	466
"DDHD2"	4726	31279	176	16	91	85	0	16	132	9	0	61	572	586	754	609	793	512
"DDI1"	2616	2616	0	0	0	0	0	0	0	0	0	0	0	0	0	0	0	0
"DDI2"	1769	42680	1007	40	568	439	17	23	1051	5	185	25	851	904	1604	1029	1282	664
"DDIT3"	1179	3929	494	260	308	186	161	99	270	188	0	342	1433	1482	951	716	1583	812
"DDIT4"	1755	2122	0	0	0	0	0	0	65	37	0	0	48	159	10	245	96	274
"DDIT4L"	2593	4586	0	0	0	0	0	0	0	0	0	0	0	0	16	0	0	0
"DDN"	3746	4157	0	0	0	0	0	0	28	14	0	0	0	0	0	0	0	0
"DDO"	1713	23371	26	0	13	13	0	0	50	0	0	0	97	73	350	233	202	127
"DDOST"	2146	9779	1103	378	592	511	216	162	392	170	352	369	5407	4765	6208	5138	5652	3859
"DDP2"	747	1589	0	0	0	0	0	0	38	0	0	0	1115	65	1196	1098	1525	623
"DDR1"	3890	15618	3	0	3	0	0	0	103	7	0	0	10	27	3	0	0	9
"DDR1 variant protein"	890	5588	3	0	3	0	0	0	73	0	0	0	0	10	3	0	0	3
"DDR2"	3253	148011	0	0	0	0	0	0	10	8	0	8	0	0	0	0	0	0
"DDRGK1"	1523	10644	476	47	206	270	23	24	284	104	0	0	904	824	814	719	1093	775
"DDT"	1589	79531	5222	2485	2987	2235	1418	1067	2010	1021	2520	2540	1604	1482	2852	1932	1673	1623
"DDTL"	1637	5723	555	315	304	251	160	155	272	139	613	405	468	481	1115	908	1281	1111
"DDX1"	2731	39456	330	2	226	104	2	0	198	29	43	26	969	1162	1135	979	1126	781
"DDX10"	6757	257156	2593	861	1470	1123	507	354	1607	838	288	471	337	199	497	427	448	345
"DDX11"	4330	30948	342	94	194	148	64	30	305	94	17	6	445	412	344	264	495	245
"DDX11L family member"	1646	2527	0	0	0	0	0	0	0	0	0	0	0	0	645	0	127	102
"DDX11L1"	1655	2537	0	0	0	0	0	0	0	0	0	0	46	34	856	214	328	0
"DDX11L10"	1655	2537	0	0	0	0	0	0	0	0	0	0	0	0	0	0	0	0
"DDX11L11"	1169	1667	0	0	0	0	0	0	34	26	0	0	0	0	0	0	0	0
"DDX11L2"	1663	2549	8	0	0	8	0	0	11	8	37	0	22	24	416	180	860	0
"DDX11L5"	1658	2540	0	0	0	0	0	0	0	0	0	0	0	0	0	0	0	0
"DDX11L9"	1491	2537	0	0	0	0	0	0	0	0	0	0	46	34	856	214	328	0
"DDX12"	3915	30482	0	0	0	0	0	0	68	6	27	0	31	45	216	160	387	245
"DDX17"	7240	8677	13727	10567	7560	6167	5686	4881	5758	4505	7681	6780	1477	2242	9164	14468	22194	4696
"DDX18"	3779	17700	337	137	224	113	57	80	328	230	0	87	1412	1672	1896	1572	2126	1534
"DDX19A"	3036	26457	594	427	377	217	213	214	141	490	221	925	752	1105	1318	1115	1548	922
"DDX19B"	2971	74209	633	430	411	222	214	216	243	520	252	994	1120	1529	1838	1574	2119	1462
"DDX20"	4337	7181	50	0	27	23	0	0	51	4	0	0	792	524	691	347	897	388
"DDX21"	4300	28085	812	1782	432	380	920	862	314	1133	100	1543	2688	6180	3205	5727	3311	3397
"DDX23"	3283	22419	471	179	232	239	87	92	232	248	34	221	1947	2008	3060	2474	3533	2273
"DDX24"	2956	30291	1277	2797	693	584	1516	1281	690	1116	123	1628	3998	4739	4052	3863	5126	3620
"DDX25"	1832	18733	0	0	0	0	0	0	0	0	0	0	0	0	0	0	0	0
"DDX26B"	3864	61906	2023	1812	1197	826	1135	677	1244	1128	126	1815	735	1077	967	881	1163	752
"DDX27"	2714	24782	532	589	314	218	335	254	379	498	189	795	1316	1631	1475	1512	1838	1317
"DDX28"	2787	2787	86	0	53	33	0	0	60	18	0	0	660	200	726	216	836	318
"DDX31"	3305	76114	292	0	138	154	0	0	376	41	160	0	201	176	228	165	273	162
"DDX39"	1535	10315	8965	7602	4766	4199	4540	3062	2853	3519	5615	6279	6434	8488	8058	8669	9458	6828
"DDX3X"	5411	16873	4874	9385	2701	2173	5082	4303	1805	4575	2683	6961	11242	24991	14420	24613	20001	21496
"DDX3Y"	4666	16373	600	1384	315	285	772	612	153	934	0	0	2969	8079	4184	8667	4	0
"DDX4"	2901	79130	0	0	0	0	0	0	0	0	0	0	0	0	0	0	0	0
"DDX41"	2396	5390	223	68	102	121	45	23	226	112	62	0	1339	1195	1601	1192	1758	1358
"DDX42"	4047	13810	4342	2261	2469	1873	1271	990	1787	1120	1381	1372	4791	4788	5232	3771	7371	3732
"DDX43"	2706	22999	34	8	11	23	8	0	14	10	0	0	0	14	0	0	0	0
"DDX46"	5700	72350	1559	513	892	667	245	268	853	287	590	574	2254	2790	2840	2518	2982	1978
"DDX47"	2402	104060	303	729	179	124	399	330	139	496	74	612	771	1467	952	1388	1024	859
"DDX49"	1833	8944	79	15	34	45	0	15	308	154	0	0	518	494	432	402	780	644
"DDX5"	3772	8112	11394	13447	6353	5041	7217	6230	6039	532	6578	7535	3543	41300	12689	14242	39915	11662
"DDX50"	2552	45570	248	67	146	102	58	9	144	267	0	271	368	354	689	539	818	501
"DDX51"	4730	7740	94	8	76	18	8	0	69	118	24	31	292	288	313	284	262	240
"DDX52"	3897	31076	320	125	192	128	53	72	263	145	0	46	350	545	806	683	873	553
"DDX53"	2119	2119	0	0	0	0	0	0	0	0	0	0	0	0	0	0	0	0
"DDX54"	4395	28302	469	131	251	218	83	48	389	240	177	265	1110	877	1359	1018	1121	1196
"DDX55"	4506	14557	556	53	303	253	39	14	329	66	141	98	321	798	309	240	392	192
"DDX56"	2529	8735	381	379	226	155	207	172	363	316	480	367	863	759	1155	1043	1730	964
"DDX58"	4979	47435	8540	39835	4725	3815	15698	24137	879	35017	132	17568	235	4625	758	1580	602	501
"DDX59"	2327	25962	219	427	132	87	236	191	118	90	11	204	408	841	367	503	432	367
"DDX6"	6240	43501	2834	1661	1545	1289	902	759	1172	1053	1032	2416	4984	5406	5583	4248	5874	3615
"DDX60"	6110	102517	190	1792	130	60	1020	772	191	2112	30	400	576	861	1242	614	813	618
"DDX60L"	6791	123753	1124	423	646	478	281	142	1499	623	224	458	1123	1522	1111	726	1397	1062
"DEAF1"	2728	51517	1221	519	586	635	254	265	808	756	1225	1250	334	344	559	449	727	641
"DEC1"	1259	260828	0	14	0	0	14	0	12	0	0	0	0	0	0	0	0	0
"DECR1"	1903	50649	6140	2287	3407	2733	1282	1005	3152	792	2655	1672	2987	3451	3091	2306	3338	2364
"DECR2"	1805	10630	0	0	0	0	0	0	79	13	0	0	167	141	186	143	161	122
"DEDD"	2364	11709	647	165	383	264	101	64	360	170	228	241	1028	932	1222	859	1431	855
"DEDD2"	1912	21525	541	158	363	178	63	95	403	330	54	1055	624	430	938	260	343	1079
"DEDPRO1"	2001	11709	647	165	383	264	101	64	360	170	228	241	1028	932	1222	859	1431	855
"DEEPEST"	1052	34186	14478	5888	4158	10320	3085	2803	9735	1627	18401	5076	2102	1718	1905	778	3496	1086
"DEF6"	2305	23953	1081	185	623	458	116	69	645	151	381	162	917	978	972	858	1826	766
"DEF8"	3769	19318	1653	273	845	808	153	120	789	350	975	219	1836	1614	3388	2195	4495	2409
"DEFA1B"	501	2445	0	0	0	0	0	0	0	0	0	0	0	0	0	10	5	0
"DEFA3"	501	2434	0	0	0	0	0	0	0	0	0	0	0	0	0	7	5	0
"DEFA4"	545	2443	0	0	0	0	0	0	0	0	0	0	0	0	0	0	0	0
"DEFA5"	451	1432	0	0	0	0	0	0	0	0	0	0	0	0	0	0	0	0
"DEFA6"	465	1379	0	0	0	0	0	0	0	0	0	0	0	0	0	0	0	0
"DEFB1"	465	7434	0	0	0	0	0	0	0	0	0	0	0	0	0	0	0	0
"DEFB103A"	512	1454	0	0	0	0	0	0	0	0	0	0	0	0	0	0	0	0
"DEFB103B"	512	1454	0	0	0	0	0	0	0	0	0	0	0	0	0	0	0	0
"DEFB104A"	282	4775	0	0	0	0	0	0	0	0	0	0	0	0	0	0	0	0
"DEFB105A"	239	1831	0	0	0	0	0	0	0	0	0	0	0	0	0	0	0	0
"DEFB106A"	305	3885	0	0	0	0	0	0	0	0	0	0	0	0	0	0	0	0
"DEFB107B"	391	13467	0	0	0	0	0	0	0	0	0	0	0	0	0	0	0	0
"DEFB108B"	223	4363	0	0	0	0	0	0	0	0	0	0	0	0	0	0	0	0
"DEFB109"	265	7106	0	0	0	0	0	0	0	0	0	0	0	0	0	0	0	0
"DEFB110"	385	3139	0	0	0	0	0	0	0	0	0	0	0	0	0	0	0	0
"DEFB112"	343	5077	0	0	0	0	0	0	0	0	0	0	0	0	0	0	0	0
"DEFB113"	243	942	0	0	0	0	0	0	0	0	0	0	0	0	0	0	0	0
"DEFB114"	211	3814	0	0	0	0	0	0	0	0	0	0	0	0	0	0	0	0
"DEFB115"	269	1970	0	0	0	0	0	0	0	0	0	0	0	0	0	0	0	0
"DEFB116"	310	5374	0	0	0	0	0	0	0	0	0	0	0	0	0	0	0	0
"DEFB118"	590	4737	0	0	0	0	0	0	0	0	0	0	0	0	0	0	0	0
"DEFB119"	499	13440	0	0	0	0	0	0	0	0	0	0	0	0	0	0	0	0
"DEFB121"	284	1292	0	0	0	0	0	0	0	0	0	0	0	0	0	0	0	0
"DEFB122"	499	7743	0	0	0	0	0	0	0	0	0	0	0	0	0	0	0	0
"DEFB123"	379	9650	0	0	0	0	0	0	0	0	0	0	0	0	0	0	0	0
"DEFB124"	218	7509	0	0	0	0	0	0	9	0	0	0	0	0	0	0	0	0
"DEFB125"	710	8946	0	0	0	0	0	0	0	0	0	0	0	0	0	0	0	0
"DEFB126"	414	3141	0	0	0	0	0	0	0	0	0	0	0	0	0	0	0	0
"DEFB127"	441	1620	0	0	0	0	0	0	0	0	0	0	0	0	0	0	0	0
"DEFB128"	284	1739	0	0	0	0	0	0	0	0	0	0	0	0	0	0	0	0
"DEFB129"	673	2603	0	0	0	0	0	0	0	0	0	0	0	0	0	0	0	0
"DEFB130"	242	7360	0	0	0	0	0	0	0	0	0	0	0	0	0	0	0	0
"DEFB131"	214	5981	0	0	0	0	0	0	0	0	0	0	0	0	0	0	0	0
"DEFB132"	2120	3359	0	0	0	0	0	0	0	0	0	0	0	0	0	0	0	0
"DEFB134"	202	2272	0	0	0	0	0	0	0	0	0	0	0	0	0	0	0	0
"DEFB135"	236	2271	0	0	0	0	0	0	0	0	0	0	0	0	0	0	0	0
"DEFB136"	237	662	0	0	0	0	0	0	0	0	0	0	0	0	0	0	0	0
"DEFB4"	337	2039	0	0	0	0	0	0	0	0	0	0	0	0	0	0	0	0
"DEGS1"	2046	10214	2374	624	1319	1055	364	260	1049	381	2269	715	4230	4197	2790	3249	3872	3190
"DEGS2"	1408	13261	386	0	168	218	0	0	8209	75	0	0	3	2	0	0	0	0
"DEHAL1"	7580	35738	0	0	0	0	0	0	0	0	0	0	0	0	0	0	0	0
"DEK"	2882	40401	5477	5347	3086	2391	2919	2428	2280	2182	1664	3669	7983	3442	2659	1909	3322	4592
"DEM1"	3030	7753	89	0	54	35	0	0	44	19	47	0	212	170	251	154	365	173
"DENND1A"	5076	550486	20757	13866	11447	9310	7496	6370	14021	12329	4219	14810	437	432	468	480	598	406
"DENND1B"	2709	265116	58757	65231	32656	26101	35261	29970	25203	18953	22985	29838	1661	2836	1749	1641	1516	772
"DENND1C"	2956	13083	835	284	452	383	132	152	380	208	503	237	1033	1337	1161	978	2269	1278
"DENND2A"	3850	122351	0	0	0	0	0	0	42	0	0	0	0	0	0	0	0	0
"DENND2C"	5284	149028	8	0	0	8	0	0	0	61	0	0	1784	1895	332	287	314	289
"DENND2D"	2054	13482	1193	1019	678	515	631	388	1796	385	114	981	578	1542	2330	1778	802	1535
"DENND3"	5464	67180	1236	4011	631	605	2150	1861	1235	4064	354	6925	345	1005	440	1115	531	587
"DENND4A"	7369	131674	6980	79583	3891	3089	43127	36456	2189	36559	838	43221	1201	2507	1237	2583	1376	863
"DENND4B"	5716	17179	6634	2430	3686	2948	1212	1218	1884	1495	5911	3110	3330	4173	7068	5618	8156	6006
"DENND4C"	7097	83438	8142	2272	4662	3480	1264	1008	4783	1313	2292	1315	4079	15816	6698	4978	5747	3714
"DENND5A"	4983	126496	11050	101536	6082	4968	54455	47081	1906	40755	1026	78695	1864	3046	3165	9166	2668	3428
"DENND5B"	9484	208221	0	0	0	0	0	0	43	0	0	0	15	51	30	48	11	9
"DENR"	3070	18583	830	286	437	393	153	133	437	223	156	296	1414	1582	686	656	1243	892
"DEPC-1"	1650	39470	467	59	253	214	20	39	441	14	9	0	331	428	325	267	381	278
"DEPDC1"	5343	22964	0	0	0	0	0	0	0	0	0	0	0	0	0	0	0	0
"DEPDC1-V1"	4533	20543	0	0	0	0	0	0	0	0	0	0	0	0	0	0	0	0
"DEPDC1B"	2514	103255	0	0	0	0	0	0	0	0	0	0	16	23	0	3	27	9
"DEPDC4"	1596	29113	0	0	0	0	0	0	0	0	0	0	0	2	0	0	5	0
"DEPDC5"	5514	152933	3796	1261	2231	1565	767	494	1680	675	958	1167	718	799	908	813	987	766
"DEPDC6"	2639	177258	0	0	0	0	0	0	0	0	0	0	77	121	64	21	87	16
"DEPDC7"	2001	17400	0	0	0	0	0	0	0	0	0	0	105	195	54	18	54	16
"DERA"	1732	126130	3787	628	2104	1683	397	231	2767	394	268	425	924	1067	990	932	1112	875
"DERL1"	5956	28261	1659	1441	947	712	800	641	738	710	170	954	2723	3247	756	2566	2829	2240
"DERL2"	1131	11883	101	37	65	36	22	15	77	43	159	44	243	243	350	204	367	448
"DERL3"	3529	4626	79	0	46	33	0	0	41	64	0	0	0	3	0	0	149	0
"DERPC"	2826	3492	213	147	2	211	68	79	189	126	307	162	4066	3710	3974	3098	5216	3333
"DES"	2255	8362	0	0	0	0	0	0	38	25	0	0	1	0	0	0	40	15
"DET1"	2481	34332	56	3	23	33	3	0	157	0	46	0	101	125	156	120	160	78
"DEXI"	1501	13509	51896	10623	28824	23072	5546	5077	12146	4558	39849	10015	17194	13630	6762	3284	10531	4930
"DFFA"	3396	12010	14	0	0	14	0	0	76	13	0	20	269	104	434	315	495	293
"DFFB"	3106	28149	138	0	100	38	0	0	264	15	116	0	178	180	103	98	196	80
"DFNA5"	2505	59667	0	26	0	0	14	12	17	12	0	0	125	100	105	113	52	81
"DFNB31"	4058	103371	156	93	79	77	66	27	238	88	0	0	0	0	3	8	3	0
"DFNB59"	1528	9946	16	0	13	3	0	0	0	0	0	0	157	164	0	0	17	0
"DGAT"	3218	12322	892	338	430	462	196	142	385	354	785	370	1320	1264	1145	1419	2161	1496
"DGAT1"	3722	12322	892	338	430	462	196	142	385	354	785	370	1320	1264	1145	1419	2161	1496
"DGAT2"	2460	32803	14	0	6	8	0	0	93	75	0	122	94	128	30	66	151	70
"DGAT2L6"	1715	28219	0	0	0	0	0	0	0	0	0	0	0	0	0	0	0	0
"DGCR10"	927	927	0	0	0	0	0	0	0	0	0	0	0	0	0	0	0	0
"DGCR14"	5799	14355	151	10	61	90	10	0	92	63	22	67	364	261	358	307	555	304
"DGCR2"	4876	86174	3028	264	1740	1288	161	103	1871	469	1510	568	1366	1086	1685	1152	2081	1303
"DGCR5"	771	16512	0	0	0	0	0	0	0	0	0	0	0	0	0	0	0	0
"DGCR6"	1572	5866	9	0	0	9	0	0	0	0	0	0	40	45	253	187	348	247
"DGCR6L"	1426	5563	52	0	23	29	0	0	72	20	0	0	313	299	627	491	771	540
"DGCR8"	4453	31566	2520	668	1442	1078	336	332	1353	795	1503	1069	837	742	1044	733	1729	717
"DGCR9"	2415	2415	0	0	0	0	0	0	0	0	0	0	0	0	0	0	0	0
"DGKA"	4098	18687	621	78	336	285	46	32	486	151	158	62	633	733	637	517	955	554
"DGKB"	6984	757877	0	0	0	0	0	0	0	0	0	0	0	0	0	0	0	0
"DGKD"	6324	117592	1389	242	822	567	136	106	1347	440	517	637	792	847	823	754	1157	722
"DGKE"	7778	34576	43	0	16	27	0	0	48	0	0	0	192	185	64	38	113	29
"DGKG"	5826	215034	0	3	0	0	3	0	160	4	0	0	81	100	114	65	155	84
"DGKH"	4278	181001	12175	21309	6595	5580	11578	9731	4439	13036	1928	14335	1441	721	288	473	324	258
"DGKH-1"	4526	118504	6263	6270	3361	2902	3561	2709	2621	3726	1447	3179	1501	2186	1113	984	1574	645
"DGKI"	4813	457225	0	0	0	0	0	0	0	0	0	0	0	25	1513	1525	2074	1527
"DGKK"	3926	101842	0	0	0	0	0	0	0	0	0	0	0	0	0	0	0	0
"DGKQ"	4658	14670	1133	399	452	681	215	184	745	431	1389	662	295	793	1219	711	2657	1312
"DGKZ"	4118	18961	4631	661	2570	2061	391	270	2239	506	5214	522	834	587	3328	2113	4357	2520
"DGKi"	4685	457225	0	0	0	0	0	0	0	0	0	0	0	25	1513	1525	2074	1527
"DGUOK"	1149	32135	2303	267	1318	985	115	152	1188	234	515	237	655	439	523	597	907	727
"DHCR24"	4295	37623	1009	411	563	446	200	211	595	151	192	35	6965	6847	3707	2911	9279	5985
"DHCR7"	2672	14020	13	5	13	0	5	0	14	12	0	0	182	541	428	390	736	715
"DHDDS"	3326	38993	2178	644	1210	968	417	227	1027	493	1176	890	726	741	980	720	1152	690
"DHDH"	1088	11289	0	0	0	0	0	0	16	0	0	0	9	6	15	7	6	0
"DHDPSL"	2487	28453	0	0	0	0	0	0	46	12	0	0	0	0	0	0	0	0
"DHFR"	3923	28757	0	0	0	0	0	0	37	2	0	0	74	50	234	147	124	17
"DHFRL1"	4038	5299	0	0	0	0	0	0	86	0	0	0	488	475	390	308	322	110
"DHH"	1935	5396	0	0	0	0	0	0	25	0	0	0	0	0	0	0	0	0
"DHODH"	2074	16313	183	0	103	80	0	0	210	21	0	15	116	95	190	49	171	52
"DHPS"	1334	6145	695	306	369	326	139	167	174	116	261	265	530	543	1008	1064	1493	964
"DHRS1"	2664	4058	466	102	274	192	47	55	253	63	130	0	338	167	225	170	533	243
"DHRS11"	1603	9007	837	164	474	363	66	98	389	135	230	157	566	477	2388	1587	1997	1382
"DHRS12"	1978	36164	543	1158	288	255	616	542	352	486	5	405	169	403	169	132	172	179
"DHRS13"	1925	5176	19	0	8	11	0	0	0	0	0	0	155	107	132	81	220	120
"DHRS2"	3169	9275	769	261	459	310	131	130	210	19	0	0	630	471	429	275	825	263
"DHRS3"	1811	49882	44	0	30	14	0	0	163	64	20	0	121	90	437	382	324	319
"DHRS4"	1284	15523	760	24	436	324	24	0	782	31	415	131	1327	1377	1302	1302	1774	1111
"DHRS4L1"	1258	14871	0	4	0	0	4	0	25	0	0	0	0	0	142	0	79	35
"DHRS4L2"	2223	14384	760	24	436	324	24	0	782	31	415	131	1327	1377	1302	1302	1774	1111
"DHRS7"	1567	16547	327	58	181	146	34	24	179	0	0	0	523	667	997	883	943	788
"DHRS7B"	1381	64579	1287	1125	747	540	646	479	765	649	146	886	261	273	277	293	366	254
"DHRS7C"	994	19847	0	0	0	0	0	0	13	0	0	0	0	0	0	0	0	0
"DHRS9"	2874	31382	26	0	8	18	0	0	171	9	68	5	329	366	1090	916	751	851
"DHRSX"	2574	281460	0	0	0	0	0	0	0	0	0	0	0	0	2322	2374	2898	2425
"DHTKD1"	5212	54291	447	69	270	177	58	11	375	58	189	74	1261	1185	693	506	938	556
"DHX15"	3041	11686	4100	3077	2200	1900	1763	1314	1832	1674	683	2268	2439	2896	2713	2699	3440	1932
"DHX16"	3480	19935	628	313	374	254	183	130	370	180	212	97	748	966	1030	746	1432	788
"DHX29"	4586	51449	561	2	276	285	0	2	487	48	18	0	1270	1284	1467	1013	1600	934
"DHX30"	4138	47288	1205	369	668	537	201	168	643	485	665	627	1495	1451	1596	1695	1870	1432
"DHX32"	3081	44977	1464	255	834	630	151	104	1042	192	0	37	928	500	896	766	1410	900
"DHX33"	4069	26589	81	21	45	36	9	12	56	67	0	0	248	212	521	321	462	257
"DHX34"	4381	33417	543	246	349	194	117	129	537	405	275	323	418	435	553	495	704	539
"DHX35"	3342	77365	1753	64	1012	741	25	39	1177	99	230	131	562	415	658	356	669	289
"DHX36"	3635	48830	823	1092	509	314	565	527	545	584	243	459	1394	1027	1131	829	1212	788
"DHX37"	4575	42296	233	90	138	95	54	36	449	229	30	52	393	405	869	741	941	507
"DHX38"	4480	19197	897	787	518	379	358	429	366	517	236	574	1409	1807	1879	2083	2231	1348
"DHX40"	3674	42818	20	15	18	2	8	7	29	19	0	1	602	813	814	719	1001	665
"DHX40P"	1141	42953	0	0	0	0	0	0	13	0	0	0	0	0	176	145	232	136
"DHX57"	4847	78145	95	0	53	42	0	0	62	0	0	12	333	458	806	533	766	454
"DHX58"	2631	11331	349	1281	196	153	689	592	230	683	22	558	384	1169	686	908	669	603
"DHX8"	4223	40348	721	70	439	282	36	34	478	124	234	178	1533	1142	1966	1414	2496	1325
"DHX9"	4455	48433	3037	2055	1616	1421	1166	889	1667	1002	238	1299	2671	2715	4754	4222	4883	3604
"DIABLO"	2250	19860	525	1057	264	261	613	444	246	721	39	2034	645	1234	688	982	919	361
"DIAPH1"	5817	104035	20904	3475	11674	9230	1818	1657	8044	1296	11567	2541	14045	13314	11660	9569	18025	6631
"DIAPH2"	5009	915936	7890	10122	4566	3324	5780	4342	5159	6595	333	4894	593	779	752	596	788	560
"DIAPH3"	4822	498396	0	0	0	0	0	0	0	0	0	0	0	0	0	0	0	0
"DICER1"	10304	71196	4757	1788	2715	2042	1003	785	2965	1189	1011	926	3717	3826	6668	5255	5229	2957
"DIDO1"	8560	60186	8105	3212	4512	3593	1767	1445	3628	2293	3830	4330	2432	1812	2617	1648	3383	1525
"DIMT1L"	1568	15378	142	13	77	65	8	5	183	55	0	53	321	1873	921	1185	2131	1154
"DINB1"	4403	87989	2996	481	1649	1347	227	254	2129	555	498	556	809	846	743	592	773	533
"DIO1"	1861	16899	289	40	164	125	20	20	131	46	49	0	1	10	0	0	0	0
"DIO2"	6692	14657	0	0	0	0	0	0	0	0	0	0	0	0	0	0	0	0
"DIO3"	2101	2103	0	0	0	0	0	0	0	0	0	0	0	0	0	0	0	0
"DIO3AS"	1911	3100	0	0	0	0	0	0	89	51	0	0	0	0	0	0	0	0
"DIO3OS"	875	3103	0	0	0	0	0	0	31	14	0	0	0	0	0	0	0	0
"DIP2A"	7328	111066	3858	1025	2110	1748	578	447	2396	681	1759	1205	1112	1276	1844	1590	2204	1376
"DIP2B"	8751	243682	30003	25219	16819	13184	13805	11414	13508	12802	17211	22176	5188	6403	5862	5066	6499	4039
"DIP2C"	7931	415478	110	38	65	45	29	9	1555	698	73	76	633	662	796	804	782	458
"DIRAS1"	3400	6827	0	0	0	0	0	0	0	0	2	0	328	246	343	254	453	309
"DIRAS2"	4109	32996	0	0	0	0	0	0	8	0	0	0	0	0	0	0	0	0
"DIRAS3"	1652	4836	0	0	0	0	0	0	0	0	0	0	0	0	0	0	0	0
"DIRC1"	1456	56368	0	0	0	0	0	0	0	0	0	0	0	0	0	0	0	0
"DIRC2"	3439	86084	19104	3808	10257	8847	2325	1483	8068	968	4927	2086	4778	4344	1686	1524	2047	1625
"DIRC3"	3981	316806	0	0	0	0	0	0	155	12	0	57	0	0	0	0	0	0
"DIS3"	7663	26804	662	307	402	260	188	119	345	275	122	415	1462	1757	1696	1110	1708	1116
"DIS3L"	3782	40317	219	17	155	64	9	8	275	3	0	0	520	512	714	658	607	482
"DIS3L2"	3522	375616	1402	545	803	599	289	256	1386	1061	212	786	401	356	433	390	521	399
"DISC1"	7070	414457	4456	1954	2648	1808	1132	822	5893	3625	527	1567	1606	1633	1588	1028	1644	1140
"DISC2"	3892	3892	59	30	19	40	29	1	80	128	0	0	13	17	13	13	28	11
"DISP1"	4751	77554	0	0	0	0	0	0	0	0	0	0	20	15	18	4	3	4
"DISP2"	5040	12824	3	1	3	0	0	1	92	16	0	0	0	0	0	0	0	0
"DIVA"	2254	40599	0	0	0	0	0	0	0	0	0	0	0	0	0	0	0	0
"DIXDC1"	5912	85380	0	0	0	0	0	0	15	0	0	0	0	0	3	0	0	0
"DJ027120"	99	99	0	0	0	0	0	0	0	0	0	0	0	0	0	0	0	0
"DJ031123"	1326	30010	931	43	490	441	43	0	691	44	393	0	306	70	30	16	133	90
"DJ031130"	483	13124	0	0	0	0	0	0	0	11	0	0	0	0	0	0	0	0
"DJ031132"	760	2209	0	0	0	0	0	0	0	0	0	0	4	0	3	0	7	0
"DJ031140"	2227	2227	17	0	0	17	0	0	20	34	0	0	4	0	1	0	0	0
"DJ031144"	1149	17308	2693	646	1513	1180	361	285	3928	374	1170	163	139	144	0	0	2	0
"DJ031150"	448	29300	0	0	0	0	0	0	13	0	0	0	0	0	0	0	0	0
"DJ031154"	953	31245	109	0	48	61	0	0	152	15	22	0	0	0	6	15	0	0
"DJ051769"	52	52	0	0	0	0	0	0	16	42	0	0	0	0	0	0	0	0
"DJ087795"	24	24	18	0	18	0	0	0	20	0	0	0	0	0	0	0	0	0
"DJ446959"	374	374	0	0	0	0	0	0	0	0	0	0	0	0	0	0	0	0
"DKC1"	2591	14934	147	27	78	69	14	13	168	77	34	35	693	595	1089	834	1133	890
"DKFZP434H168"	1910	1910	0	0	0	0	0	0	0	0	0	0	0	0	0	0	0	0
"DKFZP586I1420"	2744	2744	1965	654	1603	362	340	314	836	376	492	151	1663	1872	1353	1292	1467	1112
"DKFZP686A10121"	3276	40662	1248	24	737	511	24	0	779	55	860	311	314	250	199	115	236	153
"DKFZp313C0640"	1136	24973	217	19	122	95	13	6	365	45	63	0	470	204	718	653	885	710
"DKFZp313C2412"	4398	10388	11117	40033	6119	4998	20611	19422	3493	18332	2712	20020	3837	28415	4986	13797	5043	6408
"DKFZp313D0829"	1821	3094	0	0	0	0	0	0	0	0	0	0	0	0	0	0	0	0
"DKFZp313E1330"	3454	15582	12	0	0	12	0	0	125	0	0	0	340	302	340	187	368	198
"DKFZp313F1012"	3052	6785	1020	656	537	483	332	324	324	400	442	486	7209	7102	7919	6846	9493	6568
"DKFZp313F2116"	6844	11292	467	150	252	215	130	20	310	179	276	269	866	720	722	506	920	488
"DKFZp313G1735"	3412	49982	0	0	0	0	0	0	20	0	0	0	10	0	24	31	29	18
"DKFZp313H139"	4899	10605	4739	4873	2590	2149	2578	2295	1392	1922	2708	3958	7299	11782	7904	13013	10023	9942
"DKFZp313J1510"	1593	2042	199	177	144	55	88	89	99	189	53	206	75	418	3682	3789	5220	3935
"DKFZp313J1712"	4012	9940	2158	3521	1259	899	2023	1498	1045	1500	1342	2909	542	181	1168	1378	1129	985
"DKFZp313K0921"	1214	19837	1355	1712	762	593	953	759	478	1000	250	1612	190	225	780	836	757	599
"DKFZp313K107"	4387	58115	6619	3740	3640	2979	1786	1954	3073	2393	5120	4678	991	1199	1529	1592	1702	1249
"DKFZp313M0539"	1103	54699	770	476	501	269	257	219	446	202	134	263	361	404	683	564	684	487
"DKFZp313N0632"	3011	14572	0	0	0	0	0	0	0	0	0	0	0	4	0	0	0	0
"DKFZp313O1925"	4102	21730	329	13	182	147	0	13	246	31	100	60	143	170	50	19	68	38
"DKFZp313P2036"	4027	55662	0	0	0	0	0	0	0	0	0	0	0	0	0	0	0	0
"DKFZp434A0311"	2908	14701	462	192	231	231	121	71	390	374	363	396	215	310	535	640	775	571
"DKFZp434A042"	1869	34017	1623	2033	818	805	1091	942	915	1264	503	1317	349	464	613	703	514	380
"DKFZp434A043"	3039	60100	2109	361	1197	912	202	159	1303	150	292	156	804	670	1049	816	1338	812
"DKFZp434A0435"	1934	32094	0	0	0	0	0	0	0	0	0	0	0	0	0	0	0	0
"DKFZp434A062"	4783	4783	0	0	0	0	0	0	64	18	1	0	0	1	0	0	0	0
"DKFZp434A091"	1189	8262	116	0	64	52	0	0	148	118	7	5	97	86	62	54	154	80
"DKFZp434A1022"	3276	27301	221	78	82	139	44	34	259	141	15	27	21	1	7	0	42	18
"DKFZp434A109"	1672	9221	211	129	132	79	77	52	197	150	250	233	435	445	749	742	938	753
"DKFZp434A128"	4475	123867	854	109	339	515	48	61	499	8	0	9	828	1405	290	0	369	1
"DKFZp434A149"	1470	8496	310	387	176	134	189	198	119	448	0	332	26	84	0	8	0	0
"DKFZp434A1535"	2119	10190	1593	651	732	861	377	274	534	400	277	542	75	666	25	28	72	335
"DKFZp434A155"	2272	4240	7	10	7	0	0	10	42	11	0	0	643	620	559	460	867	515
"DKFZp434A171"	1254	18557	0	0	0	0	0	0	47	0	0	0	0	0	0	0	0	0
"DKFZp434A1721"	7404	119104	10	133	0	10	73	60	537	813	0	51	0	0	0	35	0	3
"DKFZp434A2017"	4939	39657	23	15	15	8	7	8	26	13	0	0	15	73	37	30	25	6
"DKFZp434A2422"	2124	23084	0	0	0	0	0	0	0	0	0	0	3	22	0	15	14	2
"DKFZp434B044"	1024	87215	0	0	0	0	0	0	231	165	0	0	6	10	0	10	10	0
"DKFZp434B061"	1413	1413	0	0	0	0	0	0	0	0	0	0	0	0	0	0	0	0
"DKFZp434B0819"	2029	131762	20911	21959	11458	9453	11308	10651	14570	9748	8443	15585	409	424	1600	1528	522	1566
"DKFZp434B0914"	1514	4500	5857	1175	3403	2454	489	686	1129	490	3532	1111	70	98	1016	162	623	209
"DKFZp434B103"	1702	21661	3576	2443	1989	1587	1292	1151	1430	1282	2900	2794	1292	1662	2142	1812	3412	1941
"DKFZp434B1050"	3281	70637	313	0	202	111	0	0	314	14	34	0	459	440	613	527	730	503
"DKFZp434B1222"	2036	13463	0	0	0	0	0	0	0	0	0	0	0	0	0	0	0	0
"DKFZp434B1272"	3655	36632	0	0	0	0	0	0	408	65	0	0	0	0	0	3	0	0
"DKFZp434B156"	1818	23801	46	0	20	26	0	0	111	0	0	4	258	145	223	83	253	126
"DKFZp434B168"	3517	94188	1308	388	745	563	206	182	600	250	154	406	525	337	613	609	618	520
"DKFZp434B1913"	5005	552306	0	0	0	0	0	0	0	14	0	0	0	0	0	0	0	0
"DKFZp434B216"	3363	41151	3102	2982	1699	1403	1572	1410	1766	1334	1217	2118	1301	1703	1488	1301	1523	1086
"DKFZp434B217"	2722	8985	0	0	0	0	0	0	47	36	0	0	0	0	0	7	0	0
"DKFZp434C0328"	3862	118993	30	0	30	0	0	0	17	15	0	0	784	770	0	147	427	0
"DKFZp434C0523"	2269	18614	0	0	0	0	0	0	12	12	0	0	205	206	213	140	238	103
"DKFZp434C0631"	1547	9815	0	0	0	0	0	0	0	0	0	0	0	0	0	0	0	0
"DKFZp434C0927"	3289	48597	2	0	2	0	0	0	0	0	0	0	22	55	81	67	66	46
"DKFZp434C0935"	2464	19729	875	129	465	410	82	47	535	364	282	543	709	663	592	439	720	443
"DKFZp434C119"	1459	4222	193	49	110	83	23	26	130	41	185	84	955	761	806	906	835	777
"DKFZp434C131"	2574	7095	293	69	124	169	55	14	160	143	221	69	497	445	583	539	1186	804
"DKFZp434C1418"	1708	307928	0	0	0	0	0	0	0	0	0	0	0	0	0	0	0	0
"DKFZp434C1428"	1377	14958	520	278	258	262	201	77	227	373	47	162	414	536	404	328	614	380
"DKFZp434C171"	3210	24424	680	29	423	257	14	15	422	54	339	109	2962	2582	3626	3322	3535	2418
"DKFZp434C1714"	2377	8185	245	130	111	134	90	40	103	93	0	30	74	80	287	249	406	249
"DKFZp434C191"	2668	7185	315	168	181	134	78	90	171	130	91	144	1162	1209	1224	942	1577	952
"DKFZp434C2019"	2277	39623	919	407	451	468	182	225	657	500	285	1122	65	113	84	99	60	63
"DKFZp434D0513"	4641	58944	21	15	21	0	9	6	6	0	0	3	0	0	0	0	0	0
"DKFZp434D0711"	3558	28120	2474	1294	1354	1120	711	583	1127	953	1161	1852	844	890	959	872	1224	789
"DKFZp434D156"	2613	37930	935	298	529	406	171	127	597	239	187	344	1629	1275	1789	1421	2160	1361
"DKFZp434D1620"	3755	50601	1233	42	819	414	20	22	757	34	127	30	1061	1105	1388	961	1483	929
"DKFZp434D199"	1231	10098	392	12	201	191	0	12	220	55	140	0	161	345	454	362	535	332
"DKFZp434D2011"	5152	23000	3989	3461	2221	1768	1905	1556	1769	1306	1660	2243	1662	2733	2527	2510	2627	1977
"DKFZp434D2030"	5136	9947	16	9	16	0	9	0	130	81	0	0	0	0	0	2	0	3
"DKFZp434D2111"	2107	67772	534	128	351	183	67	61	693	119	0	142	64	115	568	614	431	415
"DKFZp434D2472"	843	5422	0	0	0	0	0	0	0	13	0	0	0	0	0	0	0	0
"DKFZp434E052"	1128	21859	0	0	0	0	0	0	0	0	0	0	13	20	5	0	7	7
"DKFZp434E092"	4112	105288	0	0	0	0	0	0	0	0	0	0	0	0	0	0	0	0
"DKFZp434E1722"	4870	9383	9	0	9	0	0	0	23	15	0	0	160	183	377	144	207	173
"DKFZp434E1822"	1014	31536	10	0	10	0	0	0	49	22	0	1	0	1	0	0	0	0
"DKFZp434E202"	2145	13912	0	0	0	0	0	0	13	0	0	0	0	0	0	0	0	0
"DKFZp434E2022"	4159	36763	4739	546	2555	2184	298	248	2055	455	4057	649	2876	1928	2850	1231	4448	1966
"DKFZp434E2118"	4169	143280	0	5	0	0	1	4	23	0	1	53	0	0	0	0	0	0
"DKFZp434E2321"	2466	5746	0	0	0	0	0	0	0	0	0	0	0	0	0	0	0	0
"DKFZp434F011"	2582	173212	51	0	20	31	0	0	322	72	0	0	10	0	0	0	0	0
"DKFZp434F0427"	5018	5848	2	0	0	2	0	0	33	26	0	0	3	0	11	7	14	4
"DKFZp434F1016"	2109	28543	136	61	70	66	22	39	102	87	24	37	102	897	161	167	119	101
"DKFZp434F122"	1877	5188	0	0	0	0	0	0	0	0	0	0	0	0	0	0	0	0
"DKFZp434F1622"	3839	35398	3854	1115	2157	1697	605	510	2317	221	10588	6870	454	134	351	8	482	16
"DKFZp434F1719"	2282	5812	0	0	0	0	0	0	0	8	0	0	0	0	0	0	0	0
"DKFZp434F1826"	3557	12794	351	139	178	173	80	59	243	132	104	47	733	881	488	423	1325	807
"DKFZp434F1830"	1154	43034	0	0	0	0	0	0	15	0	0	0	0	0	0	0	0	0
"DKFZp434F2021"	4665	17263	1577	1145	860	717	653	492	636	390	160	254	1882	2105	1316	780	1680	885
"DKFZp434G0522"	1292	43128	806	230	403	403	121	109	789	452	339	316	259	289	182	170	377	203
"DKFZp434G072"	1798	31260	0	0	0	0	0	0	0	0	0	0	0	0	0	0	0	0
"DKFZp434G1115"	1555	18404	3770	1896	2068	1702	1120	776	2314	793	426	863	385	579	335	356	462	335
"DKFZp434G1221"	2714	8709	1289	513	751	538	297	216	499	414	263	785	159	202	403	208	479	252
"DKFZp434G131"	2825	53069	140	16	73	67	16	0	69	33	30	9	233	152	367	448	184	145
"DKFZp434G1310"	3049	9117	2	0	2	0	0	0	0	0	0	0	9	0	0	9	0	0
"DKFZp434G1411"	2580	67139	0	0	0	0	0	0	0	0	0	0	0	0	0	0	0	0
"DKFZp434G145"	6370	193933	5	0	0	5	0	0	54	22	17	11	28	108	103	173	114	85
"DKFZp434G1729"	2921	5109	0	0	0	0	0	0	121	100	0	0	1	2	0	0	0	0
"DKFZp434G222"	624	154451	0	0	0	0	0	0	65	11	0	19	31	48	17	30	28	10
"DKFZp434H012"	6026	10723	0	0	0	0	0	0	10	0	0	0	66	89	218	116	156	103
"DKFZp434H1228"	1544	64521	22	0	15	7	0	0	20	0	0	0	11	8	99	90	96	76
"DKFZp434H1720"	3385	45518	19	0	6	13	0	0	71	0	0	0	157	106	156	56	162	84
"DKFZp434H202"	2139	15245	2944	2456	1647	1297	1327	1129	985	836	2249	2241	2036	1643	3279	2429	3275	2534
"DKFZp434H247"	3509	9240	176	13	84	92	13	0	200	128	58	37	1110	945	717	578	868	556
"DKFZp434I042"	2330	56062	7	0	7	0	0	0	20	0	0	0	0	5	0	0	0	6
"DKFZp434I0612"	2554	33250	3536	1793	1964	1572	1025	768	1506	752	1769	1669	1808	1864	1698	1367	1781	996
"DKFZp434I0714"	3000	3000	31	0	31	0	0	0	53	48	0	0	45	45	24	46	0	27
"DKFZp434I0812"	3410	7230	114	64	67	47	44	20	61	47	0	0	763	935	977	1020	941	656
"DKFZp434I0916"	3611	23310	18	0	3	15	0	0	0	0	0	3	0	0	0	0	0	0
"DKFZp434I1020"	3836	16773	0	0	0	0	0	0	12	8	0	0	0	0	27	47	51	30
"DKFZp434I1120"	3329	22062	1	0	0	1	0	0	101	57	0	0	2	0	0	0	0	0
"DKFZp434I1130"	2235	30259	955	63	556	399	39	24	705	101	356	153	693	607	1033	751	1072	716
"DKFZp434I1230"	1983	113202	150	54	81	69	31	23	189	60	18	59	310	358	319	293	325	235
"DKFZp434I138"	1903	6072	0	0	0	0	0	0	0	0	0	0	0	0	0	0	0	0
"DKFZp434I153"	2962	72141	0	0	0	0	0	0	0	0	0	0	0	0	0	0	0	0
"DKFZp434I1614"	1037	16215	445	91	249	196	37	54	274	82	14	37	929	663	881	924	1189	886
"DKFZp434I2135"	1003	1299	28	0	28	0	0	0	23	12	0	0	0	0	0	0	0	0
"DKFZp434J0226"	1718	4675	0	0	0	0	0	0	13	0	0	0	0	0	0	0	0	0
"DKFZp434J032"	2338	113719	26034	30979	13640	12394	16375	14604	8681	13876	20434	21083	2921	3993	3285	5686	4568	2655
"DKFZp434J0420"	5003	28321	36	8	18	18	8	0	29	0	0	0	188	203	203	109	183	46
"DKFZp434J087"	1359	21838	283	56	183	100	29	27	218	99	0	25	349	330	276	237	255	302
"DKFZp434J1813"	5075	62258	256	48	102	154	26	22	196	22	41	35	1945	2176	2012	1655	2199	1666
"DKFZp434J194"	2189	2189	23	0	23	0	0	0	25	39	0	0	367	343	314	228	547	337
"DKFZp434J2031"	1916	33282	2120	1198	1141	979	698	500	1026	919	837	1990	808	973	803	798	1085	583
"DKFZp434K016"	4196	80224	132	57	77	55	44	13	240	171	8	15	203	240	274	252	319	223
"DKFZp434K028"	939	3636	0	0	0	0	0	0	19	19	0	0	0	0	0	0	0	0
"DKFZp434K0614"	1731	94684	20045	7720	11191	8854	4245	3475	11417	2415	8760	4064	1081	1503	1543	1431	1434	749
"DKFZp434K0621"	2392	32749	2	5	2	0	2	3	358	203	0	0	30	35	34	98	216	143
"DKFZp434K0814"	1450	24260	88	0	39	49	0	0	102	0	0	0	104	90	140	75	130	57
"DKFZp434K085"	4409	68514	23	111	0	23	55	56	253	205	25	9	8	62	83	62	171	108
"DKFZp434K098"	852	77229	2554	156	1363	1191	83	73	1263	98	397	437	91	92	267	184	116	80
"DKFZp434K1118"	1039	28905	292	0	158	134	0	0	269	0	0	0	84	111	125	81	119	79
"DKFZp434K114"	2532	33318	17	0	4	13	0	0	95	21	0	0	160	96	154	79	330	173
"DKFZp434K115"	2567	88658	823	1104	405	418	576	528	806	813	84	1601	1021	1135	825	662	1028	657
"DKFZp434K1323"	2715	5398	2357	651	1267	1090	383	268	1555	664	2146	1320	623	563	7826	4833	8662	3845
"DKFZp434K191"	4643	6493	0	0	0	0	0	0	9	9	0	0	0	0	0	13	0	0
"DKFZp434K229"	1862	64027	2279	759	1348	931	405	354	1539	574	393	661	217	245	373	294	432	296
"DKFZp434K2323"	1730	2883	0	0	0	0	0	0	0	0	0	0	0	0	0	0	0	0
"DKFZp434K2435"	2573	553580	10024	7685	5609	4415	4316	3369	3702	3001	294	1994	138	149	280	218	211	216
"DKFZp434K245"	1552	43613	24	20	20	4	9	11	139	3	0	18	124	193	119	80	123	105
"DKFZp434K249"	2003	12311	3306	1485	1827	1479	778	707	1016	824	3139	2465	14549	11701	14798	8132	21144	12833
"DKFZp434L0217"	2363	32287	0	0	0	0	0	0	0	0	0	0	0	0	0	0	0	0
"DKFZp434L0312"	3141	26701	0	0	0	0	0	0	218	56	0	0	152	168	167	102	273	127
"DKFZp434L0319"	4072	85430	2	0	0	2	0	0	175	30	0	0	2	0	0	0	0	0
"DKFZp434L057"	2351	7502	384	495	197	187	279	216	359	258	88	314	994	229	375	960	590	288
"DKFZp434L0610"	1585	5317	466	331	261	205	189	142	149	108	14	16	104	172	80	49	121	57
"DKFZp434L0823"	2648	64151	43	0	27	16	0	0	64	0	0	0	327	302	321	271	361	274
"DKFZp434L1215"	1849	4408	3	14	0	3	0	14	78	47	0	21	359	426	378	451	450	408
"DKFZp434L134"	679	7613	20	0	20	0	0	0	34	21	0	0	45	29	40	30	51	24
"DKFZp434L1426"	937	1202	58	0	23	35	0	0	46	70	42	46	56	62	81	72	100	74
"DKFZp434L1715"	4106	54333	2008	765	1251	757	375	390	1331	543	386	760	2374	1902	2450	2225	2646	1644
"DKFZp434L187"	4261	18504	0	0	0	0	0	0	0	0	0	0	13	13	53	19	197	98
"DKFZp434L192"	1063	1063	0	0	0	0	0	0	0	0	0	0	0	0	0	0	0	0
"DKFZp434L2417"	7485	93436	2400	87	1328	1072	44	43	1508	76	162	111	2845	3245	2857	2206	2767	1722
"DKFZp434L2422"	2974	261982	78	10	45	33	0	10	286	8	0	0	0	10	0	2	6	1
"DKFZp434L2430"	2477	47921	0	0	0	0	0	0	58	11	0	0	0	0	0	0	0	0
"DKFZp434M0223"	1437	29913	2112	1315	1112	1000	672	643	1201	1087	2144	3454	391	316	479	534	581	452
"DKFZp434M0331"	3052	4863	0	0	0	0	0	0	0	0	0	0	0	0	0	0	0	0
"DKFZp434M0435"	1015	7353	134	53	74	60	40	13	93	103	76	64	87	125	151	118	167	89
"DKFZp434M0927"	2931	78966	0	0	0	0	0	0	0	0	0	0	27	17	34	54	116	71
"DKFZp434M098"	1865	7746	0	0	0	0	0	0	0	0	0	0	0	0	0	6	0	0
"DKFZp434M104"	2262	113713	0	0	0	0	0	0	11	0	0	0	0	0	0	0	0	0
"DKFZp434M1123"	3413	22950	267	107	129	138	79	28	296	117	137	280	304	268	403	245	504	245
"DKFZp434M131"	3581	5498	0	0	0	0	0	0	0	0	0	0	0	0	0	0	0	0
"DKFZp434M1411"	3731	8432	754	169	403	351	71	98	349	210	258	248	39	31	163	127	278	133
"DKFZp434M182"	1033	8107	676	80	352	324	36	44	463	152	0	61	1031	1060	962	602	1074	671
"DKFZp434M183"	3261	13950	448	146	239	209	87	59	336	118	173	119	93	72	248	193	379	174
"DKFZp434N035"	1966	3491	0	0	0	0	0	0	0	0	0	0	26	15	73	54	118	51
"DKFZp434N0450"	3328	10787	255	0	167	88	0	0	216	99	277	54	254	217	231	234	283	199
"DKFZp434N0510"	1288	8673	205	173	145	60	102	71	208	278	0	78	68	802	498	88	79	49
"DKFZp434N061"	1625	85290	5231	598	2995	2236	280	318	2742	365	1720	329	127	240	165	192	198	126
"DKFZp434N071"	963	64324	12000	2238	6653	5347	1244	994	6124	927	5506	1586	693	582	508	414	761	249
"DKFZp434N1720"	3399	188763	191	632	101	90	374	258	21	29	0	35	20	0	0	0	0	0
"DKFZp434N177"	1370	31478	0	0	0	0	0	0	0	0	0	0	0	0	0	0	0	0
"DKFZp434N1817"	2806	59028	7	0	7	0	0	0	61	23	0	62	62	118	95	48	0	0
"DKFZp434N2030"	2761	14670	0	0	0	0	0	0	13	0	0	0	188	167	240	140	274	130
"DKFZp434N2420"	2931	37304	6205	4279	3438	2767	2359	1920	2521	2404	6389	5468	2927	2455	2042	1789	4074	1589
"DKFZp434O0320"	2713	13831	0	0	0	0	0	0	0	7	0	0	0	0	0	0	0	0
"DKFZp434O047"	1163	4467	0	0	0	0	0	0	0	0	0	0	0	0	0	0	0	0
"DKFZp434O1119"	3063	21457	0	0	0	0	0	0	352	125	0	0	91	37	88	62	165	94
"DKFZp434O1216"	3628	23796	362	28	203	159	17	11	339	173	20	89	987	910	1092	929	1332	768
"DKFZp434O1230"	2379	3287	0	0	0	0	0	0	0	0	0	0	257	169	285	205	321	178
"DKFZp434O158"	3698	28050	117	66	81	36	25	41	104	63	0	45	413	666	636	419	577	556
"DKFZp434O171"	3064	5653	0	0	0	0	0	0	0	0	0	0	0	0	1156	975	1167	925
"DKFZp434O1830"	1728	51068	0	0	0	0	0	0	0	0	0	0	392	446	418	326	418	236
"DKFZp434O209"	3238	142098	305	71	185	120	36	35	723	167	32	125	308	274	479	510	581	393
"DKFZp434O2417"	4613	28294	0	0	0	0	0	0	138	84	0	0	0	0	0	0	0	0
"DKFZp434P0116"	1179	7113	1565	785	912	653	406	379	1058	354	641	541	476	483	838	839	557	358
"DKFZp434P0216"	4447	33842	3	0	0	3	0	0	230	80	0	0	0	0	0	0	0	0
"DKFZp434P0531"	2484	15812	459	102	245	214	33	69	316	365	60	378	531	747	595	816	819	767
"DKFZp434P055"	2998	93176	0	0	0	0	0	0	3	0	0	0	0	2	0	0	0	0
"DKFZp434P1735"	2581	169749	0	0	0	0	0	0	0	0	0	0	0	0	0	0	0	0
"DKFZp434P211"	5229	13903	0	0	0	0	0	0	33	0	0	0	4	0	0	0	0	0
"DKFZp434P241"	1485	14373	110	0	49	61	0	0	74	17	0	9	259	281	273	190	290	182
"DKFZp451A172"	2164	3228	70	4169	33	37	2219	1950	89	17367	0	5320	4	328	20	323	19	228
"DKFZp451A185"	2378	4926	529	15	307	222	0	15	290	11	458	0	221	110	387	137	571	243
"DKFZp451B1418"	5691	50224	216	308	78	138	185	123	402	579	17	525	885	1106	9332	11005	13182	8213
"DKFZp451C023"	5597	52706	0	0	0	0	0	0	179	126	0	0	0	0	0	0	0	0
"DKFZp451C205"	4025	9170	0	0	0	0	0	0	70	17	0	0	230	46	218	4	180	5
"DKFZp451D084"	4248	45180	501	18	329	172	0	18	392	23	0	140	5462	5446	5431	4297	5535	3751
"DKFZp451E015"	1285	38684	594	303	339	255	176	127	203	311	99	344	58	89	51	67	47	30
"DKFZp451E113"	1468	71936	395	13	248	147	0	13	182	17	5	0	855	781	786	698	905	706
"DKFZp451F083"	2774	95070	3267	491	1892	1375	342	149	1726	437	806	632	538	449	612	385	792	304
"DKFZp451F1115"	8294	195665	0	0	0	0	0	0	28	23	0	0	99	145	58	66	96	7
"DKFZp451F173"	3154	90504	627	2406	420	207	1335	1071	511	7017	82	15558	1390	7329	1550	1420	1719	1313
"DKFZp451G202"	6923	23275	1486	511	810	676	292	219	776	319	620	488	381	869	1012	833	1157	580
"DKFZp451I0318"	4236	224902	0	0	0	0	0	0	23	0	0	0	0	0	0	0	0	0
"DKFZp451I053"	1427	9838	174	2207	89	85	1283	924	82	754	49	1343	322	572	865	1162	1031	783
"DKFZp451J181"	807	807	516	31	290	226	31	0	245	267	0	0	789	1019	956	951	1227	845
"DKFZp451K134"	2971	4010	808	747	478	330	80	667	229	112	88	467	251	649	346	449	369	220
"DKFZp451K1417"	3280	93320	758	198	441	317	144	54	607	258	170	578	171	147	167	123	217	292
"DKFZp451K202"	5779	49312	0	0	0	0	0	0	84	0	0	0	395	441	219	208	319	194
"DKFZp451M023"	5497	102411	3	0	0	3	0	0	0	0	0	0	0	0	0	0	0	0
"DKFZp451M2119"	1193	71081	1074	92	579	495	47	45	1199	100	0	92	153	219	73	37	107	74
"DKFZp451N043"	5583	77524	16	65	0	16	34	31	5	1	2	13	51	46	10	27	20	8
"DKFZp451N147"	4623	47771	2592	2273	1401	1191	1199	1074	1343	1566	1385	3747	5511	6634	3663	3528	4348	2597
"DKFZp451P074"	1575	45516	0	0	0	0	0	0	9	0	0	0	0	0	0	0	0	0
"DKFZp547A023"	1446	6625	2516	912	1604	912	457	455	768	602	787	487	2293	2184	1614	983	2542	1225
"DKFZp547B0714"	2477	35940	42	0	25	17	0	0	12	0	0	0	28	0	6	0	6	0
"DKFZp547B159"	1619	11929	7840	7352	4211	3629	3905	3447	2371	2846	6436	6415	6269	7333	7536	6616	9061	6359
"DKFZp547C039"	561	15769	164	15	144	20	15	0	35	0	0	0	35	226	32	0	64	0
"DKFZp547E087"	5038	55213	1085	1180	563	522	662	518	426	328	381	1054	51	123	1543	1973	1799	918
"DKFZp547E092"	3107	23774	1718	1061	951	767	609	452	967	761	1168	1635	807	786	1161	1030	1493	908
"DKFZp547G0215"	2724	45048	1	0	0	1	0	0	0	0	0	0	0	0	0	0	0	0
"DKFZp547G125"	1999	9978	138	46	67	71	28	18	173	47	0	21	337	248	220	256	152	307
"DKFZp547H074"	2140	19267	0	0	0	0	0	0	0	0	0	0	0	0	0	0	0	0
"DKFZp547H118"	1810	1810	282	327	160	122	174	153	234	101	0	198	809	969	1099	1101	1156	953
"DKFZp547H1310"	3676	20707	1	0	0	1	0	0	21	17	0	0	2	2	0	0	0	0
"DKFZp547H1810"	3082	20417	1059	718	596	463	405	313	649	480	696	1197	2469	2509	2429	2104	3525	2233
"DKFZp547I014"	621	621	0	0	0	0	0	0	0	0	0	0	0	0	0	0	0	0
"DKFZp547I1415"	622	117726	666	38	425	241	20	18	727	428	0	42	60	79	88	50	119	51
"DKFZp547I166"	2346	18543	897	1707	502	395	934	773	319	669	322	1515	1943	863	840	628	694	469
"DKFZp547I194"	1597	4196	601	148	284	317	84	64	302	292	100	72	435	318	406	325	437	169
"DKFZp547J0513"	2143	34761	8766	2030	4854	3912	1171	859	3862	1094	7216	3214	6094	5401	2630	1421	3186	1631
"DKFZp547J226"	2473	338684	0	0	0	0	0	0	0	0	0	0	0	0	0	0	0	0
"DKFZp547J2313"	4150	4572	0	0	0	0	0	0	0	0	0	0	0	0	0	0	0	0
"DKFZp547K152"	923	12795	143	106	71	72	49	57	204	304	185	369	148	191	158	203	188	155
"DKFZp547K246"	2008	24420	286	78	115	171	47	31	492	190	160	72	240	304	372	395	1998	338
"DKFZp547L2113"	981	13070	103	0	56	47	0	0	38	42	0	43	146	207	129	118	149	125
"DKFZp547M109"	2377	7762	0	1	0	0	1	0	10	0	0	0	0	2	0	0	8	0
"DKFZp547N1117"	2324	57189	2188	2688	1212	976	1495	1193	1186	1250	243	1438	1598	3075	1717	2399	1821	1605
"DKFZp547N203"	3908	27112	956	169	514	442	127	42	842	381	182	162	0	2	0	0	0	0
"DKFZp547O0715"	2140	52866	16144	26305	10820	5324	13580	12725	5200	5067	5211	8351	444	668	426	414	427	207
"DKFZp547O117"	908	29167	155	3	86	69	3	0	394	87	68	19	36	43	65	64	72	56
"DKFZp547P028"	2356	6509	172	81	102	70	47	34	92	108	17	21	358	400	377	427	601	388
"DKFZp547P055"	1818	7014	28	12	18	10	12	0	33	0	0	0	117	101	183	99	119	61
"DKFZp564A0122"	2602	15714	333	0	168	165	0	0	485	63	177	0	1595	697	2610	1278	2145	1296
"DKFZp564A202"	1885	24520	739	183	425	314	94	89	492	145	545	163	1259	1139	1630	1244	1853	1307
"DKFZp564B0982"	2977	15936	696	452	400	296	225	227	389	244	90	193	1149	1578	2148	2447	2011	1771
"DKFZp564B1172"	1215	8450	20	9	0	20	0	9	0	14	0	20	396	359	259	192	375	242
"DKFZp564B172"	1518	25757	5972	20931	3433	2539	11248	9683	1929	10063	2138	11485	3080	10340	3135	7147	3213	3268
"DKFZp564C0362"	1773	331401	1531	622	895	636	399	223	1770	757	55	131	132	251	161	93	146	86
"DKFZp564C0469"	1080	36068	3	0	3	0	0	0	17	5	0	0	70	65	49	40	63	33
"DKFZp564C0716"	1939	8944	79	15	34	45	0	15	308	154	0	0	518	494	432	402	780	644
"DKFZp564C1664"	1813	21780	375	49	210	165	32	17	100	50	0	65	1096	789	1096	617	1334	835
"DKFZp564C2082"	2115	28303	233	13	150	83	8	5	258	50	26	126	252	175	226	167	277	199
"DKFZp564C236"	1816	9507	2456	1183	1433	1023	517	666	1420	464	1155	745	639	606	3633	2255	4674	2268
"DKFZp564C2478"	3186	16184	73	13	34	39	13	0	64	120	0	99	306	390	762	914	709	758
"DKFZp564D0478"	1773	14256	203	12	116	87	0	12	228	262	35	130	534	520	1064	1166	589	337
"DKFZp564D116"	1443	10623	33	0	27	6	0	0	112	0	10	43	335	326	505	422	474	418
"DKFZp564D172"	4758	493974	9781	6167	5674	4107	3468	2699	7148	5180	1276	5194	2946	3450	1582	1448	1801	1515
"DKFZp564E0482"	3411	11949	0	0	0	0	0	0	15	62	0	0	3	0	0	0	0	0
"DKFZp564E1082"	2823	2823	816	185	309	507	72	113	488	407	234	921	2011	1968	1342	1176	1516	727
"DKFZp564E242"	1487	12061	491	309	248	243	153	156	277	197	106	307	1943	1776	2268	2005	2719	1618
"DKFZp564F0522"	2567	15635	618	534	386	232	162	372	235	254	197	297	942	1019	920	814	975	269
"DKFZp564F1378"	2455	21192	1109	179	600	509	72	107	541	70	0	38	2349	2181	1597	1115	1845	1101
"DKFZp564G1016"	1527	3416	46	0	15	31	0	0	158	99	0	0	199	281	285	266	405	337
"DKFZp564H012"	992	8440	82	35	54	28	16	19	90	53	0	121	580	869	570	792	683	612
"DKFZp564H0664"	1539	10297	1138	19	679	459	11	8	475	23	69	35	379	113	239	67	381	232
"DKFZp564H1122"	803	18233	146	7	86	60	3	4	137	4	0	44	219	213	241	208	276	207
"DKFZp564I1782"	1375	5815	0	229	0	0	125	104	0	155	0	0	16	235	47	244	10	41
"DKFZp564I2064"	2130	35163	12	20	12	0	11	9	98	18	0	0	472	463	369	367	415	331
"DKFZp564I2178"	1620	20487	182	0	78	104	0	0	178	66	52	0	205	188	207	154	261	164
"DKFZp564J047"	1901	35524	0	0	0	0	0	0	25	0	0	0	22	0	0	0	0	0
"DKFZp564J0863"	677	12936	118	14	77	41	7	7	104	25	0	40	0	0	227	129	241	105
"DKFZp564J1082"	2028	28591	1469	1427	591	878	844	583	716	781	681	1275	791	3574	4569	4367	3001	2443
"DKFZp564K0223"	1683	6875	1761	666	969	792	334	332	648	255	1574	320	3905	3434	7442	5950	6834	4831
"DKFZp564K142"	3655	69203	556	711	287	269	379	332	205	724	47	671	540	678	2076	1969	1813	1386
"DKFZp564K192"	1544	140232	4614	1233	2608	2006	698	535	2230	537	632	494	259	250	323	291	546	351
"DKFZp564L0678"	2228	23962	1355	1119	867	488	592	527	691	780	657	2293	25	48	459	261	594	302
"DKFZp564M0764"	3721	44185	1432	665	795	637	346	319	787	284	932	456	1687	1062	1134	360	1287	350
"DKFZp564M082"	1557	6400	0	0	0	0	0	0	52	43	0	0	369	353	524	510	661	504
"DKFZp564M1416"	4487	71411	807	254	500	307	178	76	469	97	151	206	643	585	444	465	729	428
"DKFZp564M1672"	1481	5706	1188	276	702	486	157	119	520	178	1458	312	3224	2238	3387	1595	3861	2377
"DKFZp564M2223"	2760	12647	907	414	479	428	241	173	447	229	343	439	3059	3363	3757	3126	4323	3144
"DKFZp564M2422"	1417	11600	4861	67212	3766	1095	36286	30926	39	28031	19	48241	4670	167400	1406	63162	1197	26676
"DKFZp564N1062"	1963	44857	301	40	146	155	28	12	307	10	24	33	11	428	112	261	123	348
"DKFZp564N2378"	1248	15581	397	30	205	192	15	15	221	172	184	119	788	860	1301	837	1656	1080
"DKFZp564O043"	2622	45987	768	191	417	351	148	43	587	30	22	65	111	356	680	347	787	439
"DKFZp564O052"	2341	29634	848	751	530	318	422	329	423	446	205	486	267	438	619	561	607	481
"DKFZp564O0523"	4096	9233	52	0	12	40	0	0	70	25	0	0	339	290	304	173	330	122
"DKFZp564O0582"	2127	25672	654	315	358	296	194	121	211	92	213	86	6424	6782	8332	7836	8010	6644
"DKFZp564O092"	647	2028	13	89	7	6	50	39	27	39	0	1	269	463	241	220	338	194
"DKFZp564O123"	2540	28286	213	9	151	62	9	0	132	31	0	0	1435	1657	1488	1388	1662	1267
"DKFZp564O1762"	1789	6230	0	0	0	0	0	0	29	17	0	0	35	12	41	59	46	13
"DKFZp564O1822"	1650	6679	357	45	225	132	26	19	299	78	355	18	894	379	1350	634	2128	738
"DKFZp564O2082"	1984	2215	43	5	36	7	1	4	13	23	0	0	139	145	160	109	159	135
"DKFZp564P0662"	2290	28458	358	92	222	136	37	55	297	113	140	60	475	480	760	615	942	635
"DKFZp566A0646"	2937	53646	1365	335	765	600	202	133	917	672	135	528	470	556	510	1073	637	1061
"DKFZp566B1524"	1716	20819	286	83	128	158	57	26	273	274	193	182	1216	1620	1400	944	1686	995
"DKFZp566C224"	5786	88874	9639	11016	5372	4267	5944	5072	3822	5724	2140	6614	3661	789	4171	3800	4425	3166
"DKFZp566D193"	1844	8320	0	0	0	0	0	0	72	0	0	0	927	121	763	526	968	655
"DKFZp566D244"	2397	29924	1268	517	757	511	265	252	562	412	542	647	1148	1323	1495	1163	1638	1160
"DKFZp566F0947"	528	528	0	0	0	0	0	0	0	0	0	0	0	10	0	0	0	0
"DKFZp566F123"	1517	460055	6836	2353	3886	2950	1386	967	6732	3245	670	2038	4	43	0	0	0	3
"DKFZp566F223"	1752	3209	0	0	0	0	0	0	0	0	0	0	0	6	17	793	507	574
"DKFZp566H073"	759	1796	1724	721	839	885	108	613	437	1038	113	1622	629	693	687	598	1046	909
"DKFZp566H1924"	1844	73410	12655	9411	7083	5572	5145	4266	5194	5572	6703	10010	3689	4751	2358	4010	4954	3616
"DKFZp566I1024"	1910	16449	925	186	545	380	97	89	251	79	412	36	2806	2395	2233	1873	2566	1815
"DKFZp566J2324"	264	17468	789	399	408	381	210	189	351	342	747	776	1007	385	571	413	705	393
"DKFZp566K023"	1447	11207	330	0	213	117	0	0	262	0	135	12	478	290	382	142	368	158
"DKFZp566K0247"	1453	19794	1	0	1	0	0	0	0	0	0	0	5	0	0	0	0	0
"DKFZp566K1924"	1387	26877	0	0	0	0	0	0	0	0	0	0	4	16	32	39	82	67
"DKFZp566L1346"	1928	4526	565	226	393	172	140	86	351	194	650	219	3049	2631	3784	2780	4877	2993
"DKFZp566L241"	2966	4013	5357	8013	3031	2326	4216	3797	1691	3892	2766	2707	6085	93	3512	3047	3830	2542
"DKFZp566M051"	1968	5316	400	0	207	193	0	0	112	104	136	85	58	1765	3034	1717	2885	1820
"DKFZp566M114"	1689	8070	93	27	51	42	16	11	36	8	0	16	54	52	39	44	51	35
"DKFZp566N034"	1778	312005	80	13	51	29	0	13	105	71	0	0	0	0	0	0	0	0
"DKFZp566N1646"	1323	65209	1	0	1	0	0	0	0	25	21	0	34	45	31	32	22	20
"DKFZp566O011"	2275	25489	4138	1275	2256	1882	709	566	1023	744	4262	3421	1285	2630	1408	630	2064	756
"DKFZp566P0524"	1693	69271	0	0	0	0	0	0	0	0	0	0	0	0	0	0	0	0
"DKFZp571N1833"	2916	14762	47	9	31	16	9	0	114	0	0	0	170	145	247	76	273	117
"DKFZp572F2170"	2804	5737	0	0	0	0	0	0	0	0	0	0	0	0	0	0	0	0
"DKFZp586A011"	1939	12124	890	279	511	379	131	148	410	157	477	253	964	587	911	500	1126	421
"DKFZp586A0522"	1192	5773	516	130	480	36	52	78	460	79	517	53	7993	6852	2359	1618	2587	1463
"DKFZp586A1021"	4097	5205	885	527	438	447	286	241	469	619	541	1189	2203	2134	2254	1762	2592	2313
"DKFZp586B0424"	5007	23366	187	53	120	67	30	23	212	55	23	23	419	363	518	438	462	333
"DKFZp586B1222"	3262	19812	2404	2882	1311	1093	1494	1388	703	1467	1166	2679	1089	1198	1133	940	1332	672
"DKFZp586D0624"	2477	6092	197	43	92	105	28	15	179	38	305	0	601	487	585	395	746	535
"DKFZp586D0919"	2788	9942	145	191	82	63	65	126	128	271	109	192	234	319	292	256	377	327
"DKFZp586D0922"	1266	3383	0	0	0	0	0	0	32	0	0	0	0	0	0	0	0	0
"DKFZp586D1521"	1362	2232	90	14	45	45	14	0	52	13	3	21	22	69	44	86	92	0
"DKFZp586D1717"	2121	30327	909	202	489	420	125	77	518	178	226	290	397	255	368	216	473	242
"DKFZp586D211"	4268	107417	112	64	69	43	28	36	153	91	39	47	368	433	376	269	396	248
"DKFZp586E0820"	1373	17670	37	24	15	22	7	17	122	85	21	53	128	174	176	156	255	130
"DKFZp586E1222"	3886	22550	553	122	260	293	73	49	198	8	232	0	425	283	389	254	422	278
"DKFZp586E1322"	3020	3020	0	0	0	0	0	0	30	0	0	0	31	39	30	35	38	42
"DKFZp586F0222"	2095	11186	2863	2724	1554	1309	1458	1266	1045	1044	1104	1629	2446	3370	3519	3724	3753	2753
"DKFZp586F1318"	3386	46607	388	81	248	140	26	55	419	42	0	37	254	265	213	172	267	155
"DKFZp586F1919"	1775	5620	0	0	0	0	0	0	0	0	0	0	69	83	34	8	109	65
"DKFZp586G0322"	3377	3377	1678	1294	948	730	730	564	1018	647	291	801	483	689	237	231	770	412
"DKFZp586G1517"	3367	227034	4446	3868	2470	1976	2217	1651	2107	1953	603	2535	657	743	919	855	797	639
"DKFZp586G2119"	2173	9721	1161	325	642	519	285	40	469	262	216	10	883	792	1384	216	1249	610
"DKFZp586H021"	1981	120634	79	0	43	36	0	0	62	19	12	0	202	184	191	143	156	136
"DKFZp586H1320"	1933	36455	1641	456	891	750	285	171	954	883	1480	1387	3484	3220	3676	3347	4215	3113
"DKFZp586H1322"	620	4183	13	0	0	13	0	0	37	55	0	7	60	63	90	51	81	56
"DKFZp586H2219"	2752	172914	8326	2759	4773	3553	1595	1164	4588	1717	1881	2946	1337	1484	1289	1269	1751	1328
"DKFZp586I1023"	1685	27291	53	0	53	0	0	0	94	57	25	57	186	279	1397	872	1352	1139
"DKFZp586I1223"	2398	32057	764	620	405	359	318	302	467	365	92	379	1331	1733	1636	1550	2001	1372
"DKFZp586I1520"	3351	62168	5313	1526	2920	2393	812	714	3079	1505	4132	2796	1453	1130	1695	1141	2265	752
"DKFZp586I2223"	3355	17104	2982	683	1523	1459	361	322	1452	311	2780	416	1012	694	2693	1468	3254	1500
"DKFZp586J0119"	1748	6105	397	13	191	206	5	8	157	76	38	60	804	688	834	555	1118	362
"DKFZp586J1624"	3101	10330	256	131	136	120	70	61	147	233	370	284	834	822	1237	1431	1800	1241
"DKFZp586K0821"	1684	19135	766	164	431	335	94	70	459	110	405	176	2297	2091	2399	1946	3849	1876
"DKFZp586L0724"	2413	26207	11	54	11	0	34	20	110	61	0	102	377	428	765	743	929	640
"DKFZp586M1120"	381	8795	182	12	94	88	12	0	114	0	217	0	55	59	108	0	144	0
"DKFZp586M1622"	5015	16752	961	371	544	417	158	213	455	366	624	646	1624	1871	2203	2331	2240	1404
"DKFZp586M2023"	1599	153503	2715	1973	1564	1151	1117	856	2166	1813	165	1271	9	786	1132	1065	1168	878
"DKFZp586N0222"	1744	21493	6	0	6	0	0	0	10	0	0	0	118	120	149	98	196	142
"DKFZp586O0223"	2865	49653	2365	946	1221	1144	487	459	1148	637	1019	1164	1558	1319	1736	1228	2200	1307
"DKFZp586O1224"	2031	5380	18	45	18	0	32	13	18	15	0	57	309	435	207	235	318	219
"DKFZp586P0123"	4053	73168	486	166	287	199	92	74	333	135	24	153	309	341	464	429	432	328
"DKFZp586P1420"	375	871	46	0	22	24	0	0	14	4	0	6	142	140	83	131	87	116
"DKFZp586P2219"	2150	21372	1175	2126	631	544	1054	1072	561	1196	201	2017	174	183	177	139	218	87
"DKFZp666A071"	1730	6704	10	0	2	8	0	0	16	46	0	0	115	102	147	99	314	213
"DKFZp666A163"	2464	75283	5368	561	3196	2172	310	251	2353	428	644	653	1029	1151	655	760	1350	391
"DKFZp666C019"	2681	34512	769	465	444	325	221	244	803	381	132	162	935	954	1196	1135	1360	1027
"DKFZp666C072"	3149	25539	74	0	42	32	0	0	81	0	36	0	300	9	279	71	325	115
"DKFZp666C074"	2267	11471	0	0	0	0	0	0	0	0	0	0	0	0	0	0	0	0
"DKFZp666C094"	2040	2920	54	1	35	19	0	1	41	15	0	0	67	71	50	67	123	70
"DKFZp666C185"	4058	44724	21	11	14	7	11	0	154	81	0	0	1004	1084	883	808	1256	465
"DKFZp666D0110"	484	38452	549	137	323	226	77	60	237	168	91	282	143	190	341	407	190	131
"DKFZp666E123"	3448	54771	1544	338	841	703	241	97	1280	266	338	600	160	202	203	166	162	95
"DKFZp666E157"	2863	32104	2664	308	1533	1131	198	110	1017	128	1755	467	161	136	115	87	72	13
"DKFZp666F025"	828	3913	0	0	0	0	0	0	0	0	0	0	41	24	45	21	57	27
"DKFZp666F111"	1563	3999	65	0	13	52	0	0	31	12	6	0	157	230	157	180	257	176
"DKFZp666F229"	2463	66837	399	38	244	155	11	27	622	190	19	47	499	434	355	292	629	356
"DKFZp666F238"	1332	28025	316	4	197	119	0	4	604	74	227	103	291	372	305	177	389	131
"DKFZp666G057"	3353	22081	0	0	0	0	0	0	0	0	0	0	0	0	0	0	0	0
"DKFZp666G172"	1973	7656	5	0	5	0	0	0	57	50	0	0	0	0	0	0	0	0
"DKFZp666H042"	2357	10438	7065	3769	3766	3299	2036	1733	3029	2199	6762	4076	3033	3858	5250	3821	7508	3998
"DKFZp666I142"	1575	19444	225	0	149	76	0	0	261	0	0	0	605	570	768	750	1042	878
"DKFZp666I2110"	2974	34491	435	53	234	201	24	29	383	96	2	35	337	197	421	210	506	223
"DKFZp666I2310"	5843	11965	362	220	175	187	128	92	251	229	73	188	87	123	74	98	79	61
"DKFZp666J235"	2658	234052	0	0	0	0	0	0	95	21	0	0	0	0	0	0	0	0
"DKFZp666K071"	1050	21125	329	33	181	148	33	0	221	135	0	101	311	260	481	357	567	351
"DKFZp666K117"	3233	3233	148	10	71	77	10	0	168	91	0	0	0	15	0	3	0	4
"DKFZp666K145"	1807	23341	4366	958	2387	1979	473	485	1619	570	3480	1150	3076	2886	4292	3210	4938	2971
"DKFZp666L095"	3016	92335	53	0	19	34	0	0	112	0	0	4	473	527	576	462	475	312
"DKFZp666M044"	3007	24731	140	0	72	68	0	0	199	20	0	14	366	201	467	137	480	156
"DKFZp666O0110"	4277	342832	436	94	253	183	53	41	764	155	16	76	358	318	844	782	695	631
"DKFZp666P032"	2783	156749	0	0	0	0	0	0	19	8	4	0	5	11	0	0	0	0
"DKFZp666P073"	10875	67400	675	613	347	328	356	257	508	205	271	489	1054	1209	496	420	465	346
"DKFZp666P158"	3428	64941	1964	260	1050	914	135	125	1092	327	776	151	474	435	694	634	738	587
"DKFZp667A196"	2224	29445	427	347	216	211	210	137	370	513	239	866	1913	2578	2720	3223	3076	2498
"DKFZp667B1610"	2101	43467	0	0	0	0	0	0	0	0	0	0	0	0	0	0	0	0
"DKFZp667B165"	3931	55832	1873	323	1073	800	180	143	1067	252	570	521	576	2669	967	840	910	1414
"DKFZp667C045"	3390	22621	877	183	517	360	98	85	314	60	229	136	783	1017	671	578	706	501
"DKFZp667C165"	1720	127765	294	41	224	70	24	17	381	123	38	51	50	85	61	94	52	42
"DKFZp667D0116"	2852	25746	0	36	0	0	22	14	0	8	0	9	0	35	0	9	0	0
"DKFZp667E1116"	4011	34953	13018	12758	7110	5908	6769	5989	3916	9491	8373	19579	5863	8855	5750	10471	8944	8781
"DKFZp667E137"	3023	25470	0	0	0	0	0	0	0	0	0	0	0	0	0	0	0	0
"DKFZp667E1824"	2730	30904	1868	1146	1087	781	652	494	1135	632	296	887	531	726	641	457	656	372
"DKFZp667F012"	2706	14581	835	284	452	383	132	152	380	208	503	237	1033	1337	1161	978	2269	1278
"DKFZp667F0310"	6982	33174	8142	2272	4662	3480	1264	1008	4783	1313	2292	1315	4079	15816	6698	4978	5747	3714
"DKFZp667F1514"	2163	21955	2646	3947	1451	1195	2112	1835	943	2629	1135	4239	5487	7310	5221	5206	7065	5181
"DKFZp667F2121"	3715	64359	668	6759	387	281	3701	3058	93	3315	0	1584	290	1383	427	524	245	236
"DKFZp667G2110"	1259	20747	1267	397	690	577	220	177	604	179	33	157	1703	1832	1109	744	2001	1033
"DKFZp667G248"	2457	31362	285	18	198	87	0	18	218	12	0	0	148	114	252	280	292	216
"DKFZp667H0616"	2306	34785	1448	663	812	636	364	299	834	504	673	524	675	879	885	984	785	534
"DKFZp667H0925"	2853	42502	1074	206	628	446	136	70	214	163	448	242	164	217	545	461	590	348
"DKFZp667I0310"	3266	302780	11917	41358	6567	5350	22476	18882	5922	13644	214	13508	659	666	922	705	773	580
"DKFZp667I0324"	1778	1888	0	0	0	0	0	0	0	0	0	0	0	0	0	0	0	0
"DKFZp667I093"	1297	106966	137	1329	69	68	672	657	169	694	0	121	494	567	591	570	713	252
"DKFZp667I103"	2091	18989	4749	7996	2592	2157	4056	3940	688	2481	909	1807	610	979	854	663	952	617
"DKFZp667J1224"	2531	17730	896	236	399	497	145	91	257	187	145	138	213	930	436	488	810	446
"DKFZp667J1615"	4156	95055	0	0	0	0	0	0	11	0	0	0	0	0	0	0	0	0
"DKFZp667K0918"	3556	72619	7185	1660	3876	3309	907	753	3641	640	2214	731	1567	1383	1636	1211	3142	1129
"DKFZp667K1925"	2078	166085	16111	7385	9024	7087	4134	3251	9118	4657	4408	5272	4749	5881	4505	1326	1738	1189
"DKFZp667M2411"	4606	61003	870	121	496	374	74	47	510	131	226	111	723	570	605	426	701	343
"DKFZp667N0420"	6637	57071	0	0	0	0	0	0	16	3	0	0	61	164	21	55	20	33
"DKFZp667N066"	1046	19168	7	15	5	2	9	6	85	10	0	11	122	94	235	105	121	75
"DKFZp667N1320"	5821	96499	559	10	325	234	10	0	377	21	96	62	731	733	761	550	1053	629
"DKFZp667P0924"	2842	51493	621	155	406	215	67	88	716	345	139	117	0	43	66	78	78	36
"DKFZp686A01208"	3562	4641	1154	238	430	724	92	146	35	184	476	1783	889	852	1592	1616	1891	5305
"DKFZp686A09136"	4607	15406	2781	664	1512	1269	328	336	307	591	1061	567	539	2169	2435	1395	3112	1632
"DKFZp686A11192"	2881	38663	11159	13914	6262	4897	7493	6421	4373	5280	6279	11804	5298	5636	7047	7005	6192	5810
"DKFZp686A1627"	4606	72132	0	0	0	0	0	0	20	26	0	0	0	0	0	0	0	0
"DKFZp686B07190"	3531	3531	6248	8916	3472	2776	4841	4075	4141	4072	3630	5309	4556	6671	4794	4126	4724	3043
"DKFZp686B1027"	3535	16857	2	0	0	2	0	0	63	30	0	0	0	0	0	0	0	0
"DKFZp686B203"	5666	65493	0	0	0	0	0	0	10	9	0	16	4	3	6	0	30	0
"DKFZp686B222"	1324	13884	276	13	151	125	13	0	201	52	220	0	89	69	54	31	32	38
"DKFZp686B22249"	4887	24029	2368	465	904	1464	263	202	1484	207	1137	209	1864	1848	1610	1152	1905	892
"DKFZp686B2235"	1156	32888	35	0	23	12	0	0	191	0	0	33	456	347	371	187	391	198
"DKFZp686C09209"	1806	14801	0	0	0	0	0	0	113	32	0	0	0	5	6	10	24	14
"DKFZp686C17209"	2989	38663	11159	13914	6262	4897	7493	6421	4373	5280	6279	11804	5298	5636	7047	7005	6192	5810
"DKFZp686C19121"	5307	5307	0	0	0	0	0	0	122	0	0	0	0	0	0	0	0	0
"DKFZp686C24272"	824	7287	19	0	0	19	0	0	90	35	0	0	80	92	1714	1002	2273	1803
"DKFZp686D0714"	2699	164287	0	0	0	0	0	0	0	0	0	0	0	0	0	0	0	0
"DKFZp686D09174"	4277	14121	299	152	168	131	97	55	108	121	179	138	516	544	1245	1223	1335	1176
"DKFZp686E0469"	1952	2063	0	0	0	0	0	0	0	0	0	0	0	0	0	0	0	0
"DKFZp686E07118"	4300	27490	20	20	12	8	10	10	0	0	0	0	0	0	0	0	0	0
"DKFZp686E10165"	1821	49855	48	29	22	26	16	13	66	38	0	23	202	251	198	190	227	156
"DKFZp686E10196"	2685	30735	932	270	519	413	156	114	598	314	223	335	1457	1292	463	301	875	399
"DKFZp686E14208"	2715	46877	11754	9613	6171	5583	4491	5122	4929	3207	5472	29781	5392	4799	7485	5725	6280	6482
"DKFZp686E1450"	1624	113196	955	470	566	389	280	190	857	493	66	417	314	217	222	107	183	109
"DKFZp686E22155"	2741	10236	23	0	16	7	0	0	31	0	0	0	48	56	69	70	98	55
"DKFZp686F0183"	2877	141343	2819	752	1805	1014	394	358	1874	833	272	660	906	998	998	763	1088	821
"DKFZp686F1316"	1307	8068	0	0	0	0	0	0	0	0	0	0	0	0	0	0	0	0
"DKFZp686F19123"	5170	10731	146	61	73	73	26	35	95	85	0	234	2994	3003	2906	2903	3269	2659
"DKFZp686G01261"	4209	23434	4501	1339	2221	2280	745	594	2137	510	3914	1101	4275	3656	3220	1783	3988	3179
"DKFZp686G04235"	1936	6517	296	58	153	143	31	27	141	222	55	139	1753	694	3046	3234	1757	1625
"DKFZp686G052"	3468	5495	325	73	176	149	52	21	228	62	130	153	152	149	180	99	152	50
"DKFZp686G1024"	3043	7768	0	0	0	0	0	0	66	19	0	0	0	0	0	0	0	0
"DKFZp686G1626"	6108	10347	0	0	0	0	0	0	0	0	0	4	0	0	0	0	0	0
"DKFZp686G18222"	4195	7187	1039	778	555	484	389	389	402	380	524	589	2915	3180	2802	1105	3439	1389
"DKFZp686G21125"	905	2680	1	2	0	1	2	0	35	10	0	0	4	0	0	3	4	9
"DKFZp686H10114"	2531	19244	14535	15061	8153	6382	8202	6859	7979	8037	3867	11238	937	1188	431	575	418	388
"DKFZp686H10220"	2049	12068	3235	901	1333	1902	438	463	1053	573	4069	2713	2896	2346	4549	5194	3711	2251
"DKFZp686H12134"	2479	56756	1507	399	869	638	187	212	2288	1376	369	607	862	706	1140	720	1205	517
"DKFZp686H1615"	3023	58265	0	0	0	0	0	0	0	0	0	0	0	0	0	0	0	0
"DKFZp686H1993"	4685	5739	0	0	0	0	0	0	11	0	0	0	0	0	0	0	0	0
"DKFZp686I0230"	4048	107274	0	0	0	0	0	0	14	0	0	0	4	8	0	12	0	0
"DKFZp686I0613"	3747	27842	105	0	39	66	0	0	99	0	0	0	292	303	317	209	328	161
"DKFZp686I1251"	985	64943	250	929	129	121	561	368	129	441	0	208	301	641	257	248	386	228
"DKFZp686I15204"	2647	16769	0	0	0	0	0	0	0	0	0	0	0	0	0	0	0	0
"DKFZp686I15217"	1576	3205	63	14	32	31	0	14	78	0	0	0	84	23	32	0	40	4
"DKFZp686I1710"	6164	45992	7652	1350	4242	3410	731	619	1686	547	2327	638	14542	4896	3515	2187	22197	6581
"DKFZp686I21167"	6380	25554	3949	17780	2031	1918	9456	8324	972	6811	987	11128	4319	14725	246	918	244	330
"DKFZp686J07132"	1501	90407	12202	14072	6945	5257	7647	6425	4118	7787	3924	15876	2703	3775	1696	588	155	566
"DKFZp686J1569"	2352	2352	0	0	0	0	0	0	0	0	0	0	37	17	61	0	100	31
"DKFZp686J1895"	4885	58954	12	12	3	9	7	5	13	0	23	6	37	111	31	42	133	62
"DKFZp686K01114"	6902	59072	0	0	0	0	0	0	43	0	0	0	4	0	5	0	5	0
"DKFZp686K0193"	5988	104190	376	409	214	162	229	180	304	161	47	128	702	735	1115	1064	1069	885
"DKFZp686K03100"	3943	317278	204	121	128	76	69	52	380	241	21	115	343	394	420	343	510	362
"DKFZp686K04236"	3611	9428	0	0	0	0	0	0	0	0	0	0	0	0	0	0	0	0
"DKFZp686K0542"	6155	17937	4018	3313	2257	1761	1890	1423	1968	1763	1344	3007	5034	6262	4477	3949	5735	3564
"DKFZp686K2089"	1920	35033	0	0	0	0	0	0	0	0	0	0	0	0	2	0	0	0
"DKFZp686K221"	1671	41241	193	52	110	83	31	21	167	187	0	73	1277	1468	900	849	912	669
"DKFZp686K23100"	679	9061	617	449	321	296	261	188	274	277	43	197	337	100	198	0	228	0
"DKFZp686K2366"	9543	33423	4031	3461	2209	1822	1885	1576	2017	1212	855	1831	1772	1644	1884	1094	1952	1025
"DKFZp686L04275"	1671	4278	2418	1491	1325	1093	766	725	687	512	859	752	70333	10937	105252	16436	138415	85474
"DKFZp686L07201"	695	88286	4845	3018	2649	2196	1630	1388	1904	1424	1491	2232	486	708	599	807	732	375
"DKFZp686L08115"	1637	20103	2549	2257	1469	1080	1379	878	1274	1118	1520	2581	1656	1816	1906	2690	2629	2166
"DKFZp686L23131"	3252	29621	3908	576	694	3214	287	289	619	240	147	268	194	218	373	354	436	430
"DKFZp686M0619"	4230	41671	839	700	492	347	402	298	497	355	3	132	1890	2077	1452	1160	2046	1356
"DKFZp686M1483"	2362	39537	3688	3359	2083	1605	1845	1514	1791	1525	1252	3358	587	654	668	546	697	405
"DKFZp686N0154"	3062	16362	427	28	190	237	13	15	340	9	93	0	230	235	245	168	324	219
"DKFZp686N18198"	1969	4087	0	0	0	0	0	0	55	12	0	0	25	17	13	10	28	16
"DKFZp686N23123"	5153	159100	209	100	121	88	53	47	269	316	0	200	137	169	277	231	215	134
"DKFZp686N23273"	2791	7731	0	0	0	0	0	0	19	0	0	0	195	168	444	400	341	248
"DKFZp686O04253"	2212	93201	0	0	0	0	0	0	0	0	0	0	0	0	0	0	0	0
"DKFZp686O05147"	829	32367	354	29	173	181	17	12	311	53	251	51	488	463	447	460	629	448
"DKFZp686O088"	6728	39369	0	0	0	0	0	0	47	10	0	0	0	0	0	0	0	0
"DKFZp686O11112"	5684	124669	5826	12469	3385	2441	6722	5747	2197	5202	275	6520	1592	1899	1162	993	1451	922
"DKFZp686O16111"	2189	17114	30	0	13	17	0	0	3	0	0	0	15	15	25	18	21	17
"DKFZp686O16217"	2538	224575	18	25	0	18	25	0	869	315	54	68	389	420	216	238	548	359
"DKFZp686O2082"	1655	13111	129	0	95	34	0	0	77	0	0	0	815	840	854	420	829	317
"DKFZp686O22169"	8156	31827	449	162	240	209	82	80	802	335	759	252	6592	6780	27246	33417	15913	18006
"DKFZp686O2396"	1224	22398	39	2	12	27	2	0	97	19	0	43	941	716	385	295	360	224
"DKFZp686O248"	6046	97440	133	23	81	52	7	16	138	9	26	40	14	46	36	39	31	11
"DKFZp686P0288"	5532	49536	0	0	0	0	0	0	0	0	0	0	0	0	594	259	545	256
"DKFZp686P10213"	2630	37768	11	0	0	11	0	0	0	0	0	0	0	0	0	0	0	0
"DKFZp686P13218"	1639	16245	0	0	0	0	0	0	0	0	0	0	0	0	0	0	0	0
"DKFZp686P19215"	1463	1463	0	0	0	0	0	0	0	0	0	0	0	0	0	0	0	0
"DKFZp727A051"	2686	6144	79	0	42	37	0	0	107	14	10	0	247	213	297	226	410	173
"DKFZp727A181"	3096	29555	8186	1574	4940	3246	844	730	1629	516	6445	1284	5777	5085	4290	3601	4942	3034
"DKFZp727C181"	3234	67740	1537	589	882	655	302	287	934	390	993	937	1141	974	1036	1511	1857	760
"DKFZp727G051"	3415	13230	203	575	91	112	312	263	247	511	44	756	482	321	591	578	815	509
"DKFZp761A078"	3831	49409	141	227	51	90	118	109	87	311	18	53	161	114	126	15	135	24
"DKFZp761A1322"	2876	70984	0	141	0	0	94	47	7	292	0	193	67	256	34	160	67	109
"DKFZp761B0317"	4101	105913	0	0	0	0	0	0	0	0	0	0	0	0	0	0	0	0
"DKFZp761B039"	1240	1318	117	51	3	114	34	17	170	43	230	55	281	111	147	96	556	120
"DKFZp761B0915"	768	4983	254	124	113	141	64	60	85	52	91	58	86	337	299	277	280	174
"DKFZp761B107"	2304	105190	0	0	0	0	0	0	0	8	0	0	10	19	25	33	10	6
"DKFZp761B15121"	2392	5592	0	0	0	0	0	0	12	31	0	0	0	0	0	0	0	0
"DKFZp761B1514"	3608	34695	941	485	548	393	291	194	561	372	449	446	2568	2961	2778	2390	2928	2004
"DKFZp761B182"	1101	2622	11	0	11	0	0	0	29	24	0	0	82	94	99	103	106	80
"DKFZp761B2210"	5216	140267	7439	3816	4236	3203	2083	1733	2984	1431	937	1077	1508	4853	1838	1632	1358	1029
"DKFZp761B238"	877	21101	0	0	0	0	0	0	0	0	0	0	0	0	0	0	0	0
"DKFZp761C241"	1289	52125	461	572	271	190	286	286	370	424	34	487	228	286	169	170	203	186
"DKFZp761D0211"	1014	28602	342	88	190	152	60	28	295	187	157	123	371	367	459	448	681	507
"DKFZp761D0614"	4119	52670	0	0	0	0	0	0	85	0	0	0	83	124	127	154	87	66
"DKFZp761D0712"	4305	32388	0	0	0	0	0	0	192	54	0	0	0	0	0	0	0	0
"DKFZp761D081"	2767	11467	366	258	179	187	146	112	332	98	31	118	684	665	824	461	933	575
"DKFZp761D112"	2548	2548	0	0	0	0	0	0	0	0	0	0	0	0	0	0	0	0
"DKFZp761D1923"	2176	26242	275	218	160	115	119	99	255	164	0	0	222	361	236	238	291	141
"DKFZp761E0323"	2233	45427	248	67	146	102	58	9	144	267	0	271	368	354	689	539	818	501
"DKFZp761E0611"	4171	61078	6388	1881	3574	2814	1103	778	2992	957	1461	1198	157	284	198	210	196	154
"DKFZp761E1217"	3276	551884	45	0	16	29	0	0	892	259	0	9	57	0	36	3	19	0
"DKFZp761E198"	4444	4444	1499	894	831	668	434	460	604	366	2108	1158	2518	1333	2961	2057	3179	1790
"DKFZp761F0118"	2742	55751	3924	4020	2157	1767	2163	1857	1932	1993	735	1259	570	670	591	466	501	266
"DKFZp761F137"	2238	9509	1	2	1	0	0	2	43	39	0	1	0	0	3	0	0	0
"DKFZp761F2014"	7491	54473	0	0	0	0	0	0	25	0	0	0	0	0	0	0	0	0
"DKFZp761G0122"	2228	4169	0	0	0	0	0	0	16	0	0	0	0	0	0	0	0	0
"DKFZp761G0123"	2024	34513	1936	1950	1071	865	1072	878	1179	1092	427	1303	1506	1806	1706	1533	2064	1287
"DKFZp761G18121"	1637	35911	1940	698	1138	802	379	319	944	326	603	387	760	669	396	296	409	216
"DKFZp761G1923"	3402	25491	2733	1433	1574	1159	772	661	1181	650	1006	1154	3150	2496	6092	3893	5389	3576
"DKFZp761G2423"	3444	16640	284	41	170	114	15	26	424	95	0	0	1418	1560	1463	1174	1590	1084
"DKFZp761H0716"	2778	5683	13	0	5	8	0	0	56	69	0	0	107	63	115	77	126	89
"DKFZp761H171"	4634	47660	65	5	32	33	0	5	75	0	0	0	707	632	1521	1455	1273	936
"DKFZp761H2024"	5023	132371	784	135	391	393	67	68	720	96	112	61	1448	1392	1898	1579	2258	1513
"DKFZp761H229"	3630	34320	271	24	184	87	6	18	554	139	59	15	932	716	1093	677	1197	838
"DKFZp761I097"	1430	29209	6883	4794	3922	2961	2537	2257	2251	2339	4072	4287	202	324	273	417	411	109
"DKFZp761I1011"	3215	65410	0	3	0	0	0	3	0	0	0	0	0	0	0	0	0	0
"DKFZp761I172"	935	3386	0	0	0	0	0	0	0	0	0	0	20	23	15	14	10	0
"DKFZp761I241"	5115	92433	1722	925	944	778	508	417	964	965	448	1640	475	557	968	778	925	1123
"DKFZp761J109"	2734	46327	805	0	426	379	0	0	726	0	193	41	42	24	45	105	67	101
"DKFZp761J17121"	3738	29290	0	0	0	0	0	0	0	0	0	0	0	0	0	0	0	0
"DKFZp761J1810"	3338	14750	974	467	633	341	204	263	220	482	464	941	2470	3172	954	1114	1288	1150
"DKFZp761J191"	3416	26629	0	1	0	0	0	1	24	9	0	0	0	0	0	0	0	0
"DKFZp761K058"	3090	19864	0	0	0	0	0	0	56	0	0	0	0	0	7	0	3	0
"DKFZp761K0816"	2136	5722	0	0	0	0	0	0	25	22	0	0	0	0	0	0	0	0
"DKFZp761K1323"	1964	225547	364	100	223	141	59	41	449	100	53	192	185	189	168	169	247	177
"DKFZp761K1524"	2669	16486	873	122	475	398	72	50	471	82	0	43	532	561	496	480	550	405
"DKFZp761K2322"	11870	47533	0	0	0	0	0	0	0	0	0	0	0	0	0	0	0	0
"DKFZp761L1216"	3340	21166	841	103	496	345	47	56	365	147	338	194	1859	2052	1807	1497	2143	1766
"DKFZp761L1918"	3805	48680	0	0	0	0	0	0	18	0	0	0	0	0	0	0	0	0
"DKFZp761L2416"	2107	15051	0	0	0	0	0	0	33	22	0	1	2	3	0	0	0	0
"DKFZp761M1816"	3434	234305	0	0	0	0	0	0	12	0	0	0	0	0	0	0	0	0
"DKFZp761N0624"	1905	9811	251	7	123	128	7	0	404	67	105	11	472	442	686	477	854	527
"DKFZp761N0823"	2506	8446	0	0	0	0	0	0	10	12	0	0	34	15	20	14	55	40
"DKFZp761N1114"	2051	31961	0	0	0	0	0	0	98	20	0	0	9	0	0	0	0	0
"DKFZp761O0610"	4122	62440	1537	315	910	627	160	155	1093	159	776	489	789	767	1636	1211	1285	952
"DKFZp761O0611"	2124	13017	688	177	367	321	143	34	268	163	134	233	58	96	53	69	61	41
"DKFZp761P1121"	2264	29166	4575	864	2554	2021	499	365	2285	947	4594	1812	1815	1628	1746	1373	2195	1441
"DKFZp761P2124"	3445	16900	1853	355	1093	760	193	162	606	190	216	209	591	989	731	758	866	543
"DKFZp761P221"	2462	12463	0	0	0	0	0	0	21	0	0	0	0	0	0	0	0	0
"DKFZp762B153"	2381	12580	366	435	243	123	255	180	260	164	106	418	3373	3570	4729	4321	4183	3399
"DKFZp762B162"	2891	14011	444	2383	250	194	1218	1165	221	1056	15	522	140	1615	74	780	143	189
"DKFZp762B192"	2125	14620	0	2	0	0	0	2	86	11	0	0	3	13	0	8	6	6
"DKFZp762C1313"	2925	26457	594	427	377	217	213	214	141	490	221	925	752	1105	1318	1115	1548	922
"DKFZp762C213"	2849	9715	1854	2314	986	868	1196	1118	672	1614	1882	29	158	2849	2451	349	2995	238
"DKFZp762D096"	4513	16659	1159	191	566	593	115	76	452	129	1044	381	1002	844	665	311	818	364
"DKFZp762D1813"	6919	67904	2294	735	1296	998	405	330	1214	282	380	499	1017	1120	947	661	971	501
"DKFZp762E1710"	3676	234124	2463	2379	1444	1019	1374	1005	1770	1967	309	746	655	950	848	731	685	386
"DKFZp762F112"	2239	17514	82	50	39	43	38	12	65	0	0	0	155	185	134	86	141	96
"DKFZp762F133"	3700	34392	0	0	0	0	0	0	0	0	0	0	0	0	0	0	0	0
"DKFZp762F216"	1768	4371	1769	365	957	812	79	286	459	193	1170	475	2646	2281	2717	2540	4586	2272
"DKFZp762G052"	3608	54609	7102	3299	3939	3163	1818	1481	3277	1573	3383	2812	3187	3165	3455	2668	3933	2278
"DKFZp762G094"	4059	33644	946	295	545	401	169	126	462	132	10	81	1719	1642	1243	1024	1332	593
"DKFZp762G166"	1218	38834	10	0	10	0	0	0	0	0	0	0	71	80	57	25	104	35
"DKFZp762H0213"	3269	11320	409	97	278	131	44	53	353	166	460	271	1049	947	778	674	920	604
"DKFZp762I1415"	1392	1392	0	0	0	0	0	0	54	19	0	0	407	270	498	0	612	359
"DKFZp762I166"	1925	5467	874	266	542	332	125	141	321	159	363	159	3998	3124	5098	2919	7574	5436
"DKFZp762K099"	3754	48914	0	0	0	0	0	0	17	0	0	0	0	0	0	4	0	0
"DKFZp762K109"	1217	146503	12163	13650	7203	4960	7419	6231	7950	6081	6523	10485	11296	12465	16673	18747	16772	15308
"DKFZp762K197"	2462	14382	477	35	273	204	18	17	360	32	99	0	1918	1057	1194	540	1646	726
"DKFZp762L0110"	2121	29042	910	469	588	322	238	231	470	488	189	351	718	437	716	351	837	355
"DKFZp762L137"	2635	45634	3126	3637	1769	1357	1904	1733	1382	3614	409	4435	1286	2438	1205	1655	1662	1518
"DKFZp762L185"	4966	62877	0	0	0	0	0	0	0	0	0	0	0	0	0	0	0	0
"DKFZp762M1110"	2018	42318	1140	97	483	657	79	18	1018	64	113	0	87	88	1119	197	1312	1002
"DKFZp762M186"	2132	45904	5445	1252	3003	2442	768	484	2474	1222	4872	2526	1349	627	1528	701	2163	876
"DKFZp762O156"	2523	13474	398	33	243	155	22	11	433	0	150	7	1449	944	992	640	1253	604
"DKFZp779A0729"	1636	23866	443	265	276	167	154	111	312	219	0	166	200	376	286	253	184	72
"DKFZp779C2259"	1946	42307	5027	1341	2864	2163	710	631	2015	754	1492	1190	832	903	1710	1642	2035	635
"DKFZp779G118"	4961	7478	0	0	0	0	0	0	0	0	0	0	113	89	99	118	92	35
"DKFZp779G1236"	4528	37129	0	0	0	0	0	0	0	0	0	0	0	0	0	0	0	0
"DKFZp779J0967"	3972	126516	7282	3165	4034	3248	1779	1386	3918	1780	1383	2127	1230	1541	1017	827	1091	697
"DKFZp779J2459"	3236	289696	10924	9127	6116	4808	5005	4122	4249	3236	1031	4740	86	121	78	78	420	55
"DKFZp779K0112"	2551	9409	9	0	3	6	0	0	0	0	0	0	0	108	402	631	531	302
"DKFZp779K1237"	2060	59330	1306	656	737	569	353	303	880	402	216	549	1366	1665	813	829	988	737
"DKFZp779L0160"	1644	2530	0	0	0	0	0	0	23	0	0	0	0	0	3	0	0	0
"DKFZp779L1068"	3692	82476	39	0	30	9	0	0	173	11	0	0	96	97	90	83	115	51
"DKFZp779M0311"	1899	8708	67	13	43	24	13	0	138	47	14	0	320	291	1809	2006	2289	1644
"DKFZp779M0652"	650	927	0	0	0	0	0	0	34	0	0	0	0	0	0	0	0	0
"DKFZp779N0926"	1538	8617	0	0	0	0	0	0	0	0	0	0	0	0	0	0	0	0
"DKFZp779O012"	5984	5984	545	228	301	244	109	119	180	119	41	193	92	29	24	0	61	0
"DKFZp781B11202"	2279	78970	1196	3401	701	495	1876	1525	696	1954	284	2216	1119	1634	1754	1659	1378	1327
"DKFZp781C08198"	1812	16492	0	0	0	0	0	0	0	0	0	0	0	0	0	0	0	0
"DKFZp781D08126"	1852	4919	74	8	37	37	0	8	56	0	0	13	54	140	966	586	199	478
"DKFZp781D1175"	2706	11741	73	40	43	30	37	3	128	68	0	45	36	73	69	62	76	49
"DKFZp781D1223"	499	15105	52	310	32	20	177	133	69	127	0	8	214	0	157	0	0	0
"DKFZp781D1416"	3403	385462	13715	9461	7849	5866	5155	4306	6159	5447	4295	8797	808	1131	693	681	851	394
"DKFZp781D1722"	6140	99762	0	0	0	0	0	0	0	0	0	0	0	0	0	0	0	0
"DKFZp781D1727"	3051	58664	15766	27508	8668	7098	14949	12559	6322	12809	7677	20296	2144	4778	1520	3375	1768	1994
"DKFZp781F05101"	9024	29400	2270	711	1202	1068	341	370	1259	667	1039	572	2118	2072	2745	2185	3385	2393
"DKFZp781F1053"	4994	84737	6703	23965	3768	2935	12905	11060	2135	11618	372	17497	59	180	100	418	89	89
"DKFZp781G0119"	4007	15669	0	0	0	0	0	0	0	0	0	0	0	0	0	0	0	0
"DKFZp781J13156"	1823	19215	73	92	26	47	45	47	57	40	36	6	12	12	55	56	58	36
"DKFZp781J211"	5499	80348	1781	2074	1000	781	1039	1035	1103	1288	449	800	353	555	562	576	616	395
"DKFZp781K2028"	4487	45868	1538	379	854	684	225	154	873	116	323	56	3286	3974	3670	2728	4141	2499
"DKFZp781M0415"	5415	115173	138	0	61	77	0	0	85	23	0	0	15	14	0	9	4	5
"DKFZp781M09150"	1432	2258	0	0	0	0	0	0	0	0	0	0	2	0	0	0	0	0
"DKFZp781M17165"	2066	37612	1021	40	597	424	13	27	1003	151	657	0	3066	2512	3918	2958	5287	3509
"DKK1"	1808	3377	0	0	0	0	0	0	0	0	0	0	0	0	0	0	0	0
"DKK2"	3640	114495	0	0	0	0	0	0	0	0	0	0	0	0	0	0	0	0
"DKK3"	2766	46086	0	0	0	0	0	0	21	12	0	0	0	0	0	0	0	0
"DKK4"	821	3089	0	0	0	0	0	0	8	0	0	0	0	0	0	0	0	0
"DKKL1"	1034	11331	0	0	0	0	0	0	72	38	0	0	0	0	0	0	0	0
"DL135774"	471	471	0	0	0	0	0	0	0	0	0	0	1	0	0	0	0	0
"DL137717"	119	119	0	0	0	0	0	0	20	14	0	0	0	0	0	0	0	0
"DL231865"	71	71	0	0	0	0	0	0	0	0	0	0	0	0	0	0	0	0
"DL231875"	23	23	0	0	0	0	0	0	0	0	0	0	0	0	0	0	0	0
"DL231898"	89	89	0	0	0	0	0	0	0	9	0	0	0	0	0	0	0	0
"DL231906"	71	71	0	0	0	0	0	0	0	0	0	0	0	0	0	0	0	0
"DL231926"	111	111	0	0	0	0	0	0	0	0	0	0	0	0	0	0	0	0
"DL232047"	76	76	0	0	0	0	0	0	0	0	0	0	0	0	0	0	0	0
"DL233846"	85	85	11	16	0	11	16	0	0	0	0	0	116	0	0	0	0	94
"DL233857"	110	110	0	0	0	0	0	0	0	0	0	0	0	0	0	0	0	0
"DL243095"	71	71	0	0	0	0	0	0	0	0	0	0	0	0	0	0	0	0
"DL262778"	26	26	0	0	0	0	0	0	0	0	0	0	0	0	0	0	0	0
"DL490824"	58	58	0	0	0	0	0	0	0	0	0	0	0	0	0	0	0	0
"DL491203"	65	65	0	0	0	0	0	0	0	0	0	0	0	0	0	0	0	0
"DL491219"	123	123	0	0	0	0	0	0	0	0	0	0	0	0	0	0	0	0
"DL491247"	92	92	0	1510	0	0	129	1381	0	4926	0	2213	0	0	0	0	0	0
"DL491261"	132	132	0	0	0	0	0	0	0	0	0	0	0	0	0	0	0	0
"DL491333"	138	138	0	0	0	0	0	0	0	0	0	0	0	0	0	0	0	0
"DL491334"	54	54	882	2654	675	207	1406	1248	397	1199	0	1646	0	48375	0	18407	15421	11729
"DL491344"	115	115	0	0	0	0	0	0	0	0	0	0	0	2	129	95	412	46
"DL491356"	165	165	2141	411	1151	990	385	26	758	285	1680	634	2771	2629	919	1392	3334	943
"DL491360"	88	88	843	282	505	338	282	0	435	251	644	0	1030	2211	2229	85	2124	111
"DL491575"	133	133	198	0	123	75	0	0	65	48	117	0	0	0	0	0	0	0
"DL491727"	63	63	0	10	0	0	0	10	16	0	0	0	0	0	0	1	0	0
"DL491750"	68	68	0	1	0	0	1	0	76	0	0	0	0	0	0	2965	0	0
"DL491860"	3731	3731	140	61	97	43	21	40	43	22	0	0	1370	0	0	0	0	0
"DL492000"	34	34	0	0	0	0	0	0	0	0	0	0	0	0	0	0	0	0
"DL492003"	92	92	0	0	0	0	0	0	2	0	0	0	0	0	0	0	0	0
"DL492006"	99	99	14610	13547	8138	6472	7184	6363	3236	7321	7491	21408	0	1	0	0	282915	0
"DL492122"	75	75	132	16	106	26	0	16	0	15	0	51	0	0	0	0	0	0
"DL492217"	68	68	0	191	0	0	106	85	0	304	0	313	923	1415	2345	1672	2675	2766
"DL492381"	74	74	5	155	0	5	86	69	0	43	0	130	0	0	0	0	0	0
"DL492396"	123	123	0	0	0	0	0	0	0	0	0	0	0	2	0	0	0	0
"DL492456"	1716	1716	0	0	0	0	0	0	0	0	0	0	0	0	0	0	0	0
"DL492557"	2514	2514	263	135	162	101	84	51	82	60	76	0	1565	1523	1783	0	0	0
"DL492607"	1931	1931	0	0	0	0	0	0	0	0	0	0	0	0	0	0	0	9
"DL492700"	80	80	118	494	0	118	289	205	60	233	0	0	0	3757	0	3253	0	3122
"DLAT"	4336	39442	220	0	104	116	0	0	137	0	22	8	1133	1101	1025	913	1239	857
"DLC1"	7497	431559	0	48	0	0	38	10	17	19	0	18	196	293	336	376	307	253
"DLD"	3592	30058	1495	726	861	634	411	315	1140	430	235	652	2823	3234	3207	2847	3433	2288
"DLEC1"	5660	83534	332	0	231	101	0	0	401	214	0	5	372	7	9	5	555	5
"DLEU7"	1182	131128	0	0	0	0	0	0	0	0	0	0	0	0	0	0	0	0
"DLG1"	5062	256713	5639	2249	3278	2361	1290	959	3730	1340	976	1275	962	1279	931	922	1162	829
"DLG2"	8073	2172260	0	0	0	0	0	0	10	0	0	148	0	0	0	4	3	0
"DLG3"	6019	60615	0	0	0	0	0	0	15	0	0	0	0	0	0	0	0	0
"DLG4"	4342	30159	543	51	244	299	25	26	489	272	602	117	645	578	1039	764	1137	593
"DLG5"	7509	135799	8	0	8	0	0	0	317	82	0	0	4	7	12	3	22	5
"DLGAP1"	3610	953124	30	0	13	17	0	0	73	49	0	0	55	98	52	17	321	43
"DLGAP2"	10105	207073	0	0	0	0	0	0	268	72	0	0	0	0	0	0	0	0
"DLGAP3"	3596	39948	0	0	0	0	0	0	29	21	0	0	0	0	0	0	0	3
"DLGAP4"	5022	262737	3315	783	1831	1484	412	371	2223	1272	2855	2410	1175	1006	1599	1197	2015	1358
"DLGAP5"	3102	43562	0	0	0	0	0	0	23	0	0	0	7	3	0	0	0	0
"DLK1"	1534	8206	0	0	0	0	0	0	17	0	0	0	0	0	0	0	0	0
"DLK2"	1552	5196	2	24	0	2	24	0	37	11	0	1	16	129	108	128	179	0
"DLL1"	3319	8403	0	0	0	0	0	0	11	0	0	0	0	0	0	0	0	0
"DLL3"	2391	9566	0	0	0	0	0	0	0	0	0	0	0	3	0	0	0	0
"DLL4"	3394	9692	0	0	0	0	0	0	108	26	0	0	0	0	0	0	0	0
"DLN-1"	950	1049	0	0	0	0	0	0	0	0	0	0	0	0	0	0	0	0
"DLNB13"	1085	9579	0	0	0	0	0	0	0	13	0	0	0	0	0	0	0	0
"DLNB14"	1422	17604	2340	1778	1316	1024	935	843	1062	885	2067	1845	957	4061	278	162	417	316
"DLNB26"	2606	12631	18	1	0	18	1	0	168	28	45	0	294	247	281	196	467	301
"DLNB27"	2313	4707	0	0	0	0	0	0	48	25	0	0	0	0	0	0	0	0
"DLST"	2857	21858	2164	1705	1240	924	906	799	919	1002	1071	2045	2723	3101	3862	3536	4952	3409
"DLSTP"	2798	21858	2164	1705	1240	924	906	799	919	1002	1071	2045	2723	3101	3862	3536	4952	3409
"DLX1"	2383	4193	0	0	0	0	0	0	13	0	0	0	0	0	0	0	0	0
"DLX2"	2306	3313	0	0	0	0	0	0	0	0	0	0	0	6	0	3	0	0
"DLX3"	2598	5214	0	0	0	0	0	0	0	0	0	0	0	0	0	0	0	0
"DLX4"	2012	5762	0	0	0	0	0	0	34	12	0	0	0	0	0	0	0	0
"DLX5"	1425	4441	0	0	0	0	0	0	0	0	0	0	0	0	0	0	0	0
"DLX6"	1794	5063	0	0	0	0	0	0	0	0	0	0	0	0	0	0	0	0
"DLX6AS"	1992	45551	0	0	0	0	0	0	0	0	0	0	0	0	0	0	0	0
"DM004122"	78	78	0	0	0	0	0	0	0	0	0	0	0	0	0	0	0	0
"DM004128"	104	104	392	161	154	238	102	59	248	69	130	145	148	168	120	69	141	88
"DM004134"	111	111	0	0	0	0	0	0	17	19	0	0	0	0	0	0	0	0
"DM004135"	89	89	259	91	145	114	51	40	119	23	74	202	0	0	0	0	0	0
"DM004170"	85	85	0	0	0	0	0	0	0	0	0	0	0	0	0	0	0	0
"DM004172"	88	88	0	0	0	0	0	0	0	19	0	0	0	0	0	0	0	0
"DM004175"	104	104	0	0	0	0	0	0	0	0	0	0	0	0	0	0	0	0
"DM004177"	70	70	720	563	451	269	302	261	288	270	0	0	431	0	0	0	0	0
"DM004179"	85	85	0	0	0	0	0	0	0	0	0	0	0	0	0	0	0	0
"DM004183"	81	81	11	16	0	11	16	0	21	0	0	0	116	0	0	0	0	94
"DM004189"	81	81	0	0	0	0	0	0	0	0	0	0	0	0	0	0	0	0
"DM004192"	85	85	2009	188	1598	411	96	92	2001	256	1527	143	4932	402	337	159	0	226
"DM004193"	87	87	115	59	86	29	31	28	52	0	0	48	0	0	0	0	0	0
"DM004194"	81	81	0	0	0	0	0	0	0	0	0	0	0	0	0	0	0	0
"DM004195"	81	81	0	0	0	0	0	0	0	0	0	0	0	0	0	0	0	0
"DM004196"	82	82	0	0	0	0	0	0	0	0	0	0	0	0	0	0	0	0
"DM004198"	88	88	0	0	0	0	0	0	0	0	0	0	0	0	0	0	0	0
"DM004212"	83	83	0	0	0	0	0	0	0	0	0	0	0	0	0	0	0	0
"DM004215"	103	103	0	0	0	0	0	0	0	0	0	0	0	0	0	0	0	0
"DM004219"	100	100	0	0	0	0	0	0	0	0	0	0	0	0	0	0	0	0
"DM004220"	98	98	0	0	0	0	0	0	0	10	0	0	0	0	0	0	0	0
"DM004233"	73	73	0	0	0	0	0	0	0	0	0	0	0	0	0	0	0	0
"DM004234"	95	95	0	0	0	0	0	0	0	0	0	0	0	0	0	0	0	0
"DM004235"	99	99	0	0	0	0	0	0	15	11	0	0	0	0	0	0	0	0
"DM004240"	91	91	0	0	0	0	0	0	0	0	0	0	0	0	0	0	0	0
"DM004258"	89	89	0	369	0	0	0	369	0	417	0	1070	0	0	0	0	0	0
"DM004261"	88	88	0	0	0	0	0	0	28	30	0	0	0	0	0	0	0	0
"DM004264"	76	76	362	601	292	70	361	240	242	1185	0	747	0	0	0	0	0	0
"DM004271"	91	91	0	0	0	0	0	0	0	0	0	0	0	0	0	0	0	0
"DM004276"	84	84	0	0	0	0	0	0	22	9	0	0	0	0	0	0	0	0
"DM004277"	111	111	0	0	0	0	0	0	0	0	0	0	0	0	0	0	0	0
"DM004278"	111	111	0	0	0	0	0	0	0	0	0	0	0	0	0	0	0	0
"DM004282"	109	109	18	0	18	0	0	0	0	0	35	0	0	0	0	0	0	0
"DM004285"	110	110	0	0	0	0	0	0	0	0	0	0	0	0	0	0	0	0
"DM004289"	111	111	0	0	0	0	0	0	0	0	0	0	0	0	0	0	0	0
"DM004296"	87	87	0	0	0	0	0	0	0	0	0	0	0	0	0	0	0	0
"DM004302"	95	95	0	1052	0	0	571	481	0	0	1416	9531	0	0	0	0	0	0
"DM004303"	76	76	38	0	0	38	0	0	0	0	0	0	0	0	6	7	0	0
"DM004304"	95	95	0	0	0	0	0	0	0	0	0	0	0	0	0	0	0	0
"DM004306"	94	94	0	0	0	0	0	0	0	0	0	0	0	0	0	0	0	0
"DM004309"	95	95	169	0	169	0	0	0	300	11	0	0	0	0	0	0	0	0
"DM004315"	86	86	801	2134	521	280	1202	932	287	991	0	977	0	426	0	482	42	287
"DM004325"	111	111	464	478	269	195	250	228	492	387	90	49	7097	9643	0	0	0	0
"DM004329"	90	90	0	0	0	0	0	0	0	259	0	224	0	143	0	0	0	0
"DM004330"	90	90	0	0	0	0	0	0	18	0	0	0	0	0	0	0	0	0
"DM004331"	110	110	0	0	0	0	0	0	0	0	0	0	0	0	0	0	0	0
"DM004332"	111	111	0	0	0	0	0	0	0	0	0	0	0	0	0	0	0	0
"DM004334"	99	99	0	0	0	0	0	0	0	0	0	0	0	0	0	0	0	0
"DM004349"	870	870	0	0	0	0	0	0	12	0	0	0	0	0	0	0	0	0
"DM004357"	82	82	136	330	70	66	150	180	0	0	0	0	0	0	0	0	0	0
"DM004363"	65	65	58	20	58	0	0	20	108	81	0	0	0	0	0	0	0	0
"DM004364"	89	89	0	0	0	0	0	0	0	71	0	0	0	0	0	0	0	0
"DM004368"	71	71	0	0	0	0	0	0	53	0	0	0	0	0	0	0	0	0
"DM004377"	81	81	0	0	0	0	0	0	25	48	0	27	0	0	0	0	0	0
"DM004378"	82	82	0	0	0	0	0	0	0	0	0	0	0	0	0	0	0	0
"DM004381"	75	75	0	0	0	0	0	0	0	0	0	0	0	161	0	0	0	0
"DM004388"	86	86	0	0	0	0	0	0	0	0	0	0	0	0	0	0	0	0
"DM004389"	88	88	0	0	0	0	0	0	0	0	0	0	0	0	0	0	0	0
"DM004390"	86	86	0	0	0	0	0	0	0	0	0	0	0	0	0	0	0	0
"DM004392"	87	87	0	0	0	0	0	0	0	0	0	0	0	0	0	0	0	0
"DM004393"	89	89	0	0	0	0	0	0	0	0	0	0	0	0	0	0	0	0
"DM004394"	89	89	0	0	0	0	0	0	0	0	0	0	0	0	0	0	0	0
"DM004396"	98	98	0	0	0	0	0	0	9	0	0	0	0	0	0	0	0	0
"DM004397"	83	83	0	0	0	0	0	0	0	0	0	0	0	0	0	0	0	0
"DM004398"	85	85	0	0	0	0	0	0	0	0	0	0	0	0	0	0	0	0
"DM004399"	74	74	0	0	0	0	0	0	0	0	0	0	0	0	0	0	0	0
"DM004400"	91	91	0	0	0	0	0	0	0	0	0	0	0	0	0	0	0	0
"DM004401"	90	90	0	0	0	0	0	0	0	0	0	0	0	0	0	0	0	0
"DM004403"	102	102	0	0	0	0	0	0	0	0	0	0	0	1585	0	0	0	0
"DM004406"	119	119	0	0	0	0	0	0	0	0	0	0	0	0	0	0	0	0
"DM004407"	74	74	0	0	0	0	0	0	0	0	0	0	0	0	0	0	0	0
"DM004408"	90	90	394	249	238	156	163	86	0	134	0	118	0	0	0	0	0	0
"DM004411"	83	83	0	0	0	0	0	0	0	0	0	0	0	0	0	0	0	0
"DM004413"	84	84	0	0	0	0	0	0	0	0	0	0	0	0	0	0	0	0
"DM004414"	100	100	0	0	0	0	0	0	25	9	0	0	0	0	0	0	0	0
"DM004415"	69	69	0	0	0	0	0	0	25	0	0	0	0	0	0	0	0	0
"DM004416"	101	101	27	0	27	0	0	0	33	0	0	39	0	0	0	0	0	0
"DM004418"	88	88	2097	2237	1055	1042	1321	916	369	1518	455	2122	36	213	258	0	371	395
"DM004420"	87	87	0	0	0	0	0	0	0	0	0	0	0	0	0	0	0	0
"DM004424"	89	89	0	0	0	0	0	0	0	0	0	0	0	0	0	0	0	0
"DM004425"	85	85	0	0	0	0	0	0	29	10	0	0	0	0	0	0	0	0
"DM004427"	88	88	0	0	0	0	0	0	0	0	0	0	0	0	0	0	0	0
"DM004428"	88	88	0	0	0	0	0	0	0	0	0	0	0	0	0	0	0	0
"DM004429"	83	83	0	0	0	0	0	0	0	0	0	0	0	0	0	0	0	0
"DM004431"	71	71	16	0	0	16	0	0	22	0	0	0	0	0	0	0	0	0
"DM004432"	111	111	0	13	0	0	0	13	0	0	0	0	0	0	0	0	0	0
"DM004434"	89	89	23	0	10	13	0	0	31	14	0	0	0	0	0	0	0	0
"DM004436"	111	111	0	0	0	0	0	0	0	0	0	0	0	0	0	0	0	0
"DM004437"	84	84	0	0	0	0	0	0	0	0	0	0	0	0	0	0	0	0
"DM004438"	82	82	42	0	16	26	0	0	42	21	0	32	0	0	0	0	0	0
"DM004439"	87	87	480	193	0	480	98	95	834	0	0	367	1639	1884	0	1235	1932	1049
"DM004440"	110	110	0	0	0	0	0	0	0	0	0	0	0	0	0	0	0	0
"DM004441"	87	87	0	15	0	0	15	0	18	29	0	0	0	0	0	0	0	0
"DM004442"	86	86	0	0	0	0	0	0	0	0	0	0	0	0	0	0	0	0
"DM004443"	93	93	189	15	135	54	0	15	908	117	0	267	0	0	0	0	0	0
"DM004444"	111	111	0	0	0	0	0	0	0	0	0	0	0	0	0	0	0	0
"DM004447"	86	86	0	0	0	0	0	0	0	0	0	0	0	0	0	0	0	0
"DM004450"	111	111	0	0	0	0	0	0	0	0	0	0	0	0	0	0	0	0
"DM004451"	72	72	102	0	62	40	0	0	180	0	0	0	0	0	0	0	0	0
"DM004459"	110	110	0	0	0	0	0	0	0	0	0	0	0	0	0	0	0	0
"DM004460"	111	111	0	0	0	0	0	0	0	0	0	0	0	0	0	0	0	0
"DM004461"	110	110	0	0	0	0	0	0	0	0	0	0	0	0	0	0	0	0
"DM004462"	87	87	0	0	0	0	0	0	0	0	0	0	0	0	0	0	0	0
"DM004467"	111	111	0	0	0	0	0	0	0	0	0	0	0	0	0	0	0	0
"DM004468"	110	110	0	0	0	0	0	0	0	0	0	0	0	0	0	0	0	0
"DM004471"	111	111	0	0	0	0	0	0	0	0	0	0	0	0	0	0	0	0
"DM004473"	110	110	0	0	0	0	0	0	13	0	0	0	0	0	0	0	0	0
"DM004474"	111	111	0	0	0	0	0	0	0	0	0	0	0	0	0	0	0	0
"DM004475"	98	98	0	0	0	0	0	0	0	0	0	0	0	0	0	0	0	0
"DM004476"	111	111	0	27071	0	0	26430	641	0	17534	0	377	0	1635	65	1351	34	983
"DM004477"	111	111	0	48977	0	0	26430	22547	0	17534	0	6994	0	1635	0	0	0	0
"DM004486"	81	81	0	0	0	0	0	0	0	0	0	0	0	0	0	0	0	0
"DM004490"	64	64	0	0	0	0	0	0	0	0	0	0	0	0	0	0	0	0
"DM004493"	70	70	0	0	0	0	0	0	20	0	0	0	0	0	0	0	0	0
"DM004494"	83	83	0	0	0	0	0	0	0	0	0	0	0	0	0	0	0	0
"DM004496"	87	87	0	0	0	0	0	0	0	0	0	0	0	0	0	0	0	0
"DM004505"	83	83	0	0	0	0	0	0	0	0	0	0	0	0	0	0	0	0
"DM004693"	99	99	0	0	0	0	0	0	0	0	0	0	0	0	0	0	0	0
"DM004695"	69	69	0	0	0	0	0	0	0	0	0	0	0	581	0	0	0	0
"DM004696"	67	67	0	0	0	0	0	0	0	0	0	0	0	0	0	0	0	0
"DM004697"	71	71	0	0	0	0	0	0	0	10	0	0	0	0	0	0	0	0
"DM004699"	68	68	0	0	0	0	0	0	0	0	0	0	0	0	0	0	0	0
"DM004700"	68	68	0	0	0	0	0	0	0	0	0	0	0	0	0	0	0	0
"DM004701"	70	70	0	0	0	0	0	0	0	0	0	0	0	0	0	0	0	0
"DM004702"	72	72	0	0	0	0	0	0	85	81	63	180	0	0	0	0	0	0
"DM004798"	69	69	0	0	0	0	0	0	0	0	0	0	0	0	0	0	0	0
"DM004799"	70	70	0	0	0	0	0	0	0	0	0	0	0	0	0	0	0	0
"DM004801"	68	68	0	0	0	0	0	0	0	0	0	0	0	0	0	0	0	0
"DM004802"	62	62	0	0	0	0	0	0	0	0	0	0	0	0	0	0	0	0
"DM004803"	75	75	0	0	0	0	0	0	0	18	0	0	0	0	0	0	0	0
"DM004804"	76	76	0	0	0	0	0	0	0	0	0	0	0	0	0	0	0	0
"DM004805"	74	74	0	0	0	0	0	0	0	0	0	0	0	0	0	0	0	0
"DM004806"	89	89	0	0	0	0	0	0	0	0	0	0	0	0	0	0	0	0
"DM004808"	95	95	25	37	25	0	0	37	0	113	0	0	11	9	0	6	0	7
"DM004809"	99	99	73	0	73	0	0	0	0	164	0	0	0	0	0	0	0	0
"DM004810"	88	88	108	0	71	37	0	0	803	117	46	267	0	0	0	0	0	0
"DM004811"	111	111	0	0	0	0	0	0	0	0	0	0	0	0	0	0	0	0
"DM004813"	91	91	0	0	0	0	0	0	0	0	0	0	0	0	0	0	0	0
"DM004814"	91	91	0	0	0	0	0	0	0	0	0	0	0	0	0	0	0	0
"DM004840"	25	25	0	0	0	0	0	0	0	0	0	0	0	0	0	0	0	0
"DM004858"	88	88	71	0	71	0	0	0	181	0	0	0	0	0	0	0	0	0
"DM004865"	60	60	0	0	0	0	0	0	0	0	0	0	0	0	0	0	0	0
"DM004867"	83	83	0	0	0	0	0	0	0	0	0	0	0	0	0	0	0	0
"DM110804"	61	61	45	0	25	20	0	0	16	0	0	22	373	1500	0	279	407	0
"DM110819"	61	61	38	0	23	15	0	0	24	0	0	0	278	247	359	220	475	203
"DM119400"	95	95	437	393	110	327	284	109	113	60	0	66	0	0	0	0	0	0
"DM119412"	84	84	0	0	0	0	0	0	0	78	0	0	0	0	0	0	0	0
"DM119420"	95	95	0	0	0	0	0	0	0	0	0	0	0	0	0	0	0	0
"DM119428"	2483	2483	6580	3740	3666	2914	2014	1726	3101	1692	3326	5117	4830	3130	6415	3051	6522	2649
"DM119432"	374	374	224	1020	110	114	45	975	31	1396	0	4731	267	418	0	236	134	215
"DM119439"	91	91	0	0	0	0	0	0	0	0	0	0	0	0	0	0	0	0
"DM119441"	85	85	249	9	133	116	9	0	92	57	0	47	0	0	0	0	0	0
"DM119443"	85	85	651	0	0	651	0	0	0	54	0	35	0	0	0	0	0	0
"DM119447"	88	88	151	99	85	66	99	0	27	0	0	0	0	35	0	0	0	0
"DM119452"	96	96	0	0	0	0	0	0	0	0	0	0	0	0	0	0	0	0
"DM119463"	84	84	0	0	0	0	0	0	0	0	0	0	0	0	0	0	0	0
"DM119467"	111	111	0	0	0	0	0	0	0	0	0	0	0	0	0	0	0	0
"DM119469"	96	96	0	0	0	0	0	0	0	0	0	0	0	0	0	0	0	0
"DM119471"	69	69	0	0	0	0	0	0	0	0	0	0	0	0	0	0	0	0
"DM119476"	72	72	0	0	0	0	0	0	0	0	0	0	0	0	0	0	0	0
"DM119494"	95	95	0	0	0	0	0	0	0	0	0	0	0	39	0	0	80	0
"DM119559"	65	65	0	0	0	0	0	0	0	0	0	0	0	0	0	0	0	0
"DM168007"	230	230	179	56	92	87	27	29	0	1854	0	0	0	0	0	0	0	0
"DMAP1"	1776	7228	306	136	175	131	61	75	162	94	69	95	454	344	661	442	568	376
"DMBT1"	7739	83073	0	0	0	0	0	0	65	0	0	0	0	0	0	0	0	0
"DMBX1"	2886	7218	0	0	0	0	0	0	50	17	0	0	0	0	0	0	0	0
"DMC1"	2283	51237	0	0	0	0	0	0	0	0	0	1	0	1	0	0	0	0
"DMD"	14162	2009201	0	0	0	0	0	0	19	0	0	0	0	0	0	0	0	0
"DMGDH"	3098	72021	0	0	0	0	0	0	0	0	0	0	47	71	0	0	0	0
"DMKN"	1948	16439	18	0	18	0	0	0	125	102	0	0	0	0	0	0	0	0
"DMP1"	2690	14058	0	0	0	0	0	0	0	0	0	0	0	0	0	0	0	0
"DMPK"	3248	10887	5136	1604	2692	2444	816	788	796	959	2430	3377	734	1529	779	1587	2298	2151
"DMRT1"	2225	127400	0	0	0	0	0	0	13	0	0	0	0	0	0	0	0	0
"DMRT2"	2929	7200	0	0	0	0	0	0	0	0	0	0	0	0	0	0	0	0
"DMRT3"	2186	14770	0	0	0	0	0	0	0	0	0	0	0	0	0	0	0	0
"DMRTA1"	2304	5634	0	0	0	0	0	0	0	0	0	0	0	0	0	0	0	0
"DMRTA2"	3102	5914	0	0	0	0	0	0	0	0	0	0	0	0	0	0	0	0
"DMRTB1"	1911	8088	0	0	0	0	0	0	0	13	0	0	0	0	0	0	0	0
"DMRTC1"	1105	3761	0	0	0	0	0	0	0	0	0	0	0	0	0	0	0	0
"DMRTC2"	2865	7373	0	0	0	0	0	0	0	0	0	0	0	0	0	0	0	0
"DMTF1"	4485	33450	9409	4137	5568	3841	2172	1965	4515	1794	3403	2959	2877	2780	3139	1800	3607	1674
"DMWD"	3313	9798	4300	1920	2295	2005	1007	913	750	1163	2015	3250	1528	494	616	870	1449	929
"DMXL1"	11280	177740	2247	1028	1273	974	577	451	2064	792	136	659	1404	2025	2166	1922	2096	1151
"DMXL2"	10623	175029	6892	12416	3983	2909	6718	5698	4535	11042	830	12365	2697	4076	4487	6466	4017	2503
"DNA2"	4436	58059	0	0	0	0	0	0	15	10	0	16	29	15	46	23	17	9
"DNA2L"	3111	55416	0	0	0	0	0	0	15	10	0	16	24	13	43	16	17	6
"DNAH1"	13187	84179	2379	1469	1302	1077	781	688	2684	1955	1602	1406	604	963	791	1049	1062	691
"DNAH10"	13756	173225	10	0	0	10	0	0	111	14	0	0	3	2	0	0	0	0
"DNAH11"	14269	358624	95	0	40	55	0	0	204	0	32	0	401	379	143	114	269	163
"DNAH12"	9601	202346	0	0	0	0	0	0	0	0	0	0	0	0	0	0	0	0
"DNAH14"	13872	469642	8	0	8	0	0	0	22	0	0	0	0	0	0	0	0	0
"DNAH17"	2634	25953	2032	248	1192	840	36	212	1120	307	2223	420	917	259	408	187	625	264
"DNAH2"	13590	114021	49	1418	16	33	737	681	230	971	4	2379	1	108	0	206	0	183
"DNAH3"	12412	226287	0	6	0	0	5	1	0	0	0	21	8	75	5	25	28	40
"DNAH5"	15652	254154	0	0	0	0	0	0	0	0	0	0	0	0	0	0	0	0
"DNAH6"	12870	303134	0	0	0	0	0	0	0	0	0	0	0	0	0	0	0	0
"DNAH7"	12458	331110	16	0	16	0	0	0	17	0	0	9	1	0	0	0	1253	0
"DNAH8"	14563	308017	0	0	0	0	0	0	0	0	0	0	0	0	0	0	0	0
"DNAH9"	13817	371317	0	0	0	0	0	0	14	0	0	0	0	0	0	0	0	0
"DNAI1"	2540	62172	0	0	0	0	0	0	95	46	0	0	0	0	0	0	0	0
"DNAI2"	2281	40627	0	0	0	0	0	0	105	12	0	0	0	0	0	0	0	0
"DNAJA1"	1547	13855	815	2928	488	327	1543	1385	433	1513	255	2691	2901	7164	3754	6914	3563	6076
"DNAJA2"	3144	18353	595	997	343	252	561	436	204	451	23	744	1387	2327	1615	1580	1911	1389
"DNAJA3"	2720	30917	67	0	39	28	0	0	280	119	74	0	684	525	748	526	847	594
"DNAJA4"	3192	18051	106	99	58	48	41	58	199	455	0	334	443	758	691	1350	657	754
"DNAJB1"	2236	3621	65	72	37	28	30	42	119	193	0	136	1769	2180	2143	4060	2003	3607
"DNAJB11"	2213	15638	283	769	185	98	358	411	170	586	15	643	711	2108	1550	2219	1260	1393
"DNAJB12"	4368	22321	1899	2181	1069	830	1146	1035	723	1104	1035	2009	1300	1720	1577	1827	2051	1795
"DNAJB13"	1882	19969	267	0	145	122	0	0	96	30	0	0	86	52	100	0	127	0
"DNAJB14"	2772	47169	4532	1502	2507	2025	846	656	2197	752	800	835	2119	1732	2170	1237	2353	233
"DNAJB2"	3134	7584	353	42	216	137	23	19	206	118	137	43	736	635	1187	926	1509	940
"DNAJB3"	1266	1266	0	0	0	0	0	0	0	0	0	0	0	0	0	0	0	0
"DNAJB4"	2238	12359	568	3456	332	236	1875	1581	467	1555	88	1178	336	7211	325	2481	243	1408
"DNAJB5"	2800	8163	62	829	51	11	446	383	53	474	0	835	255	1310	299	1589	355	824
"DNAJB6"	2486	80424	21814	62704	12147	9667	33475	29229	6200	39736	12895	62038	3508	10180	5401	14059	7234	9301
"DNAJB7"	2577	2577	32	0	13	19	0	0	20	0	0	0	38	23	60	48	57	26
"DNAJB8"	2471	4811	0	0	0	0	0	0	136	54	0	0	0	0	0	0	0	0
"DNAJB9"	2372	4938	0	0	0	0	0	0	0	0	0	0	830	848	929	706	943	625
"DNAJC1"	2102	247174	2565	773	1602	963	469	304	1556	682	277	809	592	648	703	643	750	573
"DNAJC10"	4217	62258	256	48	102	154	26	22	196	22	41	35	1945	2176	2012	1655	2199	1666
"DNAJC11"	3309	67740	1537	589	882	655	302	287	934	390	993	937	1141	974	1036	1511	1857	760
"DNAJC12"	1216	41511	0	0	0	0	0	0	0	0	0	0	5	6	24	18	17	6
"DNAJC13"	7602	121324	4832	501	2683	2149	268	233	2891	338	950	147	2607	2422	3245	2379	3639	2166
"DNAJC14"	3572	9600	4142	3651	2418	1724	2010	1641	1798	2781	1801	5571	1618	2241	2367	2039	2990	1929
"DNAJC15"	2780	85944	1384	77	857	527	31	46	702	39	63	80	412	428	719	603	823	593
"DNAJC16"	6038	44876	217	26	124	93	10	16	264	23	48	0	696	609	730	483	807	462
"DNAJC17"	1004	39586	994	59	618	376	59	0	762	63	720	65	282	120	475	190	826	279
"DNAJC18"	3546	27760	0	0	0	0	0	0	0	0	0	0	69	54	23	26	86	29
"DNAJC19"	1422	6029	96	61	48	48	50	11	90	33	0	0	173	101	232	176	275	170
"DNAJC2"	3079	9633	633	702	363	270	397	305	441	322	0	517	950	1255	829	853	939	698
"DNAJC21"	6220	29372	832	313	513	319	168	145	473	298	237	278	1423	1801	1348	1254	1322	1061
"DNAJC22"	2291	4644	0	0	0	0	0	0	17	0	0	0	0	0	0	0	0	0
"DNAJC24"	3004	63006	109	0	67	42	0	0	207	10	25	0	339	359	222	123	192	128
"DNAJC25"	2509	22999	595	40	313	282	40	0	365	109	53	233	232	165	264	163	235	150
"DNAJC25-GNG10"	1484	38878	1196	223	628	568	142	81	604	238	373	391	1096	1204	2967	2737	3391	2716
"DNAJC27"	4860	28321	36	8	18	18	8	0	29	0	0	0	188	203	203	109	183	46
"DNAJC28"	1913	3553	0	0	0	0	0	0	0	0	0	0	73	25	61	0	55	0
"DNAJC3"	5592	117841	6440	5971	3730	2710	3190	2781	2682	3086	978	5045	3776	4451	4239	3983	3918	2981
"DNAJC30"	2535	2535	18	0	9	9	0	0	55	22	0	0	275	189	259	165	327	233
"DNAJC4"	1345	3850	447	62	263	184	30	32	247	106	231	9	1284	744	623	594	1750	858
"DNAJC5"	3245	38878	12079	5211	6779	5300	2804	2407	4472	2559	14153	10134	5653	4057	6890	4271	8527	4918
"DNAJC5B"	1386	78966	0	0	0	0	0	0	0	0	0	0	27	17	34	54	116	71
"DNAJC5G"	2013	6009	0	0	0	0	0	0	29	0	0	0	0	0	0	0	0	0
"DNAJC6"	5977	106326	0	0	0	0	0	0	0	0	0	0	6	48	14	29	25	8
"DNAJC7"	2069	41216	2906	2333	1583	1323	1295	1038	1382	1598	1499	3889	1593	2256	2862	2920	3197	2548
"DNAJC8"	1771	32752	139	268	90	49	149	119	110	361	30	530	1329	1575	1256	1225	2383	1662
"DNAJC9"	3035	6038	325	49	201	124	31	18	218	46	140	0	144	1641	71	250	256	178
"DNAL1"	6795	57071	0	0	0	0	0	0	16	3	0	0	61	164	21	55	20	33
"DNAL4"	1490	15649	0	0	0	0	0	0	54	45	0	1	118	59	128	84	160	108
"DNALI1"	2654	9939	14	0	0	14	0	0	37	42	0	0	0	2	0	0	0	0
"DNAPTP1"	1868	1868	421	257	181	240	170	87	203	65	198	77	3125	3442	3119	2552	3751	2600
"DNASE1"	3106	5157	267	5	130	137	0	5	86	6	147	26	290	59	56	42	334	75
"DNASE1L1"	3155	7998	407	101	178	229	47	54	175	34	251	43	379	1157	1544	1256	2623	1134
"DNASE1L2"	1592	2289	0	0	0	0	0	0	76	33	0	0	0	0	3	0	0	3
"DNASE1L3"	1473	22046	893	216	565	328	112	104	622	108	71	0	1187	1193	1771	1329	1411	686
"DNASE2"	2014	6312	0	0	0	0	0	0	0	1	0	0	100	179	572	606	636	412
"DNASE2B"	1265	16478	0	0	0	0	0	0	0	0	0	0	0	3	41	17	11	12
"DND1"	1606	2791	115	0	57	58	0	0	52	19	2	0	1234	574	0	99	0	155
"DNEL2"	5302	49077	2047	248	1192	855	36	212	1031	340	2223	420	917	259	408	187	625	264
"DNER"	3284	356942	0	0	0	0	0	0	0	10	0	0	0	0	0	0	0	0
"DNHD1"	14905	74728	3079	889	1699	1380	432	457	1769	790	735	843	232	261	768	651	856	353
"DNHD1L"	2441	6803	583	275	326	257	131	144	319	229	197	272	103	129	232	186	237	49
"DNLZ"	731	1891	1674	14	1557	117	14	0	37	2	2398	6	132	109	3233	73	4073	80
"DNM1"	3263	51866	1145	509	652	493	265	244	841	647	715	700	255	351	411	431	750	283
"DNM1L"	4672	66449	3544	2383	2001	1543	1260	1123	1616	1353	456	2053	3209	3622	2868	2675	3835	2442
"DNM1P33"	1663	2399	0	1	0	0	0	1	0	14	0	0	0	0	0	0	0	0
"DNM1P35"	7300	7300	34	0	12	22	0	0	131	18	0	0	0	0	0	0	22	0
"DNM2"	4530	118787	10565	4122	5911	4654	2188	1934	4888	2300	10502	4891	5725	5441	7475	6384	10222	6424
"DNM3"	7664	571237	29	0	13	16	0	0	193	27	0	12	90	98	37	12	35	5
"DNMBP"	6417	134344	73	31	29	44	16	15	151	15	0	15	249	306	493	304	419	285
"DNMT1"	5440	61734	17558	5391	9951	7607	2867	2524	6618	1563	15248	2888	19622	13458	12147	7233	17280	7360
"DNMT2"	7522	58700	47	15	35	12	5	10	40	0	0	0	207	207	101	109	93	62
"DNMT3A"	4602	109615	996	125	549	447	46	79	1679	715	617	648	199	166	457	317	429	444
"DNMT3B"	4391	46972	0	0	0	0	0	0	74	35	0	0	0	0	0	0	0	0
"DNMT3L"	1717	15878	1016	836	718	298	426	410	553	344	523	1722	0	96	28	177	49	138
"DNPEP"	2453	14484	964	176	543	421	88	88	576	65	778	116	2798	2234	2687	1790	3752	1766
"DNTT"	2049	34236	1	0	1	0	0	0	0	0	0	0	0	0	0	0	0	0
"DNTTIP1"	1301	19490	229	27	150	79	15	12	219	59	0	0	614	493	694	533	752	524
"DNTTIP2"	2385	9406	136	320	77	59	174	146	102	144	0	204	2028	2507	1908	2023	1934	1691
"DO"	737	14170	0	0	0	0	0	0	0	0	0	0	0	0	0	0	0	0
"DOC-1R"	1704	2148	20	22	20	0	0	22	90	26	0	0	778	558	996	271	1073	692
"DOC2A"	2077	5907	22	0	22	0	0	0	10	37	1	0	327	246	266	199	346	0
"DOC2B"	1079	25411	0	0	0	0	0	0	40	31	0	0	0	0	0	0	0	0
"DOCK1"	6865	656758	26458	20279	14511	11947	11076	9203	13157	11614	6036	12190	2876	3944	2826	2509	3748	2209
"DOCK10"	7487	277525	65594	58397	36798	28796	31291	27106	27272	26122	20722	34803	9815	13194	11097	9707	13676	7673
"DOCK11"	6691	190253	8370	790	4658	3712	392	398	3937	565	2452	466	2096	2657	4368	3759	4736	2837
"DOCK2"	6199	446135	85392	67268	47752	37640	36229	31039	35822	29856	46359	49796	10731	12995	12336	11990	14933	9335
"DOCK3"	8807	708958	13758	9856	7649	6109	5391	4465	7380	4708	5455	10407	715	940	1833	1900	1787	1313
"DOCK4"	8524	480299	63328	204108	35244	28084	109814	94294	17061	88108	14605	165623	1870	1427	1291	1251	1339	1356
"DOCK5"	7606	228333	7180	5064	3962	3218	2708	2356	3945	3441	1391	2204	1429	2098	2022	2048	2516	1544
"DOCK6"	6433	63186	0	1	0	0	1	0	439	143	27	0	107	77	190	158	218	175
"DOCK7"	7160	233573	4982	1338	2844	2138	715	623	3517	1070	551	710	1399	2330	2310	2322	2685	1768
"DOCK8"	9375	192211	37743	20264	20787	16956	11096	9168	18997	12130	15661	12184	6630	8111	10003	9072	11194	7680
"DOCK9"	8412	122188	0	0	0	0	0	0	43	0	0	0	71	91	398	349	534	370
"DOHH"	2036	10120	0	5	0	0	1	4	82	84	0	0	101	107	264	282	349	250
"DOK-2"	1686	4823	1752	323	967	785	143	180	467	247	1195	319	7118	4697	1629	4103	12108	6427
"DOK1"	2277	2397	1714	555	966	748	307	248	488	274	1928	631	2067	971	2432	801	3541	1083
"DOK2"	1775	4823	1889	413	1076	813	233	180	2001	572	1275	385	7282	4899	6992	4343	12290	6589
"DOK3"	2397	6965	981	75	584	397	29	46	377	110	503	97	1217	61	2628	951	2225	997
"DOK4"	2829	7856	0	0	0	0	0	0	67	46	0	0	16	614	0	0	0	0
"DOK5"	1840	175445	0	0	0	0	0	0	0	0	0	0	0	0	0	0	0	0
"DOK6"	8400	447536	3325	3639	1864	1461	2069	1570	3223	1728	980	1584	44	86	8	5	126	4
"DOK7"	2572	31177	21	0	21	0	0	0	450	229	0	0	0	0	0	0	0	0
"DOKDEL"	1920	2787	1106	172	784	322	85	87	130	99	652	140	1882	788	2177	424	3117	955
"DOLK"	2204	2204	17	182	17	0	116	66	62	88	63	133	506	549	512	629	709	576
"DOLPP1"	2183	9335	54	0	37	17	0	0	169	42	11	0	421	255	499	258	556	314
"DOM3Z"	1797	2400	233	285	93	140	142	143	116	383	48	382	442	510	575	289	317	282
"DONSON"	2985	17710	825	732	398	427	389	343	545	260	228	260	2391	2699	2491	2083	3143	2142
"DOPEY1"	8286	101092	4156	1196	2459	1697	604	592	2264	550	325	392	1317	1271	1598	1108	1731	1074
"DOPEY2"	7715	129734	4511	1112	2557	1954	645	467	3410	787	4301	1321	2690	2569	4106	3639	4240	2825
"DOT1L"	7463	68430	4170	10779	2137	2033	5667	5112	1783	6490	1878	16935	1268	1974	2176	5343	2133	2360
"DPAGT1"	3284	11829	80	3	70	10	3	0	204	93	135	0	305	815	1122	949	717	905
"DPCR1"	5289	13223	0	0	0	0	0	0	10	20	0	0	2	2	0	0	0	0
"DPE2"	1632	44659	70	0	14	56	0	0	84	0	0	0	35	4	8	0	9	0
"DPEP1"	1746	17840	1	0	0	1	0	0	158	40	0	0	1	0	0	0	0	0
"DPEP2"	1764	5986	2040	276	1136	904	158	118	875	272	2501	815	1069	674	1536	1050	2286	1155
"DPEP3"	1747	4887	0	0	0	0	0	0	0	0	0	0	1	0	0	0	7	0
"DPF1"	2349	18669	0	0	0	0	0	0	114	68	0	0	0	1	1	2	1	0
"DPF2"	2462	19106	502	53	298	204	22	31	310	275	157	427	910	525	1037	557	1357	752
"DPF3"	3255	232243	3	0	0	3	0	0	237	85	0	0	5	3	0	0	0	0
"DPH1"	2278	4467	334	1269	193	141	672	597	281	616	251	717	973	1925	1089	1259	1391	1283
"DPH2"	2504	3393	23	0	19	4	0	0	78	35	0	0	449	351	526	428	616	368
"DPH2L1"	1721	13260	334	1269	193	141	672	597	281	616	251	717	973	1925	1061	1259	1391	1283
"DPH3"	4067	7929	20	170	19	1	110	60	55	135	0	175	1059	1450	1024	1173	1168	905
"DPH3B"	1069	1069	0	0	0	0	0	0	0	0	0	0	0	25	8	5	24	0
"DPH5"	2231	36466	154	59	100	54	36	23	387	145	0	117	198	75	103	125	139	105
"DPM1"	1078	23657	850	1228	438	412	705	523	508	661	116	1294	616	984	551	480	508	520
"DPM2"	1550	3391	296	71	171	125	52	19	107	134	62	86	566	484	689	548	829	580
"DPM3"	516	516	0	0	0	0	0	0	0	0	0	0	219	183	317	250	0	212
"DPP10"	4969	1382784	0	0	0	0	0	0	0	0	0	0	0	0	0	0	0	0
"DPP3"	2705	29252	95	0	56	39	0	0	286	67	0	24	666	507	1003	1082	1426	801
"DPP4"	4157	82297	0	0	0	0	0	0	0	2	0	0	8	18	3	4	6	7
"DPP6"	4586	1101577	0	0	0	0	0	0	294	21	0	0	0	0	0	0	0	0
"DPP7"	1629	4204	477	275	239	238	146	129	172	179	323	185	2143	1782	3119	3354	3402	2871
"DPP8"	5518	71611	1921	510	1042	879	256	254	1106	318	664	648	661	730	955	713	871	478
"DPP9"	4289	48611	9371	3636	5062	4309	1914	1722	3753	2503	9392	7279	3541	5328	6268	6008	9188	6012
"DPPA2"	1391	22730	0	0	0	0	0	0	0	0	0	0	0	0	0	0	0	0
"DPPA3"	1206	1206	0	0	0	0	0	0	0	0	0	0	0	0	0	0	0	0
"DPPA4"	2823	11432	0	0	0	0	0	0	0	0	0	0	0	0	0	0	0	0
"DPPA5"	615	1168	0	0	0	0	0	0	0	0	0	0	0	0	0	0	0	0
"DPRX"	651	4955	0	0	0	0	0	0	0	0	0	0	0	0	0	0	0	0
"DPRXP4"	664	664	326	0	153	173	0	0	182	34	162	35	0	0	0	0	0	0
"DPT"	1706	33723	0	0	0	0	0	0	0	0	0	0	0	0	0	0	0	0
"DPY19L1"	4886	109161	209	11	99	110	4	7	377	0	0	0	1294	1486	1690	579	616	411
"DPY19L1P2"	1172	12444	0	0	0	0	0	0	0	0	17	0	0	0	103	98	98	65
"DPY19L2"	4079	109663	0	0	0	0	0	0	0	0	0	0	0	0	0	0	0	0
"DPY19L2P1"	3384	82107	0	0	0	0	0	0	0	0	0	0	0	0	0	0	0	0
"DPY19L2P2"	4134	106175	0	0	0	0	0	0	0	0	0	0	0	0	0	0	0	0
"DPY19L2P3"	586	24397	0	0	0	0	0	0	0	0	0	0	0	0	0	0	0	0
"DPY19L2P4"	2021	6202	0	0	0	0	0	0	0	0	0	0	0	0	0	0	0	0
"DPY19L3"	4713	45220	28	10	9	19	10	0	30	9	2	0	305	313	364	332	201	147
"DPY19L4"	6253	73975	146	10	105	41	10	0	163	16	23	0	469	503	667	426	615	357
"DPY30"	805	15874	5	0	0	5	0	0	45	13	0	0	297	113	245	220	274	322
"DPYD"	4468	843315	143887	148154	80293	63594	80264	67890	67517	62558	50271	87541	7701	9650	7567	5695	6248	3572
"DPYS"	2132	87626	0	0	0	0	0	0	12	13	0	0	0	1	0	11	6	3
"DPYSL2"	4570	143904	19062	7956	10638	8424	4303	3653	7707	5970	14744	18767	11392	11830	9073	6149	13230	7422
"DPYSL3"	5299	119055	0	0	0	0	0	0	0	0	0	0	2	3	0	0	13	0
"DPYSL4"	2731	18866	695	119	425	270	88	31	439	308	812	176	1	0	0	0	0	0
"DPYSL5"	5221	102251	0	0	0	0	0	0	44	17	0	0	0	1	0	0	0	0
"DQ141194"	819	17410	0	0	0	0	0	0	22	18	0	0	0	0	0	0	0	0
"DQ266889"	735	121376	0	0	0	0	0	0	0	0	0	0	0	0	0	0	0	0
"DQ372722"	771	4829	0	0	0	0	0	0	14	12	0	0	0	0	0	0	0	0
"DQ515898"	933	131559	0	0	0	0	0	0	12	0	0	0	0	0	0	0	0	0
"DQ515899"	792	131559	0	0	0	0	0	0	12	0	0	0	0	0	0	0	0	0
"DQ569955"	1589	1589	0	0	0	0	0	0	0	0	0	0	0	0	0	0	0	0
"DQ570017"	60	60	0	0	0	0	0	0	0	0	0	0	0	0	0	0	0	0
"DQ570033"	74	74	0	0	0	0	0	0	0	0	0	0	0	0	0	0	0	0
"DQ570043"	52	52	0	0	0	0	0	0	0	0	0	0	0	0	36	51	44	0
"DQ570108"	45	45	0	0	0	0	0	0	0	0	0	0	0	0	0	0	0	0
"DQ570121"	76	76	0	0	0	0	0	0	0	0	0	0	0	0	0	0	0	0
"DQ570124"	29	29	0	0	0	0	0	0	0	0	0	0	0	0	0	0	0	0
"DQ570148"	40	40	0	0	0	0	0	0	0	0	0	0	0	0	0	0	0	0
"DQ570150"	40	40	0	0	0	0	0	0	0	0	0	0	0	0	1449	879	1740	556
"DQ570267"	31	31	0	0	0	0	0	0	0	0	0	0	0	0	0	0	0	0
"DQ570403"	32	32	0	0	0	0	0	0	0	10	0	0	0	0	0	0	0	0
"DQ570466"	35	35	0	0	0	0	0	0	0	0	0	0	0	0	0	0	0	0
"DQ570500"	37	37	0	0	0	0	0	0	0	0	0	0	0	0	0	0	0	0
"DQ570533"	32	32	0	0	0	0	0	0	0	0	0	0	0	0	0	0	0	0
"DQ570561"	32	32	0	0	0	0	0	0	0	0	0	0	0	0	0	0	0	0
"DQ570592"	44	44	0	0	0	0	0	0	0	0	0	0	0	0	0	0	0	0
"DQ570600"	66	66	0	0	0	0	0	0	0	0	0	0	0	0	24	27	52	0
"DQ570601"	36	36	0	0	0	0	0	0	15	14	0	0	0	0	0	0	0	0
"DQ570612"	28	28	0	0	0	0	0	0	0	0	0	0	0	0	0	0	0	0
"DQ570661"	32	32	0	0	0	0	0	0	0	0	0	0	0	0	0	0	0	0
"DQ570677"	37	37	0	0	0	0	0	0	0	0	0	0	0	0	0	0	0	0
"DQ570705"	39	39	0	0	0	0	0	0	0	0	0	0	0	0	0	0	0	0
"DQ570772"	79	79	0	0	0	0	0	0	0	0	0	0	0	0	24	43	65	0
"DQ570793"	32	32	0	0	0	0	0	0	0	0	0	0	0	0	0	0	0	0
"DQ570802"	50	50	0	0	0	0	0	0	0	0	0	0	0	0	36	51	63	0
"DQ570864"	34	34	0	0	0	0	0	0	0	0	0	0	0	0	0	0	0	0
"DQ570882"	32	32	0	0	0	0	0	0	0	0	0	0	0	0	0	0	0	0
"DQ570895"	40	40	0	0	0	0	0	0	17	17	0	0	0	0	0	0	0	0
"DQ570906"	29	29	0	0	0	0	0	0	0	0	0	0	0	0	0	0	0	0
"DQ570938"	33	33	0	0	0	0	0	0	0	0	0	0	0	0	0	0	0	0
"DQ570973"	31	31	0	0	0	0	0	0	0	0	0	0	0	0	0	0	0	0
"DQ570980"	30	30	0	0	0	0	0	0	0	26	0	0	0	0	0	0	0	0
"DQ571013"	30	30	0	0	0	0	0	0	0	0	0	0	0	0	0	0	0	0
"DQ571064"	33	33	0	0	0	0	0	0	0	0	0	0	0	0	0	0	0	0
"DQ571071"	90	90	0	0	0	0	0	0	0	0	0	0	0	0	0	0	0	0
"DQ571077"	31	31	0	0	0	0	0	0	0	0	0	0	0	0	0	0	0	0
"DQ571121"	43	43	0	0	0	0	0	0	0	0	0	0	0	0	0	0	0	0
"DQ571124"	33	33	0	0	0	0	0	0	0	0	0	0	0	0	0	0	0	0
"DQ571149"	83	83	0	0	0	0	0	0	0	0	0	0	0	0	0	0	0	0
"DQ571187"	28	28	0	0	0	0	0	0	0	0	0	0	0	0	0	0	0	0
"DQ571217"	33	33	0	0	0	0	0	0	0	0	0	0	0	0	0	0	0	0
"DQ571241"	54	54	0	0	0	0	0	0	0	0	0	0	0	0	0	0	0	0
"DQ571252"	64	64	0	0	0	0	0	0	0	0	0	0	0	0	0	0	0	0
"DQ571273"	39	39	0	0	0	0	0	0	0	0	0	0	0	0	0	0	52	0
"DQ571370"	53	53	0	0	0	0	0	0	0	0	0	0	0	0	0	0	0	0
"DQ571386"	27	27	0	0	0	0	0	0	0	0	0	0	0	0	0	0	0	0
"DQ571391"	32	32	0	0	0	0	0	0	0	0	0	0	0	0	0	0	0	0
"DQ571395"	32	32	0	0	0	0	0	0	0	0	0	0	0	0	0	0	0	0
"DQ571433"	42	42	0	0	0	0	0	0	0	0	0	0	0	0	0	0	0	0
"DQ571437"	65	65	0	0	0	0	0	0	0	0	0	0	0	0	0	0	0	0
"DQ571461"	57	57	273	170	167	106	132	38	414	469	127	60	538	406	5016	2595	6042	3040
"DQ571479"	29	29	0	0	0	0	0	0	0	0	0	0	0	0	0	0	0	0
"DQ571485"	107	107	0	0	0	0	0	0	0	0	0	0	0	0	0	0	0	0
"DQ571494"	40	40	0	0	0	0	0	0	37	31	0	0	131	91	947	734	1266	582
"DQ571507"	32	32	0	0	0	0	0	0	19	0	0	0	0	0	0	0	0	0
"DQ571524"	32	32	0	0	0	0	0	0	0	0	0	0	0	0	0	0	0	0
"DQ571566"	31	31	0	0	0	0	0	0	0	0	0	0	0	0	0	0	0	0
"DQ571657"	30	30	0	0	0	0	0	0	0	0	0	0	0	0	0	0	0	0
"DQ571691"	32	32	0	0	0	0	0	0	0	0	0	0	0	0	0	0	0	0
"DQ571776"	43	43	0	0	0	0	0	0	0	0	0	0	0	0	0	0	0	0
"DQ571875"	32	32	0	0	0	0	0	0	0	0	0	0	0	0	0	0	0	0
"DQ571880"	32	32	0	0	0	0	0	0	0	0	0	0	0	0	0	0	0	0
"DQ571896"	96	96	0	0	0	0	0	0	0	0	0	0	0	0	27	35	65	28
"DQ571973"	44	44	0	0	0	0	0	0	0	0	0	0	0	0	0	0	0	0
"DQ571986"	62	62	0	0	0	0	0	0	0	0	0	0	0	0	0	0	0	0
"DQ572100"	70	70	0	0	0	0	0	0	0	0	0	0	0	0	0	0	0	0
"DQ572214"	36	36	0	0	0	0	0	0	0	0	0	0	0	0	0	0	0	0
"DQ572278"	29	29	0	0	0	0	0	0	0	0	0	0	0	0	0	0	0	0
"DQ572327"	42	42	0	0	0	0	0	0	0	0	0	0	0	0	0	0	0	0
"DQ572409"	23	23	0	0	0	0	0	0	0	0	0	0	0	0	0	0	0	0
"DQ572519"	35	35	0	0	0	0	0	0	0	0	0	0	0	0	0	0	0	0
"DQ572560"	50	50	0	0	0	0	0	0	0	0	0	0	0	0	0	0	0	0
"DQ572592"	31	31	0	0	0	0	0	0	0	0	0	0	0	0	0	0	0	0
"DQ572652"	33	33	0	0	0	0	0	0	0	0	0	0	0	0	0	0	0	0
"DQ572667"	29	29	0	0	0	0	0	0	0	0	0	0	0	0	0	0	0	0
"DQ572677"	52	52	0	0	0	0	0	0	0	0	0	0	0	0	1249	768	1740	556
"DQ572701"	32	32	0	0	0	0	0	0	0	0	0	0	0	0	0	0	0	0
"DQ572786"	45	45	0	0	0	0	0	0	0	0	0	0	0	0	0	0	0	0
"DQ572791"	42	42	0	0	0	0	0	0	10	0	0	0	0	0	0	0	0	0
"DQ572816"	29	29	0	0	0	0	0	0	0	0	0	0	0	0	0	0	0	0
"DQ572830"	31	31	0	0	0	0	0	0	0	0	0	0	0	0	0	0	0	0
"DQ572923"	1030	1030	0	0	0	0	0	0	0	0	0	0	0	0	0	0	0	0
"DQ572979"	35	35	0	0	0	0	0	0	0	0	0	0	0	0	0	0	0	0
"DQ572980"	30	30	0	0	0	0	0	0	0	0	0	0	0	0	0	0	0	0
"DQ572986"	30	30	0	0	0	0	0	0	0	0	0	0	0	0	0	0	0	0
"DQ573006"	52	52	0	0	0	0	0	0	0	0	0	0	0	0	0	0	0	0
"DQ573033"	40	40	0	0	0	0	0	0	0	0	0	0	0	0	0	0	0	0
"DQ573052"	31	31	0	0	0	0	0	0	0	18	0	0	0	0	0	0	0	0
"DQ573108"	27	27	8	0	8	0	0	0	24	0	21	0	10	9	17	23	30	17
"DQ573170"	46	46	0	0	0	0	0	0	0	0	0	0	0	0	0	0	0	0
"DQ573192"	29	29	0	0	0	0	0	0	0	0	0	0	0	0	0	0	0	0
"DQ573195"	40	40	0	0	0	0	0	0	0	0	0	0	0	0	0	0	0	0
"DQ573199"	44	44	0	0	0	0	0	0	0	0	0	0	0	0	0	0	0	0
"DQ573253"	35	35	29	0	20	9	0	0	34	19	0	0	0	6	35	29	11	14
"DQ573257"	35	35	0	0	0	0	0	0	0	0	0	0	0	0	0	0	0	0
"DQ573334"	41	41	0	0	0	0	0	0	0	0	0	0	0	0	0	0	0	0
"DQ573430"	40	40	0	0	0	0	0	0	0	0	0	0	0	0	0	0	0	0
"DQ573432"	35	35	0	0	0	0	0	0	0	0	0	0	0	0	0	0	0	0
"DQ573486"	41	41	0	0	0	0	0	0	0	0	0	0	0	0	0	0	0	0
"DQ573539"	1714	1714	313	288	178	135	0	288	60	183	87	289	28	108	0	42	0	0
"DQ573543"	30	30	0	0	0	0	0	0	0	0	0	0	0	0	0	0	0	0
"DQ573573"	32	32	0	0	0	0	0	0	0	0	0	0	0	0	0	0	0	0
"DQ573661"	30	30	0	0	0	0	0	0	0	0	0	0	0	0	0	0	0	0
"DQ573663"	29	29	0	0	0	0	0	0	0	0	0	0	0	0	0	0	0	0
"DQ573667"	40	40	0	0	0	0	0	0	0	0	0	0	0	0	0	0	0	0
"DQ573668"	2191	2191	52	110	52	0	62	48	149	163	0	50	124	188	83	48	161	144
"DQ573684"	38	38	0	0	0	0	0	0	0	0	0	0	0	0	0	0	0	0
"DQ573709"	34	34	0	0	0	0	0	0	0	0	0	0	0	0	0	0	0	0
"DQ573710"	33	33	0	0	0	0	0	0	0	0	0	0	0	0	0	0	0	0
"DQ573744"	42	42	0	0	0	0	0	0	0	0	0	0	0	0	0	0	0	0
"DQ573754"	56	56	0	0	0	0	0	0	0	0	0	0	0	0	0	0	0	0
"DQ573774"	40	40	0	0	0	0	0	0	0	0	0	0	0	0	0	0	0	0
"DQ573799"	33	33	0	0	0	0	0	0	0	0	0	0	0	0	0	0	0	0
"DQ573820"	40	40	0	0	0	0	0	0	0	0	0	0	0	0	0	25	62	0
"DQ573850"	31	31	0	0	0	0	0	0	0	0	0	0	0	0	0	0	0	0
"DQ573852"	30	30	0	0	0	0	0	0	0	0	0	0	0	0	0	0	0	0
"DQ573937"	41	41	0	0	0	0	0	0	0	0	0	0	0	0	0	0	0	0
"DQ574014"	43	43	0	0	0	0	0	0	0	0	0	0	0	0	0	0	0	0
"DQ574019"	29	29	0	0	0	0	0	0	0	0	0	0	0	0	0	0	0	0
"DQ574071"	230	230	0	0	0	0	0	0	0	0	0	0	0	0	27	42	44	0
"DQ574073"	31	31	0	0	0	0	0	0	0	0	0	0	0	0	28	33	38	33
"DQ574074"	30	30	0	0	0	0	0	0	0	0	0	0	0	0	0	23	0	18
"DQ574151"	40	40	0	0	0	0	0	0	10	0	0	0	0	0	0	0	0	0
"DQ574155"	29	29	0	0	0	0	0	0	0	0	0	0	0	0	0	0	0	0
"DQ574214"	32	32	0	0	0	0	0	0	0	0	0	0	0	0	0	0	0	0
"DQ574229"	32	32	0	0	0	0	0	0	0	0	0	0	0	0	0	0	0	0
"DQ574239"	763	763	0	0	0	0	0	0	0	0	0	0	0	0	0	0	0	0
"DQ574249"	45	45	0	0	0	0	0	0	0	0	0	0	0	0	0	0	0	0
"DQ574255"	31	31	0	0	0	0	0	0	0	0	0	0	0	0	0	0	0	0
"DQ574291"	33	33	0	0	0	0	0	0	0	0	0	0	0	0	0	0	0	0
"DQ574292"	74	74	0	0	0	0	0	0	0	0	0	0	0	0	0	0	0	0
"DQ574306"	73	73	0	0	0	0	0	0	0	0	0	0	0	0	0	0	0	0
"DQ574353"	117	117	0	0	0	0	0	0	21	12	0	0	0	0	0	0	0	0
"DQ574380"	37	37	0	0	0	0	0	0	0	0	0	0	0	0	0	0	0	0
"DQ574483"	55	55	0	0	0	0	0	0	0	0	0	0	0	0	0	0	0	0
"DQ574505"	1248	1248	0	0	0	0	0	0	10	0	0	0	0	10	0	0	0	0
"DQ574506"	41	41	0	0	0	0	0	0	0	0	0	0	0	0	0	0	0	0
"DQ574553"	57	57	0	0	0	0	0	0	0	0	0	0	0	0	0	0	0	0
"DQ574556"	31	31	0	0	0	0	0	0	0	0	0	0	0	0	0	0	0	0
"DQ574659"	33	33	0	0	0	0	0	0	0	0	0	0	0	0	0	0	0	0
"DQ574660"	33	33	0	0	0	0	0	0	0	0	0	0	0	0	0	0	0	0
"DQ574670"	32	32	0	0	0	0	0	0	0	0	0	0	0	0	224	128	126	99
"DQ574672"	33	33	0	0	0	0	0	0	0	10	0	0	0	0	0	0	0	0
"DQ574674"	27	27	0	0	0	0	0	0	0	0	0	0	0	0	0	0	0	0
"DQ574682"	31	31	0	0	0	0	0	0	0	0	0	0	0	0	0	0	0	0
"DQ574757"	31	31	0	0	0	0	0	0	0	0	0	0	0	0	0	0	0	0
"DQ574758"	31	31	0	0	0	0	0	0	0	0	0	0	0	0	0	0	2	0
"DQ574760"	39	39	0	0	0	0	0	0	0	0	0	0	0	0	0	0	0	0
"DQ574768"	40	40	0	0	0	0	0	0	0	0	0	0	0	0	0	0	0	0
"DQ574794"	30	30	0	0	0	0	0	0	0	14	0	0	0	0	0	0	0	0
"DQ574804"	28	28	0	0	0	0	0	0	0	0	0	0	0	0	0	0	0	0
"DQ574810"	39	39	51	0	0	51	0	0	0	70	0	0	0	0	0	0	0	0
"DQ574826"	36	36	0	0	0	0	0	0	0	0	0	0	0	0	0	0	0	0
"DQ574833"	29	29	0	0	0	0	0	0	0	0	0	0	0	0	0	0	0	0
"DQ574839"	43	43	0	0	0	0	0	0	0	0	0	0	0	0	0	0	0	0
"DQ574852"	3725	3725	372	1161	0	372	605	556	906	1416	401	109	0	4091	0	0	0	0
"DQ574857"	54	54	0	0	0	0	0	0	0	0	0	0	0	0	0	0	0	0
"DQ574964"	32	32	0	0	0	0	0	0	0	12	0	0	0	0	0	0	0	0
"DQ574970"	33	33	0	0	0	0	0	0	0	0	0	0	0	0	0	0	0	0
"DQ575000"	48	48	0	0	0	0	0	0	0	0	0	0	0	0	0	0	0	0
"DQ575002"	31	31	0	0	0	0	0	0	0	0	0	0	0	0	0	0	0	0
"DQ575010"	35	35	0	0	0	0	0	0	0	18	0	0	0	0	0	0	0	0
"DQ575011"	28	28	0	0	0	0	0	0	0	0	0	0	0	0	0	0	0	0
"DQ575033"	30	30	0	0	0	0	0	0	0	0	0	0	0	0	0	0	0	0
"DQ575042"	47	47	0	0	0	0	0	0	0	21	0	0	0	0	0	0	0	0
"DQ575099"	47	47	0	0	0	0	0	0	21	0	0	0	0	0	0	0	0	0
"DQ575101"	33	33	0	0	0	0	0	0	0	0	0	0	0	0	36	51	44	0
"DQ575167"	30	30	0	0	0	0	0	0	21	0	0	0	0	0	0	0	0	0
"DQ575175"	62	62	0	0	0	0	0	0	0	0	0	0	0	0	0	0	0	0
"DQ575242"	35	35	0	0	0	0	0	0	0	0	0	0	0	0	0	0	0	0
"DQ575260"	31	31	0	0	0	0	0	0	0	0	0	0	0	0	0	0	0	0
"DQ575263"	34	34	0	0	0	0	0	0	0	0	0	0	0	0	0	0	0	0
"DQ575265"	31	31	0	0	0	0	0	0	0	0	0	0	0	0	0	0	0	0
"DQ575284"	36	36	0	0	0	0	0	0	0	0	0	0	0	0	0	0	0	0
"DQ575290"	40	40	0	0	0	0	0	0	0	0	0	0	0	0	0	0	0	0
"DQ575305"	35	35	0	0	0	0	0	0	0	0	0	0	0	0	0	0	0	0
"DQ575408"	43	43	0	0	0	0	0	0	0	0	0	0	0	0	0	0	0	0
"DQ575428"	53	53	0	0	0	0	0	0	0	0	0	0	0	0	0	0	0	0
"DQ575504"	1497	1497	135	75	67	68	37	38	248	37	0	33	134	94	4598	2425	5751	2673
"DQ575512"	31	31	0	0	0	0	0	0	0	0	0	0	0	0	0	0	0	0
"DQ575530"	35	35	0	0	0	0	0	0	15	0	0	0	0	0	0	0	0	0
"DQ575559"	45	45	0	0	0	0	0	0	10	0	0	0	0	0	0	0	0	0
"DQ575576"	35	35	0	0	0	0	0	0	0	0	0	0	0	0	0	0	0	0
"DQ575581"	33	33	0	0	0	0	0	0	0	0	0	0	0	0	0	0	0	0
"DQ575612"	38	38	0	0	0	0	0	0	0	0	0	0	0	0	0	0	0	0
"DQ575620"	44	44	0	0	0	0	0	0	0	0	0	0	0	0	0	0	0	0
"DQ575740"	31	31	0	0	0	0	0	0	0	0	0	0	0	0	43	66	70	30
"DQ575742"	28	28	4	0	0	4	0	0	36	0	21	7	10	9	17	23	30	17
"DQ575757"	39	39	0	0	0	0	0	0	0	0	0	0	0	0	0	0	0	0
"DQ575782"	52	52	0	0	0	0	0	0	0	0	0	0	0	0	0	0	0	0
"DQ575786"	79	79	0	0	0	0	0	0	0	0	0	0	0	0	0	0	0	0
"DQ575788"	79	79	0	0	0	0	0	0	0	0	0	0	0	0	0	0	0	0
"DQ575830"	37	37	0	0	0	0	0	0	0	0	0	0	0	0	0	0	0	0
"DQ575869"	75	75	0	0	0	0	0	0	0	0	0	0	0	0	0	0	0	0
"DQ575926"	33	33	0	0	0	0	0	0	23	0	0	0	0	0	0	0	0	0
"DQ575954"	44	44	0	0	0	0	0	0	17	14	0	0	0	0	0	0	0	0
"DQ575955"	33	33	0	0	0	0	0	0	0	0	0	0	0	0	224	80	0	0
"DQ575983"	60	60	0	0	0	0	0	0	0	0	0	0	0	0	0	0	0	0
"DQ575984"	30	30	0	0	0	0	0	0	0	0	0	0	0	0	0	0	0	0
"DQ576041"	30	30	0	0	0	0	0	0	20	0	0	0	0	0	0	0	0	0
"DQ576060"	36	36	0	0	0	0	0	0	0	0	0	0	0	0	0	0	0	0
"DQ576074"	30	30	0	0	0	0	0	0	0	0	0	0	0	0	0	0	0	0
"DQ576083"	32	32	0	0	0	0	0	0	14	0	0	0	0	0	0	0	0	0
"DQ576146"	30	30	0	0	0	0	0	0	0	0	0	0	0	0	0	0	0	0
"DQ576154"	38	38	0	0	0	0	0	0	0	0	0	0	0	0	0	0	0	0
"DQ576178"	43	43	0	0	0	0	0	0	36	0	0	0	0	0	0	0	0	0
"DQ576221"	39	39	0	0	0	0	0	0	0	0	0	0	0	0	0	0	0	0
"DQ576223"	34	34	0	0	0	0	0	0	36	0	0	0	0	0	0	0	0	0
"DQ576270"	37	37	0	0	0	0	0	0	0	0	0	0	0	0	0	0	0	0
"DQ576346"	55	55	0	0	0	0	0	0	0	0	0	0	0	0	0	0	0	0
"DQ576383"	30	30	0	0	0	0	0	0	0	0	0	0	0	0	0	0	0	0
"DQ576410"	37	37	0	0	0	0	0	0	0	0	0	0	0	0	0	0	0	0
"DQ576414"	85	85	0	0	0	0	0	0	0	0	0	0	0	0	0	0	0	0
"DQ576429"	68	68	0	0	0	0	0	0	0	0	0	0	0	0	0	0	0	0
"DQ576495"	65	65	0	0	0	0	0	0	0	0	0	0	0	0	0	0	0	0
"DQ576504"	32	32	0	0	0	0	0	0	8	0	0	0	0	0	0	0	0	0
"DQ576542"	30	30	0	0	0	0	0	0	0	0	0	0	0	0	0	0	0	0
"DQ576545"	31	31	0	0	0	0	0	0	0	0	0	0	0	0	0	0	0	0
"DQ576547"	34	34	0	0	0	0	0	0	0	15	0	0	0	0	0	0	0	0
"DQ576554"	47	47	0	0	0	0	0	0	0	0	0	0	0	0	0	0	0	0
"DQ576593"	44	44	0	0	0	0	0	0	0	0	0	0	0	0	0	0	0	0
"DQ576597"	40	40	0	0	0	0	0	0	0	0	0	0	0	0	0	0	0	0
"DQ576627"	30	30	24	0	15	9	0	0	17	3	7	10	11	16	51	38	56	50
"DQ576634"	28	28	0	0	0	0	0	0	0	0	0	0	0	0	0	0	0	0
"DQ576637"	42	42	0	0	0	0	0	0	0	0	0	0	0	0	0	0	0	0
"DQ576653"	37	37	0	0	0	0	0	0	0	0	0	0	0	0	0	0	0	0
"DQ576681"	32	32	0	0	0	0	0	0	0	12	0	0	0	0	0	0	0	0
"DQ576685"	31	31	0	0	0	0	0	0	0	0	0	0	0	0	0	0	0	0
"DQ576722"	38	38	0	0	0	0	0	0	0	0	0	0	0	0	0	0	0	0
"DQ576756"	1918	1918	13335	5760	7084	6251	3043	2717	4089	2437	3588	2130	9161	9552	1452	901	2155	1286
"DQ576791"	43	43	0	0	0	0	0	0	0	0	0	0	0	0	0	0	0	0
"DQ576800"	1020	1020	0	0	0	0	0	0	0	0	0	0	0	0	0	0	0	0
"DQ576802"	31	31	0	0	0	0	0	0	0	0	0	0	0	0	0	0	0	0
"DQ576810"	34	34	0	0	0	0	0	0	0	0	0	0	0	0	0	0	0	0
"DQ576825"	38	38	0	0	0	0	0	0	0	0	0	0	0	0	0	0	0	0
"DQ576853"	27	27	0	0	0	0	0	0	0	0	0	0	0	0	0	0	0	0
"DQ576856"	49	49	0	0	0	0	0	0	0	0	0	0	0	0	0	0	0	0
"DQ576882"	35	35	0	0	0	0	0	0	0	0	0	0	0	0	0	0	0	0
"DQ576886"	39	39	0	0	0	0	0	0	0	0	0	0	0	0	0	0	0	0
"DQ576895"	39	39	0	0	0	0	0	0	0	0	0	0	0	0	27	0	40	33
"DQ576896"	77	77	0	0	0	0	0	0	0	0	0	0	0	0	0	61	62	23
"DQ576926"	71	71	0	0	0	0	0	0	0	0	0	0	0	0	0	0	0	0
"DQ576951"	31	31	80	158	80	0	76	82	37	34	0	50	227	281	6142	7011	8294	6161
"DQ576952"	31	31	0	0	0	0	0	0	0	0	0	0	0	12	4693	56	6644	4787
"DQ576994"	2083	2083	0	0	0	0	0	0	0	0	0	0	0	0	0	0	0	0
"DQ576999"	36	36	0	0	0	0	0	0	0	0	0	0	0	0	0	0	38	33
"DQ577003"	31	31	0	0	0	0	0	0	0	0	0	0	0	0	0	0	0	0
"DQ577036"	33	33	0	0	0	0	0	0	0	0	0	0	0	0	0	0	0	0
"DQ577084"	33	33	0	0	0	0	0	0	0	0	0	0	0	0	0	0	0	0
"DQ577095"	68	68	0	0	0	0	0	0	0	0	0	0	0	0	0	0	0	0
"DQ577099"	35	35	0	0	0	0	0	0	12	0	0	0	0	0	533	344	890	409
"DQ577118"	54	54	0	0	0	0	0	0	0	0	0	0	0	0	0	0	0	0
"DQ577132"	31	31	0	0	0	0	0	0	0	0	0	0	0	0	0	0	52	0
"DQ577137"	31	31	0	0	0	0	0	0	0	0	0	0	0	0	0	0	0	0
"DQ577165"	31	31	0	0	0	0	0	0	0	0	0	0	0	0	0	0	0	0
"DQ577219"	36	36	0	0	0	0	0	0	0	0	0	0	0	0	0	0	0	0
"DQ577232"	29	29	0	0	0	0	0	0	0	0	0	0	0	0	0	0	0	0
"DQ577244"	30	30	0	0	0	0	0	0	0	0	0	0	0	0	24	24	18	7
"DQ577257"	34	34	0	0	0	0	0	0	0	0	0	0	0	0	0	0	0	0
"DQ577288"	33	33	0	0	0	0	0	0	0	0	0	0	0	0	0	0	0	0
"DQ577323"	53	53	0	0	0	0	0	0	0	0	0	0	0	0	0	0	0	0
"DQ577348"	39	39	0	0	0	0	0	0	0	0	0	0	0	0	0	0	0	0
"DQ577389"	41	41	0	0	0	0	0	0	0	0	0	0	0	0	0	0	0	0
"DQ577410"	43	43	0	0	0	0	0	0	0	0	0	0	0	0	0	0	0	0
"DQ577411"	35	35	0	0	0	0	0	0	0	0	0	0	0	0	0	0	0	0
"DQ577420"	461	461	0	0	0	0	0	0	0	0	0	0	0	0	0	0	0	0
"DQ577434"	52	52	0	0	0	0	0	0	0	0	0	0	0	0	0	0	0	0
"DQ577476"	69	69	0	0	0	0	0	0	0	0	0	0	0	0	0	0	0	0
"DQ577523"	2098	2098	209	224	143	66	107	117	162	53	239	565	0	686	187	123	484	133
"DQ577530"	29	29	0	0	0	0	0	0	0	0	0	0	0	0	0	0	0	0
"DQ577579"	36	36	0	0	0	0	0	0	0	0	0	0	0	0	0	0	0	0
"DQ577602"	31	31	0	0	0	0	0	0	0	10	0	0	0	0	0	0	0	0
"DQ577610"	36	36	0	0	0	0	0	0	0	0	0	0	0	0	0	0	0	0
"DQ577611"	31	31	0	0	0	0	0	0	0	0	0	0	0	0	0	0	0	0
"DQ577629"	31	31	0	0	0	0	0	0	0	0	0	0	0	0	0	0	0	0
"DQ577646"	36	36	0	0	0	0	0	0	21	0	0	0	0	0	0	0	0	0
"DQ577649"	33	33	0	0	0	0	0	0	0	0	0	0	0	0	0	0	0	0
"DQ577685"	33	33	0	0	0	0	0	0	0	0	0	0	0	0	0	0	0	0
"DQ577693"	31	31	0	0	0	0	0	0	0	0	0	0	0	0	0	0	0	0
"DQ577698"	34	34	0	0	0	0	0	0	0	0	0	0	0	0	0	0	0	0
"DQ577719"	30	30	0	0	0	0	0	0	0	0	0	0	0	0	0	0	0	0
"DQ577720"	43	43	0	0	0	0	0	0	0	0	0	0	0	0	0	0	0	0
"DQ577738"	64	64	0	0	0	0	0	0	0	0	0	0	0	0	0	0	0	0
"DQ577739"	35	35	0	0	0	0	0	0	17	0	0	0	0	0	0	0	0	0
"DQ577743"	31	31	0	0	0	0	0	0	0	0	0	0	0	0	0	0	0	0
"DQ577785"	26	26	0	0	0	0	0	0	0	0	0	0	9	10	0	4	7	0
"DQ577875"	60	60	0	0	0	0	0	0	0	0	0	0	0	0	0	0	0	0
"DQ577902"	34	34	0	0	0	0	0	0	0	0	0	0	0	0	0	0	0	0
"DQ577903"	30	30	0	0	0	0	0	0	0	0	0	0	0	0	0	0	0	0
"DQ577926"	29	29	0	0	0	0	0	0	0	0	0	0	0	0	0	0	0	0
"DQ577940"	32	32	0	0	0	0	0	0	0	0	0	0	0	0	0	0	0	0
"DQ577965"	63	63	0	0	0	0	0	0	0	0	0	0	0	0	0	0	0	0
"DQ577978"	31	31	0	0	0	0	0	0	0	0	0	0	0	0	0	0	0	0
"DQ577988"	70	70	0	0	0	0	0	0	0	0	0	0	0	0	0	0	0	0
"DQ578037"	49	49	0	0	0	0	0	0	0	0	0	0	0	0	0	0	0	0
"DQ578051"	36	36	0	0	0	0	0	0	0	0	0	0	0	0	0	0	0	0
"DQ578058"	76	76	0	0	0	0	0	0	0	0	0	0	0	0	0	0	0	0
"DQ578106"	45	45	0	0	0	0	0	0	0	0	0	0	0	0	0	0	0	0
"DQ578124"	59	59	0	0	0	0	0	0	0	0	0	0	0	0	0	0	0	0
"DQ578183"	37	37	0	0	0	0	0	0	0	0	0	0	0	0	0	0	0	0
"DQ578200"	41	41	0	0	0	0	0	0	0	0	0	0	0	0	0	0	0	0
"DQ578236"	32	32	0	0	0	0	0	0	0	0	0	0	0	0	0	0	0	0
"DQ578258"	40	40	0	0	0	0	0	0	0	0	0	0	0	0	0	0	0	0
"DQ578267"	37	37	0	0	0	0	0	0	0	0	0	0	0	0	0	0	0	0
"DQ578289"	29	29	0	0	0	0	0	0	0	0	0	0	0	0	0	0	52	0
"DQ578297"	38	38	0	0	0	0	0	0	0	0	0	0	0	0	0	25	0	18
"DQ578299"	35	35	0	0	0	0	0	0	0	0	0	0	0	0	0	35	40	0
"DQ578310"	50	50	0	0	0	0	0	0	0	0	0	0	0	0	0	0	0	0
"DQ578341"	33	33	0	0	0	0	0	0	0	0	0	0	0	0	0	0	0	0
"DQ578369"	59	59	0	0	0	0	0	0	0	0	0	0	0	0	0	0	0	0
"DQ578482"	36	36	0	0	0	0	0	0	0	0	0	0	0	0	0	0	0	0
"DQ578510"	47	47	0	0	0	0	0	0	0	0	0	0	0	0	0	0	0	0
"DQ578586"	32	32	0	0	0	0	0	0	0	0	0	0	0	0	0	0	0	0
"DQ578595"	59	59	0	0	0	0	0	0	0	0	0	0	0	0	0	0	0	0
"DQ578597"	27	27	12	0	12	0	0	0	0	0	0	0	1	0	3	4	0	0
"DQ578665"	30	30	0	0	0	0	0	0	0	0	0	0	0	0	0	0	0	0
"DQ578702"	41	41	0	0	0	0	0	0	0	0	0	0	0	0	0	0	0	0
"DQ578707"	39	39	0	0	0	0	0	0	0	0	0	0	0	0	0	0	0	0
"DQ578838"	36	36	0	0	0	0	0	0	0	0	0	0	0	0	0	0	5	3
"DQ578839"	38	38	0	0	0	0	0	0	0	0	0	0	0	0	0	0	0	0
"DQ578902"	31	31	0	0	0	0	0	0	0	0	0	0	0	0	0	0	0	0
"DQ578935"	34	34	0	0	0	0	0	0	0	0	0	0	0	0	0	0	0	0
"DQ578945"	31	31	0	0	0	0	0	0	0	0	0	0	0	0	0	0	0	0
"DQ578965"	27	27	0	0	0	0	0	0	0	0	0	0	0	0	0	0	0	0
"DQ579022"	41	41	0	0	0	0	0	0	0	0	0	0	0	0	0	0	0	0
"DQ579129"	40	40	0	0	0	0	0	0	0	0	0	0	0	0	0	0	0	0
"DQ579141"	37	37	0	0	0	0	0	0	0	0	0	0	0	0	0	0	0	0
"DQ579150"	70	70	0	0	0	0	0	0	0	10	0	0	0	0	0	0	0	0
"DQ579182"	31	31	0	0	0	0	0	0	0	0	0	0	0	0	0	0	0	0
"DQ579192"	33	33	0	0	0	0	0	0	0	0	0	0	0	0	0	0	0	0
"DQ579214"	1700	1700	0	0	0	0	0	0	0	0	0	0	0	0	0	0	0	0
"DQ579247"	49	49	0	0	0	0	0	0	0	0	0	0	0	0	0	0	0	0
"DQ579248"	50	50	0	0	0	0	0	0	0	0	0	0	0	0	0	0	0	0
"DQ579249"	41	41	0	0	0	0	0	0	0	0	0	0	0	0	0	0	0	0
"DQ579261"	35	35	0	0	0	0	0	0	0	0	0	0	0	0	0	0	0	0
"DQ579263"	31	31	0	0	0	0	0	0	33	0	0	0	0	0	0	0	0	0
"DQ579288"	31	31	0	0	0	0	0	0	0	0	0	0	0	0	0	0	0	0
"DQ579405"	32	32	0	0	0	0	0	0	0	0	0	0	0	0	0	0	0	0
"DQ579436"	28	28	0	0	0	0	0	0	0	0	0	0	0	0	0	0	0	0
"DQ579449"	30	30	0	0	0	0	0	0	0	0	0	0	0	0	0	0	0	0
"DQ579470"	34	34	0	0	0	0	0	0	0	0	0	0	0	0	0	0	0	0
"DQ579489"	34	34	0	0	0	0	0	0	7	0	0	0	0	0	0	0	0	0
"DQ579650"	51	51	0	0	0	0	0	0	0	0	0	0	0	0	0	0	0	0
"DQ579677"	32	32	0	0	0	0	0	0	0	11	0	0	0	0	0	0	0	0
"DQ579681"	31	31	0	0	0	0	0	0	0	0	0	0	0	0	0	0	0	0
"DQ579694"	28	28	0	0	0	0	0	0	0	0	0	0	0	0	0	0	0	0
"DQ579700"	46	46	0	0	0	0	0	0	0	0	0	0	0	0	0	0	0	0
"DQ579704"	41	41	18	65	0	18	31	34	129	0	0	0	882	22	73	54	48	0
"DQ579711"	29	29	0	0	0	0	0	0	0	0	0	0	0	0	0	0	0	0
"DQ579754"	36	36	0	0	0	0	0	0	0	0	0	0	0	0	0	0	0	0
"DQ579782"	35	35	0	0	0	0	0	0	0	0	0	0	0	0	0	0	0	0
"DQ579850"	28	28	0	0	0	0	0	0	0	0	0	0	0	0	57	22	194	0
"DQ579878"	66	66	0	0	0	0	0	0	0	0	0	0	0	0	0	0	0	0
"DQ579888"	35	35	0	0	0	0	0	0	0	0	0	0	0	0	0	0	0	0
"DQ579890"	33	33	0	0	0	0	0	0	29	0	0	0	0	0	0	0	0	0
"DQ579907"	30	30	0	0	0	0	0	0	0	0	0	0	0	0	0	0	0	0
"DQ579956"	63	63	0	0	0	0	0	0	0	0	0	0	0	0	0	0	0	0
"DQ579970"	29	29	0	0	0	0	0	0	0	0	0	0	0	0	0	0	0	0
"DQ579975"	41	41	0	0	0	0	0	0	0	0	0	0	0	0	0	0	0	0
"DQ580000"	33	33	0	0	0	0	0	0	0	10	0	0	0	0	0	0	0	0
"DQ580080"	56	56	0	0	0	0	0	0	0	0	0	0	0	0	0	0	0	0
"DQ580125"	105	105	0	0	0	0	0	0	0	0	0	0	0	0	0	0	0	0
"DQ580168"	31	31	0	0	0	0	0	0	0	0	0	0	0	0	0	0	0	0
"DQ580247"	32	32	0	0	0	0	0	0	0	0	0	0	0	0	0	0	0	0
"DQ580323"	32	32	0	0	0	0	0	0	0	0	0	0	0	0	0	0	0	0
"DQ580333"	30	30	0	0	0	0	0	0	0	0	0	0	0	0	0	0	0	0
"DQ580366"	53	53	0	0	0	0	0	0	0	0	0	0	0	0	0	0	0	0
"DQ580411"	56	56	0	0	0	0	0	0	0	0	0	0	0	0	0	0	0	0
"DQ580422"	30	30	0	0	0	0	0	0	0	0	0	0	0	0	0	0	0	0
"DQ580467"	30	30	0	0	0	0	0	0	0	0	0	0	0	0	0	0	0	0
"DQ580595"	30	30	0	0	0	0	0	0	0	0	0	0	0	0	0	0	0	0
"DQ580608"	32	32	0	0	0	0	0	0	0	0	0	0	0	0	0	0	0	0
"DQ580625"	25	25	0	0	0	0	0	0	0	0	0	0	0	0	0	0	0	0
"DQ580728"	42	42	0	0	0	0	0	0	0	0	0	0	0	0	0	0	0	0
"DQ580770"	38	38	0	0	0	0	0	0	0	0	0	0	0	0	0	0	0	0
"DQ580783"	47	47	0	0	0	0	0	0	0	0	0	0	0	0	0	0	0	0
"DQ580819"	36	36	0	0	0	0	0	0	0	0	0	0	0	0	0	0	0	0
"DQ580826"	30	30	0	0	0	0	0	0	0	0	0	0	0	0	0	0	0	0
"DQ580846"	2001	2001	0	0	0	0	0	0	0	0	0	0	0	0	0	0	0	0
"DQ580909"	3332	3332	0	0	0	0	0	0	0	11	0	0	0	0	0	0	0	0
"DQ580910"	41	41	0	0	0	0	0	0	17	0	0	0	0	0	0	0	0	0
"DQ580960"	63	63	0	0	0	0	0	0	0	26	0	0	0	0	0	0	0	0
"DQ581031"	90	90	238	348	0	238	164	184	248	99	0	224	0	0	0	53	0	0
"DQ581032"	97	97	0	0	0	0	0	0	0	0	0	0	0	0	0	0	0	0
"DQ581033"	95	95	0	0	0	0	0	0	0	0	0	0	0	0	0	0	0	0
"DQ581043"	41	41	0	0	0	0	0	0	0	0	0	0	0	0	0	0	0	0
"DQ581170"	58	58	0	0	0	0	0	0	0	0	0	0	0	0	0	0	0	0
"DQ581179"	64	64	0	0	0	0	0	0	0	0	0	0	0	0	0	0	0	0
"DQ581231"	41	41	0	0	0	0	0	0	0	0	0	0	0	0	0	0	0	0
"DQ581539"	42	42	0	0	0	0	0	0	13	13	0	0	0	0	0	0	0	0
"DQ581559"	40	40	0	0	0	0	0	0	0	0	0	0	0	0	0	0	0	0
"DQ581563"	40	40	0	0	0	0	0	0	0	0	0	0	0	0	0	0	0	0
"DQ581582"	40	40	0	0	0	0	0	0	0	0	0	0	0	0	0	0	0	0
"DQ581587"	52	52	0	0	0	0	0	0	0	0	0	0	0	0	0	0	0	0
"DQ581594"	31	31	0	0	0	0	0	0	0	0	0	0	0	0	0	0	0	0
"DQ581602"	63	63	0	0	0	0	0	0	0	0	0	0	0	0	0	0	0	0
"DQ581615"	30	30	0	0	0	0	0	0	0	0	0	0	0	0	0	0	0	0
"DQ581622"	48	48	0	0	0	0	0	0	0	0	0	0	0	0	0	0	0	0
"DQ581641"	91	91	0	0	0	0	0	0	0	0	0	0	0	0	0	0	0	0
"DQ581652"	127	127	0	0	0	0	0	0	14	12	0	0	0	0	0	0	0	0
"DQ581854"	49	49	0	0	0	0	0	0	0	0	0	0	0	0	0	0	0	0
"DQ581863"	30	30	0	0	0	0	0	0	33	0	0	0	0	0	0	0	0	0
"DQ581928"	2745	2745	0	0	0	0	0	0	0	0	0	0	0	0	0	0	0	0
"DQ581988"	33	33	0	0	0	0	0	0	36	0	0	0	0	0	8	0	0	0
"DQ582013"	63	63	0	0	0	0	0	0	0	0	0	0	0	0	0	0	0	0
"DQ582024"	30	30	0	0	0	0	0	0	0	0	0	0	0	0	0	0	0	0
"DQ582032"	36	36	0	0	0	0	0	0	0	0	0	0	0	0	0	0	0	0
"DQ582071"	32	32	0	0	0	0	0	0	0	0	0	0	0	0	0	0	0	0
"DQ582073"	32	32	0	0	0	0	0	0	0	0	0	0	0	0	0	0	0	0
"DQ582116"	141	141	0	0	0	0	0	0	0	0	0	0	0	0	27	42	44	30
"DQ582117"	121	121	0	0	0	0	0	0	0	0	0	0	0	0	0	27	42	0
"DQ582201"	133	133	0	0	0	0	0	0	0	0	0	0	0	0	0	0	0	0
"DQ582228"	35	35	0	0	0	0	0	0	0	0	0	0	0	0	0	0	0	0
"DQ582230"	1748	1748	0	153	0	0	77	76	314	72	161	149	0	0	0	0	0	0
"DQ582247"	84	84	0	0	0	0	0	0	0	0	0	0	0	0	17	65	61	27
"DQ582260"	41	41	0	0	0	0	0	0	0	12	0	0	0	0	0	24	0	0
"DQ582265"	32	32	0	0	0	0	0	0	60	0	0	0	0	0	1297	0	0	0
"DQ582309"	33	33	87	0	56	31	0	0	73	0	0	0	14	0	0	0	0	0
"DQ582356"	29	29	0	0	0	0	0	0	0	0	0	0	0	0	0	0	0	0
"DQ582448"	30	30	0	0	0	0	0	0	0	0	0	0	0	0	0	0	0	0
"DQ582460"	35	35	0	0	0	0	0	0	0	0	0	0	0	0	28	50	66	30
"DQ582462"	32	32	0	0	0	0	0	0	0	0	0	0	0	0	0	25	62	0
"DQ582474"	32	32	0	0	0	0	0	0	0	0	0	0	0	0	0	0	0	0
"DQ582480"	79	79	0	0	0	0	0	0	0	0	0	0	0	0	0	0	0	0
"DQ582484"	41	41	0	0	0	0	0	0	0	0	0	0	0	0	0	0	0	0
"DQ582485"	34	34	0	0	0	0	0	0	0	0	0	0	0	0	0	0	0	0
"DQ582547"	30	30	0	0	0	0	0	0	0	0	0	0	0	0	0	0	0	0
"DQ582573"	43	43	0	0	0	0	0	0	0	11	0	0	0	0	0	0	0	0
"DQ582588"	42	42	0	0	0	0	0	0	0	0	0	0	0	0	42	65	44	27
"DQ582610"	40	40	0	0	0	0	0	0	0	0	0	0	0	0	0	0	0	0
"DQ582641"	28	28	0	0	0	0	0	0	0	0	0	0	0	0	0	0	0	0
"DQ582660"	34	34	0	0	0	0	0	0	21	0	0	0	0	0	0	0	0	0
"DQ582665"	32	32	0	0	0	0	0	0	0	0	0	0	0	0	0	0	0	0
"DQ582666"	32	32	0	0	0	0	0	0	0	0	0	0	0	0	24	52	52	0
"DQ582729"	32	32	0	0	0	0	0	0	0	0	0	0	0	0	0	0	0	0
"DQ582813"	35	35	0	0	0	0	0	0	0	0	0	0	0	0	0	0	0	0
"DQ582841"	39	39	0	0	0	0	0	0	15	0	0	0	0	0	0	0	0	0
"DQ582858"	45	45	0	0	0	0	0	0	0	0	0	0	0	0	0	0	0	0
"DQ582866"	32	32	0	0	0	0	0	0	29	0	0	0	0	0	0	0	0	0
"DQ582882"	45	45	0	0	0	0	0	0	0	0	0	0	0	0	0	0	0	0
"DQ582939"	24	24	0	0	0	0	0	0	0	0	0	0	0	0	0	0	0	0
"DQ582940"	27	27	0	0	0	0	0	0	0	0	0	0	0	0	85	0	0	0
"DQ582989"	31	31	0	0	0	0	0	0	21	0	0	0	0	0	0	0	0	0
"DQ583034"	30	30	0	0	0	0	0	0	0	0	0	0	0	0	0	0	0	0
"DQ583039"	37	37	0	0	0	0	0	0	0	0	0	0	0	0	0	0	0	0
"DQ583079"	35	35	0	0	0	0	0	0	0	0	0	0	0	0	0	0	0	0
"DQ583098"	42	42	0	0	0	0	0	0	0	0	0	0	0	0	0	0	0	0
"DQ583108"	1268	1268	0	0	0	0	0	0	0	0	0	0	0	0	0	0	0	0
"DQ583118"	32	32	0	0	0	0	0	0	0	0	0	0	0	0	0	0	0	0
"DQ583119"	28	28	0	8	0	0	8	0	0	0	0	0	0	0	0	0	0	0
"DQ583161"	32	32	0	0	0	0	0	0	13	0	0	0	0	0	0	0	0	0
"DQ583165"	35	35	0	0	0	0	0	0	0	0	0	0	0	0	0	0	0	0
"DQ583226"	28	28	0	0	0	0	0	0	0	0	0	0	0	0	0	0	0	0
"DQ583233"	53	53	0	0	0	0	0	0	0	0	0	0	0	0	0	0	0	0
"DQ583414"	33	33	0	0	0	0	0	0	0	0	0	0	0	0	0	0	0	0
"DQ583483"	48	48	0	0	0	0	0	0	0	0	0	0	0	0	0	23	0	18
"DQ583486"	32	32	0	0	0	0	0	0	0	0	0	0	0	0	0	0	0	0
"DQ583499"	402	402	0	0	0	0	0	0	0	0	0	0	0	0	0	0	0	0
"DQ583509"	37	37	0	0	0	0	0	0	0	0	0	0	0	0	0	0	0	0
"DQ583543"	33	33	0	0	0	0	0	0	21	0	0	0	0	0	0	0	0	0
"DQ583554"	64	64	0	0	0	0	0	0	0	0	0	0	0	0	0	0	0	0
"DQ583578"	30	30	0	0	0	0	0	0	0	0	0	0	0	0	0	23	0	18
"DQ583610"	41	41	0	0	0	0	0	0	0	57	0	54	0	13	0	0	0	0
"DQ583683"	68	68	0	0	0	0	0	0	0	0	0	0	0	0	0	0	0	0
"DQ583708"	35	35	0	0	0	0	0	0	0	0	0	0	0	0	0	0	0	0
"DQ583737"	2470	2470	243	75	113	130	57	18	163	87	193	41	400	262	491	235	557	330
"DQ583759"	37	37	0	0	0	0	0	0	0	0	0	0	0	0	0	0	0	0
"DQ583776"	40	40	0	0	0	0	0	0	0	0	0	0	0	0	0	0	0	0
"DQ583809"	30	30	152	0	84	68	0	0	41	0	0	0	0	0	0	0	0	0
"DQ583818"	36	36	0	0	0	0	0	0	0	0	0	0	0	0	0	0	0	0
"DQ583824"	31	31	0	0	0	0	0	0	0	0	0	0	0	0	0	0	0	0
"DQ583840"	31	31	0	0	0	0	0	0	33	0	0	0	0	0	0	0	0	0
"DQ583846"	31	31	0	0	0	0	0	0	0	0	0	0	0	0	0	0	0	0
"DQ583847"	31	31	0	0	0	0	0	0	0	0	0	0	0	0	0	0	0	0
"DQ583878"	32	32	0	0	0	0	0	0	0	0	0	0	0	0	0	0	0	0
"DQ583946"	45	45	0	0	0	0	0	0	0	0	0	0	0	0	0	0	0	0
"DQ583953"	39	39	0	0	0	0	0	0	0	0	0	0	0	0	0	0	0	0
"DQ583960"	275	275	366	294	191	175	217	77	92	186	134	299	1137	1503	632	575	681	514
"DQ583972"	30	30	0	0	0	0	0	0	0	0	0	0	0	0	0	0	0	0
"DQ583986"	47	47	0	0	0	0	0	0	0	0	0	0	0	0	0	0	0	0
"DQ584005"	30	30	0	0	0	0	0	0	0	0	0	0	0	0	0	0	0	0
"DQ584012"	35	35	0	0	0	0	0	0	0	0	0	0	0	0	0	0	0	0
"DQ584014"	32	32	0	0	0	0	0	0	0	0	0	0	0	0	0	0	0	0
"DQ584023"	54	54	0	0	0	0	0	0	0	0	0	0	0	0	0	0	0	0
"DQ584035"	33	33	0	0	0	0	0	0	0	0	0	0	0	0	0	0	0	0
"DQ584039"	30	30	0	0	0	0	0	0	26	0	0	0	0	0	68	59	78	28
"DQ584075"	31	31	0	0	0	0	0	0	0	0	0	0	0	0	0	0	0	0
"DQ584103"	36	36	0	0	0	0	0	0	0	0	0	0	0	0	0	0	0	0
"DQ584108"	43	43	0	0	0	0	0	0	0	0	0	0	0	0	0	0	0	0
"DQ584116"	2072	2072	144	127	144	0	0	127	86	113	0	321	20	55	278	309	367	166
"DQ584120"	33	33	0	0	0	0	0	0	0	11	0	0	0	0	0	0	0	0
"DQ584158"	31	31	0	0	0	0	0	0	0	0	0	0	0	0	0	0	0	0
"DQ584223"	42	42	0	0	0	0	0	0	0	0	0	0	0	0	0	0	0	0
"DQ584235"	36	36	0	0	0	0	0	0	0	15	0	0	0	0	0	0	0	0
"DQ584248"	51	51	0	0	0	0	0	0	16	0	0	0	0	0	0	0	0	0
"DQ584258"	52	52	0	0	0	0	0	0	0	0	0	0	0	0	0	0	0	0
"DQ584301"	33	33	0	0	0	0	0	0	0	0	0	0	0	0	0	0	0	0
"DQ584320"	28	28	0	0	0	0	0	0	61	30	0	43	11	0	0	0	0	0
"DQ584326"	42	42	0	0	0	0	0	0	0	0	0	0	0	0	0	0	0	0
"DQ584370"	33	33	0	0	0	0	0	0	0	0	0	0	0	0	0	0	0	0
"DQ584516"	31	31	0	0	0	0	0	0	0	0	0	0	0	0	0	0	0	0
"DQ584521"	36	36	0	0	0	0	0	0	0	0	0	0	0	0	0	0	0	0
"DQ584609"	91	91	0	0	0	0	0	0	0	0	0	0	0	0	0	37	26	0
"DQ584631"	71	71	0	0	0	0	0	0	0	0	0	0	0	0	0	0	0	0
"DQ584642"	36	36	0	0	0	0	0	0	0	0	0	0	0	0	0	0	0	0
"DQ584667"	30	30	0	0	0	0	0	0	0	0	0	0	0	0	0	0	0	0
"DQ584669"	30	30	0	0	0	0	0	0	12	0	0	0	0	0	0	0	0	0
"DQ584676"	27	27	0	0	0	0	0	0	0	0	0	0	0	0	0	0	0	0
"DQ584698"	32	32	0	0	0	0	0	0	0	0	0	0	0	0	0	0	0	0
"DQ584699"	31	31	1152	91	579	573	91	0	46	93	0	63	0	309	0	0	0	0
"DQ584752"	40	40	0	0	0	0	0	0	16	0	0	0	0	0	0	0	0	0
"DQ584769"	38	38	0	0	0	0	0	0	0	0	0	0	0	0	0	0	0	0
"DQ584777"	58	58	0	0	0	0	0	0	0	0	0	0	0	0	0	0	0	0
"DQ584837"	36	36	0	0	0	0	0	0	0	0	0	0	0	0	0	0	0	0
"DQ584883"	38	38	0	0	0	0	0	0	0	0	0	0	0	0	0	0	0	0
"DQ584914"	42	42	0	0	0	0	0	0	0	0	0	0	0	0	0	0	0	0
"DQ584932"	54	54	0	0	0	0	0	0	0	0	0	0	0	0	0	0	0	0
"DQ584937"	36	36	0	0	0	0	0	0	0	0	0	0	0	0	0	0	0	0
"DQ584939"	41	41	0	0	0	0	0	0	0	10	0	0	0	0	0	0	0	0
"DQ584943"	27	27	0	0	0	0	0	0	0	0	0	0	0	0	0	0	0	0
"DQ584963"	34	34	0	0	0	0	0	0	0	21	0	0	0	0	0	0	0	0
"DQ584971"	50	50	0	0	0	0	0	0	0	0	0	0	0	0	0	0	0	0
"DQ584981"	33	33	0	0	0	0	0	0	0	0	0	0	0	0	0	0	0	0
"DQ584993"	36	36	0	0	0	0	0	0	0	0	0	0	0	0	0	0	0	0
"DQ585102"	37	37	0	0	0	0	0	0	0	0	0	0	0	0	0	0	0	0
"DQ585117"	38	38	0	0	0	0	0	0	0	0	0	0	0	0	0	0	0	0
"DQ585127"	39	39	0	0	0	0	0	0	0	0	0	0	0	0	0	0	0	0
"DQ585129"	32	32	0	0	0	0	0	0	0	0	0	0	0	0	0	0	0	0
"DQ585132"	37	37	0	0	0	0	0	0	0	0	0	0	0	0	0	0	0	0
"DQ585153"	35	35	0	0	0	0	0	0	0	0	0	0	0	0	0	0	0	0
"DQ585216"	37	37	0	0	0	0	0	0	0	0	0	0	0	0	0	0	0	0
"DQ585237"	85	85	0	0	0	0	0	0	0	0	0	0	0	0	0	0	0	0
"DQ585239"	73	73	0	0	0	0	0	0	0	0	0	0	0	0	0	0	0	0
"DQ585264"	30	30	0	0	0	0	0	0	0	0	0	0	0	0	0	0	0	0
"DQ585275"	46	46	0	0	0	0	0	0	0	0	0	0	0	0	0	0	0	0
"DQ585294"	39	39	0	0	0	0	0	0	0	0	0	0	0	0	0	0	0	0
"DQ585295"	35	35	0	0	0	0	0	0	0	0	0	0	0	0	0	0	0	0
"DQ585389"	73	73	0	0	0	0	0	0	17	0	0	0	0	0	0	0	0	0
"DQ585460"	45	45	0	0	0	0	0	0	16	11	0	0	0	0	0	0	0	0
"DQ585483"	34	34	0	0	0	0	0	0	24	19	0	0	0	0	0	0	0	0
"DQ585545"	30	30	0	0	0	0	0	0	0	0	0	0	0	0	0	0	0	0
"DQ585555"	55	55	0	0	0	0	0	0	0	0	0	0	0	0	0	0	0	0
"DQ585572"	42	42	0	0	0	0	0	0	0	0	0	0	0	0	0	0	0	0
"DQ585583"	28	28	0	0	0	0	0	0	0	0	0	0	0	0	0	0	0	0
"DQ585588"	47	47	0	0	0	0	0	0	0	0	0	0	0	0	0	0	0	0
"DQ585633"	34	34	0	0	0	0	0	0	0	0	0	0	0	0	0	0	0	0
"DQ585644"	56	56	0	0	0	0	0	0	0	0	0	0	0	0	0	0	0	0
"DQ585694"	37	37	0	0	0	0	0	0	14	12	0	0	0	0	0	0	0	0
"DQ585728"	45	45	0	0	0	0	0	0	0	0	0	0	0	0	0	0	0	0
"DQ585749"	33	33	0	0	0	0	0	0	0	0	0	0	0	0	0	0	0	0
"DQ585755"	65	65	0	0	0	0	0	0	0	0	0	0	0	0	0	0	0	0
"DQ585760"	53	53	0	0	0	0	0	0	0	0	0	0	0	0	0	0	0	0
"DQ585847"	48	48	0	0	0	0	0	0	0	0	0	0	0	0	0	0	0	0
"DQ585850"	37	37	0	0	0	0	0	0	0	0	0	0	0	0	0	0	0	0
"DQ585914"	740	740	0	0	0	0	0	0	0	0	0	0	0	0	0	0	0	0
"DQ585915"	33	33	0	0	0	0	0	0	0	0	0	0	0	0	0	0	0	0
"DQ585921"	32	32	0	0	0	0	0	0	0	0	0	0	0	0	0	0	0	0
"DQ585964"	28	28	0	0	0	0	0	0	0	0	0	0	0	0	0	0	0	0
"DQ585996"	48	48	0	0	0	0	0	0	0	0	0	0	0	0	0	0	0	0
"DQ586020"	77	77	0	0	0	0	0	0	0	0	0	0	0	0	0	51	62	23
"DQ586021"	59	59	0	0	0	0	0	0	0	0	0	0	0	0	0	35	40	28
"DQ586040"	35	35	0	0	0	0	0	0	0	0	0	0	0	0	0	0	443	0
"DQ586061"	33	33	0	0	0	0	0	0	0	0	0	0	0	0	0	0	0	0
"DQ586064"	41	41	0	0	0	0	0	0	0	0	0	0	0	0	0	0	0	0
"DQ586086"	34	34	0	0	0	0	0	0	0	0	0	0	0	0	0	0	0	0
"DQ586106"	74	74	0	0	0	0	0	0	0	0	0	0	0	0	0	0	0	0
"DQ586122"	62	62	0	0	0	0	0	0	0	0	0	0	0	0	0	0	0	0
"DQ586158"	38	38	0	0	0	0	0	0	0	0	0	0	0	0	0	0	0	0
"DQ586230"	32	32	0	0	0	0	0	0	0	0	0	0	0	0	0	0	0	0
"DQ586243"	48	48	0	0	0	0	0	0	0	0	0	0	0	0	0	0	0	0
"DQ586244"	105	105	0	0	0	0	0	0	0	0	0	0	0	0	0	0	0	0
"DQ586245"	105	105	0	0	0	0	0	0	0	0	0	0	0	0	0	50	62	28
"DQ586246"	72	72	0	0	0	0	0	0	0	0	0	0	0	0	0	25	0	0
"DQ586284"	66	66	0	0	0	0	0	0	0	0	0	0	0	0	0	0	0	0
"DQ586285"	70	70	0	0	0	0	0	0	0	0	0	0	0	0	0	0	0	0
"DQ586374"	72	72	0	0	0	0	0	0	0	0	0	0	0	0	0	0	0	0
"DQ586415"	41	41	0	0	0	0	0	0	0	0	0	0	0	0	0	0	0	0
"DQ586506"	32	32	0	0	0	0	0	0	0	0	0	0	0	0	0	0	0	0
"DQ586526"	78	78	0	0	0	0	0	0	0	0	0	0	0	0	43	51	68	23
"DQ586540"	1804	1804	107	52	69	38	24	28	96	48	0	75	467	0	0	175	310	133
"DQ586546"	3591	3591	0	0	0	0	0	0	0	0	0	0	0	0	0	0	0	0
"DQ586551"	31	31	0	0	0	0	0	0	0	0	0	0	0	0	0	0	0	0
"DQ586557"	103	103	0	0	0	0	0	0	0	0	0	0	0	0	0	0	0	0
"DQ586575"	29	29	0	0	0	0	0	0	0	0	0	0	0	0	0	0	0	0
"DQ586584"	42	42	0	0	0	0	0	0	0	0	0	0	0	0	0	0	0	0
"DQ586608"	30	30	153	0	85	68	0	0	82	0	33	0	45	38	43	30	52	22
"DQ586610"	30	30	0	0	0	0	0	0	0	0	0	0	0	0	0	0	0	0
"DQ586639"	40	40	0	0	0	0	0	0	0	0	0	0	0	0	0	0	0	0
"DQ586641"	36	36	0	0	0	0	0	0	17	0	0	0	0	0	0	0	0	0
"DQ586658"	30	30	0	0	0	0	0	0	0	0	0	0	0	0	183	163	104	56
"DQ586666"	39	39	0	0	0	0	0	0	0	0	0	0	0	0	0	0	0	0
"DQ586689"	29	29	0	0	0	0	0	0	0	0	0	0	0	0	0	0	0	0
"DQ586723"	42	42	0	0	0	0	0	0	0	0	0	0	0	0	0	0	0	0
"DQ586768"	29	29	28	0	28	0	0	0	54	9	186	50	0	0	0	0	0	0
"DQ586771"	29	29	0	0	0	0	0	0	0	11	0	0	0	0	0	0	0	0
"DQ586850"	30	30	0	0	0	0	0	0	0	0	0	0	0	0	0	0	0	0
"DQ586874"	34	34	0	0	0	0	0	0	10	0	0	0	0	0	0	0	0	0
"DQ586949"	38	38	0	0	0	0	0	0	0	0	0	0	0	0	0	0	0	0
"DQ586951"	29	29	55	0	29	26	0	0	0	204	1257	1075	6	5	78	46	85	36
"DQ586985"	71	71	0	0	0	0	0	0	0	0	0	0	0	0	0	0	0	0
"DQ587039"	310	310	0	0	0	0	0	0	0	0	0	0	0	0	0	0	0	0
"DQ587084"	66	66	0	0	0	0	0	0	24	14	0	0	0	0	0	0	0	0
"DQ587117"	178	178	0	0	0	0	0	0	0	0	0	0	0	0	28	44	51	33
"DQ587118"	39	39	0	0	0	0	0	0	0	0	0	0	0	0	0	0	0	0
"DQ587119"	4112	4112	0	0	0	0	0	0	0	0	0	0	0	0	1725	85	82	222
"DQ587143"	43	43	0	0	0	0	0	0	0	0	0	0	0	0	0	0	0	0
"DQ587154"	2000	2000	0	0	0	0	0	0	0	0	0	0	0	1	0	0	0	0
"DQ587230"	79	79	0	0	0	0	0	0	31	0	0	0	0	0	0	0	0	0
"DQ587275"	36	36	0	0	0	0	0	0	0	0	0	0	0	0	0	0	0	0
"DQ587284"	37	37	0	0	0	0	0	0	0	0	0	0	0	0	0	0	0	0
"DQ587527"	45	45	0	0	0	0	0	0	0	0	0	0	0	0	0	0	0	0
"DQ587539"	41	41	0	0	0	0	0	0	10	183	0	0	0	0	0	66	0	0
"DQ587606"	41	41	0	0	0	0	0	0	0	0	0	0	0	0	0	0	0	0
"DQ587734"	43	43	0	0	0	0	0	0	0	0	0	0	0	0	0	0	0	0
"DQ587746"	31	31	0	0	0	0	0	0	0	0	0	0	0	0	0	0	0	0
"DQ587763"	548	548	188	106	95	93	70	36	173	390	83	97	0	0	1604	865	1937	642
"DQ587803"	34	34	0	0	0	0	0	0	0	0	0	0	0	0	0	0	0	0
"DQ587806"	30	30	0	0	0	0	0	0	0	0	0	0	0	0	0	0	0	0
"DQ587882"	34	34	0	0	0	0	0	0	0	0	0	0	0	0	0	0	0	0
"DQ587887"	30	30	0	0	0	0	0	0	0	0	0	0	0	0	0	0	0	0
"DQ587888"	30	30	0	0	0	0	0	0	0	0	0	0	0	0	0	0	0	0
"DQ587889"	38	38	0	0	0	0	0	0	0	0	0	0	0	0	0	0	0	0
"DQ587906"	59	59	32	0	19	13	0	0	0	0	0	0	0	0	22	0	73	45
"DQ587954"	36	36	0	0	0	0	0	0	0	0	0	0	0	0	0	0	0	0
"DQ587956"	31	31	0	0	0	0	0	0	0	0	0	0	0	0	0	0	0	0
"DQ587962"	35	35	0	0	0	0	0	0	0	0	0	0	0	0	0	0	0	0
"DQ587965"	35	35	0	0	0	0	0	0	0	0	0	0	0	0	0	0	0	0
"DQ587983"	55	55	0	0	0	0	0	0	0	0	0	0	0	0	0	0	0	0
"DQ588019"	42	42	0	0	0	0	0	0	0	0	0	0	0	0	0	0	0	0
"DQ588034"	30	30	0	0	0	0	0	0	16	11	0	0	0	0	0	0	0	0
"DQ588041"	45	45	0	0	0	0	0	0	0	0	0	0	0	0	0	0	0	0
"DQ588066"	47	47	0	0	0	0	0	0	0	0	0	0	0	0	0	0	62	0
"DQ588077"	56	56	0	0	0	0	0	0	0	0	0	0	0	0	0	0	0	0
"DQ588124"	43	43	0	0	0	0	0	0	0	0	0	0	0	0	0	0	0	0
"DQ588135"	61	61	17	0	0	17	0	0	0	0	0	0	0	0	13	17	23	14
"DQ588163"	1120	1120	0	0	0	0	0	0	18	0	0	0	64	26	0	0	13	0
"DQ588170"	33	33	0	0	0	0	0	0	0	0	0	0	0	0	0	0	0	0
"DQ588198"	63	63	0	0	0	0	0	0	0	0	0	0	0	0	0	0	0	0
"DQ588214"	31	31	366	303	191	175	217	86	92	186	134	299	1137	1503	632	575	681	514
"DQ588223"	31	31	0	0	0	0	0	0	0	0	0	0	0	0	0	0	0	0
"DQ588224"	31	31	0	0	0	0	0	0	0	0	0	0	0	0	397	245	425	0
"DQ588227"	70	70	0	0	0	0	0	0	0	0	0	0	0	0	0	0	0	0
"DQ588253"	39	39	0	0	0	0	0	0	0	0	0	0	0	0	0	0	0	0
"DQ588286"	40	40	0	0	0	0	0	0	0	0	0	0	0	0	0	0	0	0
"DQ588329"	30	30	0	0	0	0	0	0	0	0	0	0	0	0	0	0	0	0
"DQ588362"	68	68	0	0	0	0	0	0	0	0	0	0	0	0	36	51	44	0
"DQ588388"	43	43	0	0	0	0	0	0	0	0	0	0	0	0	0	0	0	0
"DQ588396"	33	33	0	0	0	0	0	0	0	0	0	0	0	0	0	40	41	27
"DQ588406"	103	103	0	0	0	0	0	0	0	0	0	0	0	0	27	50	62	28
"DQ588415"	58	58	0	0	0	0	0	0	0	0	0	0	0	0	0	25	62	0
"DQ588417"	64	64	0	0	0	0	0	0	0	0	0	0	0	0	0	60	62	42
"DQ588475"	54	54	0	0	0	0	0	0	0	0	0	0	0	0	0	0	0	0
"DQ588479"	72	72	0	0	0	0	0	0	0	0	0	0	0	0	40	65	66	49
"DQ588582"	78	78	0	0	0	0	0	0	0	0	0	0	0	0	0	0	68	23
"DQ588584"	36	36	0	0	0	0	0	0	0	0	0	0	0	0	28	33	38	33
"DQ588655"	34	34	0	0	0	0	0	0	8	0	0	0	0	0	0	0	0	0
"DQ588687"	38	38	0	0	0	0	0	0	0	0	0	0	0	0	0	0	0	0
"DQ588715"	29	29	0	0	0	0	0	0	0	0	0	0	0	0	0	0	0	0
"DQ588725"	102	102	0	0	0	0	0	0	0	0	0	0	0	0	0	0	0	0
"DQ588732"	766	766	76	40	44	32	40	0	33	34	0	416	111	152	1432	85	1852	65
"DQ588775"	32	32	0	0	0	0	0	0	0	0	0	0	0	0	0	0	0	0
"DQ588809"	33	33	0	0	0	0	0	0	36	0	0	0	0	0	0	0	0	0
"DQ588973"	38	38	0	0	0	0	0	0	0	0	0	0	0	0	0	0	0	0
"DQ589004"	32	32	0	0	0	0	0	0	0	0	0	0	0	0	0	0	0	0
"DQ589067"	33	33	0	0	0	0	0	0	0	0	0	0	0	0	0	0	0	0
"DQ589083"	1662	1662	154	112	97	57	63	49	54	35	180	278	0	350	825	513	1083	553
"DQ589132"	41	41	0	0	0	0	0	0	0	0	0	0	0	0	0	0	0	0
"DQ589133"	58	58	0	0	0	0	0	0	0	0	0	0	0	0	0	0	0	0
"DQ589180"	68	68	0	0	0	0	0	0	0	0	0	0	0	0	0	0	0	0
"DQ589220"	40	40	0	0	0	0	0	0	0	0	0	0	0	0	0	0	0	0
"DQ589250"	31	31	0	0	0	0	0	0	0	0	0	0	0	0	0	0	0	0
"DQ589334"	26	26	0	0	0	0	0	0	0	0	0	0	0	0	0	0	0	0
"DQ589342"	33	33	0	0	0	0	0	0	0	0	0	0	0	0	0	0	0	0
"DQ589384"	36	36	0	0	0	0	0	0	0	0	0	0	0	0	0	0	0	0
"DQ589393"	47	47	0	0	0	0	0	0	0	0	0	0	0	0	0	0	0	0
"DQ589398"	50	50	0	0	0	0	0	0	0	0	0	0	0	0	0	0	0	0
"DQ589438"	38	38	0	0	0	0	0	0	0	0	0	0	0	0	0	0	0	0
"DQ589457"	38	38	0	0	0	0	0	0	0	0	0	0	0	0	0	0	0	0
"DQ589460"	43	43	0	0	0	0	0	0	0	0	0	0	0	0	0	0	0	0
"DQ589533"	30	30	0	0	0	0	0	0	0	0	0	0	0	0	0	0	0	0
"DQ589586"	39	39	0	0	0	0	0	0	14	12	0	0	0	0	0	0	0	0
"DQ589595"	33	33	0	0	0	0	0	0	0	0	0	0	0	0	0	0	0	0
"DQ589687"	84	84	0	0	0	0	0	0	0	0	0	0	0	0	0	0	0	0
"DQ589720"	29	29	0	0	0	0	0	0	0	0	0	0	0	0	0	0	0	0
"DQ589785"	31	31	0	0	0	0	0	0	0	0	0	0	0	0	0	0	0	0
"DQ589802"	27	27	0	0	0	0	0	0	0	0	0	0	1	0	23	19	26	22
"DQ589803"	33	33	0	0	0	0	0	0	0	0	0	0	0	0	0	0	0	0
"DQ589820"	31	31	0	0	0	0	0	0	0	0	0	0	0	0	0	0	0	0
"DQ589925"	29	29	0	0	0	0	0	0	0	0	0	0	0	0	0	0	0	0
"DQ589974"	1890	1890	188	20	93	95	0	20	140	57	260	158	73	50	112	35	79	17
"DQ589976"	58	58	0	0	0	0	0	0	0	0	0	0	0	0	0	0	0	0
"DQ589999"	1797	1797	0	0	0	0	0	0	0	0	0	0	0	0	0	0	0	0
"DQ590011"	40	40	0	0	0	0	0	0	19	0	0	0	0	0	0	0	0	0
"DQ590038"	92	92	0	0	0	0	0	0	0	0	0	0	0	0	0	0	0	0
"DQ590088"	34	34	0	0	0	0	0	0	0	0	0	0	0	0	0	0	0	0
"DQ590112"	1963	1963	2830	937	1586	1244	540	397	0	456	2615	1388	5250	3859	6772	4064	8213	4740
"DQ590126"	31	31	0	0	0	0	0	0	10	0	0	0	0	0	0	0	0	0
"DQ590127"	31	31	0	0	0	0	0	0	40	0	99	19	0	0	0	0	0	0
"DQ590166"	28	28	0	0	0	0	0	0	0	0	0	0	0	0	0	0	0	0
"DQ590189"	31	31	90	0	50	40	0	0	41	19	0	0	1104	906	345	286	392	226
"DQ590273"	49	49	0	0	0	0	0	0	0	0	0	0	0	0	0	0	0	0
"DQ590287"	41	41	0	0	0	0	0	0	0	0	0	0	0	0	0	0	0	0
"DQ590322"	25	25	0	0	0	0	0	0	0	0	0	0	0	0	0	0	0	0
"DQ590359"	30	30	0	0	0	0	0	0	0	12	0	0	0	0	0	0	0	0
"DQ590370"	34	34	0	0	0	0	0	0	0	0	0	0	0	0	0	0	0	0
"DQ590394"	29	29	0	0	0	0	0	0	0	0	0	0	0	0	0	0	0	0
"DQ590432"	41	41	0	0	0	0	0	0	0	0	0	0	0	0	0	0	0	0
"DQ590525"	31	31	0	0	0	0	0	0	0	0	0	0	0	0	0	0	0	0
"DQ590589"	40	40	0	0	0	0	0	0	23	0	59	0	0	0	0	0	0	0
"DQ590616"	29	29	0	0	0	0	0	0	0	0	0	0	0	0	0	0	0	0
"DQ590620"	34	34	0	0	0	0	0	0	0	0	0	0	0	0	0	0	0	0
"DQ590621"	30	30	0	0	0	0	0	0	0	0	0	0	0	0	0	0	0	0
"DQ590656"	32	32	0	0	0	0	0	0	0	0	0	0	0	0	0	0	0	0
"DQ590668"	31	31	0	0	0	0	0	0	0	0	0	0	0	0	0	0	0	0
"DQ590680"	32	32	0	0	0	0	0	0	0	0	0	0	0	0	0	0	0	0
"DQ590682"	40	40	0	0	0	0	0	0	10	0	0	0	0	0	0	0	0	0
"DQ590691"	42	42	0	0	0	0	0	0	0	0	0	0	0	0	0	0	0	0
"DQ590761"	1867	1867	0	0	0	0	0	0	39	30	0	0	2413	2491	1454	1234	1547	1167
"DQ590792"	32	32	0	0	0	0	0	0	0	0	0	0	0	0	0	0	0	0
"DQ590839"	39	39	0	0	0	0	0	0	0	0	0	0	0	0	0	0	0	0
"DQ590878"	64	64	0	0	0	0	0	0	0	0	0	0	0	0	0	0	0	0
"DQ590886"	42	42	0	0	0	0	0	0	0	0	0	0	0	0	0	0	0	0
"DQ590893"	36	36	0	0	0	0	0	0	0	0	0	0	0	0	0	0	0	0
"DQ590919"	37	37	0	0	0	0	0	0	0	0	0	0	0	0	0	0	0	0
"DQ590930"	68	68	0	0	0	0	0	0	0	0	0	0	0	0	0	0	0	0
"DQ590957"	30	30	0	0	0	0	0	0	0	0	0	0	0	0	0	0	0	0
"DQ590971"	32	32	0	0	0	0	0	0	0	0	0	0	0	0	0	0	0	0
"DQ591026"	111	111	0	0	0	0	0	0	0	0	0	0	0	0	0	0	0	0
"DQ591060"	780	780	0	0	0	0	0	0	11	0	0	0	0	0	1034	577	0	0
"DQ591061"	840	840	0	0	0	0	0	0	0	0	0	0	0	0	1028	569	1837	820
"DQ591120"	41	41	0	0	0	0	0	0	16	0	0	0	0	0	0	0	0	0
"DQ591153"	37	37	0	0	0	0	0	0	0	0	0	0	0	0	0	0	0	0
"DQ591184"	43	43	0	0	0	0	0	0	0	0	0	0	0	0	0	0	0	0
"DQ591188"	29	29	0	0	0	0	0	0	0	21	0	0	0	0	0	0	0	0
"DQ591254"	52	52	0	0	0	0	0	0	0	0	0	0	0	0	0	0	0	0
"DQ591331"	35	35	0	0	0	0	0	0	0	0	0	0	0	0	0	0	0	0
"DQ591379"	33	33	0	0	0	0	0	0	0	0	0	0	0	0	0	0	0	0
"DQ591414"	70	70	0	0	0	0	0	0	0	0	0	0	0	0	0	35	40	0
"DQ591451"	36	36	0	0	0	0	0	0	0	0	0	0	0	0	0	0	0	0
"DQ591515"	44	44	0	0	0	0	0	0	0	0	0	0	0	0	0	0	0	0
"DQ591572"	29	29	175	0	0	175	0	0	0	186	0	0	1137	1503	632	575	681	514
"DQ591724"	32	32	0	0	0	0	0	0	16	0	0	0	0	0	0	0	0	0
"DQ591726"	46	46	0	0	0	0	0	0	0	0	0	0	0	0	0	0	0	0
"DQ591735"	38	38	0	0	0	0	0	0	0	0	0	0	0	0	0	0	0	0
"DQ591781"	40	40	0	0	0	0	0	0	0	0	0	0	0	0	0	0	0	0
"DQ591858"	39	39	0	0	0	0	0	0	16	0	0	0	0	0	0	0	0	0
"DQ591902"	31	31	0	0	0	0	0	0	0	0	0	0	0	0	0	0	0	0
"DQ591916"	61	61	0	0	0	0	0	0	21	0	0	0	0	0	0	0	0	0
"DQ591923"	35	35	0	0	0	0	0	0	0	0	0	0	0	0	0	0	0	0
"DQ591992"	31	31	0	0	0	0	0	0	0	0	0	0	0	0	0	0	0	0
"DQ592014"	78	78	0	0	0	0	0	0	12	17	0	0	0	0	0	0	0	0
"DQ592095"	31	31	88	0	55	33	0	0	56	0	0	28	709	821	390	298	505	344
"DQ592136"	68	68	0	0	0	0	0	0	0	0	0	0	0	0	0	0	0	0
"DQ592221"	70	70	0	0	0	0	0	0	0	0	0	0	0	0	0	0	0	0
"DQ592264"	31	31	0	0	0	0	0	0	0	0	0	0	0	0	0	0	0	0
"DQ592269"	107	107	0	0	0	0	0	0	0	0	0	0	0	0	0	0	0	0
"DQ592322"	29	29	0	0	0	0	0	0	0	0	0	0	0	0	0	0	0	0
"DQ592358"	35	35	0	0	0	0	0	0	0	0	0	0	0	0	0	0	0	0
"DQ592359"	35	35	0	0	0	0	0	0	0	0	0	0	0	0	0	0	0	0
"DQ592376"	111	111	0	0	0	0	0	0	21	0	0	0	0	0	0	0	0	0
"DQ592381"	31	31	0	0	0	0	0	0	0	0	0	0	0	0	0	0	0	0
"DQ592389"	31	31	0	0	0	0	0	0	0	0	0	0	0	0	0	0	0	0
"DQ592438"	61	61	0	0	0	0	0	0	0	0	0	0	0	0	0	0	0	0
"DQ592442"	2773	2773	0	0	0	0	0	0	26	0	0	0	0	0	0	0	0	0
"DQ592480"	31	31	0	0	0	0	0	0	0	0	0	0	0	0	0	0	0	0
"DQ592502"	43	43	0	0	0	0	0	0	0	0	0	0	0	0	0	0	0	0
"DQ592558"	35	35	0	0	0	0	0	0	0	0	0	0	0	0	0	0	0	0
"DQ592649"	40	40	0	0	0	0	0	0	0	0	0	0	0	0	0	0	0	0
"DQ592653"	33	33	0	0	0	0	0	0	0	0	0	0	0	0	0	0	0	0
"DQ592654"	31	31	0	0	0	0	0	0	0	0	0	0	0	0	0	0	0	0
"DQ592682"	32	32	366	303	191	175	217	86	92	186	134	299	1137	1503	632	575	681	514
"DQ592688"	40	40	0	0	0	0	0	0	0	0	0	0	0	0	0	0	0	0
"DQ592694"	32	32	0	0	0	0	0	0	17	0	0	0	0	0	0	0	0	0
"DQ592701"	33	33	0	0	0	0	0	0	0	0	0	0	0	0	0	0	0	0
"DQ592711"	31	31	0	0	0	0	0	0	0	0	0	0	0	0	0	0	0	0
"DQ592713"	36	36	0	0	0	0	0	0	0	0	0	0	0	0	0	0	0	0
"DQ592725"	28	28	0	0	0	0	0	0	0	0	0	0	0	0	0	0	0	0
"DQ592825"	33	33	0	0	0	0	0	0	0	0	0	0	0	0	0	0	0	0
"DQ592852"	31	31	0	0	0	0	0	0	0	0	0	0	0	0	0	0	0	0
"DQ592953"	26	26	0	0	0	0	0	0	0	0	0	0	0	0	0	0	0	0
"DQ592963"	32	32	0	0	0	0	0	0	0	21	0	0	0	0	0	0	0	0
"DQ592978"	27	27	0	0	0	0	0	0	0	0	0	0	0	0	0	0	0	0
"DQ593007"	72	72	0	0	0	0	0	0	0	21	0	0	0	0	0	0	0	0
"DQ593033"	43	43	0	0	0	0	0	0	0	0	0	0	0	0	0	0	0	0
"DQ593116"	119	119	0	0	0	0	0	0	0	0	0	0	0	0	0	0	0	0
"DQ593143"	38	38	0	0	0	0	0	0	0	0	0	0	0	0	0	0	0	0
"DQ593188"	32	32	0	0	0	0	0	0	0	0	0	0	0	0	0	0	0	0
"DQ593224"	30	30	0	0	0	0	0	0	0	0	0	0	0	0	0	0	0	0
"DQ593233"	30	30	0	0	0	0	0	0	0	0	0	0	0	0	0	0	0	0
"DQ593239"	53	53	0	0	0	0	0	0	0	0	0	0	0	0	0	0	0	0
"DQ593272"	32	32	0	0	0	0	0	0	0	0	0	0	0	0	0	0	0	0
"DQ593323"	32	32	0	0	0	0	0	0	0	0	0	0	0	0	0	0	0	0
"DQ593342"	30	30	0	0	0	0	0	0	0	0	0	0	0	0	0	178	187	65
"DQ593344"	38	38	0	0	0	0	0	0	0	0	0	0	0	0	0	0	0	0
"DQ593347"	48	48	0	0	0	0	0	0	0	0	0	0	0	0	0	0	0	0
"DQ593353"	514	514	0	0	0	0	0	0	0	0	0	0	0	0	43	64	58	30
"DQ593367"	46	46	0	0	0	0	0	0	0	0	0	0	0	0	0	0	0	0
"DQ593368"	31	31	0	0	0	0	0	0	0	0	0	0	0	0	0	0	0	0
"DQ593421"	23	23	0	0	0	0	0	0	0	0	0	0	0	0	0	0	0	0
"DQ593426"	39	39	0	0	0	0	0	0	0	0	0	0	0	0	0	0	0	0
"DQ593430"	35	35	0	0	0	0	0	0	0	0	0	0	0	0	0	0	0	0
"DQ593444"	36	36	0	0	0	0	0	0	0	0	0	0	0	0	0	0	0	0
"DQ593488"	38	38	0	0	0	0	0	0	0	0	0	0	0	0	0	0	0	0
"DQ593490"	31	31	0	0	0	0	0	0	0	0	0	0	0	0	0	0	0	0
"DQ593500"	35	35	0	0	0	0	0	0	0	0	0	0	0	0	0	0	0	0
"DQ593540"	38	38	0	0	0	0	0	0	14	0	0	0	0	0	0	0	0	0
"DQ593554"	30	30	0	0	0	0	0	0	61	30	0	43	11	13	0	0	0	0
"DQ593585"	30	30	0	0	0	0	0	0	0	15	0	0	0	0	0	0	0	0
"DQ593611"	44	44	0	0	0	0	0	0	15	0	0	0	0	0	0	0	0	0
"DQ593627"	48	48	0	0	0	0	0	0	0	0	0	0	0	0	44	65	67	28
"DQ593628"	47	47	0	0	0	0	0	0	0	0	0	0	0	0	36	55	56	0
"DQ593630"	61	61	0	0	0	0	0	0	0	0	0	0	0	0	0	42	62	30
"DQ593719"	30	30	17	0	0	17	0	0	0	0	0	0	0	0	2	2	23	0
"DQ593805"	27	27	55	0	29	26	0	0	0	0	183	0	0	34	72	46	80	36
"DQ593864"	33	33	0	0	0	0	0	0	0	0	0	0	0	0	27	42	0	0
"DQ593945"	38	38	0	0	0	0	0	0	0	0	0	0	0	0	0	0	0	0
"DQ593983"	29	29	0	0	0	0	0	0	0	0	0	0	0	0	0	0	0	0
"DQ593990"	31	31	0	0	0	0	0	0	0	0	0	0	0	0	0	0	0	0
"DQ593994"	34	34	0	0	0	0	0	0	0	0	0	0	0	0	0	0	0	0
"DQ594001"	3764	3764	72	14	63	9	7	7	19	0	0	0	1069	1058	833	680	966	689
"DQ594032"	48	48	0	0	0	0	0	0	0	0	0	0	0	0	0	0	0	0
"DQ594218"	41	41	0	0	0	0	0	0	0	0	0	0	0	0	0	0	0	0
"DQ594240"	36	36	0	0	0	0	0	0	0	0	0	0	0	0	36	0	0	0
"DQ594272"	41	41	0	0	0	0	0	0	0	0	0	0	0	0	0	0	0	0
"DQ594289"	32	32	0	0	0	0	0	0	0	0	0	0	0	0	0	0	0	0
"DQ594304"	29	29	0	0	0	0	0	0	0	0	0	0	0	0	0	0	0	0
"DQ594309"	30	30	0	0	0	0	0	0	0	0	0	0	0	0	0	0	0	0
"DQ594366"	2484	2484	0	0	0	0	0	0	16	0	0	0	0	0	0	0	0	0
"DQ594400"	38	38	0	0	0	0	0	0	0	0	0	0	0	0	0	0	0	0
"DQ594410"	43	43	0	0	0	0	0	0	15	0	0	0	0	0	0	0	0	0
"DQ594437"	33	33	0	0	0	0	0	0	0	0	0	0	0	0	0	0	0	0
"DQ594471"	28	28	0	0	0	0	0	0	0	0	0	0	0	0	0	0	0	0
"DQ594515"	4060	4060	0	0	0	0	0	0	0	0	0	0	0	0	0	0	0	0
"DQ594518"	38	38	0	0	0	0	0	0	0	21	0	0	0	0	0	0	0	0
"DQ594520"	34	34	0	0	0	0	0	0	0	0	0	0	0	0	0	0	0	0
"DQ594525"	41	41	0	0	0	0	0	0	16	0	0	0	0	0	0	0	0	0
"DQ594660"	59	59	0	0	0	0	0	0	0	0	0	0	0	0	0	0	0	0
"DQ594666"	33	33	0	0	0	0	0	0	0	0	0	0	0	0	0	0	0	0
"DQ594669"	41	41	0	0	0	0	0	0	0	0	0	0	0	0	0	0	0	0
"DQ594696"	37	37	0	0	0	0	0	0	0	0	0	0	0	0	0	0	0	0
"DQ594725"	47	47	0	0	0	0	0	0	0	11	0	0	0	0	0	0	0	0
"DQ594729"	24	24	0	0	0	0	0	0	0	0	0	0	0	0	0	0	6	0
"DQ594761"	45	45	0	0	0	0	0	0	0	0	0	0	0	0	0	0	0	0
"DQ594762"	31	31	0	0	0	0	0	0	0	0	0	0	0	0	0	0	0	0
"DQ594766"	42	42	0	0	0	0	0	0	33	0	0	0	0	0	0	0	0	0
"DQ594771"	48	48	0	0	0	0	0	0	0	0	0	0	0	0	0	0	0	0
"DQ594776"	30	30	0	0	0	0	0	0	0	0	0	0	0	0	0	0	0	0
"DQ594785"	41	41	0	0	0	0	0	0	0	0	0	0	0	0	0	0	0	0
"DQ594798"	29	29	95	106	62	33	56	50	116	33	0	0	0	911	0	0	0	0
"DQ594827"	37	37	0	0	0	0	0	0	0	0	0	0	0	0	0	0	0	0
"DQ594846"	32	32	0	0	0	0	0	0	0	0	0	0	0	0	0	0	0	0
"DQ594870"	32	32	0	0	0	0	0	0	16	11	0	0	0	0	0	0	0	0
"DQ594911"	75	75	0	0	0	0	0	0	0	0	0	0	0	0	0	0	0	0
"DQ594920"	42	42	0	0	0	0	0	0	0	0	0	0	0	0	0	0	0	0
"DQ594965"	41	41	0	0	0	0	0	0	0	0	0	0	0	0	0	0	0	0
"DQ594995"	31	31	0	0	0	0	0	0	0	0	0	0	0	0	0	0	0	0
"DQ595026"	32	32	0	0	0	0	0	0	0	0	0	0	0	0	0	0	0	0
"DQ595048"	41	41	0	0	0	0	0	0	0	0	0	0	0	0	0	0	0	0
"DQ595055"	2207	2207	0	0	0	0	0	0	9	0	0	0	0	0	2	0	0	0
"DQ595071"	35	35	0	0	0	0	0	0	0	0	0	0	0	0	0	0	0	0
"DQ595116"	32	32	0	0	0	0	0	0	0	0	0	0	0	0	0	0	0	0
"DQ595165"	45	45	0	0	0	0	0	0	0	0	0	0	0	0	0	0	0	0
"DQ595216"	31	31	0	0	0	0	0	0	0	0	0	0	0	0	27	51	62	28
"DQ595234"	31	31	0	0	0	0	0	0	0	0	0	0	0	0	0	0	0	0
"DQ595261"	30	30	0	0	0	0	0	0	0	0	0	0	0	0	0	0	0	0
"DQ595330"	64	64	45	0	23	22	0	0	0	0	0	0	10	0	75	47	40	0
"DQ595361"	45	45	0	0	0	0	0	0	0	0	0	0	0	0	0	0	0	0
"DQ595383"	47	47	0	0	0	0	0	0	0	0	0	0	0	0	0	0	0	0
"DQ595400"	43	43	0	0	0	0	0	0	0	0	0	0	0	0	0	0	0	0
"DQ595416"	38	38	0	0	0	0	0	0	0	0	0	0	0	0	0	0	0	0
"DQ595454"	30	30	0	0	0	0	0	0	0	0	0	0	0	0	0	0	0	0
"DQ595545"	32	32	0	0	0	0	0	0	0	0	0	0	0	0	0	0	0	0
"DQ595547"	64	64	0	0	0	0	0	0	0	0	0	0	0	0	0	0	0	0
"DQ595580"	30	30	0	0	0	0	0	0	33	0	0	0	0	0	0	0	0	0
"DQ595581"	35	35	0	0	0	0	0	0	0	0	0	0	0	0	0	0	0	0
"DQ595590"	32	32	0	0	0	0	0	0	0	0	0	0	0	0	0	0	0	0
"DQ595602"	36	36	0	0	0	0	0	0	0	0	0	0	0	0	0	0	0	0
"DQ595616"	34	34	0	0	0	0	0	0	0	0	0	0	0	0	0	0	0	0
"DQ595631"	28	28	0	0	0	0	0	0	0	0	0	0	0	0	0	0	0	0
"DQ595648"	33	33	0	0	0	0	0	0	0	0	0	0	0	0	0	0	0	0
"DQ595731"	58	58	0	0	0	0	0	0	0	15	0	0	0	0	0	0	0	0
"DQ595736"	1391	1391	0	0	0	0	0	0	9	0	0	0	9	30	2	0	589	0
"DQ595740"	29	29	0	0	0	0	0	0	0	0	0	0	0	0	0	0	0	0
"DQ595741"	40	40	0	0	0	0	0	0	0	0	0	0	0	0	0	0	0	0
"DQ595780"	37	37	0	0	0	0	0	0	0	0	0	0	0	0	0	0	0	0
"DQ595787"	30	30	0	0	0	0	0	0	0	0	0	0	0	0	0	0	0	0
"DQ595836"	51	51	0	0	0	0	0	0	0	0	0	0	0	0	0	0	0	0
"DQ595853"	33	33	0	0	0	0	0	0	0	0	0	0	0	0	0	0	0	0
"DQ595898"	33	33	0	0	0	0	0	0	0	0	0	0	0	0	0	0	0	0
"DQ595899"	111	111	0	0	0	0	0	0	10	0	0	0	0	0	0	0	0	0
"DQ595911"	56	56	0	0	0	0	0	0	0	0	0	0	0	0	0	0	0	0
"DQ595936"	31	31	0	0	0	0	0	0	0	0	0	0	0	0	0	0	0	0
"DQ595965"	73	73	0	0	0	0	0	0	0	0	0	0	0	0	0	0	0	0
"DQ596041"	33	33	0	0	0	0	0	0	0	0	0	0	0	0	0	0	0	0
"DQ596042"	33	33	0	0	0	0	0	0	75	35	0	110	404	331	5061	2740	5836	3024
"DQ596057"	35	35	0	0	0	0	0	0	0	0	0	0	0	0	0	0	0	0
"DQ596074"	43	43	287	0	247	40	0	0	178	43	0	0	11	25	0	0	0	0
"DQ596092"	30	30	0	0	0	0	0	0	0	0	0	0	0	0	0	0	0	0
"DQ596114"	32	32	0	0	0	0	0	0	0	0	0	0	0	0	0	0	0	0
"DQ596118"	30	30	0	0	0	0	0	0	0	0	0	0	0	0	0	0	0	0
"DQ596138"	29	29	0	0	0	0	0	0	0	0	0	0	0	0	0	0	0	0
"DQ596206"	29	29	0	0	0	0	0	0	0	20	0	0	0	0	0	0	0	0
"DQ596227"	59	59	0	0	0	0	0	0	0	0	0	0	0	0	0	0	0	0
"DQ596229"	27	27	0	0	0	0	0	0	0	0	0	0	0	0	0	0	12	0
"DQ596239"	132	132	0	0	0	0	0	0	0	0	0	0	0	0	24	27	52	0
"DQ596269"	70	70	0	0	0	0	0	0	0	0	0	0	0	0	0	0	0	0
"DQ596290"	35	35	0	0	0	0	0	0	0	0	0	0	0	0	0	0	0	0
"DQ596294"	40	40	0	0	0	0	0	0	0	0	0	0	0	0	0	0	0	0
"DQ596298"	32	32	0	0	0	0	0	0	0	0	0	0	0	0	0	0	0	0
"DQ596302"	31	31	0	0	0	0	0	0	0	0	0	0	0	0	0	0	0	0
"DQ596303"	40	40	0	0	0	0	0	0	0	0	0	0	0	0	0	0	0	0
"DQ596319"	34	34	0	0	0	0	0	0	0	0	0	0	0	0	0	0	0	0
"DQ596352"	30	30	0	0	0	0	0	0	17	21	0	0	21	0	0	0	0	0
"DQ596454"	31	31	0	0	0	0	0	0	0	0	0	0	0	0	0	0	0	0
"DQ596478"	40	40	0	0	0	0	0	0	0	0	0	0	0	0	0	0	0	0
"DQ596480"	30	30	0	0	0	0	0	0	0	0	0	0	0	0	0	0	0	0
"DQ596488"	47	47	0	0	0	0	0	0	0	0	0	0	0	0	0	0	0	0
"DQ596500"	31	31	0	0	0	0	0	0	0	0	0	0	0	0	0	0	0	0
"DQ596554"	36	36	0	0	0	0	0	0	0	0	0	0	0	0	0	0	0	0
"DQ596563"	31	31	37	0	0	37	0	0	141	96	74	75	0	0	0	0	0	0
"DQ596604"	43	43	0	0	0	0	0	0	0	0	0	0	0	0	0	0	0	0
"DQ596613"	81	81	0	0	0	0	0	0	0	0	0	0	0	0	0	0	0	0
"DQ596633"	43	43	182	27	111	71	14	13	110	59	188	95	1372	0	0	0	0	0
"DQ596646"	2196	2196	0	0	0	0	0	0	0	0	0	0	0	0	0	0	0	0
"DQ596658"	75	75	0	0	0	0	0	0	0	0	0	0	0	0	0	0	0	0
"DQ596667"	29	29	0	0	0	0	0	0	0	0	0	0	0	0	0	0	0	0
"DQ596700"	35	35	0	0	0	0	0	0	21	0	0	0	0	0	0	0	0	0
"DQ596703"	30	30	0	0	0	0	0	0	0	0	0	0	0	0	0	0	0	0
"DQ596707"	35	35	0	0	0	0	0	0	0	0	0	0	0	0	0	0	0	0
"DQ596733"	24	24	0	0	0	0	0	0	0	0	0	0	0	0	0	0	0	0
"DQ596793"	32	32	0	0	0	0	0	0	0	0	0	0	0	0	0	0	0	0
"DQ596804"	39	39	0	0	0	0	0	0	0	0	0	0	0	0	0	0	0	0
"DQ596816"	28	28	0	0	0	0	0	0	0	0	0	0	0	0	0	0	0	0
"DQ596823"	34	34	0	0	0	0	0	0	0	0	0	0	0	0	0	0	0	0
"DQ596833"	30	30	0	0	0	0	0	0	0	0	0	0	0	0	0	0	0	0
"DQ596879"	35	35	0	0	0	0	0	0	0	0	0	0	0	0	0	0	0	0
"DQ596883"	76	76	0	0	0	0	0	0	0	0	0	0	0	0	0	0	0	0
"DQ596887"	29	29	0	0	0	0	0	0	0	0	0	0	0	0	0	0	0	0
"DQ596891"	24	24	0	0	0	0	0	0	0	0	0	0	0	0	0	0	0	0
"DQ596925"	32	32	0	0	0	0	0	0	0	0	0	0	0	0	0	0	0	0
"DQ596928"	32	32	0	0	0	0	0	0	0	0	0	0	0	0	0	0	0	0
"DQ596932"	28	28	100	50	0	100	0	50	0	0	0	0	0	934	0	0	0	0
"DQ596940"	31	31	0	0	0	0	0	0	0	0	0	0	85	41	105	0	96	0
"DQ596967"	35	35	0	0	0	0	0	0	0	0	0	0	0	0	0	0	0	0
"DQ597035"	42	42	0	0	0	0	0	0	20	0	0	0	0	0	0	0	0	0
"DQ597063"	32	32	0	0	0	0	0	0	14	12	0	0	0	0	0	0	0	0
"DQ597072"	42	42	0	0	0	0	0	0	0	0	0	0	0	0	0	0	0	0
"DQ597117"	32	32	0	0	0	0	0	0	0	0	0	0	0	0	0	0	0	0
"DQ597175"	33	33	0	0	0	0	0	0	0	0	0	0	0	0	0	0	0	0
"DQ597183"	34	34	0	0	0	0	0	0	0	0	0	0	0	0	0	0	0	0
"DQ597235"	32	32	0	0	0	0	0	0	0	0	0	0	0	0	0	0	0	23
"DQ597254"	31	31	0	0	0	0	0	0	0	0	0	0	0	0	0	0	0	0
"DQ597264"	31	31	0	0	0	0	0	0	0	0	0	0	0	0	0	0	0	0
"DQ597351"	33	33	0	0	0	0	0	0	0	0	0	0	0	0	0	0	0	0
"DQ597391"	42	42	0	0	0	0	0	0	0	0	0	0	0	0	27	42	44	30
"DQ597410"	35	35	0	0	0	0	0	0	0	0	0	0	0	0	0	0	0	0
"DQ597442"	37	37	0	0	0	0	0	0	0	0	0	0	0	0	0	0	0	0
"DQ597461"	68	68	0	0	0	0	0	0	0	0	0	0	0	0	27	52	62	31
"DQ597482"	1283	1283	12	0	0	12	0	0	60	20	0	0	0	0	0	0	0	0
"DQ597512"	49	49	0	0	0	0	0	0	0	8	0	0	0	0	0	0	0	0
"DQ597535"	24	24	0	0	0	0	0	0	0	0	0	0	0	0	0	3	0	0
"DQ597549"	32	32	0	0	0	0	0	0	0	0	0	0	0	0	0	0	0	0
"DQ597560"	29	29	0	0	0	0	0	0	0	0	0	0	0	0	0	0	0	0
"DQ597575"	24	24	34	0	0	34	0	0	34	0	0	0	0	0	0	0	0	0
"DQ597589"	40	40	0	0	0	0	0	0	0	0	0	0	0	0	0	0	0	0
"DQ597597"	82	82	0	0	0	0	0	0	0	0	0	0	0	0	17	40	41	27
"DQ597637"	79	79	0	0	0	0	0	0	0	0	0	0	0	0	0	0	0	0
"DQ597692"	44	44	0	0	0	0	0	0	0	0	0	0	0	0	36	51	44	0
"DQ597703"	87	87	0	0	0	0	0	0	0	0	0	0	0	0	36	51	63	0
"DQ597713"	59	59	0	0	0	0	0	0	0	0	0	0	0	0	0	0	0	0
"DQ597735"	32	32	0	0	0	0	0	0	0	0	0	0	0	0	0	51	62	18
"DQ597780"	25	25	0	0	0	0	0	0	0	0	0	0	0	0	0	0	0	0
"DQ597811"	36	36	0	0	0	0	0	0	0	0	0	0	0	0	0	0	0	0
"DQ597844"	63	63	0	0	0	0	0	0	0	0	0	0	0	0	0	0	0	0
"DQ597892"	41	41	0	0	0	0	0	0	0	0	0	0	0	0	0	0	0	0
"DQ597900"	28	28	35	0	14	21	0	0	0	9	0	0	0	0	0	0	0	0
"DQ598064"	31	31	0	0	0	0	0	0	0	0	0	0	0	0	17	40	0	27
"DQ598076"	64	64	0	0	0	0	0	0	0	0	0	0	0	0	0	0	0	0
"DQ598122"	58	58	0	0	0	0	0	0	0	0	0	0	0	0	0	0	0	0
"DQ598168"	48	48	131	103	64	67	83	20	263	390	0	143	0	0	264	0	0	228
"DQ598207"	45	45	0	0	0	0	0	0	19	0	0	0	0	0	0	0	0	0
"DQ598244"	32	32	0	0	0	0	0	0	0	0	0	0	0	0	0	0	0	0
"DQ598270"	300	300	0	0	0	0	0	0	0	0	0	0	0	0	0	0	0	0
"DQ598276"	135	135	0	0	0	0	0	0	0	0	0	0	0	0	27	42	44	0
"DQ598304"	47	47	0	0	0	0	0	0	0	0	0	0	0	0	0	0	0	0
"DQ598314"	32	32	0	0	0	0	0	0	14	12	0	0	0	0	0	0	0	0
"DQ598334"	30	30	0	0	0	0	0	0	19	0	0	0	0	0	0	0	0	0
"DQ598339"	30	30	0	0	0	0	0	0	0	0	0	0	0	0	0	0	0	0
"DQ598345"	64	64	0	0	0	0	0	0	0	0	0	0	0	0	0	0	0	0
"DQ598454"	43	43	0	0	0	0	0	0	0	0	0	0	0	0	0	0	0	0
"DQ598473"	32	32	0	0	0	0	0	0	0	0	0	0	0	0	0	0	0	0
"DQ598479"	28	28	0	0	0	0	0	0	0	0	0	0	0	0	0	0	0	0
"DQ598506"	31	31	0	0	0	0	0	0	0	0	0	0	0	0	0	0	0	0
"DQ598665"	43	43	0	0	0	0	0	0	0	14	0	0	0	0	0	0	0	0
"DQ598668"	32	32	0	0	0	0	0	0	0	0	0	0	0	0	0	0	0	0
"DQ598729"	35	35	0	0	0	0	0	0	0	0	0	0	0	0	0	0	0	0
"DQ598733"	31	31	0	0	0	0	0	0	0	0	0	0	0	0	0	0	0	0
"DQ598861"	32	32	0	0	0	0	0	0	0	0	0	0	0	0	0	0	0	0
"DQ598918"	83	83	11	16	0	11	16	0	21	0	0	0	0	0	0	0	0	0
"DQ599003"	36	36	0	0	0	0	0	0	0	0	0	0	0	0	0	0	0	0
"DQ599038"	50	50	0	0	0	0	0	0	0	0	0	0	0	0	0	0	0	0
"DQ599087"	31	31	0	0	0	0	0	0	0	0	0	0	0	0	0	0	0	0
"DQ599146"	28	28	0	0	0	0	0	0	0	0	0	0	194	165	0	0	0	0
"DQ599212"	28	28	0	0	0	0	0	0	0	0	0	0	0	0	0	0	0	0
"DQ599228"	32	32	0	0	0	0	0	0	0	0	0	0	0	0	0	0	0	0
"DQ599242"	2800	2800	455	193	393	62	193	0	139	97	0	157	93	117	58	92	120	81
"DQ599277"	30	30	0	0	0	0	0	0	0	0	0	0	0	0	0	0	0	0
"DQ599297"	38	38	0	0	0	0	0	0	0	0	0	0	0	0	0	0	0	0
"DQ599327"	32	32	71	0	22	49	0	0	120	28	0	0	960	554	686	336	875	319
"DQ599444"	64	64	0	0	0	0	0	0	0	0	0	0	0	0	0	0	0	0
"DQ599537"	51	51	0	0	0	0	0	0	0	0	0	0	0	0	0	0	0	0
"DQ599569"	36	36	83	0	42	41	0	0	0	86	0	107	2291	0	0	0	0	0
"DQ599577"	39	39	0	0	0	0	0	0	16	0	0	0	0	0	0	0	0	0
"DQ599581"	40	40	0	0	0	0	0	0	0	0	0	0	0	0	0	0	0	0
"DQ599653"	63	63	0	0	0	0	0	0	0	0	0	0	0	0	0	0	0	0
"DQ599663"	41	41	0	0	0	0	0	0	33	0	0	0	0	0	0	0	0	0
"DQ599716"	28	28	0	0	0	0	0	0	0	0	0	0	0	0	0	0	0	0
"DQ599760"	51	51	0	0	0	0	0	0	0	0	0	0	0	0	0	0	0	0
"DQ599768"	84	84	0	0	0	0	0	0	0	0	0	0	0	0	224	128	127	117
"DQ599785"	36	36	0	0	0	0	0	0	0	0	0	0	0	0	0	0	0	0
"DQ599787"	62	62	0	0	0	0	0	0	0	0	0	0	0	0	0	0	0	0
"DQ599798"	142	142	0	0	0	0	0	0	0	0	0	0	0	0	0	0	0	0
"DQ599799"	60	60	0	0	0	0	0	0	0	10	0	0	0	0	0	0	42	0
"DQ599802"	61	61	0	0	0	0	0	0	0	0	0	0	0	0	0	0	0	0
"DQ599834"	38	38	0	0	0	0	0	0	0	0	0	0	0	0	0	0	0	0
"DQ599837"	46	46	0	0	0	0	0	0	0	0	0	0	0	0	0	0	0	0
"DQ599872"	221	221	0	0	0	0	0	0	15	0	0	0	16	22	0	0	32	145
"DQ599874"	32	32	0	0	0	0	0	0	0	0	0	0	0	0	224	128	126	99
"DQ599898"	42	42	0	0	0	0	0	0	0	0	0	0	0	0	0	0	0	0
"DQ599904"	29	29	0	0	0	0	0	0	0	0	0	0	0	0	0	0	0	0
"DQ599922"	757	757	0	0	0	0	0	0	0	0	0	0	0	0	1249	768	1740	801
"DQ599933"	31	31	0	0	0	0	0	0	0	0	0	0	133	106	19	57	31	86
"DQ599950"	31	31	0	0	0	0	0	0	0	0	0	0	0	0	0	0	0	0
"DQ599953"	42	42	0	0	0	0	0	0	0	0	0	0	0	0	0	0	0	0
"DQ599993"	32	32	0	0	0	0	0	0	0	0	0	0	0	0	0	0	0	0
"DQ599996"	31	31	0	0	0	0	0	0	0	0	0	0	0	0	0	0	0	0
"DQ600002"	30	30	0	0	0	0	0	0	0	0	0	0	0	0	0	0	0	0
"DQ600101"	70	70	0	0	0	0	0	0	0	0	0	0	0	0	0	0	0	0
"DQ600102"	31	31	0	0	0	0	0	0	0	0	0	0	0	0	0	0	0	0
"DQ600105"	33	33	0	0	0	0	0	0	0	0	0	0	0	0	0	0	0	0
"DQ600137"	31	31	0	0	0	0	0	0	0	0	0	0	0	0	0	0	0	0
"DQ600156"	29	29	0	0	0	0	0	0	0	0	0	0	0	0	0	0	0	0
"DQ600225"	45	45	0	0	0	0	0	0	0	0	0	0	0	0	0	0	0	0
"DQ600234"	50	50	0	0	0	0	0	0	0	0	0	0	0	0	0	0	0	109
"DQ600328"	126	126	0	0	0	0	0	0	0	17	0	0	0	0	0	0	0	0
"DQ600333"	40	40	0	0	0	0	0	0	0	0	0	0	0	0	0	0	0	0
"DQ600342"	33	33	0	0	0	0	0	0	11	0	0	0	0	1	30	8	39	12
"DQ600379"	41	41	0	0	0	0	0	0	0	0	0	0	0	0	0	0	0	0
"DQ600486"	25	25	0	0	0	0	0	0	0	0	0	0	0	0	0	0	0	0
"DQ600537"	48	48	0	0	0	0	0	0	0	0	0	0	0	0	27	51	62	28
"DQ600540"	62	62	0	0	0	0	0	0	0	0	0	0	0	0	0	0	0	0
"DQ600552"	50	50	0	0	0	0	0	0	0	0	0	0	0	0	0	0	0	0
"DQ600587"	62	62	0	0	0	0	0	0	0	0	0	0	0	0	0	0	0	0
"DQ600633"	55	55	0	0	0	0	0	0	0	0	0	0	0	0	0	0	0	0
"DQ600718"	38	38	0	0	0	0	0	0	0	0	0	0	0	0	0	0	0	0
"DQ600788"	29	29	0	0	0	0	0	0	0	0	0	0	0	0	0	0	0	0
"DQ600792"	30	30	0	0	0	0	0	0	0	0	0	0	0	0	0	0	0	0
"DQ600808"	89	89	0	0	0	0	0	0	0	0	0	0	0	0	0	0	0	0
"DQ600835"	38	38	0	0	0	0	0	0	0	0	0	0	0	0	0	0	0	0
"DQ600844"	39	39	0	0	0	0	0	0	0	0	0	0	0	0	0	0	0	0
"DQ600887"	50	50	0	0	0	0	0	0	0	0	0	0	0	0	0	0	0	0
"DQ600900"	30	30	0	0	0	0	0	0	0	0	0	0	0	0	0	0	0	0
"DQ600930"	31	31	0	0	0	0	0	0	0	0	0	0	0	0	0	0	0	0
"DQ601089"	2514	2514	67	68	47	20	39	29	27	25	0	53	65	1894	1465	1685	2388	1363
"DQ601137"	54	54	0	0	0	0	0	0	0	0	0	0	0	0	0	0	0	0
"DQ601150"	31	31	0	0	0	0	0	0	0	0	0	0	0	0	0	0	0	0
"DQ601152"	47	47	0	0	0	0	0	0	0	0	0	0	0	0	0	0	0	0
"DQ601159"	36	36	0	0	0	0	0	0	0	0	0	0	0	0	0	0	0	0
"DQ601165"	32	32	0	0	0	0	0	0	0	0	0	0	0	0	0	0	0	0
"DQ601279"	30	30	0	0	0	0	0	0	0	0	0	0	0	0	0	0	0	0
"DQ601289"	36	36	0	0	0	0	0	0	0	0	0	0	0	0	0	0	0	0
"DQ601334"	37	37	0	0	0	0	0	0	0	0	0	0	0	0	0	0	0	0
"DQ601342"	29	29	0	0	0	0	0	0	8	0	0	0	0	0	0	0	38	0
"DQ601360"	58	58	0	0	0	0	0	0	0	0	0	0	0	0	0	0	0	0
"DQ601396"	36	36	0	0	0	0	0	0	0	0	0	0	0	0	0	25	62	0
"DQ601452"	39	39	0	0	0	0	0	0	0	0	0	0	0	0	0	0	0	0
"DQ601567"	59	59	0	0	0	0	0	0	0	0	0	0	0	0	0	0	0	0
"DQ601595"	37	37	0	0	0	0	0	0	0	0	0	0	0	0	0	0	0	0
"DQ601664"	32	32	0	0	0	0	0	0	0	0	0	0	0	0	0	0	0	0
"DQ601689"	32	32	0	0	0	0	0	0	0	0	0	0	0	0	0	0	0	0
"DQ601694"	30	30	0	0	0	0	0	0	0	0	0	0	0	0	0	0	0	0
"DQ601751"	33	33	0	0	0	0	0	0	0	0	0	0	0	0	0	0	0	0
"DQ601755"	31	31	0	0	0	0	0	0	0	0	0	0	0	0	0	0	0	0
"DQ601762"	30	30	0	0	0	0	0	0	0	0	0	0	0	0	0	0	0	0
"DQ601810"	31	31	0	0	0	0	0	0	0	0	0	0	0	0	0	0	0	0
"DQ601812"	42	42	0	0	0	0	0	0	0	0	0	0	0	0	0	0	0	0
"DQ601847"	36	36	0	0	0	0	0	0	0	0	0	0	0	0	0	0	0	0
"DQ601873"	36	36	0	0	0	0	0	0	0	0	0	0	0	0	0	0	0	0
"DQ601882"	32	32	0	0	0	0	0	0	0	0	0	0	0	0	0	0	0	0
"DQ601895"	61	61	0	0	0	0	0	0	0	0	0	0	0	0	0	0	0	0
"DQ601923"	41	41	0	0	0	0	0	0	0	0	0	0	0	0	0	0	0	0
"DQ601936"	29	29	0	0	0	0	0	0	0	0	0	0	0	0	0	0	0	0
"DQ655967"	255	4060	0	0	0	0	0	0	0	0	0	0	0	0	0	0	0	0
"DQ655968"	257	4060	0	0	0	0	0	0	0	0	0	0	0	0	0	0	0	0
"DQ655969"	148	4060	0	0	0	0	0	0	0	0	0	0	0	0	0	0	0	0
"DQ655986"	370	5234	0	0	0	0	0	0	9	0	0	0	0	0	0	0	0	0
"DQ656008"	1017	3359	0	0	0	0	0	0	0	0	0	0	0	0	0	0	0	0
"DQ656011"	175	175	0	0	0	0	0	0	0	0	0	0	0	0	0	0	0	0
"DQ656015"	533	47408	0	0	0	0	0	0	0	0	0	0	0	0	0	0	0	0
"DQ658414"	2331	19188	2764	22945	1543	1221	12317	10628	29	15077	0	39314	78	5877	32	6782	67	5786
"DQ673922"	2214	19890	0	0	0	0	0	0	43	0	0	0	0	0	0	0	0	0
"DQ673923"	1658	19890	0	0	0	0	0	0	43	0	0	0	0	0	0	0	0	0
"DQ673928"	162	1598	0	0	0	0	0	0	0	0	0	0	0	0	0	0	0	0
"DQ673930"	366	6886	0	0	0	0	0	0	14	0	0	0	0	0	0	0	0	0
"DQ673931"	268	1598	0	0	0	0	0	0	0	0	0	0	0	0	0	0	0	0
"DQ673933"	479	6886	0	0	0	0	0	0	14	0	0	0	0	0	0	0	0	0
"DQ673934"	509	11178	0	0	0	0	0	0	27	0	0	0	0	0	0	0	0	0
"DQ673939"	452	1828	0	0	0	0	0	0	0	0	0	0	0	0	0	0	0	0
"DQ673940"	509	13576	0	0	0	0	0	0	27	0	0	0	0	0	0	0	0	0
"DQ673941"	379	13507	0	0	0	0	0	0	27	0	0	0	0	0	0	0	0	0
"DQ673942"	600	14530	0	0	0	0	0	0	43	0	0	0	0	0	0	0	0	0
"DQ673943"	551	14530	0	0	0	0	0	0	43	0	0	0	0	0	0	0	0	0
"DQ673944"	872	5059	0	0	0	0	0	0	16	0	0	0	0	0	0	0	0	0
"DQ673945"	855	5059	0	0	0	0	0	0	16	0	0	0	0	0	0	0	0	0
"DQ673947"	420	13507	0	0	0	0	0	0	27	0	0	0	0	0	0	0	0	0
"DQ673948"	469	13507	0	0	0	0	0	0	27	0	0	0	0	0	0	0	0	0
"DQ673950"	759	3169	0	0	0	0	0	0	0	0	0	0	0	0	0	0	0	0
"DQ673957"	921	5059	0	0	0	0	0	0	16	0	0	0	0	0	0	0	0	0
"DQ673965"	1412	8831	0	0	0	0	0	0	16	0	0	0	0	0	0	0	0	0
"DQ673967"	645	10485	0	0	0	0	0	0	30	0	0	0	0	0	0	0	0	0
"DQ673968"	413	10485	0	0	0	0	0	0	30	0	0	0	0	0	0	0	0	0
"DQ673969"	526	10485	0	0	0	0	0	0	30	0	0	0	0	0	0	0	0	0
"DQ673970"	873	10485	0	0	0	0	0	0	30	0	0	0	0	0	0	0	0	0
"DQ673971"	824	10485	0	0	0	0	0	0	30	0	0	0	0	0	0	0	0	0
"DQ673972"	770	12359	0	0	0	0	0	0	27	0	0	0	0	0	0	0	0	0
"DQ673974"	364	2517	0	0	0	0	0	0	0	0	0	0	0	0	0	0	0	0
"DQ673977"	1698	5141	0	0	0	0	0	0	16	0	0	0	0	0	0	0	0	0
"DQ786190"	2131	2131	0	0	0	0	0	0	0	0	0	0	0	0	0	0	0	0
"DQ786202"	533	4354	0	0	0	0	0	0	0	0	0	0	0	0	0	0	0	0
"DQ786213"	1194	1296	55	0	26	29	0	0	205	149	0	37	282	4	134	60	501	142
"DQ786258"	655	2516	0	0	0	0	0	0	0	0	0	0	11	0	211	44	828	172
"DQ786262"	829	829	0	0	0	0	0	0	0	0	0	0	0	0	7	3	16	6
"DQ786263"	2302	2302	0	0	0	0	0	0	0	0	0	0	0	0	139	85	124	23
"DQ786271"	2466	13882	0	0	0	0	0	0	0	0	0	0	0	102	0	0	0	0
"DQ786274"	1471	1471	0	0	0	0	0	0	0	0	0	0	138	204	177	118	173	145
"DQ786280"	829	829	0	0	0	0	0	0	0	0	0	0	0	1	7	3	17	9
"DQ786290"	829	1791	0	0	0	0	0	0	84	0	159	43	0	0	22	15	35	0
"DQ786293"	1386	1386	0	0	0	0	0	0	0	0	0	0	0	0	0	0	0	0
"DQ786304"	1479	1479	0	0	0	0	0	0	0	0	0	0	0	0	0	0	0	62
"DQ786323"	848	8065	0	0	0	0	0	0	0	0	0	0	0	0	1866	7289	3515	2564
"DQ841025"	82	82	0	0	0	0	0	0	0	0	0	0	0	0	0	0	0	0
"DQX1"	2644	8150	1	0	0	1	0	0	65	0	0	0	0	1	0	0	0	0
"DR1"	3209	16670	983	221	529	454	140	81	428	127	52	197	2036	2228	2011	1664	2549	696
"DRAM"	3215	46296	3540	29053	2006	1534	15734	13319	120	14828	98	34641	495	8371	761	9918	700	5562
"DRAM1"	3548	46296	3540	29053	2006	1534	15734	13319	120	14828	98	34641	495	8371	761	9918	700	5562
"DRAM2"	2106	22885	2284	232	1312	972	114	118	1210	123	293	109	1953	965	2322	1244	1782	934
"DRAP1"	995	2305	42	0	23	19	0	0	47	23	0	0	1327	1190	1371	1507	2366	1655
"DRCTNNB1A"	688	37460	6358	2019	3485	2873	1170	849	5758	457	6731	669	641	292	1119	647	1004	619
"DRD1"	3374	3489	0	0	0	0	0	0	0	0	0	0	0	0	0	0	0	0
"DRD2"	2791	15378	0	0	0	0	0	0	71	8	0	0	0	0	0	0	0	0
"DRD3"	1647	50344	0	0	0	0	0	0	0	0	0	0	0	0	0	0	0	0
"DRD4"	1364	3400	1	0	1	0	0	0	0	25	0	0	0	0	0	0	0	0
"DRD5"	2376	2376	0	0	0	0	0	0	13	0	0	0	0	0	0	0	0	0
"DREG"	3733	29157	0	0	0	0	0	0	0	0	0	0	76	63	46	7	71	14
"DRG1"	1458	34634	106	75	39	67	52	23	124	99	87	264	480	315	839	750	868	661
"DRG2"	1901	20011	688	202	443	245	124	78	520	347	336	116	506	469	743	609	952	592
"DRGX"	812	25747	0	0	0	0	0	0	23	0	0	0	0	0	0	0	0	0
"DRP2"	7142	44554	0	0	0	0	0	0	15	0	0	0	0	0	0	0	0	0
"DSC1"	4271	33605	0	0	0	0	0	0	0	0	0	0	0	0	0	0	0	0
"DSC2"	5260	36446	51	0	30	21	0	0	67	0	20	0	1069	1027	770	831	951	789
"DSC3"	6994	52730	0	0	0	0	0	0	0	0	0	0	0	0	0	0	0	0
"DSCAM"	7142	834698	0	0	0	0	0	0	101	22	0	0	0	0	0	0	0	0
"DSCAML1"	6932	369489	0	36	0	0	24	12	1045	336	0	0	0	0	0	0	0	0
"DSCC1"	2277	21990	0	0	0	0	0	0	0	0	0	0	0	0	0	4	13	0
"DSCR10"	861	2488	0	0	0	0	0	0	0	0	0	0	0	0	0	0	0	0
"DSCR1L2"	1274	21623	219	0	128	91	0	0	309	0	51	0	572	518	552	370	747	392
"DSCR3"	4016	44109	2337	262	1310	1027	180	82	1403	263	716	350	2486	570	2306	1884	3097	1805
"DSCR4"	1100	67142	0	0	0	0	0	0	0	0	0	0	0	0	0	0	0	0
"DSCR5a"	976	7796	0	0	0	0	0	0	28	0	0	0	68	72	200	201	159	173
"DSCR6"	2236	13095	0	0	0	0	0	0	0	0	0	0	0	0	0	0	0	0
"DSCR6a"	1937	13508	0	0	0	0	0	0	0	0	0	0	0	0	0	0	0	0
"DSCR8"	816	35061	0	0	0	0	0	0	0	0	0	0	0	0	0	0	0	0
"DSCR9"	1149	1149	30	0	30	0	0	0	10	8	0	0	0	0	0	0	0	0
"DSE"	4043	67332	17993	13622	9679	8314	7448	6174	7866	10789	5121	7882	9619	10358	7842	5536	11189	5991
"DSEL"	9283	10150	0	0	0	0	0	0	0	0	0	0	0	0	0	0	0	0
"DSG1"	5459	39341	0	0	0	0	0	0	0	0	0	0	0	0	0	0	0	0
"DSG2"	5667	50788	0	0	0	0	0	0	0	0	0	0	0	0	3	0	4	0
"DSG3"	5565	30933	0	0	0	0	0	0	19	0	0	0	0	0	0	0	0	0
"DSG4"	3652	37142	0	0	0	0	0	0	0	0	0	0	0	0	0	0	0	0
"DSN1"	2489	22037	63	0	43	20	0	0	129	49	0	27	409	349	276	152	363	161
"DSP"	9754	45078	0	0	0	0	0	0	0	0	0	0	0	0	0	0	0	0
"DSPP"	4334	8344	0	0	0	0	0	0	0	0	0	0	0	0	0	0	0	0
"DST"	18169	496628	1491	969	795	696	533	436	1197	681	132	264	1298	1728	1564	1455	2102	1117
"DSTN"	1750	38054	133	8	68	65	4	4	163	48	0	44	1258	573	1103	1209	1600	938
"DSTYK"	7921	69097	1404	1606	799	605	955	651	897	1687	301	4861	1219	1879	1343	1070	1549	852
"DTD1"	1371	176004	664	168	377	287	96	72	816	302	255	240	380	458	416	409	609	435
"DTGCU2"	1917	12305	0	0	0	0	0	0	0	0	0	0	0	0	3	2	6	3
"DTHD1"	2763	62716	3	54	0	3	0	54	11	0	0	25	0	0	0	0	0	0
"DTL"	4426	69269	0	0	0	0	0	0	0	1	0	0	0	0	1868	1950	2270	1766
"DTNA"	6552	298528	95985	100069	53709	42276	54249	45820	38441	33293	37885	47147	3137	4365	2721	2419	3370	1952
"DTNB"	2493	296391	9	10	0	9	10	0	92	60	0	12	50	68	104	125	72	63
"DTNBP1"	2087	139472	4614	1233	2608	2006	698	535	2230	537	632	494	259	250	323	291	546	351
"DTWD1"	2755	24108	79	0	52	27	0	0	58	0	0	0	116	101	162	84	147	90
"DTWD2"	4978	151671	92	45	45	47	27	18	159	20	0	14	3529	3530	8895	8417	5083	7404
"DTX1"	3297	40173	10	61	0	10	25	36	164	47	0	0	5	1	0	90	0	70
"DTX2"	2830	44341	1846	353	964	882	203	150	848	289	1530	766	723	367	1371	916	1486	856
"DTX3"	3201	4978	0	0	0	0	0	0	0	0	0	0	0	17	0	0	3	4
"DTX3L"	5770	10864	712	289	379	333	163	126	344	216	0	42	3339	2949	2517	1077	2686	1015
"DTX4"	5804	36250	0	13	0	0	13	0	70	0	0	63	2108	2590	1916	2015	3345	1890
"DTYMK"	1058	11072	322	0	200	122	0	0	121	20	121	0	205	218	236	209	236	209
"DULLARD"	1789	8355	309	72	112	197	52	20	214	260	107	306	2262	2332	2066	1998	2497	1719
"DUOX1"	5712	35584	2229	2292	1212	1017	1388	904	833	717	181	457	1044	1455	690	483	1831	766
"DUOX2"	6379	21508	0	0	0	0	0	0	141	32	0	0	27	75	29	48	129	45
"DUOXA1"	1888	12371	249	143	136	113	58	85	253	34	8	0	278	100	165	153	489	215
"DUOXA2"	1874	3777	128	81	70	58	31	50	171	9	0	0	187	0	90	0	0	0
"DUPD1"	666	20680	0	0	0	0	0	0	0	0	0	0	0	1	0	0	0	0
"DUS1L"	2093	7604	446	170	259	187	102	68	252	200	456	263	857	1045	1553	1192	2094	1142
"DUS2L"	1942	55981	181	0	118	63	0	0	354	21	189	0	252	235	316	242	390	277
"DUS3L"	2122	6096	303	369	184	119	211	158	155	94	165	417	375	387	694	699	705	649
"DUS4L"	2355	14535	0	0	0	0	0	0	31	0	0	0	73	67	113	54	75	49
"DUSP1"	2019	3103	360	2925	191	169	1542	1383	123	1836	115	1705	489	9866	637	8990	541	11154
"DUSP10"	2623	40697	22	209	0	22	117	92	94	192	0	288	88	184	155	315	106	307
"DUSP11"	2212	12735	178	0	93	85	0	0	119	17	30	18	520	277	500	354	685	422
"DUSP12"	1267	7372	53	33	21	32	27	6	50	9	0	0	364	384	416	262	493	232
"DUSP13"	1777	14780	0	0	0	0	0	0	81	14	0	0	0	0	29	10	19	3
"DUSP14"	2194	3609	14	0	0	14	0	0	27	0	0	0	145	136	163	111	249	180
"DUSP15"	1741	23028	0	0	0	0	0	0	55	42	0	0	0	0	0	0	0	0
"DUSP16"	3573	86488	2599	5978	1362	1237	3276	2702	814	2078	395	3184	298	1328	248	289	423	161
"DUSP18"	2932	6421	407	0	271	136	0	0	310	55	456	65	1217	792	699	260	1152	460
"DUSP19"	5367	21435	0	0	0	0	0	0	0	0	0	0	0	0	3	0	0	0
"DUSP2"	1680	2264	61	4281	46	15	2192	2089	51	3	93	4569	433	18381	747	22530	264	31892
"DUSP21"	885	885	0	0	0	0	0	0	18	0	0	0	0	0	0	0	0	0
"DUSP22"	3005	46727	7358	4746	4212	3146	2583	2163	4180	2717	3859	4963	2539	2497	1908	1954	3449	2131
"DUSP23"	743	1527	0	0	0	0	0	0	22	14	0	0	374	0	788	699	880	625
"DUSP26"	1648	8585	0	0	0	0	0	0	39	10	0	0	0	0	0	0	0	0
"DUSP27"	4055	34333	0	0	0	0	0	0	0	0	0	0	0	0	0	0	0	0
"DUSP28"	3710	3961	70	2	70	0	0	2	267	21	34	0	185	102	167	72	211	50
"DUSP3"	4261	12880	942	1580	299	643	867	713	282	818	570	1269	5708	620	4590	6138	5855	4891
"DUSP4"	3403	12707	0	0	0	0	0	0	0	17	0	0	21	3	4	6	25	0
"DUSP5"	2530	13677	1683	9504	953	730	5093	4411	352	4857	194	5774	1340	7177	944	7923	1202	7237
"DUSP5P"	2474	7504	0	0	0	0	0	0	42	0	0	0	0	0	0	0	0	0
"DUSP6"	2821	4459	0	0	0	0	0	0	6	10	0	0	332	327	376	304	65	219
"DUSP7"	3341	4815	37	0	37	0	0	0	105	13	192	0	354	259	1100	151	1966	397
"DUSP8"	4480	17871	0	1223	0	0	710	513	77	893	0	2199	11	524	14	1107	33	839
"DUSP9"	2437	4125	0	0	0	0	0	0	23	0	0	0	0	0	0	0	0	0
"DUT"	2203	11949	63	0	34	29	0	0	68	13	0	0	472	541	706	567	675	529
"DUX4"	3248	8236	0	0	0	0	0	0	0	0	0	0	0	0	0	0	0	0
"DUXA"	3352	15764	0	0	0	0	0	0	0	0	0	0	0	0	0	0	0	0
"DVL1"	4411	6842	355	37	195	160	27	10	301	162	233	106	433	447	771	408	914	675
"DVL1L1"	2200	4900	152	17	83	69	14	3	104	36	78	34	319	376	612	259	701	547
"DVL2"	3031	9204	786	38	454	332	32	6	298	143	67	125	699	589	638	535	901	690
"DVL3"	5076	18031	966	371	549	417	158	213	455	386	624	646	1624	1872	2246	2369	2274	1442
"DVS27"	2565	42177	0	0	0	0	0	0	0	0	0	0	0	0	0	0	0	0
"DYDC1"	3281	20649	0	0	0	0	0	0	0	0	0	0	0	0	0	0	0	0
"DYDC2"	2260	23330	0	0	0	0	0	0	0	17	0	0	0	0	0	0	0	0
"DYM"	2645	416909	6200	4775	3684	2516	2645	2130	4631	3268	1238	3170	646	676	776	699	897	666
"DYNC1H1"	14418	86272	12491	4433	6954	5537	2406	2027	4621	1805	5177	2007	14366	13523	13472	9883	19353	9464
"DYNC1I1"	3062	325919	0	0	0	0	0	0	29	0	0	0	25	0	18	20	4	18
"DYNC1I2"	2620	60939	2132	1365	1223	909	747	618	945	1003	314	1459	466	432	2336	2092	3065	2194
"DYNC1LI1"	2495	44883	5336	3366	2898	2438	1877	1489	2016	1731	1659	4657	2131	2783	1348	1466	2588	1828
"DYNC1LI2"	4349	30728	4199	2616	2015	2184	1408	1208	1045	967	2022	1473	3323	3931	4035	3176	4488	877
"DYNC2H1"	13789	370433	0	0	0	0	0	0	0	0	0	0	0	5	0	0	0	0
"DYNC2LI1"	2929	21141	0	0	0	0	0	0	0	0	0	0	69	88	74	54	94	58
"DYNLL1"	811	28639	151	0	80	71	0	0	116	7	0	23	3382	3445	4214	3000	5359	2977
"DYNLL2"	1525	6840	135	0	89	46	0	0	40	31	0	48	1312	1647	1199	1469	2274	1537
"DYNLRB1"	1101	19188	594	348	361	233	189	159	530	308	33	426	798	73	705	442	1840	618
"DYNLRB2"	1040	9687	0	0	0	0	0	0	0	0	0	0	0	0	0	0	0	0
"DYNLT1"	700	8236	205	98	110	95	82	16	241	58	0	246	594	680	1034	755	609	248
"DYNLT3"	2220	8801	0	0	0	0	0	0	0	0	0	0	398	614	421	69	506	376
"DYRK1A"	6590	96473	19278	12887	10630	8648	6912	5975	8332	6052	7244	10894	1657	1625	1931	1350	2102	1457
"DYRK1B"	2545	8852	107	7	45	62	0	7	126	0	37	0	249	207	281	169	426	270
"DYRK2"	6161	13933	2234	177	1290	944	136	41	658	49	670	90	2588	1380	2158	786	2108	920
"DYRK3"	2264	13662	0	3	0	0	2	1	0	5	0	2	0	33	0	95	0	19
"DYRK4"	1857	23798	40	0	30	10	0	0	110	0	0	0	192	126	367	250	341	213
"DYSF"	7059	233141	2486	1241	1557	929	634	607	5368	2984	877	818	1992	1942	9108	9587	6449	4465
"DYSFIP1"	1445	1554	0	0	0	0	0	0	0	22	0	0	0	0	0	0	0	0
"DYT1"	2277	11221	679	24	360	319	11	13	297	69	108	26	2843	2694	715	529	2672	494
"DYTN"	2063	66777	0	0	0	0	0	0	0	0	0	0	1	2	0	0	0	0
"DYX1C1"	2001	77926	426	17	224	202	6	11	313	10	0	19	201	669	580	593	434	413
"DZIP1"	7510	66502	0	0	0	0	0	0	18	0	0	0	0	0	0	0	0	0
"DZIP1L"	3507	53619	376	44	196	180	28	16	643	54	123	22	166	139	183	113	338	181
"DZIP3"	5574	105357	5	19	3	2	5	14	56	23	0	0	259	346	289	270	250	154
"DcR1"	1283	14516	0	3	0	0	3	0	26	17	0	0	22	53	33	17	137	67
"DelGEF"	1587	225040	4032	591	2273	1759	341	250	3113	1121	442	822	260	255	279	239	425	276
"Dip2"	3544	8730	2316	871	1335	981	509	362	1281	476	1252	920	884	1033	1261	1081	1587	948
"Dorfin"	869	15760	5338	50503	3303	2035	27128	23375	532	24222	1393	26001	367	466	577	188	599	519
"E2BP3"	513	1174	22	0	22	0	0	0	13	0	0	0	0	0	0	0	0	0
"E2F1"	2706	10919	9	0	9	0	0	0	34	30	0	0	61	47	9	4	24	54
"E2F2"	5199	24793	0	0	0	0	0	0	93	13	0	0	19	0	4	0	7	0
"E2F3"	5016	91810	10426	12513	5798	4628	6770	5743	4296	6420	4146	12806	1491	1744	1543	1836	1671	1254
"E2F4"	2109	6754	720	253	393	327	118	135	385	246	316	375	1576	1462	2027	1448	2136	1334
"E2F5"	1740	37134	0	0	0	0	0	0	0	0	0	0	15	22	0	0	24	5
"E2F6"	3452	21797	328	118	203	125	71	47	374	182	0	127	320	357	664	552	728	509
"E2F7"	5753	44335	0	37	0	0	18	19	0	15	0	0	0	33	0	96	0	0
"E2F8"	3726	16891	0	0	0	0	0	0	0	0	0	0	0	0	0	0	0	0
"E4F1"	2586	12177	637	149	354	283	67	82	462	299	452	180	451	204	682	265	883	329
"EAF1"	4493	15057	67	99	44	23	50	49	66	144	0	61	833	976	898	1158	1009	769
"EAF2"	1025	51340	392	125	216	176	67	58	170	31	0	0	103	123	70	134	67	97
"EAF6"	680	18880	546	93	312	234	52	41	391	47	371	68	837	533	876	606	1175	595
"EAPP"	1354	23810	68	0	20	48	0	0	63	0	4	12	448	374	588	356	675	440
"EARS2"	3970	35363	188	16	100	88	0	16	227	33	26	0	529	142	368	238	399	243
"EB-1"	2542	87920	0	0	0	0	0	0	0	0	0	0	0	0	0	0	0	0
"EBAG9"	1646	25081	59	0	28	31	0	0	48	0	0	0	417	429	434	297	497	352
"EBBP"	5824	80457	0	0	0	0	0	0	34	0	0	0	205	148	206	112	242	147
"EBF1"	5292	403866	0	0	0	0	0	0	25	9	0	0	0	0	0	0	0	0
"EBF2"	2313	200821	0	0	0	0	0	0	24	0	0	0	0	0	0	0	0	0
"EBF3"	4377	128546	0	0	0	0	0	0	309	40	0	0	0	0	0	0	0	0
"EBF4"	2928	67231	0	0	0	0	0	0	98	16	0	0	0	0	0	0	0	0
"EBI3"	1135	7979	0	1057	0	0	624	433	18	899	0	2800	20	2669	38	1568	48	778
"EBNA1BP2"	1753	106763	27	0	21	6	0	0	101	33	0	0	511	547	633	540	719	548
"EBP"	1160	6940	66	0	15	51	0	0	0	17	0	0	1116	564	674	528	543	634
"EBPL"	1044	30814	20	0	20	0	0	0	36	0	0	0	172	120	60	74	73	63
"EBRP"	1103	30814	20	0	20	0	0	0	36	0	0	0	172	120	60	74	73	63
"EC45"	1399	3266	134	168	79	55	74	94	141	154	0	0	8551	9226	11536	13711	15025	13100
"ECD"	2350	33572	513	1220	279	234	717	503	300	863	105	1079	418	759	467	688	451	422
"ECE1"	5258	62445	164	587	85	79	373	214	629	1293	0	1812	478	622	590	497	922	646
"ECE2"	3501	43375	349	461	195	154	237	224	121	229	0	11	31	16	82	92	107	66
"ECEL1"	2983	7997	0	0	0	0	0	0	46	34	0	0	0	0	0	0	0	0
"ECH1"	1271	16435	473	77	240	233	45	32	315	31	139	15	1323	1224	1385	1105	2335	1372
"ECHDC1"	2343	54897	1161	97	495	666	79	18	1033	64	113	0	110	108	1120	230	1338	1029
"ECHDC2"	2395	16887	1338	785	737	601	503	282	406	254	8	140	268	356	231	160	476	231
"ECHDC3"	1777	21710	8	0	0	8	0	0	14	11	0	8	229	173	487	355	193	145
"ECHS1"	1336	10922	143	14	48	95	14	0	239	52	41	12	2167	2042	2470	2696	3818	1744
"ECM1"	3358	5779	44	31	17	27	17	14	71	40	22	0	759	431	906	861	1338	1064
"ECM2"	3258	40740	2261	2139	1317	944	1203	936	915	756	394	833	0	0	0	0	0	0
"ECSCR"	739	58077	0	0	0	0	0	0	19	0	0	0	0	0	0	0	0	0
"ECSIT"	1693	23245	242	97	141	101	54	43	322	137	146	393	614	298	554	542	757	571
"ECT2"	4371	70733	70	8	34	36	8	0	95	38	10	44	378	406	370	262	402	190
"ECT2L"	4281	90900	226	20	106	120	20	0	181	0	61	20	0	12	0	0	0	0
"EDA"	5286	423410	0	0	0	0	0	0	0	0	0	0	84	86	0	0	0	33
"EDA2R"	3430	43411	0	0	0	0	0	0	0	9	0	0	0	0	0	0	0	0
"EDAR"	4434	94899	0	0	0	0	0	0	199	0	0	0	0	0	0	0	0	0
"EDARADD"	2897	89294	0	17	0	0	0	17	7	18	0	12	5435	1601	77	0	0	0
"EDC3"	4078	65488	1223	487	685	538	251	236	650	379	452	551	787	816	830	625	513	746
"EDC4"	5258	11408	872	271	486	386	136	135	455	341	225	273	1686	1395	2060	1713	2840	1838
"EDEM1"	6164	32292	10836	38169	6091	4745	20665	17504	2671	15519	4494	30682	6945	26342	5753	16331	7785	14191
"EDEM2"	2422	160102	2524	868	1411	1113	454	414	2223	924	1370	1888	975	1717	2162	903	1951	1658
"EDEM3"	6718	64416	1641	598	937	704	319	279	1239	245	214	328	2114	2297	2611	2062	2458	1340
"EDF1"	645	4169	185	69	84	101	37	32	9	53	133	90	1804	1887	1665	2287	2260	1591
"EDIL3"	2985	442487	0	0	0	0	0	0	0	0	0	0	0	0	0	0	0	0
"EDN1"	3005	6244	0	0	0	0	0	0	0	0	0	0	0	55	0	25	0	14
"EDN2"	1284	5427	0	0	0	0	0	0	35	8	0	0	0	0	0	0	0	0
"EDN3"	2658	25549	0	0	0	0	0	0	14	15	0	0	0	0	0	0	0	0
"EDNRA"	4320	64201	0	0	0	0	0	0	0	0	0	0	0	0	0	0	0	0
"EDNRB"	4479	24289	0	0	0	0	0	0	0	0	0	0	0	0	0	0	0	0
"EDR3"	2608	79184	6777	2632	3780	2997	1367	1265	3720	986	2438	2158	354	555	681	475	496	362
"EDRF1"	4207	44630	660	79	367	293	41	38	400	125	89	89	539	418	655	377	699	354
"EEA1"	8031	156823	11786	11881	6604	5182	6487	5394	4926	3549	2428	5605	2606	3606	1797	2132	3076	1809
"EED"	2412	33965	1896	3426	1056	840	1868	1558	598	1405	149	2319	513	1121	726	672	758	801
"EEF1A1"	3547	5818	2028	8952	1153	875	4883	4069	618	5125	405	5847	26791	34989	159151	198150	221369	169084
"EEF1A2"	3248	4306	2000	8596	1125	875	4796	3800	548	4966	405	5785	4	5	23346	28391	157199	17057
"EEF1AL7"	1646	1646	0	0	0	0	0	0	0	0	0	0	0	0	609	1300	1512	1169
"EEF1B2"	1116	3337	58	24	18	40	0	24	0	38	0	30	1017	1166	3162	3642	5161	3931
"EEF1D"	2477	17949	3055	3346	1597	1458	1735	1611	1202	1823	2561	3856	2133	3192	3230	4907	5389	4245
"EEF1DP3"	1371	106691	2080	322	1049	1031	147	175	3007	1012	185	412	7	26	10	12	14	13
"EEF1E1"	1090	23194	185	0	91	94	0	0	146	7	0	15	302	313	264	180	404	239
"EEF1G"	1643	15330	496	280	295	201	137	143	382	331	113	401	13888	14587	20157	20372	28924	22187
"EEF2"	3172	9408	1879	2309	993	886	1243	1066	651	51	387	1665	24043	8039	24766	23644	37374	27633
"EEF2K"	7429	82475	6185	1769	3300	2885	925	844	2171	866	2328	2283	2368	2402	1894	996	2010	1163
"EEFSEC"	2222	255177	10060	2736	5692	4368	1599	1137	6040	3448	3407	4165	675	518	701	495	743	446
"EEN-B2-L1"	1898	171402	0	0	0	0	0	0	13	0	0	0	0	0	0	0	0	0
"EEPD1"	4694	148317	2973	1956	1545	1428	1150	806	2301	1670	537	1874	379	380	643	580	564	482
"EF070117"	762	49187	0	0	0	0	0	0	0	0	0	0	0	0	0	0	0	0
"EF070119"	955	49187	0	0	0	0	0	0	0	0	0	0	0	0	0	0	0	0
"EF070122"	591	49187	0	0	0	0	0	0	0	0	0	0	0	0	0	0	0	0
"EF413001"	2282	38937	10	0	0	10	0	0	35	0	0	0	0	0	0	0	0	0
"EF433558"	251	1239	0	0	0	0	0	0	0	0	0	0	0	0	0	0	0	0
"EF537580"	349	80270	0	0	0	0	0	0	0	0	0	0	0	0	0	0	0	0
"EF553526"	394	4222	0	0	0	0	0	0	69	42	0	7	0	0	11	13	12	8
"EF565086"	918	6470	0	0	0	0	0	0	38	0	0	0	0	0	10	0	3	0
"EF565094"	1923	34714	0	0	0	0	0	0	0	0	0	0	0	0	0	0	0	0
"EF565102"	405	10589	0	0	0	0	0	0	0	0	0	0	0	0	0	0	0	0
"EF565118"	1228	14806	0	0	0	0	0	0	0	0	0	0	0	0	0	0	0	0
"EF565129"	447	39783	0	0	0	0	0	0	0	8	0	0	0	0	0	0	0	0
"EF609116"	3936	34106	833	129	488	345	77	52	718	430	2040	1566	103	30	298	143	192	46
"EF633108"	845	30108	0	0	0	0	0	0	0	0	0	0	0	0	0	0	0	0
"EFA6B"	5487	29118	2048	419	1142	906	240	179	854	455	1221	593	3094	2721	3471	2652	4696	2930
"EFCAB1"	2292	20398	0	0	0	0	0	0	0	0	0	0	0	0	0	0	0	0
"EFCAB10"	1597	15208	0	0	0	0	0	0	26	2	0	0	148	136	126	86	110	83
"EFCAB2"	4239	155248	58	20	39	19	20	0	139	9	0	17	16	0	49	65	33	28
"EFCAB3"	1703	46260	0	0	0	0	0	0	0	0	0	0	0	0	0	0	0	0
"EFCAB4A"	1869	3763	5	0	5	0	0	0	72	11	0	0	20	29	25	32	44	9
"EFCAB4B"	3208	138267	144	67	67	77	44	23	363	215	79	0	524	104	766	807	557	336
"EFCAB5"	5154	166848	437	51	173	264	12	39	0	526	0	221	200	197	39	7	28	14
"EFCAB6"	4832	283466	0	0	0	0	0	0	130	36	0	0	0	0	0	0	0	0
"EFCAB7"	2374	49352	0	0	0	0	0	0	10	0	0	0	0	4	4	0	4	11
"EFCAB8"	3987	102687	0	0	0	0	0	0	0	78	0	0	0	0	0	0	1	0
"EFEMP1"	2928	57255	0	0	0	0	0	0	0	0	0	0	0	0	0	0	0	0
"EFEMP2"	2013	6429	213	98	96	117	65	33	255	126	55	209	11	6	5	12	33	20
"EFG"	3485	48043	749	189	422	327	101	88	533	291	21	123	1220	1432	1774	1611	1575	1188
"EFHA1"	1885	111469	2062	876	1000	1062	486	390	1494	755	128	875	1216	1213	942	858	997	888
"EFHA2"	4002	95403	0	0	0	0	0	0	0	0	0	0	0	0	0	0	0	0
"EFHB"	2866	54740	3	0	0	3	0	0	11	0	0	0	0	3	0	0	0	5
"EFHC1"	5591	75589	1268	255	736	532	170	85	809	133	626	145	2025	2113	1904	1447	2321	1283
"EFHC2"	3266	195796	0	0	0	0	0	0	0	0	0	0	0	0	0	4	0	0
"EFHD1"	1993	49285	0	0	0	0	0	0	88	0	0	0	0	1	0	0	0	0
"EFHD2"	2423	20450	5066	2812	2950	2116	1484	1328	1835	1654	4816	4824	8788	8115	12962	12208	16450	10618
"EFNA1"	1569	7037	0	0	0	0	0	0	21	69	0	0	0	176	5	384	6	223
"EFNA2"	646	13778	0	1	0	0	1	0	55	65	0	0	1	1	0	0	0	0
"EFNA3"	1781	23795	1	1	0	1	0	1	141	52	0	0	161	75	113	43	189	43
"EFNA4"	1259	5816	1	0	0	1	0	0	44	11	0	0	144	60	107	43	179	40
"EFNA5"	5339	294007	0	0	0	0	0	0	0	0	0	0	0	0	0	0	0	0
"EFNB1"	3333	13166	9	0	0	9	0	0	68	26	0	0	198	101	366	193	375	183
"EFNB2"	4322	45241	0	0	0	0	0	0	11	0	0	0	0	0	0	0	0	0
"EFNB3"	3222	6173	0	0	0	0	0	0	16	0	0	0	0	0	0	0	0	0
"EFR3A"	5317	109412	8351	6523	4591	3760	3564	2959	4100	2806	1638	2899	3528	3872	5318	4338	4740	3300
"EFR3B"	7480	117032	0	0	0	0	0	0	96	42	0	0	0	0	0	0	0	0
"EFS"	3123	9232	0	0	0	0	0	0	48	15	0	0	0	0	0	0	0	0
"EFTUD1"	3705	132545	347	23	197	150	21	2	563	24	89	13	529	536	842	619	839	551
"EFTUD2"	4195	49340	2231	738	1172	1059	448	290	1106	717	1193	1525	3041	3494	3853	3292	4611	3200
"EGF"	4900	99373	0	0	0	0	0	0	0	0	0	0	0	0	0	0	0	0
"EGFL6"	2396	63954	0	0	0	0	0	0	10	0	0	0	0	0	0	0	0	0
"EGFL7"	2134	13823	0	0	0	0	0	0	106	71	0	0	3	2	26	31	22	26
"EGFL8"	1578	3959	212	0	112	100	0	0	54	15	0	0	0	0	0	0	0	0
"EGFLAM"	4894	207050	0	0	0	0	0	0	45	0	0	0	0	0	0	0	0	0
"EGFR"	5627	188307	0	0	0	0	0	0	237	91	0	22	0	0	0	0	0	0
"EGLN1"	7102	61295	1149	0	619	530	0	0	904	10	106	0	1325	972	635	799	1577	930
"EGLN2"	2804	30167	4576	2583	2480	2096	1291	1292	1372	1721	2710	3550	4300	4464	4579	5084	7026	4627
"EGLN3"	2725	26863	18	14	0	18	0	14	25	0	0	0	132	142	77	13	171	18
"EGOT"	1462	2396	86	29	52	34	15	14	33	67	0	29	0	0	0	0	0	2
"EGR1"	3138	3825	82	201	51	31	119	82	93	160	0	55	233	1993	249	756	228	1636
"EGR2"	2977	4368	3695	2030	2021	1674	1109	921	1021	886	1972	2601	134	87	9386	114	299	6853
"EGR3"	4336	5643	201	760	122	79	196	564	23	901	0	898	269	5495	147	2523	174	1133
"EGR4"	2374	2773	0	0	0	0	0	0	0	40	0	0	0	173	0	182	0	107
"EHBP1"	5187	340620	93	30	55	38	21	9	146	76	71	25	222	339	194	224	263	184
"EHBP1L1"	5198	16608	6264	4210	3489	2775	2153	2057	1639	2073	4250	5176	5137	6112	6779	7505	8937	6145
"EHD1"	3620	26943	2965	14881	1658	1307	7908	6973	487	9236	228	30199	1787	2700	1040	24270	1742	21977
"EHD2"	3589	29791	0	0	0	0	0	0	71	56	0	0	0	0	0	0	0	0
"EHD3"	3911	34381	0	0	0	0	0	0	15	0	0	0	0	0	0	0	3	0
"EHD4"	2897	73116	10926	7893	6175	4751	4297	3596	4977	6781	4362	8648	5858	5528	2745	3588	8278	2347
"EHF"	3732	39333	3104	2544	1720	1384	1379	1165	1732	1595	676	2909	2527	2490	2741	2005	2727	1862
"EHHADH"	3916	63412	0	0	0	0	0	0	0	0	0	0	150	109	75	29	136	23
"EHMT1"	5132	217134	14277	4972	7954	6323	2530	2442	7212	4361	9409	8730	1141	1124	1580	1381	1897	1184
"EHMT2"	4056	17448	723	127	415	308	72	55	449	63	251	16	1593	1231	2356	1593	2599	1669
"EI24"	2275	15278	30	0	0	30	0	0	17	45	0	73	686	540	950	715	1010	750
"EID1"	2092	2092	123	48	65	58	30	18	42	13	0	0	3758	3909	4019	3221	4625	2841
"EID2"	1391	1391	0	0	0	0	0	0	0	0	0	0	216	148	279	147	310	136
"EID2B"	1866	1866	0	0	0	0	0	0	15	0	0	0	44	0	26	0	24	0
"EID3"	1433	1433	836	283	631	205	154	129	337	25	87	81	0	26	0	0	0	0
"EIF1"	1329	2772	873	1210	477	396	631	579	299	565	411	948	7634	14397	10090	17750	12150	14826
"EIF1AD"	2842	5563	134	26	56	78	15	11	117	61	0	74	758	302	984	620	1109	514
"EIF1AX"	4437	17331	146	410	62	84	157	253	151	305	0	559	1027	1447	1621	2086	2360	1926
"EIF1AY"	1396	17430	0	0	0	0	0	0	0	7	0	0	196	378	412	417	0	0
"EIF1B"	1014	2742	46	154	34	12	92	62	17	70	0	185	817	1137	1311	3173	1642	1511
"EIF2A"	3892	39230	1095	1175	647	448	643	532	662	713	113	721	4044	2388	1999	2044	3953	2617
"EIF2AK1"	4478	36982	815	279	465	350	153	126	404	151	115	140	695	2563	2607	2201	4073	2337
"EIF2AK2"	2947	50493	1135	463	669	466	194	269	775	518	61	137	274	311	786	366	529	379
"EIF2AK3"	4563	70735	336	573	200	136	335	238	381	337	30	224	529	710	776	919	686	569
"EIF2AK4"	5551	101452	873	148	511	362	73	75	889	112	178	38	3255	3586	1401	1256	1752	1210
"EIF2B1"	1802	12678	401	0	231	170	0	0	233	22	50	13	1476	1237	1479	967	751	1024
"EIF2B2"	1547	6682	55	0	19	36	0	0	47	27	0	0	391	306	410	326	523	315
"EIF2B3"	1671	135834	544	189	252	292	110	79	425	102	276	100	395	323	448	516	497	394
"EIF2B4"	1824	5977	397	13	191	206	5	8	157	76	38	60	804	688	834	555	1118	362
"EIF2B5"	3068	10290	567	402	339	228	228	174	385	318	506	414	1296	1131	1405	1785	1619	1159
"EIF2C1"	7495	41089	2625	433	1463	1162	219	214	1168	200	1591	268	1997	1663	2562	1977	2355	1444
"EIF2C2"	3517	104382	6787	17418	3522	3265	9360	8058	3314	10689	2148	16133	221	4555	341	473	417	161
"EIF2C3"	3574	125292	6584	5349	3615	2969	2912	2437	3062	2536	1955	4237	465	959	501	532	458	379
"EIF2C4"	4776	47362	3743	409	2029	1714	206	203	2170	226	1424	310	2886	2468	2227	1223	2415	1140
"EIF2S1"	4172	26200	577	643	322	255	338	305	414	633	61	757	2044	2667	1994	1986	2320	1669
"EIF2S2"	2599	23970	2156	2455	1172	984	1379	1076	845	1139	706	2089	860	1280	1667	1988	2148	1793
"EIF2S3"	3475	23862	688	588	404	284	350	238	236	232	184	557	2637	3035	2112	1674	2748	1784
"EIF3A"	5326	45794	5921	5403	3233	2688	2863	2540	2167	2764	1341	4564	7636	11823	10227	8331	10620	7355
"EIF3B"	3098	25903	1553	1139	892	661	565	574	669	944	467	1891	2744	3128	3882	3556	4165	3855
"EIF3C"	4106	14478	0	0	0	0	0	0	0	0	0	9	176	185	3788	3953	11330	8095
"EIF3CL"	4109	14473	0	0	0	0	0	0	0	0	0	9	176	185	3788	3953	11330	8095
"EIF3D"	1963	18381	1336	889	736	600	483	406	745	644	523	996	4392	5127	3839	3908	6140	4500
"EIF3E"	2124	41091	2271	2587	1253	1018	1530	1057	1183	1661	264	2061	1266	2017	4056	3721	5859	3875
"EIF3EIP"	2293	39151	2338	2335	1353	985	1299	1036	1052	1244	936	2912	4190	5390	6864	6971	6976	4622
"EIF3F"	1684	9273	144	58	63	81	33	25	205	193	0	180	346	452	2108	1619	1810	1448
"EIF3G"	1137	4910	1681	449	1308	373	247	202	358	200	949	368	8020	5100	7267	4606	9050	5413
"EIF3H"	2067	121440	5103	5668	2756	2347	3197	2471	2657	4083	769	4707	3037	2935	2170	2785	4792	2302
"EIF3I"	1930	10021	72	85	30	42	46	39	48	152	41	256	1293	1934	1921	1996	2307	1965
"EIF3IP1"	988	988	0	0	0	0	0	0	0	0	0	0	0	0	0	0	0	0
"EIF3J"	2564	25735	1644	2595	1269	375	1420	1175	709	1513	424	2458	2093	3200	2064	2349	2437	1972
"EIF3K"	1185	16404	1111	369	640	471	239	130	474	245	944	1167	1735	1212	2543	2561	3877	2781
"EIF3L"	1961	39269	2338	2335	1353	985	1299	1036	1052	1244	936	2912	4190	5390	6864	6971	6976	4622
"EIF3M"	1246	18623	662	647	382	280	342	305	454	379	88	691	2853	2916	2666	2502	3410	2455
"EIF3S6"	1404	46988	2271	2587	1253	1018	1530	1057	1183	1661	264	2061	1266	2017	4056	3721	5859	3875
"EIF4A1"	3085	14050	6717	8934	3677	3040	4728	4206	2219	6393	5057	5315	9456	10570	21010	22691	22644	20377
"EIF4A2"	1902	6324	5357	8013	3031	2326	4216	3797	1691	3892	2766	2707	6085	93	3512	3047	3830	2542
"EIF4A3"	1696	11921	179	122	120	59	75	47	88	86	43	0	1005	915	1864	1621	1996	1490
"EIF4B"	4057	35932	1964	727	1084	880	414	313	986	447	405	1207	4754	4858	7261	5267	12492	6863
"EIF4E"	4850	52181	1469	845	927	542	522	323	726	504	197	727	448	487	1528	1259	1644	1194
"EIF4E1B"	1983	15961	0	0	0	0	0	0	156	42	0	0	0	0	0	0	0	0
"EIF4E2"	3486	32994	2073	803	1213	860	471	332	1682	666	391	477	2768	3266	3093	2618	3846	2552
"EIF4E3"	6213	75092	1137	108	646	491	76	32	1157	325	617	653	225	1785	772	688	916	491
"EIF4EBP1"	861	29864	218	11	119	99	6	5	146	0	82	0	388	0	709	687	551	808
"EIF4EBP2"	7532	24513	1543	475	895	648	244	231	827	327	538	451	5390	5849	5382	3668	5386	3358
"EIF4EBP3"	694	1914	426	210	147	279	88	122	123	135	59	193	22	212	24	34	203	151
"EIF4ENIF1"	3652	50160	675	37	374	301	24	13	476	95	32	66	505	280	812	179	973	369
"EIF4G1"	5691	19951	4343	3814	2440	1903	1928	1886	1214	1742	1842	3026	13494	13886	13223	13147	15927	11207
"EIF4G1 variant protein"	1318	6743	2436	1771	1565	871	1030	741	537	972	778	565	4504	4632	4766	4814	6289	4457
"EIF4G2"	4026	10928	4077	5661	1597	2480	3094	2567	196	275	2703	3157	38371	16949	29619	36348	37874	27771
"EIF4G3"	6318	370366	45800	29789	25929	19871	16246	13543	18956	12378	22807	24424	4223	4598	5366	4574	6827	4694
"EIF4H"	2553	22725	2285	2930	1262	1023	1521	1409	877	1352	1142	2789	4864	6027	8083	8906	10368	8428
"EIF5"	6188	10075	2842	4521	1547	1295	2381	2140	1013	2053	1214	2941	5256	7903	6928	8956	7370	5709
"EIF5A"	1359	4926	522	543	334	188	291	252	141	378	138	659	3146	3264	5572	6536	6271	5757
"EIF5A2"	5541	20223	0	0	0	0	0	0	0	0	0	0	79	89	23	15	18	11
"EIF5AL1"	3835	3835	0	0	0	0	0	0	0	0	0	0	846	1018	1023	1071	991	998
"EIF5B"	4720	62894	929	753	565	364	432	321	442	750	65	277	2967	3024	2868	2370	2950	2107
"EIF6"	1235	5783	205	171	145	60	110	61	42	63	0	74	2409	1860	1185	1346	1727	1545
"EKN1"	1550	88060	0	0	0	0	0	0	0	0	0	0	11	8	0	0	0	0
"ELA3A"	1332	29724	0	0	0	0	0	0	29	0	0	0	0	0	0	0	0	0
"ELAC1"	2236	20104	13	0	13	0	0	0	33	0	0	0	224	130	238	105	277	128
"ELAC2"	3032	25658	391	12	228	163	9	3	431	42	186	12	1123	995	1096	720	1341	725
"ELANE"	927	3955	0	0	0	0	0	0	0	18	0	0	10	5	0	3	13	17
"ELAVL1"	6063	47073	1456	651	800	656	309	342	1141	885	739	1550	1449	1724	1515	1362	2112	1399
"ELAVL2"	3812	135960	0	0	0	0	0	0	0	0	0	0	0	0	0	0	0	0
"ELAVL3"	4689	29662	0	0	0	0	0	0	152	72	0	0	1	1	0	0	0	0
"ELAVL4"	2138	92254	0	0	0	0	0	0	0	0	0	0	5	26	5	4	4	0
"ELC"	591	1707	0	0	0	0	0	0	19	16	0	0	0	0	27	20	0	3
"ELF1"	3747	87454	15814	16880	8854	6960	9118	7762	6170	7665	5223	11159	4315	3666	4372	3227	4207	2915
"ELF2"	3272	81782	5488	3204	3043	2445	1593	1611	3067	2505	1017	2675	1428	461	1783	1084	1946	909
"ELF3"	6171	9235	0	0	0	0	0	0	59	0	0	0	0	0	0	0	9	0
"ELF4"	4186	45581	4763	2028	2567	2196	1016	1012	1476	1559	3613	3432	979	788	1227	902	1338	856
"ELF5"	2458	33006	0	0	0	0	0	0	39	0	0	0	2	0	0	3	0	3
"ELFN1"	3744	38794	0	0	0	0	0	0	327	101	0	0	0	11	3	0	13	13
"ELFN2"	8363	59506	16	26	16	0	0	26	535	420	0	0	0	0	0	0	0	0
"ELK1"	4708	15084	76	65	48	28	50	15	140	80	0	196	875	880	503	1243	705	1011
"ELK3"	2156	73401	1072	400	579	493	183	217	802	337	447	145	429	417	252	257	585	324
"ELK4"	3029	13604	736	332	400	336	196	136	497	241	164	427	243	279	368	297	326	128
"ELKS"	9473	504697	8452	7001	4771	3681	3804	3197	5168	4488	1120	3543	1440	1482	1895	1539	2000	1343
"ELL"	4098	79464	7888	5547	4404	3484	2853	2694	3843	4518	6430	13286	346	934	896	352	480	875
"ELL2"	6056	76973	2009	35820	1206	803	19399	16421	398	12666	0	25533	577	5651	1076	5444	606	2383
"ELL3"	2347	26522	1747	1115	1032	715	582	533	858	727	1264	1187	13640	10993	19561	18850	22279	17129
"ELMO1"	3708	594552	102745	87914	56812	45933	47358	40556	45482	39317	41674	53513	1360	1357	2694	2699	1861	2572
"ELMO2"	4918	16444	1420	554	724	696	271	283	850	653	339	372	1735	1736	1935	1679	2224	1286
"ELMO3"	2531	4900	136	25	70	66	17	8	122	136	77	105	14	20	84	59	93	73
"ELMOD1"	3139	75689	0	0	0	0	0	0	0	0	0	0	0	0	0	0	0	0
"ELMOD2"	1297	26493	219	8	107	112	0	8	247	4	31	0	247	881	802	282	264	210
"ELMOD3"	2781	37032	1448	663	812	636	364	299	834	504	673	524	675	879	885	984	785	534
"ELN"	3521	41809	0	0	0	0	0	0	242	45	0	0	4	0	0	0	0	0
"ELOF1"	1181	2426	46	18	16	30	8	10	107	24	0	12	461	360	544	376	823	362
"ELOVL1"	1606	4016	374	110	210	164	69	41	121	102	149	171	2453	2361	1473	2128	3930	1107
"ELOVL2"	4079	63631	0	0	0	0	0	0	0	0	0	0	0	0	0	0	0	0
"ELOVL3"	1313	3201	0	0	0	0	0	0	39	9	0	0	0	0	0	0	0	0
"ELOVL4"	3059	32781	0	0	0	0	0	0	0	0	0	0	0	0	0	0	0	0
"ELOVL5"	3085	81393	9057	33149	4935	4122	17681	15468	2973	20517	1327	27754	4361	2604	4653	2455	5066	4741
"ELOVL6"	3395	149592	0	0	0	0	0	0	0	0	0	0	0	0	0	0	0	0
"ELOVL7"	4238	92486	83	11866	59	24	6394	5472	0	5452	0	5122	50	259	10	225	52	5
"ELP2"	2712	44722	2929	402	1607	1322	249	153	1060	192	1114	494	1761	2019	2136	1483	970	487
"ELP2P"	2678	2678	0	1	0	0	1	0	9	19	0	0	0	0	0	1	0	0
"ELP3"	3232	98085	2325	294	1293	1032	190	104	1636	334	131	216	794	589	828	850	682	743
"ELP4"	2005	274032	1995	1314	1245	750	722	592	1457	1032	9	881	225	310	288	174	205	154
"ELSPBP1"	1036	30474	0	0	0	0	0	0	12	0	0	0	0	0	0	0	0	0
"ELTD1"	3632	117046	0	0	0	0	0	0	0	0	0	0	0	0	0	0	0	0
"EMB"	4481	15798	18497	7083	10885	7612	3830	3253	2734	2352	9701	4318	2609	3514	5628	4324	6431	3177
"EMCN"	4047	122752	0	0	0	0	0	0	0	0	0	0	0	0	0	0	0	0
"EMD"	1343	2286	70	84	46	24	62	22	17	119	0	153	571	896	648	922	780	735
"EME1"	2313	8230	41	67	0	41	17	50	85	142	0	32	2291	4	5	0	5	8
"EME2"	1444	3113	1391	145	832	559	73	72	172	44	414	258	47	59	1195	1072	1360	947
"EMG1"	1234	25578	1034	226	617	417	101	125	609	335	268	293	2643	2600	2605	1977	3106	2164
"EMID1"	2080	53634	0	0	0	0	0	0	208	102	0	0	0	0	0	0	0	0
"EMID2"	3024	196184	0	0	0	0	0	0	432	147	0	0	9	0	5	0	37	0
"EMILIN1"	3867	7759	0	0	0	0	0	0	90	51	0	0	56	27	27	7	80	37
"EMILIN2"	4015	67062	17105	18331	9907	7198	9824	8507	5967	14447	8690	18485	13605	14983	15741	14770	18217	12909
"EMILIN3"	3831	6894	0	0	0	0	0	0	0	11	0	0	0	0	0	0	0	0
"EML1"	4820	168459	0	0	0	0	0	0	188	36	0	0	0	0	0	0	0	0
"EML2"	2860	36068	358	92	222	136	37	55	297	113	140	60	475	480	760	615	942	635
"EML3"	3693	10164	1470	519	695	775	217	302	606	265	1473	444	1359	1282	1442	1449	2319	1593
"EML4"	5570	163198	7620	19310	4291	3329	10561	8749	4122	11113	2324	16717	1792	2152	2909	2911	3151	2409
"EML5"	7121	177954	0	0	0	0	0	0	25	0	0	0	438	500	37	0	80	31
"EML6"	7891	247007	445	41	229	216	28	13	332	401	137	97	0	6979	0	0	0	0
"EMP1"	2808	20107	192	0	102	90	0	0	111	48	0	0	2098	2206	1562	1267	1974	1063
"EMP2"	5185	52261	0	0	0	0	0	0	0	0	0	0	0	0	0	0	0	0
"EMP3"	834	5183	476	1128	264	212	593	535	159	435	110	1283	3323	5125	2184	4893	4000	4261
"EMR1"	3143	52883	0	0	0	0	0	0	0	0	0	0	0	13	73	41	10	0
"EMR2"	6792	46150	4081	10387	2265	1816	5518	4869	1145	4605	2084	8754	3130	7501	2922	4542	1963	3998
"EMR3"	2316	55680	134	94	85	49	46	48	31	29	0	0	2291	2310	6522	5970	6504	5327
"EMR4P"	2747	38347	3033	388	1800	1233	221	167	1431	274	281	201	457	374	1246	981	996	702
"EMSY"	3200	15966	160	46	82	78	21	25	131	79	0	52	57	69	49	54	89	35
"EMX1"	2191	17418	1	0	1	0	0	0	123	22	0	0	0	1	0	0	0	0
"EMX2"	7285	60776	0	0	0	0	0	0	62	8	0	0	0	0	0	0	0	0
"EN1"	2963	6013	0	0	0	0	0	0	0	0	0	0	0	0	0	0	0	0
"EN2"	3391	6698	0	0	0	0	0	0	0	0	0	0	0	0	0	0	0	0
"ENAH"	13187	166313	0	0	0	0	0	0	0	0	0	0	0	0	0	0	0	0
"ENAM"	5683	18077	0	0	0	0	0	0	0	0	0	0	0	0	0	0	0	0
"ENC1"	5519	14016	22	0	22	0	0	0	59	12	0	0	396	148	573	181	523	168
"ENDOD1"	4652	42800	0	0	0	0	0	0	0	0	0	0	262	316	273	214	181	184
"ENDOG"	1147	4177	202	17	137	65	17	0	107	42	128	0	567	472	50	449	85	57
"ENDOGL-1"	1628	28679	417	89	250	167	65	24	319	79	68	50	295	339	192	173	234	83
"ENDOGL1"	3361	30035	484	89	294	190	65	24	336	79	68	50	295	339	192	196	234	83
"ENG"	3209	39757	1682	365	958	724	246	119	910	777	1472	816	3422	2777	6347	5786	3515	4406
"ENGASE"	4736	8392	1723	598	903	820	343	255	790	418	1472	693	844	903	1771	1650	2648	1561
"ENHO"	1080	1999	0	0	0	0	0	0	43	27	0	0	209	115	383	330	514	453
"ENKUR"	3324	34115	0	0	0	0	0	0	0	13	0	0	62	30	38	0	40	10
"ENO1"	2276	10295	4131	3985	2281	1850	2181	1804	1188	1806	2790	6106	15058	24157	13973	26125	21140	18719
"ENO2"	2838	8490	9	5	5	4	3	2	60	20	0	30	56	91	93	108	62	106
"ENO3"	1533	6038	52	0	21	31	0	0	99	57	0	8	76	55	127	116	173	77
"ENOPH1"	2019	30519	175	1	84	91	1	0	269	8	70	0	654	1239	963	847	1051	771
"ENOSF1"	2101	40120	794	110	460	334	47	63	815	196	125	112	283	327	826	628	449	435
"ENOX1"	3035	573428	0	0	0	0	0	0	0	0	0	0	0	0	0	0	0	0
"ENOX2"	4196	279851	1695	820	1060	635	487	333	1399	760	36	535	243	286	556	485	540	326
"ENPEP"	5013	87264	0	0	0	0	0	0	0	0	0	0	0	0	0	0	0	0
"ENPP1"	7465	87139	0	0	0	0	0	0	0	0	0	0	0	0	0	0	0	0
"ENPP2"	3302	81789	606	1064	370	236	627	437	359	361	14	178	1802	2069	4463	4348	1559	1414
"ENPP3"	3454	118969	0	0	0	0	0	0	0	3	0	0	30	68	87	136	22	7
"ENPP4"	4683	16736	0	0	0	0	0	0	0	0	0	0	176	252	226	109	140	67
"ENPP5"	3010	10957	0	0	0	0	0	0	0	0	0	0	0	0	0	0	0	0
"ENPP6"	3943	129256	0	0	0	0	0	0	19	31	0	0	0	0	0	0	0	0
"ENPP7"	1847	11140	0	0	0	0	0	0	66	52	0	0	0	0	0	0	0	0
"ENSA"	2937	6345	825	2112	439	386	1111	1001	295	1069	243	1863	123	3737	1587	1520	2658	2240
"ENTHD1"	2716	150746	0	0	0	0	0	0	0	0	0	0	197	180	777	843	1109	855
"ENTPD1"	12749	121351	10364	5165	5875	4489	2809	2356	4116	1909	2402	4460	2045	2384	1572	1430	2066	1262
"ENTPD2"	2109	5954	0	0	0	0	0	0	50	56	0	0	2	2	0	26	0	10
"ENTPD3"	2855	41360	0	0	0	0	0	0	0	0	0	0	1	0	0	0	0	0
"ENTPD4"	3003	25674	3340	2344	1976	1364	1335	1009	1540	1444	1193	1945	2064	2650	2155	2051	2530	1649
"ENTPD5"	3112	57920	126	0	61	65	0	0	62	10	0	0	550	570	699	475	624	317
"ENTPD6"	2777	31023	1766	842	949	817	438	404	1207	1082	841	320	1732	1734	1960	1755	3291	1817
"ENTPD7"	8751	51740	150	0	82	68	0	0	263	16	18	37	568	1360	648	486	649	283
"ENTPD8"	2231	7086	0	0	0	0	0	0	74	11	0	0	0	8	0	6	26	11
"ENY2"	573	9276	188	292	100	88	164	128	175	53	17	36	1241	1253	1053	861	1344	811
"EOMES"	2770	5787	11	0	0	11	0	0	16	0	0	0	106	31	42	34	144	23
"EP300"	8791	87468	10590	4732	5953	4637	2532	2200	4473	2534	5322	6119	5398	5480	5970	4479	7712	4334
"EP400"	12317	130498	4290	1290	2372	1918	762	528	2489	1718	1704	2117	1468	1544	2136	1989	2415	1545
"EP400NL"	4342	10740	578	101	301	277	63	38	630	175	268	124	95	107	172	154	235	86
"EPAS1"	5153	89274	4018	336	2327	1691	224	112	2289	192	888	190	3223	2796	4351	4018	4793	3312
"EPB4.1"	4277	36551	90	101	47	43	53	48	80	49	0	23	862	883	770	647	1017	665
"EPB41"	6390	233332	738	684	375	363	338	346	513	347	64	405	1220	1282	1178	955	1434	937
"EPB41L1"	6773	34941	0	4	0	0	4	0	504	188	0	0	211	216	772	698	546	685
"EPB41L2"	4917	43748	22512	54861	12661	9851	29610	25251	10510	22141	10364	49630	4442	6060	11543	11635	7551	5796
"EPB41L3"	4469	151600	4325	8127	2379	1946	4445	3682	1141	4434	33	6823	2959	3787	1553	2186	1405	1319
"EPB41L4A"	4730	256697	44	0	16	28	0	0	56	168	0	68	144	140	126	75	172	96
"EPB41L4B"	5604	148769	0	0	0	0	0	0	23	9	0	0	0	0	0	0	0	0
"EPB41L5"	6564	166027	2	0	0	2	0	0	0	0	0	0	0	11	0	3	0	5
"EPB42"	2551	23897	0	0	0	0	0	0	60	0	0	0	0	0	0	0	0	0
"EPB49"	2781	23351	0	0	0	0	0	0	83	40	0	0	20	8	0	0	5	0
"EPC1"	2928	78256	5324	6127	2997	2327	3338	2789	2884	2328	1250	4044	1060	1143	822	769	1013	557
"EPC2"	3654	142577	8120	7792	4635	3485	4457	3335	4035	3781	1784	4201	906	909	1167	863	1265	899
"EPCAM"	1725	17880	0	0	0	0	0	0	0	0	0	0	5	0	0	0	35	0
"EPDR1"	2598	31378	0	0	0	0	0	0	39	0	0	0	99	78	183	147	205	149
"EPGN"	850	5104	0	0	0	0	0	0	0	0	0	0	0	0	0	0	0	0
"EPHA1"	3379	17780	1588	625	670	918	326	299	299	1024	581	2242	3413	4815	3	5603	8	0
"EPHA10"	5527	49179	0	0	0	0	0	0	170	85	0	0	0	0	0	0	0	0
"EPHA2"	3963	31734	0	0	0	0	0	0	214	142	0	0	0	2	0	39	0	3
"EPHA3"	5824	374610	0	0	0	0	0	0	0	0	0	0	0	0	0	0	0	0
"EPHA4"	6364	154263	16	9	16	0	9	0	34	0	0	0	0	13	0	5	3	0
"EPHA5"	7878	350373	0	0	0	0	0	0	0	0	0	0	0	0	1849	1832	2571	1969
"EPHA6"	3695	934363	0	0	0	0	0	0	0	0	0	0	0	0	0	0	0	0
"EPHA7"	6657	179560	0	0	0	0	0	0	0	0	0	0	0	0	0	0	0	0
"EPHA8"	5013	40085	0	0	0	0	0	0	183	91	2	0	63	43	0	0	0	0
"EPHB1"	4528	465047	55	40	28	27	20	20	130	39	0	26	20	0	16	12	10	14
"EPHB2"	4884	204493	184	4	122	62	4	0	1671	474	0	21	343	263	822	596	327	380
"EPHB3"	4235	20610	0	0	0	0	0	0	33	3	0	0	4	0	0	0	16	0
"EPHB4"	5077	22963	0	0	0	0	0	0	167	47	0	0	1	5	0	55	0	0
"EPHB6"	4061	16055	55	6	38	17	0	6	143	20	108	0	516	522	855	888	1042	807
"EPHX1"	1838	20260	747	223	521	226	125	98	405	209	197	298	1395	356	697	1948	1154	1792
"EPHX2"	2213	53841	0	0	0	0	0	0	45	15	0	0	0	0	0	0	0	0
"EPHX3"	1816	5502	0	0	0	0	0	0	41	25	0	0	0	0	0	0	4	0
"EPHX4"	1450	33562	0	0	0	0	0	0	0	0	0	0	0	0	0	0	0	0
"EPM2A"	3463	110547	162	222	96	66	148	74	214	90	0	51	190	190	217	212	233	172
"EPM2AIP1"	7439	7439	825	1723	437	388	959	764	372	789	333	1494	1058	3267	957	3154	1158	2381
"EPN1"	2957	19143	1227	86	642	585	38	48	698	291	1027	257	952	1151	1436	1515	2929	1310
"EPN2"	4845	99339	4495	143	2424	2071	66	77	2955	370	1298	260	901	900	1034	920	1446	951
"EPN3"	3936	11064	0	0	0	0	0	0	86	48	0	0	0	0	0	0	0	0
"EPO"	1333	2900	0	0	0	0	0	0	25	28	0	0	0	0	0	0	0	0
"EPOR"	2106	6546	11	0	11	0	0	0	24	11	0	0	10	12	79	30	27	0
"EPPIN"	4051	5546	0	0	0	0	0	0	0	0	0	0	0	0	0	0	0	0
"EPPK1"	7524	7524	22	8	14	8	4	4	97	42	0	0	4	5	0	0	0	0
"EPR-1"	1659	10464	0	0	0	0	0	0	28	0	0	0	0	0	0	0	4	0
"EPRS"	5047	78060	406	150	183	223	86	64	274	31	24	31	2594	2712	2409	2051	3060	1967
"EPS15"	5245	165062	12869	5453	7285	5584	2843	2610	6925	2265	5045	3820	5377	6444	5761	5094	5611	3377
"EPS15L1"	3925	34667	2934	585	1611	1323	375	210	2518	673	1375	955	754	657	816	733	989	695
"EPS8"	4102	169436	264	42	150	114	34	8	112	22	0	0	274	331	619	762	322	306
"EPS8L1"	2604	12071	99	0	46	53	0	0	144	102	78	0	56	86	122	89	186	97
"EPS8L2"	3354	17849	5	0	3	2	0	0	79	32	0	0	56	44	8	0	70	48
"EPS8L3"	2260	13864	0	0	0	0	0	0	109	22	0	0	0	0	0	0	0	0
"EPS8R1"	1986	6231	87	0	46	41	0	0	62	49	0	0	45	72	88	75	151	75
"EPS8R2"	1811	16184	4	0	2	2	0	0	64	21	0	0	19	17	4	0	27	26
"EPSTI1"	1586	104257	2141	2843	1338	803	1564	1279	2556	3380	61	872	185	280	530	242	365	310
"EPX"	2687	12405	0	0	0	0	0	0	67	14	0	0	16	3	8	0	44	11
"EPYC"	1544	41347	0	0	0	0	0	0	0	0	0	0	0	0	0	0	0	0
"ERAF"	508	922	0	0	0	0	0	0	0	0	0	0	0	0	0	0	0	0
"ERAL1"	1835	6031	70	56	39	31	31	25	66	31	28	0	756	702	819	715	991	697
"ERAP1"	5603	47379	5011	2758	2816	2195	1554	1204	2858	1862	1238	1925	8435	9864	7719	6329	9721	5945
"ERAP2"	5701	43756	519	47	282	237	24	23	538	11	41	26	1697	1902	1486	1194	3945	2592
"ERAS"	1267	1267	0	0	0	0	0	0	0	0	0	0	0	0	0	0	0	0
"ERBB2"	4897	40523	1	0	0	1	0	0	291	107	0	0	4	0	13	7	20	20
"ERBB2IP"	7086	154468	16773	34073	9438	7335	18646	15427	6781	12679	5724	22138	3531	4879	3221	3343	3583	2376
"ERBB3"	5538	23237	0	0	0	0	0	0	40	0	0	0	1	1	0	1	0	0
"ERBB4"	11951	1162912	0	0	0	0	0	0	0	0	0	0	0	0	0	0	0	0
"ERC1"	9314	504697	8452	7001	4771	3681	3804	3197	5168	4488	1120	3543	1440	1482	1895	1539	2000	1343
"ERC2"	6143	960057	0	0	0	0	0	0	116	15	0	0	59	84	8	5	0	4
"ERCC1"	1263	10111	144	129	82	62	86	43	406	373	142	240	619	636	987	721	1127	781
"ERCC2"	2619	7549	121	0	70	51	0	0	261	104	89	0	409	363	459	335	541	319
"ERCC3"	3400	33605	755	62	415	340	55	7	467	24	340	14	1041	621	992	587	1464	659
"ERCC4"	6772	32193	101	0	38	63	0	0	97	0	0	0	647	436	746	193	721	285
"ERCC5"	4384	65254	2087	505	1204	883	271	234	1044	149	566	123	2582	1922	2696	1401	3091	1481
"ERCC6"	11250	50036	6394	894	3572	2822	501	393	2181	204	1152	296	1681	1328	985	773	1710	837
"ERCC6L"	4328	34353	383	0	269	114	0	0	492	13	189	0	0	0	0	1	0	1
"ERCC8"	3566	33693	707	121	395	312	63	58	463	159	27	175	152	250	179	127	218	106
"EREG"	4633	23619	0	0	0	0	0	0	15	14	0	0	3	415	4	392	0	0
"ERF"	3077	3164	1106	938	598	508	494	444	382	483	746	1722	788	1014	1074	1567	1215	1494
"ERG"	5141	280641	0	0	0	0	0	0	57	23	0	0	0	7	0	4	3	0
"ERG2"	3174	22907	6	0	5	1	0	0	57	77	1	0	6	0	0	0	0	0
"ERGIC1"	3951	13093	2165	293	1124	1041	185	108	2117	852	478	215	2426	2699	3089	2865	3601	2605
"ERGIC2"	1790	40565	222	0	172	50	0	0	191	0	30	30	311	349	635	581	371	262
"ERGIC3"	2905	3379	627	121	376	251	59	62	183	62	404	624	1503	1463	2110	2062	2600	2002
"ERH"	805	18183	241	187	140	101	99	88	127	68	0	81	990	1185	1527	1223	1411	1317
"ERI1"	4622	30537	4855	3614	2791	2064	2012	1602	4407	2587	902	1700	2646	3007	5495	5176	6265	5517
"ERI2"	3744	10135	8006	17829	4495	3511	9070	8759	1591	11632	798	30946	1565	7361	1547	5147	1565	3546
"ERI3"	1836	134198	1129	210	704	425	99	111	1903	463	414	437	305	336	380	401	436	348
"ERICH1"	3560	8055	15337	49632	8434	6903	26354	23278	4638	26886	8382	30886	1351	14390	2634	17295	3037	7860
"ERLEC1"	3135	32429	213	43	123	90	36	7	216	27	17	0	814	633	881	747	1223	729
"ERLIN1"	3449	35888	432	7	263	169	0	7	285	10	73	0	802	568	1045	633	1155	668
"ERLIN2"	4832	21223	200	53	126	74	28	25	122	54	5	0	1045	999	851	699	905	558
"ERMAP"	3962	15076	651	252	351	300	118	134	270	147	32	51	578	567	501	369	523	319
"ERMN"	3777	7292	57	50	37	20	38	12	0	39	0	4	59	83	0	4	20	0
"ERMP1"	5356	48511	2817	2941	1545	1272	1644	1297	1513	1179	374	943	1599	1936	1884	1760	1975	1491
"ERN1"	4027	87114	2770	14756	1500	1270	7565	7191	1105	5555	402	8403	245	679	537	1107	453	365
"ERN2"	3640	23195	0	0	0	0	0	0	25	0	0	0	0	0	0	0	0	0
"ERO1-L"	3320	53814	1172	107	738	434	52	55	666	61	261	113	745	792	1477	1139	1849	1184
"ERO1L"	3324	53814	1172	107	738	434	52	55	666	61	261	113	745	792	1477	1139	1849	1184
"ERO1LB"	5068	66917	2749	12966	1659	1090	7032	5934	1093	9879	258	5250	1909	3686	342	446	342	312
"ERO1Lbeta"	1107	46056	352	247	240	112	152	95	272	260	27	286	45	72	28	71	37	36
"ERP27"	1542	24488	220	277	98	122	146	131	64	259	0	171	20	38	57	25	37	17
"ERP29"	1475	9874	995	129	559	436	58	71	375	34	349	0	2973	2156	3695	2752	4777	3179
"ERP44"	4870	119867	6615	5844	3614	3001	3190	2654	3475	3568	1275	4326	1429	1869	1998	1760	1906	1540
"ERRFI1"	3132	14615	12	280	0	12	155	125	0	162	0	47	66	54	22	354	4	36
"ERV3"	2811	15936	3067	966	1658	1409	431	535	584	246	1444	932	500	135	2	2	6	2
"ESAM"	2245	4414	330	33	164	166	16	17	194	30	81	0	280	255	161	153	89	382
"ESCO1"	4511	71433	2500	449	1497	1003	279	170	1088	289	249	257	743	818	681	666	727	449
"ESCO2"	3367	30366	0	0	0	0	0	0	0	0	0	0	0	10	0	0	0	0
"ESD"	2458	6229	212	13	96	116	7	6	266	42	10	72	1896	1954	1926	1574	2038	1667
"ESF1"	3229	70564	232	199	166	66	133	66	268	256	0	22	414	553	510	484	464	392
"ESM1"	2091	7720	0	0	0	0	0	0	0	0	0	0	0	0	0	0	0	0
"ESPL1"	6735	25346	31	1747	17	14	924	823	110	1298	0	2156	46	1567	51	1560	90	1056
"ESPN"	3543	36157	0	2	0	0	2	0	517	284	0	0	0	1	0	0	0	0
"ESPNL"	4691	32978	18011	7308	9971	8040	3814	3494	5642	2870	17343	6269	5574	4369	6864	4122	7284	4211
"ESPNP"	1174	3697	0	0	0	0	0	0	68	57	0	0	0	0	0	0	0	0
"ESR1"	6473	412777	1063	607	637	426	360	247	1385	757	319	781	148	189	332	288	245	148
"ESR2"	5555	52159	0	0	0	0	0	0	0	11	0	0	1	0	0	0	1	0
"ESRP1"	3820	66330	0	0	0	0	0	0	0	0	0	0	0	0	0	0	0	0
"ESRP2"	4066	7688	1199	112	733	466	73	39	394	213	332	118	2687	1907	2017	1826	2612	1864
"ESRRA"	2285	10513	2900	1035	1564	1336	607	428	840	477	3166	1936	2825	2459	3263	2213	4380	2524
"ESRRB"	3023	130490	0	0	0	0	0	0	218	78	0	0	0	0	0	0	0	0
"ESRRG"	5667	573687	0	0	0	0	0	0	0	0	0	0	0	0	0	0	0	0
"ESSPL"	990	14280	0	0	0	0	0	0	0	0	0	0	0	0	0	0	0	0
"EST-YD1"	565	36833	0	0	0	0	0	0	0	0	0	0	0	0	0	0	0	0
"ESX1"	1472	4870	0	0	0	0	0	0	0	0	0	0	0	0	0	0	0	0
"ESYT1"	4232	16400	2010	600	1127	883	323	277	855	397	1070	311	11697	11167	8849	7561	12951	8286
"ESYT2"	5979	98632	5310	32872	2919	2391	17575	15297	2014	16229	765	13473	2291	3734	2163	2338	2602	1771
"ESYT3"	4469	43842	0	0	0	0	0	0	67	20	0	0	0	0	3	0	5	5
"ET"	1111	2300	240	86	120	120	32	54	131	649	190	756	4672	6531	5347	7110	5986	5665
"ETA"	3497	59344	0	0	0	0	0	0	0	0	0	0	0	0	0	0	0	0
"ETAA1"	3289	13093	23	0	23	0	0	0	51	0	0	0	330	166	260	24	277	72
"ETF1"	3895	37146	2074	7268	1189	885	4018	3250	811	3804	713	8004	2974	5436	3524	5875	4137	4614
"ETFA"	1802	80967	4015	2178	2325	1690	1294	884	1912	1609	428	1982	2169	2467	2039	2017	2548	1805
"ETFB"	1305	9688	106	26	52	54	0	26	102	41	0	0	58	455	592	543	801	574
"ETFDH"	2359	36564	39	0	18	21	0	0	100	80	62	21	144	833	232	349	395	239
"ETHE1"	1101	19618	1555	387	829	726	195	192	642	575	1259	2194	747	730	554	574	1080	616
"ETNK1"	7168	65533	9406	10226	5222	4184	5700	4526	4143	3442	2558	4313	4475	5249	4361	3624	4397	2816
"ETNK2"	2723	21118	0	0	0	0	0	0	45	17	0	0	82	27	116	97	208	268
"ETS1"	5250	63551	1650	1435	1006	644	779	656	559	760	715	3059	2514	3048	2263	2172	1656	1234
"ETS2"	3944	19647	226	2447	117	109	1298	1149	24	1030	0	1593	352	2507	629	3503	552	1015
"ETV1"	6817	98786	0	0	0	0	0	0	0	0	0	0	0	0	0	0	0	0
"ETV2"	1577	3128	3	0	3	0	0	0	0	65	0	0	6	4	5	0	6	0
"ETV3"	2007	13926	2790	11044	1548	1242	6097	4947	534	5634	433	5817	2115	204	1033	6327	1054	2704
"ETV3L"	1981	7766	0	0	0	0	0	0	10	17	0	0	0	0	0	2	0	0
"ETV4"	2404	18552	0	0	0	0	0	0	45	0	0	0	11	11	9	9	14	7
"ETV5"	4113	62795	84	0	74	10	0	0	109	4	0	0	432	289	741	354	292	149
"ETV6"	5984	245537	156182	250783	86908	69274	135124	115659	60590	128227	96362	229272	7330	8883	6689	5768	7650	4878
"ETV7"	1678	21497	0	0	0	0	0	0	76	0	0	0	0	0	0	0	0	0
"EU036692"	285	877	0	0	0	0	0	0	11	74	0	0	0	120	0	169	0	0
"EU154351"	2067	21183	2297	683	1263	1034	383	300	1358	851	2231	1137	56	60	219	154	189	55
"EU154352"	2253	21183	2297	683	1263	1034	383	300	1358	851	2231	1137	56	60	219	154	189	55
"EU233817"	4318	362914	0	0	0	0	0	0	0	0	0	0	0	0	0	0	0	0
"EU250746"	1770	63715	0	0	0	0	0	0	0	0	0	0	0	0	0	0	0	0
"EU250747"	2237	46479	0	49	0	0	24	25	78	0	0	0	20	12	13	13	67	18
"EU250752"	484	302309	0	0	0	0	0	0	21	0	0	0	0	0	0	0	0	0
"EVC"	7087	117850	844	263	464	380	143	120	755	436	0	49	1319	1600	369	275	1027	569
"EVC2"	4949	147123	0	0	0	0	0	0	58	17	0	0	2	3	0	0	12	0
"EVI1"	4720	50473	0	0	0	0	0	0	0	0	0	0	0	0	0	0	0	0
"EVI2A"	1715	4043	405	257	228	177	135	122	175	108	0	0	460	502	177	261	5053	288
"EVI2B"	2071	10344	1662	681	964	698	375	306	46	226	729	262	10295	174	412	273	389	304
"EVI5"	7453	283708	23342	14589	13299	10043	8001	6588	12756	7764	7996	11756	1688	2001	1400	900	1367	793
"EVI5L"	3831	34702	368	0	216	152	0	0	548	222	502	8	446	363	563	461	825	593
"EVL"	3715	120737	52797	19907	29169	23628	10465	9442	14487	5977	27048	10253	14044	13825	17244	13001	15320	9322
"EVPL"	7043	20582	1	1	1	0	1	0	79	27	0	0	0	2	0	0	0	0
"EVPLL"	2000	11881	2	0	2	0	0	0	11	0	0	1	0	0	0	0	0	0
"EVX1"	1861	4030	0	0	0	0	0	0	0	0	0	0	0	0	0	0	0	0
"EVX2"	1618	3855	0	0	0	0	0	0	0	0	0	0	0	0	0	0	0	0
"EWS-ATF1"	2089	56645	648	75	311	337	25	50	425	53	9	239	800	545	851	611	1000	602
"EWSR1"	3954	11014	5865	6938	3262	2603	3679	3259	2260	3118	2861	5525	3430	4608	5877	6703	6998	4866
"EXD1"	3199	47964	0	0	0	0	0	0	0	0	0	0	0	0	0	0	0	0
"EXD2"	3535	50590	38	0	26	12	0	0	28	0	0	0	346	351	222	143	453	189
"EXD3"	2903	116368	151	0	102	49	0	0	706	183	0	0	70	38	78	72	190	92
"EXLM1"	1524	10619	2401	4365	1169	1232	2372	1993	938	1847	812	2351	647	1066	791	716	1079	684
"EXO1"	3242	41514	0	0	0	0	0	0	0	0	0	0	0	0	3	0	0	8
"EXOC1"	3601	51430	1749	761	944	805	426	335	1339	411	278	437	1846	1740	2164	1653	2060	1331
"EXOC2"	4633	207972	17226	6119	9649	7577	3266	2853	7828	2931	4911	4009	3016	3467	2743	1578	2559	2463
"EXOC3"	2773	24075	2744	1023	1478	1266	578	445	1113	684	918	627	1413	1282	1774	1320	2616	1517
"EXOC3L"	4303	10776	164	50	74	90	26	24	129	136	119	43	140	165	210	174	476	138
"EXOC3L2"	1729	21592	0	0	0	0	0	0	45	15	0	0	0	3	0	0	0	0
"EXOC4"	4208	812690	20318	17742	11350	8968	9917	7825	14256	13352	2576	11268	1538	1910	2482	2266	2331	2071
"EXOC5"	8527	66423	1696	273	981	715	168	105	899	186	34	210	2356	2550	3325	2665	3596	1940
"EXOC6"	3767	228317	2392	508	1497	895	266	242	1861	538	244	397	878	1014	895	675	804	583
"EXOC6B"	5820	364574	527	401	290	237	213	188	807	638	34	190	123	192	125	119	156	69
"EXOC7"	4965	22783	1640	981	947	693	476	505	891	450	1789	1321	2713	2804	1682	3248	4825	1394
"EXOC8"	5097	5097	403	49	228	175	39	10	287	92	57	34	1153	1394	1193	1158	1291	800
"EXOD1"	3432	10135	56	46	32	24	23	23	66	9	0	14	365	434	407	278	490	242
"EXOG"	3316	30035	484	89	294	190	65	24	336	79	68	50	295	339	192	196	234	83
"EXOSC1"	1157	10103	245	0	140	105	0	0	151	21	0	0	449	329	189	252	527	271
"EXOSC10"	2830	33262	809	220	427	382	150	70	440	286	156	204	1453	1315	1388	1090	1714	1109
"EXOSC2"	2708	11296	155	30	95	60	14	16	154	64	209	16	509	391	382	248	446	259
"EXOSC3"	1585	5120	68	126	32	36	73	53	197	63	35	35	408	95	231	212	91	213
"EXOSC4"	897	2030	24	0	22	2	0	0	74	12	0	0	381	205	384	264	477	279
"EXOSC5"	997	10980	143	0	94	49	0	0	166	47	0	0	277	119	273	153	371	174
"EXOSC6"	1701	1701	0	22	0	0	22	0	16	14	0	0	565	845	180	179	196	147
"EXOSC7"	1585	37410	270	2	170	100	0	2	307	124	75	20	267	174	378	344	433	327
"EXOSC8"	1420	9073	160	39	80	80	30	9	155	28	0	0	507	210	516	325	581	336
"EXOSC9"	1663	15429	161	83	76	85	43	40	116	91	51	96	441	825	336	344	531	403
"EXPH5"	10192	88217	0	21	0	0	11	10	0	0	0	0	0	0	0	0	0	0
"EXT1"	3374	312458	45971	125873	25499	20472	67797	58076	19347	75751	17685	55448	984	949	983	1102	1154	883
"EXT2"	3802	149882	2002	789	1103	899	509	280	1655	792	191	298	1327	1398	1763	1503	2347	1505
"EXTL1"	4023	14683	0	0	0	0	0	0	116	11	0	0	0	7	12	12	19	7
"EXTL2"	2988	22479	16	68	16	0	29	39	63	92	0	92	157	88	221	270	155	151
"EXTL3"	6179	52051	224	0	143	81	0	0	180	13	33	24	1043	920	1042	712	1562	822
"EYA1"	4342	164799	0	0	0	0	0	0	0	0	0	0	0	0	0	0	0	0
"EYA2"	2754	210618	0	0	0	0	0	0	9	13	0	0	0	0	0	0	0	0
"EYA3"	2063	114314	4266	4435	2433	1833	2334	2101	2169	2820	1548	9864	280	483	324	295	362	240
"EYA4"	5712	290764	0	0	0	0	0	0	0	0	0	0	0	0	0	0	0	0
"EYS"	10632	1987244	2710	802	1553	1157	439	363	1345	123	226	186	144	107	576	216	689	438
"EZH1"	4666	44779	744	394	401	343	225	169	413	174	372	301	663	691	1021	369	1190	738
"EZH2"	2705	76941	7627	47186	4077	3550	25545	21641	1492	21132	662	34275	399	4176	599	2279	767	1276
"EZR"	3161	52568	2626	1333	1392	1234	735	598	1123	969	561	2751	2920	3716	1839	945	4423	1040
"Elk1"	2044	15084	76	65	48	28	50	15	140	80	0	196	875	880	503	1243	705	1011
"Em:AC004997.11"	556	556	0	0	0	0	0	0	0	15	0	0	0	0	0	0	0	0
"Em:AC005003.4"	1632	1632	16	0	0	16	0	0	13	0	0	0	15	0	22	0	0	0
"Em:AC006547.7"	2207	2207	0	0	0	0	0	0	24	0	0	0	0	0	0	0	0	0
"Em:AC008101.5"	719	719	48	0	21	27	0	0	37	30	0	41	107	85	139	103	151	62
"Em:U51561.2"	1930	1930	4289	5919	4274	15	1694	4225	1171	1172	1776	2748	0	0	0	0	0	0
"Em:U62317.15"	627	900	1	0	1	0	0	0	0	0	0	0	1	837	347	5	0	7
"EphB1"	1629	337633	55	25	28	27	15	10	103	39	0	26	0	0	4	0	7	0
"F10"	1542	26730	408	102	252	156	59	43	408	433	323	485	578	392	456	484	691	495
"F11"	3293	23719	0	0	0	0	0	0	0	0	0	0	0	0	0	0	0	0
"F11R"	4894	43774	393	0	315	78	0	0	282	60	75	20	1628	1542	909	816	2051	1299
"F12"	2067	7438	1	0	0	1	0	0	31	37	0	0	0	0	0	0	0	0
"F13A1"	3877	176614	77069	34806	43011	34058	18980	15826	59276	25648	61990	31324	59158	138758	158184	87340	161533	96834
"F13B"	2229	28078	0	0	0	0	0	0	0	0	0	0	0	0	0	0	0	0
"F2"	2023	20314	0	0	0	0	0	0	28	0	0	0	5	6	0	0	0	0
"F2R"	3811	19728	0	0	0	0	0	0	0	0	0	0	0	62	0	0	25	0
"F2RL1"	2884	16308	0	0	0	0	0	0	12	0	0	0	0	0	0	0	0	0
"F2RL2"	3411	7934	0	0	0	0	0	0	43	19	0	0	0	0	0	0	0	0
"F2RL3"	2731	3004	0	0	0	0	0	0	0	0	0	0	0	0	0	0	0	0
"F3"	2573	11892	278	4126	134	144	2198	1928	9	2663	0	5687	235	11764	171	23840	171	10293
"F379"	1132	1471	0	0	0	0	0	0	0	0	0	0	0	0	0	0	0	0
"F5"	9204	74579	0	0	0	0	0	0	0	0	0	0	0	2	0	0	0	0
"F7"	3133	14891	0	0	0	0	0	0	29	40	0	30	0	0	0	0	0	0
"F8"	9055	186930	0	0	0	0	0	0	50	0	0	0	636	389	1657	1343	2008	1130
"F8A3"	1702	1702	0	0	0	0	0	0	21	0	0	0	482	340	1501	1201	1813	1056
"F9"	2810	32724	0	0	0	0	0	0	0	0	0	0	0	0	0	0	0	0
"FA2H"	2424	61865	2171	43	1248	923	30	13	1294	272	596	0	215	137	418	333	513	551
"FAAH"	2172	61865	2291	43	1316	975	30	13	1511	435	614	8	315	237	494	404	689	643
"FAAH2"	2021	202519	0	0	0	0	0	0	0	0	0	0	584	810	0	0	0	0
"FABP1"	1850	5039	0	0	0	0	0	0	0	0	0	0	0	0	0	0	0	0
"FABP12"	487	6269	0	0	0	0	0	0	0	0	0	0	0	0	0	0	0	0
"FABP2"	2252	4912	0	0	0	0	0	0	0	0	0	0	0	0	0	0	0	0
"FABP3"	1101	7825	461	2449	221	240	1312	1137	300	756	16	1200	501	921	2839	4469	3369	3713
"FABP4"	842	4743	52	0	44	8	0	0	30	0	0	0	626	430	1251	1838	745	1184
"FABP5"	664	4225	756	250	420	336	146	104	560	480	516	574	362	366	11343	9511	8356	8193
"FABP5L3"	855	6120	0	0	0	0	0	0	0	0	0	0	0	0	0	0	0	0
"FABP6"	750	51357	0	0	0	0	0	0	15	0	0	0	0	0	0	0	0	0
"FABP7"	2343	3393	0	0	0	0	0	0	0	0	0	0	0	0	0	0	0	0
"FABP9"	402	3141	0	0	0	0	0	0	0	0	0	0	0	0	0	0	0	0
"FACL5"	2639	18874	610	1207	293	317	733	474	319	1313	120	3868	1479	2071	1600	2181	1939	1752
"FADD"	1855	4241	93	0	49	44	0	0	48	0	0	0	833	221	824	260	1136	381
"FADS1"	4426	17428	2466	754	1369	1097	309	445	864	752	1484	904	2499	10089	5218	5834	6678	5114
"FADS2"	3161	39114	5654	2579	3227	2427	1386	1193	2470	2282	2984	3004	9681	8607	6830	5655	12001	8688
"FADS3"	1790	18009	82	44	59	23	23	21	244	124	31	30	315	361	293	266	546	349
"FADS6"	2058	16234	0	0	0	0	0	0	135	55	1	0	0	0	0	0	0	0
"FAF1"	2602	519003	6693	3499	3839	2854	1926	1573	4888	2712	695	2404	380	622	759	643	521	603
"FAF2"	4525	61720	1429	1245	765	664	757	488	730	584	309	1815	1707	1894	2034	1593	2131	1410
"FAH"	3432	30391	0	0	0	0	0	0	88	26	0	0	213	177	345	316	263	198
"FAHD1"	1703	12978	58	0	20	38	0	0	40	0	0	0	643	494	577	442	745	418
"FAHD2A"	1432	10432	74	76	43	31	64	12	120	253	39	169	220	323	337	374	427	462
"FAHD2B"	1272	11260	0	0	0	0	0	0	0	9	0	0	0	0	44	117	127	49
"FAIM"	3072	22441	0	0	0	0	0	0	0	16	0	16	73	55	111	126	89	86
"FAIM2"	5608	35484	526	0	259	267	0	0	889	209	789	42	2276	2089	1131	1028	3179	2157
"FAIM3"	3091	18747	0	0	0	0	0	0	31	31	0	0	116	124	317	345	183	170
"FAM100A"	1416	6045	210	150	153	57	70	80	263	139	862	414	692	348	942	466	1411	602
"FAM100B"	1592	6095	290	406	137	153	223	183	116	118	0	532	696	874	682	954	930	917
"FAM101A"	2151	26860	11	2	4	7	0	2	159	54	2	0	2	0	0	0	0	0
"FAM101B"	3619	5959	0	0	0	0	0	0	13	13	0	0	378	0	447	592	304	212
"FAM102A"	4387	7346	376	31	235	141	19	12	567	199	315	76	582	422	616	490	735	592
"FAM102B"	5350	78979	4469	429	2540	1929	227	202	2379	134	458	191	2812	2834	2351	1574	3106	1709
"FAM103A1"	1150	4430	0	0	0	0	0	0	12	0	0	0	24	35	614	470	625	516
"FAM104A"	2891	25042	860	94	411	449	46	48	547	41	217	123	1152	861	1035	607	1199	700
"FAM104B"	1102	15822	0	0	0	0	0	0	0	0	0	0	98	108	85	62	99	66
"FAM105A"	7054	34396	7000	915	3892	3108	544	371	2784	312	2573	102	2035	1631	2199	1229	3408	1593
"FAM105B"	7902	35060	3532	1950	1912	1620	1146	804	1629	1206	1064	1675	1597	1437	1746	1220	2068	1065
"FAM106A"	2282	2282	12	11	0	12	11	0	0	0	0	0	8	0	0	0	0	0
"FAM107A"	3617	63492	0	0	0	0	0	0	101	0	0	0	0	0	0	0	0	0
"FAM107B"	3857	256339	2553	8852	1438	1115	4885	3967	825	4936	0	5188	543	766	772	1087	898	766
"FAM108A1"	1721	8544	782	249	410	372	110	139	323	210	702	479	747	562	2373	1590	1614	1657
"FAM108A6"	1525	3758	174	10	81	93	0	10	111	95	99	108	608	486	1419	1043	456	990
"FAM108B1"	3108	46082	529	94	288	241	63	31	401	46	0	21	515	227	468	161	573	172
"FAM108C1"	2361	60310	0	0	0	0	0	0	0	0	0	0	33	34	13	0	44	0
"FAM109A"	3141	8442	1000	13	600	400	0	13	417	50	848	19	1845	942	1908	773	2708	1238
"FAM109B"	2334	5188	26	0	0	26	0	0	82	11	0	0	308	131	254	54	453	117
"FAM110A"	1813	12568	1024	524	528	496	274	250	438	536	802	1848	645	755	508	607	965	701
"FAM110B"	4373	155166	462	173	199	263	107	66	769	261	0	98	304	236	591	510	357	423
"FAM110C"	967	4778	0	0	0	0	0	0	0	0	0	0	0	0	0	0	0	0
"FAM111A"	6094	12193	1334	619	742	592	335	284	646	366	500	136	1214	1888	1719	1173	2039	874
"FAM111B"	3563	20230	0	0	0	0	0	0	0	0	0	0	0	0	0	0	0	0
"FAM113A"	2115	5363	613	272	319	294	152	120	301	207	434	251	716	580	614	996	1671	977
"FAM113B"	2330	157057	10	26	0	10	12	14	42	10	0	12	81	85	27	11	159	42
"FAM114A1"	2129	75989	0	0	0	0	0	0	10	7	0	0	41	33	51	22	28	20
"FAM114A2"	3385	47157	72	18	17	55	7	11	114	4	14	0	360	341	439	310	214	245
"FAM115A"	4092	49172	143	0	95	48	0	0	179	0	0	0	102	310	595	451	602	269
"FAM115C"	5198	14541	0	0	0	0	0	0	0	0	0	0	11	0	200	50	199	26
"FAM116A"	4677	67636	2034	171	1209	825	115	56	1062	46	360	101	925	920	851	546	742	475
"FAM116B"	2026	15099	28	7	16	12	0	7	82	113	6	0	94	86	114	84	181	97
"FAM117A"	2367	53831	260	52	153	107	30	22	712	154	93	159	310	259	494	441	216	187
"FAM117B"	5780	134580	28	17	11	17	8	9	433	0	0	3	310	301	389	174	636	485
"FAM118A"	3248	32755	1673	110	924	749	65	45	1118	568	3692	1789	662	342	637	266	912	328
"FAM118B"	1894	50923	1537	480	984	553	241	239	1074	962	269	1131	4703	5268	465	2745	704	398
"FAM119A"	4809	16136	2069	2726	1138	931	1521	1205	1063	1438	463	1877	1848	2749	1627	2201	1906	1531
"FAM119B"	2843	9942	145	191	82	63	65	126	128	271	109	192	234	319	292	256	377	327
"FAM11A"	2197	35203	279	0	112	167	0	0	206	0	11	0	135	104	460	108	628	355
"FAM120A"	4974	114225	7714	1577	4155	3559	878	699	4159	1546	2959	1902	5564	5557	6227	5542	7925	4651
"FAM120AOS"	2767	7093	389	273	227	162	160	113	298	207	350	285	581	1334	700	589	839	501
"FAM120B"	3249	98394	9546	4375	5381	4165	2347	2028	4784	2953	3383	4363	1184	1371	1166	948	1569	868
"FAM120C"	8097	114957	421	46	228	193	16	30	354	23	141	44	412	325	396	225	309	172
"FAM122A"	3647	3647	34	19	18	16	8	11	34	0	0	0	665	518	843	406	947	514
"FAM122B"	3747	27115	769	134	434	335	94	40	408	62	384	156	872	901	724	569	1003	504
"FAM122C"	2281	47397	171	0	87	84	0	0	49	28	131	63	191	155	23	48	25	19
"FAM123A"	3186	3186	0	0	0	0	0	0	0	0	0	0	0	0	0	0	0	0
"FAM123B"	8444	20628	201	0	134	67	0	0	205	50	0	0	313	320	475	286	496	186
"FAM123C"	6254	12632	0	0	0	0	0	0	11	12	0	0	0	0	0	0	0	0
"FAM124A"	2346	31210	0	0	0	0	0	0	38	0	0	0	0	0	0	0	0	0
"FAM124B"	2596	23297	0	0	0	0	0	0	0	0	0	0	0	0	0	0	2	5
"FAM125A"	1307	3428	129	0	50	79	0	0	118	80	74	0	284	231	267	244	460	267
"FAM125B"	4828	180193	6039	2205	3277	2762	1121	1084	6516	2810	1553	3286	1051	1004	1007	673	1764	864
"FAM126A"	6370	72885	13054	5142	7094	5960	2830	2312	7841	1815	13262	3060	5482	4321	9057	5030	2435	5049
"FAM126B"	9570	97952	1258	484	732	526	220	264	1057	435	191	408	1003	1008	999	727	3316	566
"FAM127A"	1237	1237	51	12	23	28	0	12	38	14	0	0	868	756	1177	1109	1348	1088
"FAM127B"	1256	1256	20	0	20	0	0	0	0	0	0	0	202	69	336	235	337	58
"FAM127C"	2034	2034	0	0	0	0	0	0	0	0	0	0	23	47	91	89	268	167
"FAM128A"	695	8532	0	9	0	0	9	0	106	34	0	0	87	63	37	32	73	51
"FAM128B"	733	8598	72	0	49	23	0	0	65	38	0	0	477	325	556	487	867	224
"FAM129A"	6939	183517	24657	133691	13895	10762	72368	61323	7055	56984	5494	84086	11442	2984	5466	4693	9592	5687
"FAM129B"	4504	63733	23098	11185	12684	10414	5953	5232	8379	7416	22090	23226	17250	15638	18937	14767	27667	18495
"FAM129C"	2523	30539	2	1	2	0	1	0	99	43	0	14	18	21	9	0	22	12
"FAM12A"	880	2441	0	0	0	0	0	0	0	0	0	0	0	0	0	0	0	0
"FAM12B"	896	2521	0	0	0	0	0	0	0	0	0	0	0	0	0	0	0	0
"FAM131A"	3679	5806	728	336	370	358	184	152	327	279	427	597	924	305	911	864	1345	823
"FAM131B"	5860	8400	17	0	13	4	0	0	74	19	0	0	192	96	175	97	298	182
"FAM131C"	1707	15864	0	0	0	0	0	0	293	141	0	0	0	0	0	0	0	0
"FAM132A"	1044	4271	1	0	1	0	0	0	0	20	0	0	0	0	0	0	0	0
"FAM132B"	2283	4882	1	0	1	0	0	0	35	12	0	0	0	0	4	0	0	0
"FAM133A"	3160	38058	0	0	0	0	0	0	0	0	0	0	0	0	0	0	0	0
"FAM133B"	2478	29634	848	751	530	318	422	329	423	446	205	486	267	438	619	561	607	481
"FAM134A"	4616	7253	638	121	318	320	53	68	287	84	442	33	4378	2998	3978	2331	5851	3067
"FAM134B"	3243	143972	0	30	0	0	18	12	0	114	0	16	0	0	0	5	0	0
"FAM134C"	3819	29921	846	238	472	374	122	116	702	160	226	312	1813	1158	1755	872	2301	1093
"FAM135A"	5952	134735	577	36	326	251	20	16	670	105	34	75	311	403	382	396	394	260
"FAM135B"	7047	347433	0	0	0	0	0	0	34	0	0	0	0	0	0	0	0	0
"FAM136A"	1809	6113	78	22	55	23	0	22	50	30	0	11	812	780	955	701	1011	621
"FAM136B"	416	416	0	0	0	0	0	0	0	0	0	0	0	0	0	0	0	0
"FAM138E"	1132	1471	0	0	0	0	0	0	0	0	0	0	0	0	0	0	0	0
"FAM13A"	5882	331219	4433	1134	2561	1872	644	490	2057	385	459	384	62	279	522	264	473	302
"FAM13AOS"	3872	8390	5091	3585	2714	2377	1927	1658	2042	1290	2561	2130	1627	1984	725	262	876	349
"FAM13B"	5577	95162	13948	3790	7799	6149	2038	1752	4638	1754	5872	3187	3539	4421	2427	3376	3723	1344
"FAM13C"	3562	116773	0	0	0	0	0	0	0	0	0	0	0	0	0	0	0	0
"FAM149A"	2717	27823	1	0	0	1	0	0	128	55	0	0	0	0	0	0	0	0
"FAM149B1"	3145	74063	215	20	98	117	0	20	309	103	0	13	400	402	549	382	649	372
"FAM150A"	1175	31425	0	0	0	0	0	0	0	0	0	0	0	0	0	0	0	0
"FAM150B"	1402	8747	40	0	22	18	0	0	10	11	0	0	0	0	0	0	0	0
"FAM151A"	1988	14351	25	0	25	0	0	0	135	0	0	0	88	55	67	59	83	79
"FAM151B"	1535	54408	612	1245	393	219	656	589	113	73	73	152	59	113	31	18	57	33
"FAM152A"	3995	55982	1263	537	810	453	297	240	703	414	148	481	1230	1318	1145	947	1231	772
"FAM153A"	4398	69270	0	0	0	0	0	0	0	0	0	0	0	0	0	0	0	0
"FAM153B"	2115	31548	0	0	0	0	0	0	0	0	0	0	0	0	0	0	0	0
"FAM153C"	1816	38969	0	0	0	0	0	0	0	9	0	0	0	0	0	0	0	0
"FAM154A"	1864	105293	0	0	0	0	0	0	0	0	0	0	170	162	0	0	0	0
"FAM154B"	3131	22115	0	0	0	0	0	0	0	0	0	0	0	0	0	0	0	0
"FAM155A"	3861	698582	0	0	0	0	0	0	8	9	0	0	0	0	0	0	0	0
"FAM155B"	4020	27273	0	0	0	0	0	0	36	9	0	0	0	0	0	0	0	0
"FAM156A"	2641	32105	210	52	103	107	31	21	86	31	0	0	55	28	1540	800	2178	983
"FAM156B"	2024	9500	0	0	0	0	0	0	0	0	0	0	0	0	1540	467	2173	980
"FAM157A"	1507	40713	0	0	0	0	0	0	0	0	0	0	0	0	189	219	229	79
"FAM157B"	1285	27537	0	0	0	0	0	0	0	0	0	0	0	0	171	92	64	17
"FAM158A"	840	2624	28	0	18	10	0	0	18	81	0	0	1167	67	587	796	711	734
"FAM159A"	1423	35729	0	0	0	0	0	0	13	0	0	0	0	0	3	0	3	0
"FAM160A1"	4590	254388	0	0	0	0	0	0	28	11	0	0	1	0	0	0	0	0
"FAM160A2"	3503	23378	848	90	522	326	55	35	449	286	444	265	480	787	901	558	1070	538
"FAM160B1"	5823	42971	210	0	122	88	0	0	275	9	22	30	985	850	1209	600	1158	644
"FAM160B2"	3748	15178	702	100	428	274	54	46	452	160	383	63	826	686	1112	842	1525	920
"FAM161A"	3865	29295	0	0	0	0	0	0	0	0	0	0	0	0	0	0	3	0
"FAM161B"	2313	16132	0	0	0	0	0	0	17	0	0	31	0	2	9	3	11	5
"FAM162A"	1041	23790	389	113	191	198	58	55	328	57	0	21	738	523	624	564	969	652
"FAM162B"	1040	13528	0	0	0	0	0	0	0	0	0	0	0	0	0	0	0	0
"FAM163A"	3091	73030	0	0	0	0	0	0	20	12	0	0	0	0	0	0	0	0
"FAM163B"	502	1202	0	0	0	0	0	0	36	18	0	0	0	0	0	0	0	0
"FAM164A"	3356	53715	106	17	48	58	0	17	210	29	10	0	109	97	96	70	165	39
"FAM164B"	1082	73910	0	0	0	0	0	0	0	0	0	0	0	0	0	0	0	0
"FAM164C"	2078	8501	14	0	14	0	0	0	36	0	12	0	0	0	0	0	5	0
"FAM165B"	894	13695	11	0	0	11	0	0	19	0	33	0	142	134	95	69	117	86
"FAM166A"	1131	4187	130	48	59	71	22	26	181	176	80	0	3762	4263	4599	5463	6513	5293
"FAM166B"	964	1953	0	0	0	0	0	0	0	0	0	0	0	0	0	0	0	0
"FAM167A"	4177	23907	0	0	0	0	0	0	208	69	0	0	0	0	0	0	0	0
"FAM167B"	956	1643	0	0	0	0	0	0	0	0	0	0	0	0	0	0	0	0
"FAM168A"	1803	192202	22074	4363	12168	9906	2311	2052	5324	342	5791	4268	2464	3294	1006	1564	1082	1180
"FAM168B"	5412	45556	4076	2673	2297	1779	1520	1153	1349	1251	1963	3107	4650	4653	5100	4092	6232	3673
"FAM169A"	6003	118389	0	0	0	0	0	0	0	0	0	0	0	129	0	3	0	0
"FAM169B"	3305	77222	0	0	0	0	0	0	20	0	0	0	0	0	0	0	0	0
"FAM170A"	1379	6264	0	0	0	0	0	0	0	0	0	0	0	0	0	0	0	0
"FAM170B"	1411	2864	0	0	0	0	0	0	0	0	0	0	0	0	0	0	0	0
"FAM171A1"	3955	159413	0	0	0	0	0	0	14	24	0	0	0	0	0	0	0	0
"FAM171A2"	2642	10136	0	1	0	0	1	0	30	0	0	0	3	5	0	0	0	0
"FAM171B"	4130	4130	40	11	21	19	5	6	0	0	0	27	319	387	174	113	67	8
"FAM172A"	4730	493974	9781	6167	5674	4107	3468	2699	7148	5180	1276	5194	2946	3450	1582	1448	1801	1515
"FAM172B"	2297	5022	0	0	0	0	0	0	0	0	0	0	0	0	0	0	0	0
"FAM173A"	862	1433	54	0	35	19	0	0	25	5	0	0	312	240	262	222	522	263
"FAM173B"	1944	23578	770	36	389	381	0	36	338	42	375	42	111	422	108	97	146	243
"FAM174A"	1239	51318	30	0	17	13	0	0	52	0	0	0	192	191	196	189	220	187
"FAM174B"	2630	38352	0	0	0	0	0	0	10	9	0	0	0	213	0	1	1	0
"FAM175A"	3036	8962	195	0	134	61	0	0	35	0	78	18	285	259	373	211	344	238
"FAM175B"	3000	34886	714	232	429	285	153	79	376	141	125	238	1283	941	993	733	1312	766
"FAM176A"	1927	68965	0	0	0	0	0	0	0	0	0	0	0	0	0	0	0	0
"FAM176B"	1057	2125	0	0	0	0	0	0	0	0	0	0	49	11	80	35	392	168
"FAM177A1"	3261	38476	179	166	113	66	152	14	213	314	0	196	422	856	479	575	623	532
"FAM177B"	1854	13445	0	0	0	0	0	0	0	0	0	0	0	0	0	0	0	0
"FAM178A"	7304	52565	3339	743	1926	1413	402	341	1618	198	985	186	2387	1649	2527	1119	2963	1206
"FAM178B"	2701	110683	0	0	0	0	0	0	442	141	0	0	0	0	0	0	0	0
"FAM179A"	3566	70932	25	0	13	12	0	0	244	156	59	0	0	14	45	17	22	9
"FAM179B"	6420	112219	274	22	109	165	22	0	341	43	73	50	324	386	431	289	491	249
"FAM180A"	1804	19249	1	0	1	0	0	0	0	0	0	0	0	0	0	0	0	0
"FAM180B"	1391	2503	0	0	0	0	0	0	0	0	0	0	0	0	0	0	0	0
"FAM181A"	1809	10688	0	0	0	0	0	0	0	0	0	0	0	0	0	0	0	0
"FAM181B"	1855	1855	0	0	0	0	0	0	0	0	0	0	0	0	0	0	0	0
"FAM182A"	5115	32304	0	0	0	0	0	0	0	0	0	0	0	0	0	0	0	0
"FAM182B"	5484	31694	0	0	0	0	0	0	80	26	0	0	0	0	13	7	33	20
"FAM183A"	518	8472	0	0	0	0	0	0	0	0	0	0	0	0	0	0	0	0
"FAM183B"	1648	1744	0	0	0	0	0	0	0	0	0	0	0	0	0	0	0	0
"FAM184A"	4059	118816	0	0	0	0	0	0	0	0	0	0	1	1	0	0	0	0
"FAM184B"	3858	149426	558	266	290	268	141	125	297	403	142	311	229	1767	88	31	247	35
"FAM185A"	2265	60274	176	10	113	63	0	10	306	56	0	18	80	67	96	62	104	36
"FAM186A"	7484	30020	0	0	0	0	0	0	24	0	0	0	0	0	0	0	0	0
"FAM186B"	3105	22753	57	2091	38	19	1236	855	114	979	0	532	0	72	0	6	0	0
"FAM187B"	1181	3926	0	0	0	0	0	0	0	0	0	0	0	0	0	0	0	0
"FAM188A"	2390	82346	1609	824	919	690	512	312	1281	734	84	429	330	599	523	584	602	370
"FAM188B"	3204	140252	0	0	0	0	0	0	409	226	0	0	0	0	3	5	0	0
"FAM189A1"	4718	450474	0	0	0	0	0	0	137	66	0	0	526	374	505	307	538	295
"FAM189A2"	2434	63131	29	0	18	11	0	0	116	0	0	0	113	105	84	74	148	49
"FAM189B"	3201	8279	23	0	11	12	0	0	72	44	0	0	461	233	307	235	499	335
"FAM18A"	3798	52090	2012	448	1110	902	251	197	1824	502	2909	1247	910	769	687	565	1093	619
"FAM18B"	1796	25446	163	44	129	34	20	24	137	48	13	107	440	499	841	636	873	584
"FAM18B2"	4233	26653	1303	330	763	540	191	139	993	468	102	470	22	61	274	211	302	127
"FAM190A"	6215	1474687	8168	4265	4660	3508	2292	1973	6236	3661	20	278	19570	21618	52047	47865	62540	48194
"FAM190B"	7687	189868	9046	22307	5036	4010	11866	10441	3197	9394	575	13202	2126	2694	1620	1441	1920	1233
"FAM192A"	2901	33596	4220	2642	2359	1861	1392	1250	2024	1258	2303	2315	2555	2480	1572	1256	3132	2106
"FAM193A"	5002	136475	7715	5439	4336	3379	2795	2644	3405	2750	3593	6026	1042	1019	877	858	1191	745
"FAM193B"	4363	34749	2570	327	1452	1118	208	119	1528	615	1974	621	624	421	936	581	1460	678
"FAM194A"	2065	44067	0	0	0	0	0	0	0	0	0	0	0	0	0	0	0	0
"FAM194B"	2436	74444	0	0	0	0	0	0	0	0	0	0	0	0	0	0	0	0
"FAM195A"	915	6627	532	317	289	243	147	170	287	274	339	898	551	432	937	1224	1025	976
"FAM195B"	1231	10876	305	59	185	120	33	26	209	171	38	138	438	325	354	903	856	598
"FAM196A"	4413	60734	8039	7957	4429	3610	4392	3565	3687	3465	1575	4177	0	0	0	0	0	0
"FAM196B"	3552	117027	37936	37002	21227	16709	19948	17054	15144	16341	20308	26762	106	157	13	11	1	5
"FAM19A1"	1918	539398	0	0	0	0	0	0	0	0	0	0	133	136	0	0	0	0
"FAM19A2"	4058	484510	45	0	16	29	0	0	60	0	0	9	0	0	5	0	5	0
"FAM19A3"	1136	6667	0	0	0	0	0	0	11	12	0	0	38	41	85	64	75	49
"FAM19A4"	2239	200796	0	0	0	0	0	0	0	0	0	0	0	0	0	0	0	0
"FAM19A5"	2640	175626	0	0	0	0	0	0	1754	718	0	0	0	0	0	0	0	0
"FAM20A"	4512	65839	2120	240	1169	951	168	72	2215	147	1484	276	679	317	1788	1538	1151	948
"FAM20B"	5953	50629	1029	1775	610	419	938	837	482	604	98	211	1383	1585	1338	1100	1313	860
"FAM20C"	2761	107744	5740	238	3168	2572	120	118	3200	1120	8817	633	1355	999	4486	3801	3182	2812
"FAM21A"	4702	65586	80	8	42	38	4	4	55	10	8	47	310	363	278	195	288	177
"FAM21B"	4354	55395	64	122	32	32	72	50	87	3	8	31	363	384	5002	4086	4664	3180
"FAM21C"	4655	65746	658	290	331	327	155	135	521	131	292	318	802	708	5133	4304	4629	2944
"FAM22A"	3293	9528	34	42	34	0	23	19	43	30	0	39	0	0	20	8	42	12
"FAM22D"	5550	12977	9	0	9	0	0	0	0	0	0	0	41	39	37	28	57	20
"FAM22F"	2568	10450	0	0	0	0	0	0	16	0	0	0	0	0	4	8	11	4
"FAM22G"	4895	13982	349	69	222	127	22	47	266	120	247	150	18	3	11	14	48	9
"FAM23A"	5466	48636	19	0	19	0	0	0	81	3	0	0	846	1175	3271	2537	2999	2051
"FAM24A"	597	2410	0	0	0	0	0	0	0	0	0	0	0	0	0	0	0	0
"FAM24B"	773	30546	94	0	55	39	0	0	207	12	0	0	70	24	47	13	133	15
"FAM25A"	354	4432	0	0	0	0	0	0	8	0	0	0	0	0	0	0	0	0
"FAM25B"	335	4466	0	0	0	0	0	0	0	0	0	0	0	0	0	0	0	0
"FAM26D"	1475	29837	0	0	0	0	0	0	0	0	0	0	0	0	0	0	0	0
"FAM26E"	3540	6902	0	0	0	0	0	0	0	0	0	0	0	0	0	0	0	0
"FAM26F"	1111	2379	0	0	0	0	0	0	0	33	0	16	187	371	81	105	144	77
"FAM27A"	704	1255	0	0	0	0	0	0	10	0	0	0	0	0	0	0	0	0
"FAM27B"	704	1261	0	0	0	0	0	0	16	0	0	0	0	0	0	0	0	0
"FAM27C"	704	1257	0	0	0	0	0	0	0	0	0	0	0	0	0	0	0	0
"FAM27E3"	1403	1577	0	0	0	0	0	0	0	0	0	0	0	0	0	0	0	0
"FAM27L"	615	1135	0	0	0	0	0	0	0	0	0	0	0	0	0	0	0	0
"FAM30A"	9617	14664	0	0	0	0	0	0	368	121	0	16	0	6	3	0	4	0
"FAM32A"	1451	6622	135	26	100	35	11	15	121	123	32	50	2443	2105	2498	1833	3108	2202
"FAM33A"	2798	45494	36	0	19	17	0	0	94	0	0	0	375	423	387	331	513	319
"FAM35A"	3411	96269	2370	1940	1284	1086	1098	842	1212	1078	431	1328	916	1007	2360	2449	2313	1888
"FAM35B"	1749	24558	0	0	0	0	0	0	0	0	0	0	14	0	1044	1199	1278	1151
"FAM35B2"	1754	24579	0	0	0	0	0	0	0	0	0	0	0	0	1236	1340	1059	882
"FAM36A"	2618	9720	1476	2864	319	1157	1566	1298	1195	0	331	1746	0	1655	1710	1115	2110	1063
"FAM38A"	8045	69789	9549	6695	5612	3937	3552	3143	4506	7302	11131	13980	6916	7032	7210	8146	9313	6227
"FAM38B"	2948	31121	0	0	0	0	0	0	0	0	0	0	0	0	0	0	0	0
"FAM3A"	1714	9869	78	0	27	51	0	0	81	37	0	0	188	335	234	284	331	428
"FAM3B"	1392	40995	0	0	0	0	0	0	62	17	0	0	0	0	0	0	3	0
"FAM3C"	2550	47517	714	171	425	289	112	59	543	9	58	45	74	21	271	764	934	715
"FAM3D"	1317	32892	0	0	0	0	0	0	13	0	0	0	0	0	0	0	0	0
"FAM40A"	3559	20185	1007	494	568	439	208	286	498	441	521	650	1245	1217	1523	1134	1854	909
"FAM40B"	5133	53965	0	0	0	0	0	0	13	24	0	0	10	31	45	30	45	21
"FAM41AY1"	2052	15785	0	0	0	0	0	0	0	0	0	0	0	0	0	0	0	0
"FAM41C"	1707	8731	0	0	0	0	0	0	0	0	0	0	0	0	0	0	0	0
"FAM43A"	3144	3144	0	156	0	0	90	66	16	165	0	0	344	2342	412	1032	378	392
"FAM43B"	2582	2582	0	0	0	0	0	0	0	0	0	0	0	0	0	0	0	0
"FAM44C"	1497	1497	0	0	0	0	0	0	0	0	0	0	0	0	0	0	0	0
"FAM45A"	2389	33606	223	13	166	57	0	13	141	0	57	0	657	473	976	686	1135	650
"FAM46A"	5666	6979	505	82	319	186	60	22	281	37	91	0	1890	576	2011	272	1567	323
"FAM46B"	2374	7822	0	0	0	0	0	0	53	12	0	0	0	0	0	0	0	0
"FAM46C"	5721	22408	0	0	0	0	0	0	29	11	0	0	0	95	0	196	0	0
"FAM46D"	3111	109809	0	0	0	0	0	0	0	0	0	0	0	0	0	0	0	0
"FAM47A"	2555	2555	0	0	0	0	0	0	0	0	0	0	0	0	0	0	0	0
"FAM47B"	2105	2105	0	0	0	0	0	0	0	0	0	0	0	0	0	0	0	0
"FAM47C"	3271	3271	0	0	0	0	0	0	0	0	0	0	0	0	0	0	0	0
"FAM47E"	4556	30350	0	0	0	0	0	0	0	0	0	0	49	37	85	36	73	10
"FAM48A"	3102	50399	1436	184	824	612	116	68	963	203	419	110	1394	1304	1348	1021	1686	981
"FAM48B1"	2664	2664	0	0	0	0	0	0	0	0	0	0	0	0	0	0	0	0
"FAM48B2"	2454	2454	0	0	0	0	0	0	0	0	0	0	0	0	0	0	0	0
"FAM49A"	1502	113197	3454	9046	2070	1384	5000	4046	1811	7977	142	5728	272	721	223	414	302	235
"FAM49B"	2209	98284	37800	29117	21205	16595	15907	13210	13689	12889	22966	26328	2842	5887	3933	3486	3978	2722
"FAM4A1"	1033	27258	465	927	279	186	501	426	160	436	18	299	196	246	220	202	253	224
"FAM50A"	1352	6518	426	193	250	176	104	89	133	215	87	224	1130	1340	1526	1535	2022	1388
"FAM50B"	1619	1920	0	0	0	0	0	0	0	0	0	0	118	62	92	31	98	8
"FAM53A"	2631	44111	302	0	182	120	0	0	642	281	220	20	101	45	36	15	169	89
"FAM53B"	5745	125069	15846	2743	8608	7238	1631	1112	7431	2471	10539	3810	2084	1534	2091	1307	2757	1603
"FAM53C"	4422	12194	617	1090	333	284	581	509	308	480	136	909	1424	2134	1320	2260	1949	1550
"FAM54A"	1801	19283	48	21	48	0	21	0	31	61	0	0	42	8	71	4	103	36
"FAM54B"	2541	7311	235	60	130	105	36	24	229	80	59	53	770	855	952	656	1359	735
"FAM55A"	1893	38144	0	0	0	0	0	0	0	0	0	0	0	0	0	0	0	0
"FAM55B"	1784	28454	0	0	0	0	0	0	0	0	0	0	0	0	0	0	0	0
"FAM55C"	8919	48789	220	10861	156	64	5606	5255	232	19534	24	4369	1892	2019	1492	1384	1424	906
"FAM55D"	2168	25172	0	0	0	0	0	0	0	0	0	0	0	36	0	0	0	0
"FAM57A"	2084	10229	18	24	18	0	24	0	0	216	0	35	3	308	19	298	10	85
"FAM57B"	1923	6439	0	0	0	0	0	0	39	25	0	0	0	1	0	0	0	0
"FAM58A"	1290	11249	174	0	66	108	0	0	99	40	0	0	331	214	813	523	623	697
"FAM58B"	1106	11249	174	0	66	108	0	0	99	40	0	0	331	214	813	523	623	697
"FAM59A"	3047	202972	33	19	33	0	0	19	0	32	0	46	1486	1784	5980	6454	7193	5280
"FAM59B"	5144	8930	0	0	0	0	0	0	34	10	0	0	7	23	0	0	4	0
"FAM5B"	3565	110926	0	0	0	0	0	0	14	0	0	0	0	0	0	0	0	0
"FAM5C"	2892	379964	0	0	0	0	0	0	0	0	0	0	0	0	0	0	0	0
"FAM60A"	3156	45634	3126	3637	1769	1357	1904	1733	1382	3614	409	4435	1286	2438	1205	1655	1662	1518
"FAM62C"	2485	38288	0	0	0	0	0	0	67	20	0	0	0	0	3	0	5	0
"FAM63A"	3566	10925	239	24	92	147	15	9	209	13	35	16	871	402	471	333	761	387
"FAM63B"	5000	86341	241	21	107	134	0	21	238	0	0	0	518	395	313	215	261	101
"FAM64A"	1715	6529	0	0	0	0	0	0	52	43	0	0	0	0	0	0	0	0
"FAM65A"	4160	17060	2890	214	1577	1313	107	107	1140	461	3124	724	2012	1456	2297	1660	3280	1753
"FAM65B"	5494	106684	230	100	164	66	69	31	260	60	26	230	431	565	167	170	171	103
"FAM65C"	4301	50779	1783	11214	963	820	7421	3793	580	43684	187	9243	0	1417	0	1451	0	286
"FAM66A"	3095	34722	0	0	0	0	0	0	10	0	0	0	0	0	0	0	0	0
"FAM66C"	3273	20792	5	0	0	5	0	0	89	0	2	0	9	6	0	0	10	0
"FAM66D"	1920	451065	2106	1111	1164	942	628	483	1357	707	782	1124	0	78	13	11	17	7
"FAM66E"	1441	53744	0	0	0	0	0	0	0	0	0	0	0	0	0	0	0	0
"FAM69A"	2621	34433	11049	6989	6224	4825	3776	3213	5456	3013	4179	4657	7672	8877	7010	8038	9707	8427
"FAM69B"	3080	3834	73	12	48	25	12	0	112	80	32	0	7	70	1	0	14	2
"FAM69C"	2045	21541	0	0	0	0	0	0	13	0	0	0	0	0	0	0	0	0
"FAM70A"	3506	52887	118	0	62	56	0	0	59	0	0	0	223	243	139	463	589	419
"FAM70B"	1118	7916	170	1	75	95	1	0	673	185	29	0	93	104	92	76	163	91
"FAM71A"	2300	2300	12	62	12	0	35	27	31	2699	0	110	0	0	0	0	0	0
"FAM71B"	2027	3930	0	0	0	0	0	0	0	0	0	0	0	0	0	0	0	0
"FAM71C"	1794	2291	0	0	0	0	0	0	0	0	0	0	0	0	0	0	0	0
"FAM71D"	1763	39123	0	22	0	0	11	11	9	0	0	14	38	28	0	0	0	0
"FAM71E1"	1294	9958	8	0	0	8	0	0	53	14	0	0	217	163	78	74	97	192
"FAM71E2"	3452	8604	0	0	0	0	0	0	123	78	0	0	1	2	0	0	0	0
"FAM71F1"	1961	22684	0	1	0	0	1	0	10	0	0	0	0	0	0	0	0	0
"FAM71F2"	1588	11955	100	146	46	54	77	69	89	70	0	102	0	18	0	11	8	0
"FAM72A"	1863	16157	0	27	0	0	27	0	0	0	0	0	49	64	26	12	30	10
"FAM72B"	2377	16677	4	0	4	0	0	0	17	0	0	0	36	5	366	198	417	226
"FAM72C"	1850	16270	4	0	4	0	0	0	0	0	0	0	36	5	310	198	417	226
"FAM72D"	2397	16693	1	20	0	1	20	0	7	0	0	0	5	20	212	182	197	145
"FAM73A"	5278	98770	397	10	258	139	10	0	468	5	17	0	648	781	918	763	1304	455
"FAM73B"	3602	35099	403	115	252	151	79	36	492	291	190	119	495	442	746	592	962	654
"FAM74A1"	1792	7042	0	0	0	0	0	0	0	0	0	0	0	0	0	0	0	0
"FAM74A3"	1885	7157	0	0	0	0	0	0	0	0	0	0	0	0	0	0	0	0
"FAM74A4"	1947	7115	0	0	0	0	0	0	0	0	0	0	0	0	0	0	0	0
"FAM75A2"	4228	6260	0	0	0	0	0	0	0	0	0	0	0	0	0	0	0	0
"FAM75A3"	4226	6247	0	0	0	0	0	0	0	0	0	0	0	0	0	0	0	0
"FAM75A5"	4228	6246	0	0	0	0	0	0	0	0	0	0	0	0	0	0	0	0
"FAM75A6"	4216	6228	0	0	0	0	0	0	0	0	0	0	0	0	0	0	0	0
"FAM75A7"	4229	6248	0	0	0	0	0	0	0	0	0	0	0	0	0	0	0	0
"FAM75B"	771	1346	0	0	0	0	0	0	0	0	0	0	0	0	0	0	0	0
"FAM75C1"	4481	9165	0	0	0	0	0	0	0	18	0	0	0	0	0	0	0	0
"FAM76A"	3467	36933	389	0	192	197	0	0	185	17	0	0	450	288	413	136	511	256
"FAM76B"	4020	20850	381	456	227	154	261	195	260	180	42	180	574	635	603	446	607	358
"FAM78A"	3937	18442	1949	180	1058	891	108	72	833	76	1597	32	75	1328	3243	843	5174	1670
"FAM78B"	2175	106563	0	0	0	0	0	0	15	0	0	0	0	0	0	0	0	0
"FAM7A1"	1149	28264	0	0	0	0	0	0	17	0	0	0	13	0	53	32	143	45
"FAM7A3"	1149	28013	0	0	0	0	0	0	0	0	0	0	0	5	43	18	130	26
"FAM81A"	3477	85381	2	2	0	2	0	2	0	0	0	0	0	0	0	0	0	0
"FAM81B"	1621	57648	0	0	0	0	0	0	0	0	0	0	0	0	0	0	0	0
"FAM82A1"	2110	73046	3256	2529	1732	1524	2215	314	355	1422	0	1646	276	36980	264	19702	290	12398
"FAM82A2"	3146	19965	386	0	244	142	0	0	187	56	276	137	411	264	752	679	804	623
"FAM82B"	3073	36432	809	68	391	418	43	25	701	98	48	19	801	515	725	418	911	391
"FAM83A"	4601	29920	0	0	0	0	0	0	30	19	0	0	0	0	0	0	0	0
"FAM83B"	3169	95250	0	0	0	0	0	0	0	0	0	0	0	0	0	0	0	0
"FAM83C"	3171	6940	0	0	0	0	0	0	58	44	0	0	0	0	0	0	0	0
"FAM83D"	4855	19887	0	0	0	0	0	0	8	0	0	0	0	0	0	0	0	0
"FAM83E"	2016	12839	0	0	0	0	0	0	16	23	0	0	1	0	0	0	0	0
"FAM83F"	2076	35092	0	0	0	0	0	0	0	24	0	0	0	0	0	0	0	0
"FAM83G"	2935	33680	88	272	38	50	155	117	339	423	0	307	100	332	92	107	151	329
"FAM83H"	5594	9812	111	23	60	51	20	3	137	21	59	82	443	400	462	324	828	556
"FAM84A"	2588	3593	0	0	0	0	0	0	0	0	0	0	0	0	0	0	0	0
"FAM84B"	5234	5781	0	0	0	0	0	0	9	0	0	0	0	0	0	0	0	0
"FAM86A"	2622	12012	165	0	91	74	0	0	135	56	58	0	571	477	570	454	839	543
"FAM86B1"	2512	13563	0	0	0	0	0	0	111	22	0	0	67	78	122	87	187	101
"FAM86B2"	2547	12012	0	0	0	0	0	0	0	0	0	0	0	0	0	0	0	3
"FAM86C"	2151	13721	10	0	10	0	0	0	41	33	0	0	8	4	69	3	87	46
"FAM86D"	2155	13496	0	0	0	0	0	0	111	22	0	0	67	78	122	87	187	98
"FAM89A"	1534	21293	0	0	0	0	0	0	36	0	0	0	149	128	68	68	6	64
"FAM89B"	1460	1851	225	128	118	107	53	75	36	97	104	163	1893	1608	2216	2231	3060	2635
"FAM8A1"	4749	11433	279	0	146	133	0	0	101	63	0	0	667	659	859	512	902	543
"FAM90A1"	2523	6360	0	0	0	0	0	0	55	0	0	0	56	2	0	0	111	8
"FAM90A7"	3920	26516	0	0	0	0	0	0	0	0	0	0	0	0	0	0	0	0
"FAM91A1"	5353	46808	2150	1054	1206	944	596	458	1557	979	230	1198	2567	3038	3801	3441	3743	2534
"FAM92A1"	1624	4467	2320	154	1579	741	88	66	1580	0	356	48	1297	780	334	213	374	193
"FAM92A3"	2455	2455	0	0	0	0	0	0	0	0	0	0	0	0	0	0	0	0
"FAM92B"	1905	14151	0	0	0	0	0	0	219	12	0	0	0	0	0	0	0	0
"FAM95B1"	4241	7922	0	0	0	0	0	0	97	65	0	0	29	1	2209	1674	1699	1037
"FAM96A"	1751	19691	741	29	383	358	15	14	477	14	281	16	2601	1753	1682	421	2040	444
"FAM96B"	697	2363	68	35	38	30	19	16	49	32	0	38	500	481	891	481	779	645
"FAM98A"	3550	6188	618	534	386	232	162	372	235	254	197	297	942	1019	920	814	975	269
"FAM98B"	1547	30736	495	19	256	239	0	19	208	79	0	49	841	1054	842	657	980	770
"FAM98C"	1283	5955	175	0	125	50	0	0	82	30	126	0	543	514	151	78	152	104
"FAM99B"	1069	2361	0	0	0	0	0	0	0	0	0	0	1	0	0	0	0	0
"FAM9A"	1526	10587	0	0	0	0	0	0	0	0	0	0	0	0	0	0	0	0
"FAM9B"	1651	139610	0	0	0	0	0	0	0	0	0	0	0	0	0	0	0	0
"FAM9C"	3541	9065	0	0	0	0	0	0	0	0	0	0	0	0	0	0	0	0
"FANCA"	5507	79108	1481	796	869	612	423	373	1015	527	1289	805	769	797	1246	1182	1331	865
"FANCB"	3018	29657	0	0	0	0	0	0	9	0	0	0	0	0	0	0	4	3
"FANCC"	4605	218655	453	160	217	236	88	72	433	140	0	87	261	264	167	162	232	113
"FANCD2"	5246	73232	75	94	45	30	63	31	108	82	20	41	356	393	287	259	425	265
"FANCE"	2565	14745	0	0	0	0	0	0	56	0	0	0	54	59	51	26	89	46
"FANCF"	3310	3310	20	0	0	20	0	0	0	0	0	0	333	40	308	0	346	26
"FANCG"	2645	6180	105	0	45	60	0	0	63	22	27	0	131	181	216	112	366	131
"FANCI"	4787	73170	414	328	179	235	178	150	181	35	44	181	444	1024	527	522	674	442
"FANCL"	1744	82137	1701	1277	1040	661	796	481	1206	794	33	793	1143	1297	1072	655	981	677
"FANCM"	7150	64958	121	8	84	37	5	3	113	11	0	0	141	139	168	96	132	99
"FANK1"	7370	98961	0	0	0	0	0	0	58	7	0	0	10	5	0	0	0	0
"FAP"	2805	72846	0	0	0	0	0	0	0	0	0	0	1	1	0	0	0	0
"FAR1"	5285	63687	15476	3588	8694	6782	1959	1629	6500	1325	5677	1917	7667	7520	7990	5097	8069	4085
"FAR2"	2106	110409	129	52	74	55	22	30	211	30	0	24	234	196	847	819	496	526
"FARP1"	4946	306584	1522	2299	845	677	1314	985	540	1232	9	959	436	577	900	1315	767	1106
"FARP2"	4024	138546	2280	369	1276	1004	194	175	1420	559	518	349	1510	1729	1355	1160	2294	1071
"FARS2"	1853	510541	5133	2640	2796	2337	1562	1078	6138	4064	856	2966	191	189	186	167	364	217
"FARSA"	1866	11276	465	19	214	251	9	10	227	142	98	43	1299	1371	1381	1021	1507	1174
"FARSB"	2311	84667	127	56	61	66	28	28	313	77	19	71	337	344	625	535	580	426
"FARSLB"	2447	84667	127	56	61	66	28	28	313	77	19	71	337	344	625	535	580	426
"FAS"	5985	45990	74	0	27	47	0	0	124	27	0	17	500	540	818	916	594	593
"FASLG"	1861	7827	0	0	0	0	0	0	0	0	0	0	0	6	0	0	0	0
"FASN"	8500	19893	2010	837	1066	944	394	443	824	944	679	1156	3636	3673	2388	2274	3540	2466
"FASN variant protein"	2124	3851	594	351	306	288	163	188	259	318	528	534	2855	2690	1063	1252	1727	1136
"FASTK"	2479	4170	487	63	264	223	16	47	217	157	403	217	962	856	1229	1037	1614	1111
"FASTKD1"	3017	44161	1262	135	682	580	37	98	697	100	312	79	1143	1040	1254	859	1362	814
"FASTKD2"	6953	30799	292	86	153	139	69	17	258	202	0	17	687	785	904	730	1005	654
"FASTKD3"	2408	9844	61	33	16	45	14	19	57	12	0	0	80	201	299	141	235	81
"FASTKD5"	2871	13375	687	273	380	307	178	95	403	433	296	649	951	976	852	934	36	774
"FAT1"	14790	136051	0	0	0	0	0	0	12	0	0	0	0	0	0	0	0	0
"FAT2"	14558	64853	129	0	84	45	0	0	227	0	0	0	8	3	2	1	5	0
"FAT3"	19070	544373	0	0	0	0	0	0	22	0	0	0	0	0	0	0	0	0
"FAT4"	16126	176521	0	0	0	0	0	0	16	0	0	0	0	0	0	0	0	0
"FATE1"	1072	7156	0	0	0	0	0	0	0	0	0	0	0	0	0	0	0	0
"FAU"	1127	1220	99	99	33	66	66	33	107	120	0	130	0	1872	2972	4373	3955	4308
"FBF1"	3891	30503	11	1	0	11	0	1	130	47	1	0	67	96	114	85	156	122
"FBI12"	1092	1178	435	3854	240	195	2056	1798	59	2906	0	1513	62	0	174	38	829	0
"FBL"	1437	8150	41	0	20	21	0	0	51	83	0	0	266	354	572	573	678	561
"FBL2"	2394	109185	1995	650	1132	863	358	292	924	341	795	371	2625	2382	2681	2031	3025	1892
"FBL3B"	1748	21189	2	0	2	0	0	0	0	0	0	0	0	0	0	0	0	0
"FBL4"	2439	74250	3887	499	2270	1617	332	167	2282	370	943	267	417	638	587	505	521	428
"FBLIM1"	3503	29932	0	0	0	0	0	0	39	16	0	0	0	0	0	0	0	0
"FBLL1"	1058	1058	0	0	0	0	0	0	0	0	0	0	0	0	0	0	0	0
"FBLN1"	2964	98297	0	0	0	0	0	0	220	101	0	0	0	0	0	0	0	0
"FBLN2"	4598	69683	0	0	0	0	0	0	347	185	0	0	3	0	0	0	3	0
"FBLN5"	2767	78292	0	0	0	0	0	0	12	0	0	0	0	9	0	12	0	0
"FBLN7"	2307	49831	0	0	0	0	0	0	31	9	0	0	0	0	0	5	0	0
"FBN1"	11692	237415	0	0	0	0	0	0	0	0	0	0	0	3	0	0	0	0
"FBN2"	10788	280135	17	0	6	11	0	0	5	0	0	0	112	187	607	661	178	38
"FBN3"	9025	82095	0	0	0	0	0	0	220	107	0	0	0	0	0	0	0	0
"FBP1"	1595	36502	2254	146	1307	947	81	65	1186	59	1622	50	3892	2304	8107	5396	6719	4367
"FBP2"	1309	35072	0	0	0	0	0	0	16	0	0	0	0	0	0	0	0	0
"FBRS"	2900	10889	1812	2752	1015	797	1441	1311	539	1472	1051	4175	2361	3099	2954	6484	3610	4773
"FBRSL1"	4562	94616	12281	8956	6528	5753	4601	4355	4848	6060	11125	13277	1763	1928	2573	2502	3448	2299
"FBW1A"	253	125391	340	0	184	156	0	0	290	10	86	21	33	20	43	20	36	18
"FBW3"	2281	2281	56	8	32	24	0	8	41	13	0	0	0	36	0	0	0	1
"FBX24"	1650	14786	1	1	1	0	1	0	289	298	0	0	6	0	0	0	0	0
"FBX3"	1071	27397	362	66	229	133	45	21	322	46	94	117	460	156	326	192	404	139
"FBXL10"	3368	152020	14630	26165	8201	6429	13626	12539	4543	18156	9629	49211	2626	4020	2174	3812	2674	2781
"FBXL12"	1898	8788	404	407	239	165	227	180	209	258	362	586	885	916	490	563	724	509
"FBXL13"	3136	261709	78	10	45	33	0	10	286	8	0	0	0	10	0	2	6	1
"FBXL14"	2448	2448	152	11	83	69	11	0	110	41	0	0	1017	581	1186	733	1366	745
"FBXL15"	2366	3324	50	0	31	19	0	0	92	89	0	0	321	262	445	297	681	415
"FBXL16"	3418	13303	75	0	34	41	0	0	91	55	0	0	82	50	0	3	91	21
"FBXL17"	5203	523061	17045	9959	9656	7389	5739	4220	8968	5171	1554	5011	862	376	793	697	909	607
"FBXL18"	8233	37972	570	20	326	244	20	0	606	389	591	663	782	523	662	362	1010	357
"FBXL19"	3807	24210	370	37	245	125	37	0	480	206	269	95	475	325	637	414	674	555
"FBXL2"	2375	109185	1995	650	1132	863	358	292	924	341	795	371	2625	2382	2681	2031	3025	1892
"FBXL20"	2419	141037	3109	384	1693	1416	211	173	2216	204	1338	290	141	151	381	298	557	275
"FBXL21"	1335	5106	0	0	0	0	0	0	0	0	0	0	0	0	0	0	0	0
"FBXL22"	1932	3339	65	9	50	15	9	0	62	85	0	27	0	0	2	0	0	0
"FBXL3"	3553	21943	1573	533	917	656	271	262	826	388	304	572	387	1665	2364	1281	2634	1229
"FBXL4"	2905	74250	3887	499	2270	1617	332	167	2282	370	943	267	417	638	587	505	521	428
"FBXL5"	3487	50861	5937	2610	3224	2713	1446	1164	3356	1192	1942	1633	3521	2653	3776	1914	4197	1854
"FBXL6"	3115	3946	321	70	174	147	56	14	130	132	147	173	650	529	744	644	1248	638
"FBXL7"	4566	439597	0	0	0	0	0	0	10	0	0	0	0	0	0	0	0	0
"FBXL8"	1602	4188	5	0	0	5	0	0	159	66	92	26	177	87	195	104	294	132
"FBXO10"	4664	77983	71	37	43	28	29	8	202	77	0	101	848	699	968	769	838	738
"FBXO11"	3958	98755	14591	11805	7939	6652	6499	5306	5895	5391	7474	10195	2522	1629	2583	972	2520	853
"FBXO15"	3209	26717	0	0	0	0	0	0	0	0	0	0	0	0	18	3	3	6
"FBXO16"	1300	61856	51	0	25	26	0	0	37	0	0	0	42	57	48	25	95	36
"FBXO17"	2221	34340	0	0	0	0	0	0	39	11	0	0	0	1	0	0	0	0
"FBXO18"	3723	43208	1336	483	735	601	263	220	793	387	576	586	769	779	1149	987	1391	886
"FBXO2"	1549	6291	0	0	0	0	0	0	0	0	0	0	0	3	0	0	0	1
"FBXO21"	4244	46716	420	59	246	174	26	33	396	40	72	0	110	168	840	520	256	226
"FBXO22"	2823	30744	549	131	340	209	78	53	471	99	0	83	405	422	406	359	491	269
"FBXO22OS"	449	449	130	25	75	55	13	12	46	16	0	0	164	244	220	197	226	141
"FBXO24"	2264	14786	1	1	1	0	1	0	289	298	0	0	6	0	0	0	0	0
"FBXO25"	2450	63067	64	0	45	19	0	0	105	0	0	0	381	314	302	247	253	233
"FBXO27"	2327	8536	0	0	0	0	0	0	0	8	0	0	0	0	0	0	0	0
"FBXO28"	5454	47960	843	183	401	442	72	111	535	352	105	668	1429	1378	1331	930	1378	891
"FBXO3"	5801	33403	495	66	279	216	45	21	402	55	94	117	589	442	413	197	425	173
"FBXO30"	4408	16649	567	36	356	211	36	0	324	70	56	20	1078	693	1148	535	1166	441
"FBXO31"	3827	31619	863	110	470	393	63	47	919	249	308	76	151	123	234	302	596	141
"FBXO32"	1523	38089	35	0	17	18	0	0	88	0	13	0	156	35	98	12	157	22
"FBXO33"	3852	34828	908	19	558	350	9	10	587	41	49	78	1093	862	396	311	1167	802
"FBXO34"	5299	75926	7271	18139	4020	3251	9841	8298	2566	9548	1115	11190	2031	2376	1956	1322	2089	1131
"FBXO36"	2935	90619	18	0	14	4	0	0	27	0	0	0	3	43	5	6	2	5
"FBXO38"	4398	58855	2502	1672	1423	1079	956	716	1381	839	377	1104	1090	1215	1356	1090	1375	774
"FBXO39"	1670	11414	0	0	0	0	0	0	0	0	0	0	0	0	0	0	0	0
"FBXO4"	1732	9829	0	0	0	0	0	0	10	2	0	0	251	150	156	118	235	165
"FBXO40"	5726	36971	0	0	0	0	0	0	0	0	0	0	1	0	0	0	0	0
"FBXO41"	7134	16245	650	136	359	291	72	64	450	262	339	189	553	678	906	632	1459	807
"FBXO42"	3066	66530	6584	11535	3652	2932	6397	5138	2590	7261	3116	17995	190	253	296	330	945	331
"FBXO43"	3259	12418	0	0	0	0	0	0	0	0	0	0	0	0	0	0	0	0
"FBXO44"	3326	8471	96	0	33	63	0	0	57	7	0	0	236	227	310	208	509	277
"FBXO45"	5734	20205	222	11	133	89	11	0	141	8	57	0	1114	601	940	442	1205	433
"FBXO46"	2992	12890	814	719	453	361	407	312	322	733	529	2356	113	702	417	27	1	7
"FBXO47"	2313	30972	0	0	0	0	0	0	0	0	0	0	0	0	0	0	0	0
"FBXO48"	2714	4885	0	0	0	0	0	0	12	0	0	0	39	128	83	60	77	52
"FBXO5"	2256	13082	25	12	0	25	12	0	74	28	0	0	144	123	130	61	155	89
"FBXO6"	1553	10259	317	33	199	118	23	10	162	58	58	176	613	1014	850	549	1311	862
"FBXO7"	4771	16874	2434	1355	1311	1123	793	562	1289	687	776	951	2699	2749	3435	2707	4298	2844
"FBXO8"	2567	47592	300	56	207	93	32	24	260	29	0	57	364	137	539	384	305	353
"FBXO9"	4701	35413	871	325	491	380	184	141	625	94	422	199	1630	1316	1516	1213	2067	1274
"FBXW10"	3480	35337	0	0	0	0	0	0	0	0	4	0	0	0	0	0	0	0
"FBXW11"	4588	145323	12841	7841	7117	5724	4368	3473	5620	4581	6528	8241	2303	2279	2134	1582	2621	1728
"FBXW12"	1656	22481	0	0	0	0	0	0	0	0	0	0	0	0	0	0	0	0
"FBXW2"	9379	36417	2732	450	1531	1201	242	208	1260	413	737	270	2643	2225	2313	1374	2821	1169
"FBXW4"	2220	84323	3939	1112	2190	1749	577	535	2497	578	1315	1237	373	378	476	407	547	464
"FBXW5"	2432	4287	642	251	355	287	143	108	192	192	537	444	2881	2286	3720	3358	4862	3525
"FBXW7"	4051	213907	12876	10296	7295	5581	5680	4616	6752	8672	3808	11343	582	689	663	702	830	582
"FBXW8"	4866	120194	1781	106	1037	744	62	44	1981	330	271	52	373	358	536	309	481	195
"FBXW9"	1747	7727	4	0	4	0	0	0	54	67	0	2	54	64	81	50	135	52
"FCAMR"	2699	12568	0	0	0	0	0	0	16	12	0	0	0	0	0	0	0	0
"FCAR"	1687	16291	0	0	0	0	0	0	18	9	0	54	0	0	0	12	0	12
"FCER1A"	1168	18509	248	24	142	106	24	0	71	5	189	25	2799	2156	4378	2535	6131	2064
"FCER1G"	599	3953	231	0	156	75	0	0	223	32	296	0	1710	1512	3996	1964	6670	2264
"FCER2"	1937	11328	15415	8366	8679	6736	4389	3977	6834	2889	16322	10057	23099	21086	22573	19760	27913	18325
"FCF1"	2411	23540	39	2	12	27	2	0	97	19	0	43	941	716	385	295	360	224
"FCGBP"	16425	86571	1	0	0	1	0	0	70	22	0	0	0	0	4	0	12	3
"FCGR1A"	2181	9825	0	0	0	0	0	0	0	0	0	0	0	0	5	7	0	0
"FCGR1B"	1586	8299	0	0	0	0	0	0	0	0	0	0	0	0	3	0	0	0
"FCGR1C"	1342	9003	0	0	0	0	0	0	0	0	0	0	0	0	4	0	0	0
"FCGR2A"	2435	14156	234	512	132	102	263	249	448	296	4	361	6395	2473	1907	2169	3460	3417
"FCGR2B"	1641	15013	737	331	375	362	204	127	518	162	558	314	5076	4577	2215	2361	4275	4580
"FCGR2C"	1514	18904	1137	1160	712	425	674	486	668	349	657	725	1486	1773	869	1039	2088	2065
"FCGR3A"	2311	8267	0	0	0	0	0	0	20	0	0	0	468	539	523	495	856	644
"FCGR3B"	2296	8170	0	0	0	0	0	0	0	0	0	0	0	1	18	15	56	22
"FCGRT"	2008	14020	3397	3753	1494	1903	1923	1830	1056	701	4069	2811	3735	2539	6344	7054	5505	3363
"FCHO1"	3254	40852	2574	190	1402	1172	131	59	1140	235	2137	363	1762	1187	1943	1061	2399	1541
"FCHO2"	5006	134542	2676	506	1532	1144	270	236	2797	625	298	266	1679	1964	2380	2214	1803	1127
"FCHSD1"	4339	12118	923	161	559	364	66	95	377	98	383	41	336	572	759	553	570	353
"FCHSD2"	4509	305354	25097	31386	14258	10839	16854	14532	9496	16334	7396	29106	1918	1304	1903	1524	2469	1371
"FCMD"	6978	82989	18	37	5	13	20	17	102	3	0	0	340	352	379	250	448	158
"FCN1"	1290	8375	0	0	0	0	0	0	12	8	0	0	6	0	28	27	10	23
"FCN2"	1065	6710	0	0	0	0	0	0	0	0	0	0	0	0	0	0	0	0
"FCN3"	1038	5714	0	0	0	0	0	0	22	14	0	0	0	0	0	0	0	0
"FCRH3"	2814	24371	19	0	16	3	0	0	13	13	0	37	183	300	76	115	129	15
"FCRL1"	3107	25746	0	36	0	0	22	14	0	8	0	9	0	35	0	9	0	0
"FCRL2"	2601	31401	0	0	0	0	0	0	0	0	0	0	25	22	9	0	3	0
"FCRL3"	3577	19826	19	0	16	3	0	0	13	13	0	37	183	300	76	115	129	15
"FCRL4"	3470	24332	1	0	1	0	0	0	0	0	0	0	0	0	0	0	0	0
"FCRL5"	5406	39144	0	0	0	0	0	0	22	11	0	0	0	0	0	0	0	0
"FCRL6"	2009	15742	2076	509	1070	1006	276	233	769	128	572	295	348	316	545	187	638	246
"FCRLA"	2368	7381	0	0	0	0	0	0	0	0	0	0	4	20	0	3	3	5
"FCRLB"	2003	6600	43	0	23	20	0	0	30	0	0	0	305	225	70	72	186	235
"FDFACT2"	1672	6819	1569	1239	898	671	646	593	406	654	398	1125	337	571	707	727	1496	859
"FDFT1"	2369	36298	17003	918	15675	1328	503	415	1447	801	811	1362	2661	2789	1850	1478	3254	1785
"FDPS"	1547	11920	1637	1101	888	749	581	520	628	511	498	1236	1786	2141	1816	1878	2362	1502
"FDPSL2A"	4981	4981	347	55	164	183	37	18	147	44	233	112	1	0	34	48	38	17
"FDX1"	3222	35012	440	1679	212	228	881	798	213	1278	0	881	287	540	650	728	510	486
"FDX1L"	2010	10627	22	0	10	12	0	0	19	46	0	5	48	120	136	228	322	214
"FDXACB1"	3041	5373	7	0	0	7	0	0	14	0	0	0	177	107	152	51	181	62
"FDXR"	2495	10513	0	0	0	0	0	0	176	77	0	0	72	37	118	113	105	97
"FECH"	7333	41897	58	0	36	22	0	0	53	8	0	0	667	724	908	691	890	664
"FELE-1"	2706	4855	3740	1778	2001	1739	984	794	3821	1742	3171	1410	6843	7584	12658	13194	16416	8519
"FELE-2"	3629	54357	0	0	0	0	0	0	0	0	0	0	0	3	0	0	1	0
"FEM1A"	3843	3843	311	194	173	138	79	115	107	103	72	239	1	1805	1984	2066	2364	1743
"FEM1B"	7272	7272	1387	528	745	642	295	233	670	355	54	334	3560	2208	4627	2384	4137	1775
"FEM1C"	5816	23985	3011	13510	1702	1309	7238	6272	1123	6483	361	4931	1945	6103	2640	846	2411	1692
"FEN1"	2248	4559	165	33	89	76	18	15	125	16	0	30	0	576	358	260	445	368
"FER"	2970	439852	200	284	128	72	136	148	1222	703	26	116	81	252	175	195	161	76
"FER1L4"	6619	48978	1	0	0	1	0	0	22	36	0	2	0	5	0	0	0	0
"FER1L5"	6528	62051	1	0	1	0	0	0	135	18	0	0	0	0	0	0	0	0
"FER1L6"	6091	268076	0	0	0	0	0	0	0	10	0	0	0	0	0	0	0	0
"FERD3L"	641	641	0	0	0	0	0	0	0	0	0	0	0	0	0	0	0	0
"FERMT1"	5165	48700	0	0	0	0	0	0	0	0	0	0	4	4	3	4	35	17
"FERMT2"	3371	93827	0	6	0	0	2	4	9	0	0	0	0	1	0	0	0	0
"FERMT3"	2567	17213	4121	1918	2310	1811	1001	917	1470	1090	3506	4081	10169	10458	11300	11516	12650	10074
"FES"	2823	11341	4784	629	2645	2139	317	312	1765	147	4763	0	4805	2933	5098	1889	6546	2223
"FETUB"	1794	17040	0	0	0	0	0	0	0	0	0	0	0	0	0	0	0	0
"FEV"	1882	4572	0	0	0	0	0	0	14	0	0	0	0	0	0	0	0	0
"FEZ1"	1732	8029	0	0	0	0	0	0	0	0	0	0	0	13	0	9	0	3
"FEZ2"	2101	45930	5033	1402	2864	2169	744	658	2027	808	1492	1218	832	903	1711	1643	2036	636
"FEZF1"	2108	3118	0	0	0	0	0	0	0	0	0	0	0	0	0	0	0	0
"FEZF2"	2091	3845	0	0	0	0	0	0	0	0	0	0	0	0	0	0	0	0
"FFAR1"	924	924	0	0	0	0	0	0	0	0	0	0	0	0	0	0	0	0
"FFAR2"	2052	2052	0	0	0	0	0	0	25	0	0	0	0	124	0	413	0	180
"FFAR3"	1672	1901	0	0	0	0	0	0	0	0	0	0	0	0	0	20	0	0
"FGA"	3661	7619	0	0	0	0	0	0	0	0	0	0	0	0	0	0	0	0
"FGB"	1957	8106	0	0	0	0	0	0	0	0	0	0	0	0	0	0	0	0
"FGD1"	4291	50712	1	0	0	1	0	0	59	26	0	0	638	632	671	542	806	559
"FGD2"	3321	23424	28050	9017	15408	12642	4889	4128	9892	4007	32351	9800	10299	9037	11178	6566	19739	8189
"FGD3"	3471	88919	4638	390	2569	2069	205	185	2770	393	2752	429	1624	818	1288	748	1886	815
"FGD4"	8430	143943	17796	20505	9965	7831	10955	9550	10865	11591	11827	14744	2472	2666	3712	3162	3085	1854
"FGD5"	5916	115604	1025	32	602	423	23	9	1158	170	310	43	810	736	934	676	1881	1172
"FGD6"	9308	140716	1687	456	902	785	227	229	1063	149	258	79	932	1002	1384	1061	1037	967
"FGF1"	4066	105893	0	0	0	0	0	0	56	11	0	0	0	0	0	0	0	0
"FGF10"	630	83689	0	0	0	0	0	0	0	0	0	0	0	0	0	0	0	0
"FGF11"	3866	25865	250	21	128	122	0	21	243	80	162	0	985	536	666	318	1292	585
"FGF12"	3677	267156	0	0	0	0	0	0	12	8	0	0	0	0	0	0	0	0
"FGF13"	2680	80093	0	0	0	0	0	0	25	10	0	0	0	0	0	0	0	0
"FGF14"	2836	680921	0	0	0	0	0	0	13	0	0	0	0	0	0	0	0	0
"FGF16"	351	2366	0	0	0	0	0	0	0	0	0	0	0	0	0	0	0	0
"FGF17"	2581	4136	0	0	0	0	0	0	14	0	0	0	0	0	0	0	0	0
"FGF18"	1519	37497	0	0	0	0	0	0	169	87	0	0	0	0	0	0	0	0
"FGF19"	2139	6101	0	0	0	0	0	0	12	0	0	0	0	0	0	0	0	0
"FGF2"	6777	71529	0	0	0	0	0	0	14	0	0	0	70	41	49	31	60	43
"FGF20"	1019	9342	0	0	0	0	0	0	0	0	0	0	0	0	0	0	0	0
"FGF21"	1311	2768	0	0	0	0	0	0	57	23	0	0	0	0	0	0	0	0
"FGF22"	592	3779	0	0	0	0	0	0	11	30	0	0	0	0	0	0	0	0
"FGF23"	3021	11503	0	0	0	0	0	0	0	0	0	0	0	0	0	0	0	0
"FGF3"	1550	9457	0	0	0	0	0	0	42	13	0	0	0	0	0	0	0	0
"FGF4"	1223	2376	0	0	0	0	0	0	15	0	0	0	0	0	0	0	0	0
"FGF5"	5391	24430	0	0	0	0	0	0	0	0	0	0	0	0	0	0	0	0
"FGF6"	747	11474	0	0	0	0	0	0	0	0	0	0	235	130	50	0	111	0
"FGF7"	3939	64149	0	0	0	0	0	0	0	0	0	0	0	0	0	0	0	0
"FGF8"	1110	5942	0	0	0	0	0	0	0	0	0	0	0	0	0	0	0	0
"FGF9"	4533	33427	0	0	0	0	0	0	0	0	0	0	0	0	0	0	0	0
"FGFBP1"	1181	2778	0	0	0	0	0	0	0	0	0	0	0	0	0	0	0	0
"FGFBP2"	1172	2997	0	0	0	0	0	0	0	0	0	0	82	21	24	45	63	55
"FGFBP3"	2565	2914	0	0	0	0	0	0	0	0	0	0	0	0	0	0	0	0
"FGFR1"	5912	57697	1513	202	831	682	110	92	769	172	544	415	822	822	1109	1231	1755	1422
"FGFR1OP"	1897	41251	517	43	326	191	30	13	365	41	0	30	318	349	218	246	289	162
"FGFR1OP2"	2307	27548	1080	453	633	447	322	131	731	306	147	357	1652	1786	1788	1384	1963	1122
"FGFR2"	4654	120129	0	0	0	0	0	0	12	11	0	0	0	0	0	0	0	0
"FGFR3"	4311	15562	0	0	0	0	0	0	48	59	0	0	0	9	0	0	0	0
"FGFR4"	3085	11205	0	0	0	0	0	0	107	15	0	0	0	0	0	0	0	0
"FGFRL1"	3233	15747	435	125	243	192	92	33	177	125	192	0	547	520	542	484	639	464
"FGG"	1793	8175	0	0	0	0	0	0	0	0	0	0	0	0	0	0	0	0
"FGGY"	2561	402443	108	104	64	44	57	47	359	219	33	93	91	106	131	153	137	134
"FGIF"	2148	2253	163	0	93	70	0	0	74	27	0	0	587	416	475	260	598	280
"FGL1"	2008	45974	49	0	18	31	0	0	66	0	0	0	141	67	235	83	141	61
"FGL2"	4269	6463	6576	2372	3643	2933	1287	1085	2998	758	2268	561	55147	60529	49485	14156	64241	12677
"FGR"	2496	13950	10038	13363	5211	4827	6988	6375	2500	6662	8406	21781	9997	8144	8289	11256	8265	13479
"FH"	1797	22150	108	411	58	50	206	205	96	142	4	161	770	1256	743	813	1046	969
"FHAD1"	5121	150856	0	0	0	0	0	0	225	47	0	0	8	20	0	25	10	0
"FHDC1"	6491	36715	0	0	0	0	0	0	0	0	0	0	0	5	0	0	0	0
"FHIT"	3355	1501714	228	85	126	102	39	46	2527	1229	0	244	0	15	14	12	28	9
"FHL1"	2894	42065	0	0	0	0	0	0	0	0	0	0	102	95	189	177	188	204
"FHL2"	2753	27679	8	0	0	8	0	0	0	53	0	0	21	37	9	10	83	10
"FHL3"	1708	8792	1236	113	848	388	76	37	258	121	500	152	1025	183	146	200	223	207
"FHL5"	2131	54079	0	0	0	0	0	0	0	0	0	0	0	0	0	0	0	0
"FHOD1"	4399	18133	2936	821	1238	1698	336	485	956	632	2757	1135	4774	4025	4221	2747	9003	4007
"FHOD3"	4967	482318	0	0	0	0	0	0	43	44	0	0	24	32	0	0	34	0
"FHOS"	2150	13867	2479	588	811	1668	203	385	907	573	2001	1005	4080	2599	3494	1425	8410	3337
"FHR4"	2039	30552	0	0	0	0	0	0	0	0	0	0	0	0	0	0	0	0
"FI58G"	3878	22681	140	0	64	76	0	0	224	81	0	46	1067	995	1502	1233	1736	1067
"FIBCD1"	3263	36415	5	0	5	0	0	0	368	203	0	0	0	1	0	0	0	0
"FIBIN"	3004	3004	0	0	0	0	0	0	0	0	0	0	0	0	0	0	0	0
"FIBL-5"	2296	5406	0	0	0	0	0	0	12	0	0	0	0	9	0	9	0	0
"FIBP"	1459	4800	142	7	65	77	0	7	172	42	93	97	948	792	827	743	1101	919
"FICD"	1654	4331	128	27	44	84	14	13	136	55	0	27	257	185	237	166	324	212
"FIG4"	3128	134212	7005	1177	3897	3108	694	483	5290	771	2136	566	1080	1409	2133	2139	2568	1902
"FIGF"	2118	38861	4	0	0	4	0	0	0	0	0	0	0	0	0	0	0	0
"FIGLA"	727	13335	0	0	0	0	0	0	0	0	0	0	0	0	0	0	0	0
"FIGN"	4538	128397	0	0	0	0	0	0	0	0	0	0	0	0	0	0	0	0
"FIGNL1"	3971	6256	28	0	15	13	0	0	0	0	0	0	140	138	226	52	178	45
"FIGNL2"	4533	4533	0	0	0	0	0	0	35	0	0	0	0	0	0	0	0	0
"FILIP1"	4933	198891	0	0	0	0	0	0	0	0	0	0	0	0	0	0	1	0
"FILIP1L"	4215	266578	1113	4408	684	429	2390	2018	689	2303	0	2141	614	1784	413	1320	744	682
"FIP1L1"	3509	82134	3421	1125	1952	1469	606	519	1717	663	376	534	802	828	645	611	1113	661
"FIP1L1/PDGFRA fusion"	1152	4804	0	0	0	0	0	0	0	0	0	0	2	19	10	9	18	12
"FIS"	2053	7900	0	0	0	0	0	0	9	0	0	0	0	0	0	0	0	0
"FIS1"	1029	12700	481	179	292	189	70	109	191	184	580	855	604	788	1271	1585	1175	892
"FIST3"	444	10335	882	635	499	383	369	266	460	255	138	385	298	442	428	365	402	201
"FITM1"	1005	1385	5	0	5	0	0	0	0	0	0	0	0	0	0	3	0	0
"FITM2"	960	4694	48	0	32	16	0	0	105	14	0	0	6	5	10	12	15	6
"FIZ1"	6676	10600	132	52	79	53	29	23	205	14	56	24	652	420	289	178	1021	193
"FJ009034"	463	3095	0	0	0	0	0	0	0	0	0	0	0	0	0	0	0	0
"FJ515873"	1548	69831	0	0	0	0	0	0	0	0	0	0	0	0	0	0	0	0
"FJ573251"	795	795	12	4	5	7	0	4	10	6	0	0	228	107	183	159	121	112
"FJ706072"	962	7300	795	596	450	345	314	282	460	289	521	290	541	561	828	577	935	609
"FJ706073"	940	7300	795	596	450	345	314	282	460	289	521	290	541	561	828	577	935	609
"FJ706074"	842	7300	795	596	450	345	314	282	460	289	521	290	541	561	828	577	935	609
"FJ706075"	665	7300	795	596	450	345	314	282	460	289	521	290	541	561	828	577	935	609
"FJ706076"	471	7300	795	596	450	345	314	282	460	289	521	290	541	561	828	577	935	609
"FJ706077"	378	7300	795	596	450	345	314	282	460	289	521	290	541	561	828	577	935	609
"FJ997633"	461	81506	0	0	0	0	0	0	0	0	0	0	0	0	0	0	0	0
"FJH1"	2526	7907	666	404	391	275	240	164	206	134	163	533	260	918	1188	475	1668	779
"FJX1"	2686	2686	0	0	0	0	0	0	0	0	0	0	0	99	0	103	0	0
"FKBP10"	2893	10509	0	0	0	0	0	0	77	16	0	0	0	0	0	0	0	0
"FKBP11"	2694	3580	563	316	408	155	266	50	259	276	551	578	145	204	177	208	185	156
"FKBP12-Exip2"	1356	24195	7446	746	4129	3317	392	354	3685	544	5210	746	8710	8540	11250	9395	13355	9219
"FKBP12-Exip3"	1522	24195	5563	562	3123	2440	305	257	2503	365	4662	556	106	8535	11246	9392	13354	9218
"FKBP14"	2251	13386	291	45	166	125	25	20	183	27	0	0	161	31	65	60	111	69
"FKBP15"	4399	55878	4992	805	2773	2219	488	317	3500	486	1452	497	6298	5909	8614	5641	8604	5322
"FKBP1A"	1636	24195	5563	562	3123	2440	305	257	2503	365	4662	556	106	8535	11246	9392	13354	9218
"FKBP1B"	1157	13966	0	0	0	0	0	0	44	24	0	0	109	141	91	73	223	112
"FKBP1P1"	1643	2163	431	137	220	211	74	63	137	104	233	258	0	0	0	0	0	0
"FKBP2"	736	3195	90	14	42	48	9	5	57	36	0	0	218	451	320	306	697	329
"FKBP3"	1630	19208	330	28	152	178	14	14	238	60	158	127	897	834	912	722	1185	655
"FKBP36"	1305	13083	0	0	0	0	0	0	15	0	0	0	0	0	30	0	33	0
"FKBP4"	3749	10479	322	38	148	174	21	17	276	52	199	0	1137	744	1784	1644	1502	1219
"FKBP5"	7391	108387	15914	42960	8978	6936	23270	19690	4901	22097	4874	45873	3785	7961	4339	2301	2130	4868
"FKBP6"	1579	30343	296	720	138	158	379	341	234	563	0	968	491	1000	11514	20886	10346	10791
"FKBP63"	2146	49453	17	0	17	0	0	0	42	0	0	0	165	178	336	320	266	162
"FKBP7"	3021	14964	0	0	0	0	0	0	0	0	0	0	3	11	21	18	32	13
"FKBP8"	1783	11821	255	51	121	134	29	22	179	76	41	9	3348	499	1731	1800	4892	1067
"FKBP9"	3643	49539	17	0	17	0	0	0	42	0	0	0	165	178	336	320	266	162
"FKBP9L"	2544	8387	0	0	0	0	0	0	0	0	0	0	0	0	20	17	19	6
"FKBPL"	1343	1582	0	0	0	0	0	0	0	25	0	0	118	11	110	0	5	24
"FKHRL1P2"	7260	7260	0	0	0	0	0	0	0	0	0	0	21	0	230	252	210	88
"FKRP"	3478	12531	36	10	36	0	10	0	15	53	2	96	197	234	184	177	201	152
"FKSG17"	1559	10915	0	0	0	0	0	0	0	0	0	0	305	167	22	45	1222	38
"FKSG2"	521	831	0	0	0	0	0	0	0	0	0	0	0	0	0	0	0	0
"FKSG21"	1341	60700	0	0	0	0	0	0	0	0	0	0	4	0	0	0	0	0
"FKSG24"	1657	3490	7	0	4	3	0	0	122	53	0	0	330	278	341	195	598	362
"FKSG29"	609	609	627	1022	238	389	562	460	407	1504	0	419	0	0	0	0	0	0
"FKSG40"	2806	6889	0	0	0	0	0	0	65	17	0	0	5	0	18	0	5	0
"FKSG42"	2793	2793	0	0	0	0	0	0	0	0	0	0	8	18	0	0	0	0
"FKSG46"	1008	1008	0	0	0	0	0	0	0	0	0	0	0	0	0	0	0	0
"FKSG52"	490	667	168	0	113	55	0	0	0	0	0	0	0	0	0	0	0	0
"FKSG56"	451	451	91	0	78	13	0	0	98	0	0	142	0	0	0	0	0	0
"FKSG62"	591	1027	0	0	0	0	0	0	0	0	0	0	22	0	0	0	0	0
"FKSG65"	605	605	0	0	0	0	0	0	0	0	0	0	0	0	0	0	0	0
"FKSG71"	1006	19574	0	0	0	0	0	0	0	0	0	0	0	0	0	0	0	0
"FKSG73"	1337	1337	0	0	0	0	0	0	0	0	0	0	0	0	0	0	0	0
"FKSG76"	2423	117801	4947	1055	2870	2077	665	390	4704	858	466	582	276	292	366	253	434	270
"FKSG83"	1163	1163	0	0	0	0	0	0	0	0	0	0	0	0	0	0	0	0
"FKTN"	7580	66174	18	37	5	13	20	17	102	3	0	0	340	352	379	250	448	158
"FL25415"	4259	72153	71	0	54	17	0	0	228	0	0	0	10	36	28	17	40	9
"FLAD1"	2671	7867	334	0	193	141	0	0	242	71	57	78	622	430	685	403	757	473
"FLC3A"	831	11531	1134	1791	589	545	940	851	482	584	408	1170	2364	2986	2117	1318	2359	1502
"FLCN"	3698	24975	1992	1768	1123	869	990	778	987	1086	1253	2143	1213	1157	1955	1904	1864	1087
"FLG"	12750	23030	0	0	0	0	0	0	0	0	0	0	0	0	0	0	0	0
"FLG2"	9124	11270	0	0	0	0	0	0	0	0	0	0	0	0	0	0	0	0
"FLI1"	4159	119350	18334	3234	10173	8161	1818	1416	11008	1484	12994	2711	2382	2021	2814	2129	3074	2104
"FLII"	4297	13904	1582	922	859	723	549	373	672	493	785	580	6000	6975	5866	5889	11989	6376
"FLJ00001"	1134	5484	56	40	27	29	22	18	142	101	0	27	922	868	840	548	1452	726
"FLJ00007"	4275	11816	919	161	555	364	66	95	377	98	383	41	336	572	759	553	570	353
"FLJ00015"	5147	33179	3045	8521	1677	1368	4531	3990	856	4096	1544	7061	2765	6611	2172	3327	1426	3113
"FLJ00017"	2500	28322	24482	23108	13436	11046	12151	10957	4918	18399	14165	8611	8720	11644	3023	2276	10605	2538
"FLJ00023"	4480	16798	4055	1169	2312	1743	416	753	1704	844	1916	1021	3027	410	3602	2418	3997	2059
"FLJ00038"	1913	13273	404	135	238	166	82	53	338	163	338	368	57	42	3153	2127	4170	1964
"FLJ00043"	1162	3945	3910	2604	2119	1791	1340	1264	779	1162	1701	2708	3233	4133	4322	4620	5527	3857
"FLJ00050"	4852	11926	0	0	0	0	0	0	112	0	0	0	0	0	0	0	0	0
"FLJ00051"	4381	6161	1013	647	634	379	307	340	1215	49	756	318	308	645	5424	1078	1400	1404
"FLJ00057"	3491	35638	217	80	110	107	55	25	221	158	29	202	70	182	103	182	87	109
"FLJ00058"	3579	5594	0	0	0	0	0	0	75	33	0	0	0	0	179	164	457	342
"FLJ00059"	4931	11572	4639	1981	2535	2104	1015	966	1281	992	4486	1941	5768	4745	4390	3858	7421	3712
"FLJ00060"	1740	11288	2	0	0	2	0	0	17	0	0	0	0	0	0	0	0	0
"FLJ00069"	2661	3727	31	0	13	18	0	0	48	23	0	0	17	36	67	52	87	22
"FLJ00072"	5142	5142	756	36	323	433	16	20	180	48	869	7	881	380	598	284	1239	456
"FLJ00075"	3524	14965	59	0	39	20	0	0	47	11	35	27	43	50	3374	2448	5273	2575
"FLJ00080"	4505	10811	216	17	104	112	17	0	205	199	32	111	212	279	476	554	248	401
"FLJ00087"	1905	2937	25	0	12	13	0	0	0	9	0	0	70	60	84	93	138	104
"FLJ00089"	2356	5164	571	34	309	262	34	0	232	42	261	29	329	176	326	91	384	48
"FLJ00100"	4444	10219	4522	1955	2471	2051	1015	940	1246	992	4486	1911	5654	4614	4311	3757	6987	3636
"FLJ00104"	6199	7538	322	16	167	155	16	0	194	91	0	65	218	227	179	107	378	163
"FLJ00108"	4482	4553	99	0	58	41	0	0	160	47	0	34	34	36	99	99	110	112
"FLJ00114"	974	9519	63299	91850	34817	28482	48688	43162	16494	42526	50732	101278	13950	34907	8271	14133	9251	9248
"FLJ00118"	4040	14587	6221	2303	3412	2809	1197	1106	776	966	5711	3823	5640	4035	6890	4271	8527	4918
"FLJ00129"	1805	25133	0	0	0	0	0	0	0	0	0	0	0	0	0	0	0	0
"FLJ00130"	5214	31392	589	899	118	471	439	460	516	165	1206	1202	366	73	351	356	527	335
"FLJ00132"	2072	2235	30	5	24	6	0	5	120	52	37	0	155	131	264	208	305	43
"FLJ00135"	5458	7891	485	145	275	210	96	49	250	45	65	206	486	530	751	665	980	616
"FLJ00138"	6240	22630	0	0	0	0	0	0	12	0	0	0	5	24	19	7	10	4
"FLJ00139"	941	4633	181	192	73	108	117	75	184	177	465	73	173	107	401	349	667	439
"FLJ00140"	2860	12880	2	1	2	0	1	0	64	11	0	14	18	21	9	0	22	12
"FLJ00147"	1054	4894	442	181	233	209	93	88	212	75	136	82	591	635	567	444	722	451
"FLJ00149"	3469	163591	243	143	171	72	64	79	209	86	64	172	87	105	61	47	44	20
"FLJ00150"	1227	19817	464	13	295	169	3	10	365	32	22	92	100	155	225	131	202	111
"FLJ00153"	3833	36247	11	0	11	0	0	0	63	29	31	0	17	13	194	116	136	73
"FLJ00157"	1472	3687	457	243	225	232	120	123	97	85	92	34	170	180	604	141	797	566
"FLJ00161"	2319	5840	197	96	109	88	54	42	85	72	0	0	273	246	351	286	620	259
"FLJ00164"	3836	41770	6607	3695	3594	3013	1942	1753	2416	2518	5060	6988	1895	1830	1964	1733	2522	1748
"FLJ00169"	1969	3340	574	169	327	247	112	57	389	131	416	107	2839	2235	2735	2190	3859	2340
"FLJ00171"	916	3260	590	333	315	275	174	159	211	249	468	505	3898	726	1439	1122	1521	1216
"FLJ00176"	2689	11336	0	0	0	0	0	0	41	26	0	0	0	1	729	0	1019	0
"FLJ00177"	2107	32898	2893	1599	1806	1087	918	681	1415	1155	1555	1716	2130	1265	3052	1525	1477	1559
"FLJ00181"	2729	11663	0	0	0	0	0	0	93	67	0	0	0	0	0	0	0	0
"FLJ00182"	2890	8221	977	111	588	389	53	58	415	185	516	274	1828	921	2575	976	2841	1312
"FLJ00183"	2923	5940	927	954	503	424	731	223	273	836	280	1280	891	979	1343	1144	1745	1060
"FLJ00193"	928	2762	0	0	0	0	0	0	14	0	0	0	0	0	0	0	0	0
"FLJ00194"	5570	70484	44	0	23	21	0	0	239	0	59	0	802	894	817	639	821	453
"FLJ00198"	1021	4184	272	116	204	68	81	35	91	93	129	124	491	526	390	183	1512	240
"FLJ00199"	4362	35429	403	115	252	151	79	36	492	291	190	119	495	442	746	592	962	654
"FLJ00200"	3248	4231	16446	2066	9293	7153	1245	821	1535	1122	3825	6542	1696	2035	2106	2297	2797	1923
"FLJ00209"	2710	17833	444	97	225	219	65	32	392	91	255	10	1398	859	799	760	1086	753
"FLJ00210"	1485	9583	581	49	323	258	27	22	314	154	182	52	610	471	972	633	1297	487
"FLJ00213"	5123	13081	2110	1399	1195	915	758	641	1104	487	697	782	2153	2166	2384	1658	2755	1500
"FLJ00217"	1033	3599	984	433	589	395	281	152	499	366	847	603	1421	764	2201	920	2396	1175
"FLJ00219"	2637	61464	0	0	0	0	0	0	0	0	0	0	0	0	0	0	0	0
"FLJ00225"	5085	108258	10458	5878	5888	4570	3266	2612	4836	2984	3038	4275	2175	1705	2032	902	2604	1170
"FLJ00227"	3650	7176	392	43	205	187	13	30	156	49	677	277	394	280	253	220	679	516
"FLJ00236"	3648	13718	3	0	0	3	0	0	62	13	0	0	48	18	12	7	28	7
"FLJ00246"	2279	65078	3997	2802	2354	1643	1457	1345	1647	1243	1374	1825	1110	1271	1559	1320	1615	841
"FLJ00253"	4454	216940	21824	18056	12262	9562	9855	8201	10704	8782	7706	12954	124	136	87	72	216	128
"FLJ00256"	1890	3501	0	60	0	0	36	24	148	250	0	0	0	8	0	7	0	0
"FLJ00259"	5564	37142	647	187	433	214	114	73	426	317	223	152	233	183	161	154	311	106
"FLJ00268"	4047	14519	0	0	0	0	0	0	40	6	0	0	0	0	0	0	0	0
"FLJ00270"	3213	34533	58	25	51	7	6	19	173	61	0	32	26	31	14	29	70	66
"FLJ00275"	5548	6700	0	0	0	0	0	0	19	0	0	1	27	10	289	361	484	40
"FLJ00276"	2800	23424	28050	9017	15408	12642	4889	4128	9892	4007	32351	9800	10299	9037	11178	6566	19739	8189
"FLJ00277"	3229	3385	49	0	30	19	0	0	53	30	0	0	1	2	20	0	3103	8
"FLJ00278"	1627	1627	0	0	0	0	0	0	0	0	0	0	0	0	256	124	303	102
"FLJ00284"	5735	15461	2578	485	1550	1028	270	215	1540	195	313	416	552	391	681	243	685	308
"FLJ00285"	3239	27199	196	14	93	103	14	0	158	47	72	3	151	164	1649	1474	2200	1322
"FLJ00295"	2024	25671	2303	267	1208	1095	142	125	1238	148	2142	466	108	47	125	43	171	52
"FLJ00296"	2003	10920	755	82	400	355	55	27	455	63	594	93	983	660	632	297	709	319
"FLJ00301"	2934	18465	0	0	0	0	0	0	43	0	0	0	157	70	135	45	150	4
"FLJ00302"	1209	32720	7639	4937	4220	3419	2736	2201	3736	2269	2094	3612	317	612	200	123	163	95
"FLJ00305"	5627	32540	15	0	11	4	0	0	54	19	0	0	59	66	87	38	106	48
"FLJ00307"	2175	102122	17	0	17	0	0	0	140	48	11	40	60	84	86	101	94	81
"FLJ00310"	5795	93962	0	0	0	0	0	0	75	12	0	0	0	0	0	0	0	0
"FLJ00312"	5371	30983	0	0	0	0	0	0	0	0	0	0	0	0	1613	952	2857	1045
"FLJ00313"	2753	15085	1533	133	792	741	45	88	1012	253	1159	308	908	514	1242	374	900	266
"FLJ00314"	5615	59980	0	47	0	0	31	16	78	76	0	101	0	0	0	0	0	0
"FLJ00317"	2703	3938	0	0	0	0	0	0	0	0	0	0	0	0	0	0	0	0
"FLJ00318"	5218	89298	19748	4729	11618	8130	2440	2289	7416	4816	28060	11983	154	104	433	318	639	310
"FLJ00319"	1046	8989	406	211	187	219	119	92	230	197	231	143	547	149	570	637	950	764
"FLJ00320"	5954	14522	34	0	29	5	0	0	97	56	0	22	188	78	163	119	176	100
"FLJ00322"	1238	3625	30	22	30	0	12	10	4	0	0	0	10	37	1624	1823	2487	1335
"FLJ00323"	4423	24483	17	0	17	0	0	0	19	0	0	0	79	102	37	42	43	32
"FLJ00326"	8622	25740	0	0	0	0	0	0	0	0	0	0	0	0	0	0	0	0
"FLJ00327"	4482	312701	1402	545	803	599	289	256	1386	1061	212	786	401	356	433	390	521	399
"FLJ00332"	1804	5961	497	106	295	202	23	83	273	176	421	58	473	338	941	608	1227	910
"FLJ00336"	3874	35679	1761	192	982	779	90	102	839	335	1668	486	814	692	715	564	1094	729
"FLJ00345"	1549	1866	18	13	11	7	13	0	23	12	0	0	0	17	9	11	63	9
"FLJ00350"	6659	7862	485	145	275	210	96	49	250	45	65	206	486	530	751	665	980	616
"FLJ00353"	6687	55977	3675	880	1990	1685	515	365	1685	304	838	677	1927	2152	1872	1483	2441	1357
"FLJ00364"	1425	69570	3262	973	1709	1553	465	508	1529	743	673	1576	133	243	134	75	115	41
"FLJ00377"	3549	27719	0	0	0	0	0	0	82	38	0	0	68	65	39	38	90	32
"FLJ00380"	1192	7722	832	176	474	358	119	57	304	107	298	138	1606	1237	1942	1253	2538	1035
"FLJ00382"	3245	26821	18	25	0	18	25	0	202	95	54	68	356	386	146	175	194	140
"FLJ00383"	4592	7886	1590	1280	922	668	681	599	535	664	1134	1749	9796	10346	10339	14512	16491	13591
"FLJ00385"	4084	8274	18	25	0	18	25	0	444	144	54	68	390	418	185	220	457	264
"FLJ00391"	4897	18058	1744	156	983	761	83	73	1004	117	1088	154	2034	1556	1656	969	2999	1728
"FLJ00419"	1901	20697	514	1165	255	259	640	525	492	1718	69	2243	590	950	467	1193	719	749
"FLJ00420"	4583	17971	872	314	503	369	113	201	597	356	903	680	868	798	1182	970	1804	1031
"FLJ10035"	3318	44002	2871	1944	1674	1197	1058	886	915	413	246	146	519	298	526	294	760	324
"FLJ10038"	5941	5941	389	224	246	143	131	93	558	353	161	559	251	226	345	175	71	22
"FLJ10213"	1661	1661	149	205	64	85	112	93	79	83	113	108	42	148	0	71	0	0
"FLJ10324"	3579	7014	1	0	0	1	0	0	25	26	0	0	0	0	0	0	0	0
"FLJ10357"	5508	19510	1399	72	766	633	31	41	666	121	480	40	2572	1794	2402	1650	3044	1782
"FLJ10661"	1649	10356	0	0	0	0	0	0	68	0	0	0	13	0	4	3	3	7
"FLJ10769"	2129	24456	1131	455	686	445	224	231	514	357	624	414	742	635	1108	788	1285	664
"FLJ10922"	1909	31572	60	0	24	36	0	0	215	13	0	115	131	99	164	121	217	126
"FLJ11151"	5766	45273	6751	2582	3794	2957	1436	1146	2822	1115	4107	2520	5204	122	3939	3421	5042	2907
"FLJ11235"	1395	1395	0	0	0	0	0	0	0	0	0	0	0	0	0	0	0	0
"FLJ11292"	2901	23468	0	0	0	0	0	0	0	0	0	0	0	0	0	0	0	0
"FLJ12505"	1832	24384	0	0	0	0	0	0	11	14	0	0	0	0	0	0	0	0
"FLJ12529"	1076	13187	1107	757	621	486	448	309	358	344	353	883	312	634	343	361	1031	278
"FLJ12825"	3944	63982	0	0	0	0	0	0	123	23	0	0	0	0	0	0	3	0
"FLJ13057"	2924	2924	0	0	0	0	0	0	11	0	0	0	129	119	0	0	0	0
"FLJ13197"	2376	51929	4	0	4	0	0	0	0	0	0	0	24	9	0	7	48	12
"FLJ13224"	1631	1631	143	231	57	86	121	110	53	214	0	1083	3	35	3	29	9	1
"FLJ13305"	2405	27041	0	0	0	0	0	0	0	0	0	0	0	0	0	0	3	0
"FLJ13984"	8341	116612	488	77	291	197	50	27	583	120	0	102	364	358	324	218	364	221
"FLJ14107"	1840	1840	79	98	37	42	61	37	72	74	0	82	0	0	0	0	0	0
"FLJ14346"	2546	2546	39	9	16	23	9	0	72	42	0	0	28	18	36	31	70	50
"FLJ14668"	2006	6113	78	22	55	23	0	22	50	30	0	11	812	780	955	701	1011	621
"FLJ14816"	2016	2016	0	0	0	0	0	0	30	0	0	0	0	0	0	0	0	0
"FLJ16124"	1123	635908	0	0	0	0	0	0	53	0	0	0	0	0	0	0	0	0
"FLJ16165"	2611	26396	0	0	0	0	0	0	16	12	0	0	0	0	0	0	0	0
"FLJ16686"	1299	10842	0	17	0	0	0	17	0	0	0	5	0	0	0	0	0	0
"FLJ16779"	7635	7635	0	0	0	0	0	0	25	10	0	0	1	0	0	0	0	0
"FLJ20079"	5687	26427	2246	1343	1261	985	779	564	1115	680	1942	1863	93	86	596	340	628	312
"FLJ20184"	1440	79061	0	0	0	0	0	0	0	0	0	0	0	0	0	0	0	0
"FLJ20297"	3575	30716	603	332	337	266	174	158	586	492	359	562	1140	945	1711	1327	2472	1309
"FLJ20674"	1979	2400	0	0	0	0	0	0	0	0	0	0	38	40	2	23	11	12
"FLJ21075"	2395	37527	0	0	0	0	0	0	11	0	0	0	0	0	0	0	0	0
"FLJ21820"	2138	137522	272	0	157	115	0	0	710	16	0	30	460	459	141	334	436	317
"FLJ22536"	1899	527941	0	0	0	0	0	0	58	8	0	0	0	0	0	0	0	0
"FLJ22624"	2677	28288	448	100	242	206	59	41	386	66	0	0	410	295	308	131	374	116
"FLJ23834"	6518	73221	0	0	0	0	0	0	35	10	0	0	0	0	0	0	0	0
"FLJ23867"	2715	2715	3628	1279	2030	1598	680	599	1007	463	1013	745	11615	11354	14124	12682	17319	13399
"FLJ25006"	2107	10725	8492	3495	498	7994	1788	1707	7469	831	13452	3485	1304	785	1078	298	1892	406
"FLJ25037"	1735	70857	0	0	0	0	0	0	38	0	0	0	2	1	131	132	204	107
"FLJ25328"	1703	8394	0	0	0	0	0	0	77	29	0	0	0	0	0	0	0	0
"FLJ25363"	1498	85179	0	0	0	0	0	0	0	0	0	0	0	0	0	0	0	0
"FLJ25758"	1464	1464	0	0	0	0	0	0	0	0	0	0	0	0	0	0	0	0
"FLJ25801"	1347	9979	0	0	0	0	0	0	0	0	0	0	0	0	0	0	0	0
"FLJ26850"	1436	16114	0	0	0	0	0	0	22	0	0	0	0	0	0	0	0	0
"FLJ30058"	3098	31642	0	0	0	0	0	0	9	0	0	0	0	0	0	0	0	0
"FLJ30294"	3167	19913	0	0	0	0	0	0	0	0	0	0	0	0	0	0	0	0
"FLJ30679"	1981	1981	0	0	0	0	0	0	10	0	0	0	0	0	0	0	0	0
"FLJ31222"	1466	20209	0	0	0	0	0	0	10	0	0	0	0	0	0	0	0	0
"FLJ31952"	7805	13743	91	0	0	91	0	0	70	35	0	0	167	136	533	351	623	306
"FLJ32063"	3316	4660	0	0	0	0	0	0	17	0	0	0	0	0	0	0	0	0
"FLJ32065"	3760	9037	0	39	0	0	28	11	17	0	0	0	32	166	198	194	68	81
"FLJ32810"	4776	303251	0	0	0	0	0	0	0	0	0	0	2	0	0	0	0	0
"FLJ33360"	2421	26853	0	0	0	0	0	0	16	0	0	0	0	0	0	0	0	0
"FLJ33534"	1432	26863	0	0	0	0	0	0	17	0	0	0	0	0	0	0	0	0
"FLJ33630"	2954	61522	1088	88	729	359	46	42	954	18	0	0	182	193	191	99	229	104
"FLJ34503"	2010	17257	0	0	0	0	0	0	0	0	0	7	0	0	0	0	0	0
"FLJ35024"	3777	199673	0	0	0	0	0	0	0	0	0	0	0	0	0	0	0	0
"FLJ35220"	2826	22916	190	37	134	56	23	14	378	173	64	125	96	165	82	120	202	102
"FLJ35390"	2149	3016	76	1	29	47	0	1	26	15	0	87	184	104	632	409	709	480
"FLJ35776"	995	3266	17	0	0	17	0	0	55	26	0	0	40	45	49	11	62	39
"FLJ36000"	3800	9010	0	0	0	0	0	0	55	49	0	0	0	0	0	0	0	0
"FLJ36031"	2443	2443	35	0	19	16	0	0	50	0	0	0	1140	397	1458	634	1488	594
"FLJ36208"	2045	2464	0	0	0	0	0	0	0	15	0	0	0	3	0	0	0	0
"FLJ36492"	3909	17615	17	0	10	7	0	0	157	133	0	0	0	0	639	596	1034	594
"FLJ36777"	2142	5954	0	0	0	0	0	0	15	0	0	0	0	0	0	0	0	0
"FLJ37201"	3664	6630	0	0	0	0	0	0	0	0	0	0	0	0	0	0	0	0
"FLJ37307"	4131	31805	0	2	0	0	2	0	9	11	0	0	0	0	0	0	0	0
"FLJ37453"	2734	13934	351	583	192	159	288	295	181	303	0	458	111	121	140	115	165	89
"FLJ37543"	2974	68728	0	0	0	0	0	0	0	0	0	0	0	0	0	0	0	0
"FLJ38101"	2051	11811	126	0	60	66	0	0	109	7	0	18	551	345	742	267	686	292
"FLJ38668"	550	26672	42	4	36	6	0	4	117	0	6	0	414	380	452	308	593	382
"FLJ38723"	2930	6268	0	0	0	0	0	0	10	0	0	0	0	0	0	0	0	0
"FLJ39582"	2617	8453	0	0	0	0	0	0	57	0	0	0	120	20	1	4	8	2
"FLJ39609"	500	1866	0	0	0	0	0	0	0	13	0	0	0	0	0	0	0	0
"FLJ39639"	2215	3571	253	23	138	115	23	0	161	42	92	38	126	42	116	48	144	33
"FLJ39653"	2550	31526	6047	2911	3391	2656	1613	1298	2687	1034	4398	2308	1004	1418	685	657	885	511
"FLJ39739"	2391	96950	46	60	23	23	35	25	116	128	0	36	22	18	143	192	151	158
"FLJ40125"	1717	4033	34	32	23	11	24	8	18	34	0	20	88	84	33	37	90	46
"FLJ40142"	1783	32458	35	0	20	15	0	0	138	19	0	0	235	78	185	83	36	123
"FLJ40235"	1715	18252	0	0	0	0	0	0	0	0	0	0	0	0	0	0	0	0
"FLJ40292"	1750	1750	206	133	120	86	53	80	148	80	78	245	0	0	0	0	0	0
"FLJ40330"	5375	40708	0	0	0	0	0	0	0	0	0	0	0	0	0	0	0	0
"FLJ40434"	926	1651	0	0	0	0	0	0	0	0	0	0	0	0	0	0	0	0
"FLJ40448"	2186	2929	237	222	235	2	126	96	17	3	215	262	1	0	0	0	0	0
"FLJ40504"	1953	31398	0	0	0	0	0	0	0	0	0	0	0	0	0	0	0	0
"FLJ40852"	2533	33894	2	0	0	2	0	0	0	0	0	0	0	1	0	0	4	0
"FLJ41423"	2602	17113	0	0	0	0	0	0	40	0	0	0	0	0	0	0	0	0
"FLJ41484"	3250	3250	15143	14457	8295	6848	7691	6766	1	8376	889	17845	20	145	37	0	271	32
"FLJ41562"	3206	29558	0	0	0	0	0	0	0	0	0	0	0	0	0	0	0	0
"FLJ41603"	4878	53394	0	3	0	0	3	0	0	0	0	0	0	0	0	0	0	0
"FLJ41856"	3024	19107	0	0	0	0	0	0	10	0	0	0	0	0	0	0	0	0
"FLJ41941"	2381	8585	0	0	0	0	0	0	0	0	0	0	0	0	0	0	0	0
"FLJ42280"	2712	21899	0	0	0	0	0	0	0	0	0	0	0	0	0	0	0	0
"FLJ42289"	3158	6263	0	0	0	0	0	0	0	0	0	0	0	0	0	0	0	0
"FLJ42627"	7147	7147	20	0	20	0	0	0	30	0	0	0	52	29	392	371	536	273
"FLJ42709"	3507	161436	0	0	0	0	0	0	0	0	0	0	0	0	0	0	0	0
"FLJ42875"	622	3655	0	0	0	0	0	0	0	0	0	0	0	0	0	0	0	0
"FLJ43390"	867	11058	0	0	0	0	0	0	0	0	0	0	0	0	0	0	0	0
"FLJ43663"	3234	165734	34621	41924	19853	14768	22439	19485	9726	9303	14651	19851	96	180	106	198	99	123
"FLJ43826"	3585	23301	0	0	0	0	0	0	14	9	0	0	0	0	0	0	0	0
"FLJ43859"	4927	6572	0	0	0	0	0	0	0	0	0	0	0	0	0	0	0	0
"FLJ43860"	4195	73403	0	36	0	0	28	8	412	727	0	486	0	80	0	26	0	0
"FLJ43950"	4864	6488	0	0	0	0	0	0	0	0	0	0	0	0	0	0	0	0
"FLJ44054"	2937	39877	0	7	0	0	7	0	42	15	1	0	0	0	0	0	0	0
"FLJ44082"	4931	6596	0	0	0	0	0	0	0	0	0	0	0	0	0	0	0	0
"FLJ44313"	2079	2570	65	0	30	35	0	0	8	0	0	0	1	32	21	0	2	1
"FLJ44635"	2270	17567	1115	2654	675	440	1406	1248	397	1232	65	1646	1060	48462	31062	50788	51055	38627
"FLJ44653"	2269	3052	0	0	0	0	0	0	0	0	0	0	0	0	0	0	0	0
"FLJ44817"	3939	18938	0	0	0	0	0	0	104	34	0	0	0	0	0	0	0	0
"FLJ44838"	4201	5885	0	0	0	0	0	0	0	0	0	0	0	0	0	0	0	0
"FLJ44881"	2339	3608	0	0	0	0	0	0	0	0	0	0	0	0	0	0	0	0
"FLJ44955"	2705	2705	59	0	33	26	0	0	34	0	0	0	0	0	0	0	0	0
"FLJ45079"	4706	5088	0	0	0	0	0	0	49	0	0	0	0	0	0	0	0	0
"FLJ45244"	807	22247	0	0	0	0	0	0	0	0	0	0	0	0	0	0	10	0
"FLJ45340"	10268	19759	4714	2262	2770	1944	1186	1076	1277	1256	6043	3941	2054	2554	2826	2566	2449	1349
"FLJ45422"	4630	7387	0	0	0	0	0	0	0	0	0	0	0	0	0	0	0	0
"FLJ45445"	4877	5195	0	0	0	0	0	0	0	0	0	0	0	0	366	360	436	256
"FLJ45983"	2216	3036	0	0	0	0	0	0	9	0	0	0	0	0	0	0	0	0
"FLJ46111"	1829	1829	0	0	0	0	0	0	0	0	0	0	0	0	0	0	0	0
"FLJ46321"	4836	6485	0	0	0	0	0	0	0	0	0	0	0	0	0	0	0	0
"FLJ46361"	3771	40953	0	0	0	0	0	0	48	0	0	0	0	0	0	0	0	0
"FLJ46536"	3648	21987	6260	2394	3434	2826	1269	1125	1247	559	684	168	1044	1243	1578	1011	5166	2620
"FLJ90650"	4527	65149	0	0	0	0	0	0	0	0	0	0	0	0	0	0	0	0
"FLJ90709"	2806	86880	2320	221	1366	954	144	77	1626	235	472	381	553	559	381	359	780	350
"FLJ90757"	4423	5588	125	0	32	93	0	0	170	81	135	0	1836	1207	1312	749	2232	1005
"FLNA"	8558	26108	28008	23551	15169	12839	12457	11094	6705	12630	16308	24500	112093	109988	77412	120913	127161	88334
"FLNB"	9607	163857	539	177	266	273	109	68	727	149	264	201	1172	1111	1767	1414	3555	2237
"FLNC"	9185	28846	0	0	0	0	0	0	346	177	0	0	0	0	0	0	0	0
"FLOT1"	1843	14954	661	2588	377	284	1372	1216	244	1096	0	2255	265	443	397	739	912	493
"FLOT2"	2642	18359	2144	520	1182	962	305	215	942	582	2832	1544	2831	4914	4116	3428	7625	4363
"FLRT1"	3249	15285	0	0	0	0	0	0	206	52	0	0	0	0	1	0	0	0
"FLRT2"	7180	97783	125	182	74	51	114	68	0	0	0	32	158	69	0	0	0	0
"FLRT3"	3980	13629	0	0	0	0	0	0	0	0	0	0	0	0	0	0	0	0
"FLT1"	7153	194784	1220	38430	742	478	20736	17694	219	16782	20	27625	1217	4995	2449	5548	1669	2784
"FLT3"	3998	97319	2	0	0	2	0	0	0	0	0	0	19	30	55	57	56	21
"FLT3LG"	1453	13077	147	13	147	0	0	13	232	7987	0	1975	26	38	70	59	101	62
"FLT4"	5886	48119	0	0	0	0	0	0	200	191	0	0	0	0	0	0	0	0
"FLVCR1"	3441	38602	141	0	89	52	0	0	136	15	141	14	497	319	244	142	200	90
"FLVCR2"	3664	69574	17649	4137	9761	7888	2335	1802	7468	3494	11346	4274	5545	3729	4965	2954	6346	3036
"FLYWCH1"	5004	39230	517	113	330	187	53	60	522	203	796	597	645	511	1420	1085	1492	905
"FLYWCH2"	1030	16188	11	0	0	11	0	0	18	24	12	0	155	1	276	233	349	227
"FMI2"	3801	40417	4	0	0	4	0	0	281	151	0	0	5	6	48	30	29	55
"FMN1"	3932	44911	0	17	0	0	10	7	59	0	0	0	5	7	34	21	13	0
"FMN2"	6454	383300	0	0	0	0	0	0	20	0	0	0	1177	1171	0	0	0	0
"FMNL1"	3986	25391	6174	6088	3389	2785	3188	2900	2053	3905	5575	8729	6450	7138	7053	10795	12611	8395
"FMNL2"	5599	314597	39533	118665	21887	17646	64198	54467	12175	39811	11168	96614	2141	3676	1396	1556	2748	1584
"FMNL3"	11218	69475	15201	74185	8446	6755	39868	34317	3242	36776	9227	75744	1913	7061	4366	6504	6206	4259
"FMO1"	2172	37480	0	0	0	0	0	0	7	0	0	0	0	0	0	0	0	0
"FMO2"	5191	27436	0	0	0	0	0	0	0	0	0	0	0	0	0	0	0	0
"FMO3"	2205	26941	0	0	0	0	0	0	0	0	0	0	0	0	0	0	0	0
"FMO4"	2148	27738	30	14	30	0	14	0	7	0	0	22	471	658	255	30	290	186
"FMO5"	2641	39394	553	0	254	299	0	0	371	23	32	0	1598	1871	339	356	594	429
"FMO6P"	2132	23825	0	0	0	0	0	0	0	0	0	0	0	0	0	0	0	0
"FMO9P"	1367	21320	0	0	0	0	0	0	0	0	0	0	0	0	0	0	0	0
"FMOD"	2988	10538	2395	10638	1339	1056	5656	4982	853	5849	800	14450	6538	78109	4806	63353	8176	63965
"FMR1"	4842	23453	532	309	290	242	194	115	535	116	45	137	1008	1165	1234	894	1252	772
"FMR1NB"	1020	45333	0	0	0	0	0	0	0	0	0	0	0	0	0	0	0	0
"FN1"	8843	75612	1225	527	673	552	289	238	1912	714	1447	598	13442	12965	53565	70885	29686	31560
"FN3K"	2160	12196	0	0	0	0	0	0	35	38	0	0	21	4	21	35	17	18
"FN3KRP"	1957	11309	195	9	119	76	9	0	141	76	0	7	568	512	679	509	1009	604
"FN5"	885	20875	1393	6687	791	602	3594	3093	380	6398	519	8351	19	552	904	1538	24	961
"FNBP1"	5442	156009	15823	47627	9002	6821	25371	22256	5210	29741	7428	59149	4590	5537	4132	2996	6274	3652
"FNBP1L"	5204	106379	319	0	195	124	0	0	279	7	0	0	304	412	233	128	397	174
"FNBP4"	4128	50925	3214	5076	1852	1362	2751	2325	1520	2938	1462	4250	1952	3262	2048	2103	2295	1366
"FNDC1"	6573	102712	0	0	0	0	0	0	33	0	0	0	0	2	0	0	0	0
"FNDC3A"	6311	233868	4192	2439	2441	1751	1300	1139	4043	2492	619	1564	1935	2420	3163	3068	2512	1868
"FNDC3B"	7038	361074	27659	83175	15487	12172	44594	38581	15874	53533	6171	53859	1901	2391	3213	3105	2540	1977
"FNDC4"	1677	3377	0	0	0	0	0	0	0	0	0	0	0	0	0	0	0	8
"FNDC5"	2663	8472	0	0	0	0	0	0	40	1	0	0	0	0	8	5	0	0
"FNDC6"	1801	30614	125	23	82	43	18	5	16	21	0	27	14	0	19	24	27	13
"FNDC7"	3071	29811	1	0	1	0	0	0	0	0	0	0	0	0	0	0	0	0
"FNDC8"	1358	9121	450	337	247	203	172	165	23	9	0	0	0	0	0	0	0	0
"FNIP1"	6632	155351	11848	13892	6736	5112	7568	6324	5350	4611	2710	6931	1475	1394	1562	1083	1562	894
"FNIP2"	5800	137771	47765	106966	26757	21008	57701	49265	14144	46140	17588	80274	7928	16277	8597	12685	9011	6496
"FNK"	1821	4960	465	2794	267	198	1438	1356	108	6147	161	19076	327	2943	611	9606	503	5374
"FNTA"	4685	29483	1739	676	1053	686	390	286	829	346	540	630	2128	1700	1775	1312	2435	1392
"FNTB"	2843	148231	3525	642	2027	1498	382	260	2516	492	1270	424	3630	3726	2374	1753	3587	2172
"FOLH1"	2657	62036	0	0	0	0	0	0	0	2	0	0	0	5	0	0	22	14
"FOLH1B"	2751	62036	0	0	0	0	0	0	0	2	0	0	0	5	0	0	22	14
"FOLR1"	1360	6110	0	0	0	0	0	0	26	0	0	0	0	0	0	0	0	0
"FOLR2"	1135	5176	0	0	0	0	0	0	0	0	0	0	30	7	107	100	106	66
"FOLR3"	978	4165	0	0	0	0	0	0	0	0	0	0	0	1	0	0	0	4
"FOLR4"	735	2056	0	0	0	0	0	0	0	0	0	0	0	0	0	0	0	0
"FOS"	2160	3456	610	269	327	283	156	113	320	243	526	225	341	487	732	333	561	593
"FOSB"	3813	5304	72	123	48	24	83	40	76	300	0	240	0	87	0	37	0	5
"FOSL1"	1672	8307	23	37	23	0	9	28	55	174	0	176	8	499	28	237	86	115
"FOSL2"	3993	21737	12431	6940	6817	5614	3643	3297	4133	2811	10781	8747	11711	8108	8152	6273	13661	5982
"FOXA1"	3110	5298	0	0	0	0	0	0	0	0	0	0	0	0	0	0	0	0
"FOXA2"	2424	3460	0	0	0	0	0	0	0	0	0	0	0	0	0	0	0	0
"FOXA3"	1990	9538	0	0	0	0	0	0	41	32	0	0	0	0	0	0	0	0
"FOXB1"	1461	1723	0	0	0	0	0	0	8	0	0	0	0	0	0	0	0	0
"FOXB2"	1300	1300	0	0	0	0	0	0	0	0	0	0	0	0	0	0	0	0
"FOXC1"	3448	3448	0	0	0	0	0	0	0	0	0	0	0	63	0	0	0	0
"FOXC2"	1680	1680	0	0	0	0	0	0	0	0	0	0	0	0	0	0	0	0
"FOXD1"	2267	2267	0	0	0	0	0	0	0	0	0	0	0	0	0	0	0	0
"FOXD2"	4675	4675	129	0	70	59	0	0	38	0	97	0	501	26	68	3	162	0
"FOXD3"	2069	2069	0	0	0	0	0	0	0	0	0	0	0	0	0	0	0	0
"FOXD4"	2184	2184	0	0	0	0	0	0	0	0	0	0	0	0	0	2	0	0
"FOXD4L1"	2067	2067	0	0	0	0	0	0	0	0	0	0	0	0	0	0	0	0
"FOXD4L3"	2219	2219	0	0	0	0	0	0	0	0	0	0	0	0	0	0	0	0
"FOXD4L4"	3110	3110	0	0	0	0	0	0	0	0	0	0	0	0	0	0	0	0
"FOXD4L5"	3108	3108	0	0	0	0	0	0	0	0	0	0	0	0	0	0	0	0
"FOXD4L6"	2726	2726	0	0	0	0	0	0	0	0	0	0	0	0	0	0	0	0
"FOXE1"	3451	3451	0	0	0	0	0	0	0	0	0	0	0	0	0	0	0	0
"FOXE3"	1981	1981	0	0	0	0	0	0	0	0	0	0	0	0	0	0	0	0
"FOXF1"	2563	3938	0	0	0	0	0	0	0	0	0	0	0	0	0	0	0	0
"FOXF2"	2188	5764	0	0	0	0	0	0	0	0	0	0	0	0	0	0	0	0
"FOXG1"	2585	2585	0	0	0	0	0	0	0	0	0	0	0	0	0	0	0	0
"FOXH1"	2184	2603	579	262	305	274	142	120	145	199	765	383	810	885	1127	996	1896	1042
"FOXI1"	2297	3813	0	0	0	0	0	0	0	0	0	0	1	0	0	0	0	0
"FOXI2"	3180	3914	0	0	0	0	0	0	13	0	0	0	0	0	0	0	0	0
"FOXI3"	1263	4329	0	0	0	0	0	0	0	0	0	0	0	0	0	0	0	0
"FOXJ1"	2632	4956	0	0	0	0	0	0	25	10	0	0	0	0	0	0	0	0
"FOXJ2"	5492	22760	837	144	475	362	92	52	425	130	254	213	1617	1386	1704	996	2184	1145
"FOXJ3"	5366	158427	3705	1097	2088	1617	647	450	2009	878	232	1150	1497	490	1398	888	1474	936
"FOXK1"	11200	89146	8401	1436	4745	3656	826	610	3777	1720	7345	2538	1873	1236	2145	1018	2678	1231
"FOXK2"	5269	84889	3843	1185	2197	1646	739	446	2265	1419	2217	2409	1429	1185	1587	1280	1711	1241
"FOXL1"	3190	3190	0	0	0	0	0	0	0	0	0	0	0	0	0	0	0	0
"FOXL2"	2917	2917	0	0	0	0	0	0	0	0	0	0	0	0	0	0	0	0
"FOXM1"	3635	19455	143	0	64	79	0	0	103	33	0	0	94	62	100	38	221	72
"FOXN1"	2873	31897	17	0	6	11	0	0	63	48	0	0	0	0	0	0	0	0
"FOXN2"	5470	64641	4035	740	2230	1805	361	379	2025	265	873	251	1740	1446	1973	844	1870	976
"FOXN3"	7908	260939	92171	99436	50991	41180	53585	45851	30259	39315	52590	88789	7520	8338	5862	4461	7596	4054
"FOXN4"	3361	31243	0	0	0	0	0	0	63	12	0	0	0	0	0	0	0	0
"FOXO1"	5739	110933	14040	45024	7899	6141	24412	20612	6722	32654	6317	50770	794	1876	1243	3185	1092	1322
"FOXO3"	7344	123904	4068	10705	2104	1964	5856	4849	2846	6204	1065	9315	838	835	1223	1686	1307	871
"FOXO4"	3324	7360	1	0	0	1	0	0	81	10	0	0	364	324	483	423	559	363
"FOXP1"	6342	628169	15476	8698	8944	6532	4949	3749	11570	8742	4570	12702	273	778	547	430	718	411
"FOXP2"	3726	276042	0	0	0	0	0	0	0	0	0	0	0	0	0	0	0	0
"FOXP3"	2393	14392	37	0	24	13	0	0	138	48	0	0	0	1	109	124	0	130
"FOXP4"	5965	55959	434	11	245	189	5	6	620	276	31	39	239	205	111	94	287	163
"FOXQ1"	2319	2319	449	123	261	188	52	71	92	35	310	63	5260	1069	2763	186	3839	762
"FOXR1"	1158	9579	0	0	0	0	0	0	0	13	0	0	0	0	0	0	0	0
"FOXR2"	1926	1926	0	0	0	0	0	0	0	0	0	0	0	0	0	0	0	0
"FOXRED1"	2224	7188	269	138	170	99	82	56	100	61	29	105	278	234	373	304	476	259
"FOXRED2"	5018	19858	0	0	0	0	0	0	126	29	0	0	203	144	252	222	495	293
"FOXS1"	1319	1319	0	0	0	0	0	0	15	0	0	0	0	0	0	0	0	0
"FP12591"	2627	30804	1656	133	860	796	90	43	863	174	556	268	1217	792	999	786	1110	778
"FP13812"	2426	20790	763	360	425	338	179	181	475	454	336	994	403	420	576	514	644	459
"FP15621"	1180	31354	812	0	411	401	0	0	793	220	741	0	953	676	1673	1289	1890	1239
"FP15737"	2008	2008	29	0	0	29	0	0	0	22	0	31	329	325	131	290	200	182
"FP221"	866	1901	110	129	79	31	65	64	74	30	50	125	384	324	354	268	454	288
"FP2747"	3712	23312	1633	225	893	740	153	72	1683	129	1356	276	556	261	1428	1175	910	727
"FP634"	2036	8924	269	138	170	99	82	56	100	61	29	105	278	234	373	304	476	259
"FP6578"	2617	4488	363	19	193	170	8	11	390	169	401	27	1205	217	599	228	1416	240
"FP7162"	2355	10299	175	0	105	70	0	0	440	145	0	61	424	286	360	201	631	274
"FPGS"	2502	11404	542	189	249	293	65	124	272	475	105	682	1943	1018	1170	1151	1454	1181
"FPGT"	3430	9196	105	9	66	39	0	9	197	4	60	0	721	541	743	370	771	364
"FPR1"	1318	6125	0	0	0	0	0	0	0	0	0	0	57	39	74	81	63	55
"FPR2"	2070	9326	0	0	0	0	0	0	0	0	0	0	5	12	46	0	0	33
"FPR3"	2519	30925	34698	15194	19288	15410	8248	6946	11563	7669	17572	15603	20904	25200	13588	9384	10433	7126
"FRA10AC1"	2528	34002	178	0	89	89	0	0	121	7	0	0	241	204	313	175	83	48
"FRAG1"	2147	28392	621	143	328	293	113	30	326	186	106	208	181	314	237	186	346	222
"FRAP1"	4040	25028	413	339	224	189	192	147	215	158	236	239	971	979	1107	1055	1292	952
"FRAS1"	15698	486701	22	0	0	22	0	0	15	0	0	0	544	548	671	685	744	498
"FRAT1"	2652	2652	0	0	0	0	0	0	28	0	0	0	155	13	213	0	273	79
"FRAT2"	2206	2206	220	0	130	90	0	0	90	0	144	47	1317	159	1529	152	2000	289
"FRAXG-associated short stature candid..."	630	2964	8	0	8	0	0	0	14	0	0	0	0	0	0	0	0	0
"FREM1"	7408	173083	0	0	0	0	0	0	0	0	0	0	0	0	0	0	0	0
"FREM2"	16184	200094	0	0	0	0	0	0	0	0	0	0	0	0	0	0	0	0
"FREQ"	4999	64728	0	1	0	0	1	0	115	289	0	77	121	79	247	337	209	210
"FRG1"	1051	22386	469	0	285	184	0	0	236	37	0	0	811	748	785	770	1018	929
"FRG1B"	2629	42031	610	204	369	241	120	84	1052	176	392	302	670	473	495	499	820	550
"FRG2"	2088	2889	0	0	0	0	0	0	0	0	0	0	0	0	0	0	0	0
"FRG2B"	893	1697	0	0	0	0	0	0	0	0	0	0	0	0	0	0	0	0
"FRG2C"	2068	2878	0	0	0	0	0	0	0	0	0	0	0	0	0	0	0	0
"FRK"	2857	119230	0	0	0	0	0	0	0	0	0	0	0	0	0	0	0	0
"FRMD1"	3038	23376	0	0	0	0	0	0	128	67	0	0	0	0	0	0	0	0
"FRMD3"	2536	291043	0	0	0	0	0	0	118	78	0	23	0	7	0	0	0	0
"FRMD4A"	6828	687161	9473	976	5242	4231	514	462	3556	433	3534	283	2302	1662	3934	1907	3975	2043
"FRMD4B"	5284	216286	9590	9150	5372	4218	5166	3984	4468	5065	1897	8695	1433	987	1324	1172	1704	1115
"FRMD5"	2576	321700	0	0	0	0	0	0	39	9	0	0	0	0	0	0	0	0
"FRMD6"	5399	17080	0	12	0	0	6	6	44	0	0	0	202	145	158	36	183	16
"FRMD7"	3212	51029	0	0	0	0	0	0	0	20	0	16	0	10	0	0	0	0
"FRMD8"	3760	26954	1891	616	1024	867	212	404	936	603	1801	1216	1746	1265	1611	1124	2669	1328
"FRMPD1"	5481	78901	0	0	0	0	0	0	11	0	0	0	0	0	0	0	0	0
"FRMPD2"	4823	118111	0	0	0	0	0	0	0	10	0	0	0	0	0	0	0	0
"FRMPD2L1"	1889	19591	0	0	0	0	0	0	0	0	0	0	0	0	0	0	0	0
"FRMPD4"	6467	583946	0	0	0	0	0	0	0	0	0	0	0	0	0	0	0	0
"FRRS1"	2695	57092	131	20	66	65	20	0	140	4	0	0	122	109	170	109	259	169
"FRS2"	6873	109434	2623	1361	1560	1063	780	581	1263	1209	307	1374	579	535	608	358	657	329
"FRS3"	2173	9718	0	0	0	0	0	0	62	0	8	0	62	24	67	7	93	9
"FRY"	10777	265340	926	1191	600	326	666	525	1037	1192	168	753	649	914	793	855	982	666
"FRYL"	11770	282938	5774	1893	3456	2318	1129	764	4488	1797	544	1239	1874	2393	2582	2376	2795	1766
"FRZB"	2041	32763	0	0	0	0	0	0	0	0	0	0	0	0	0	0	0	0
"FSBP"	1908	5745	0	0	0	0	0	0	0	0	0	0	0	0	0	0	3	0
"FSCB"	3146	3146	0	0	0	0	0	0	0	0	0	0	0	0	0	0	0	0
"FSCN1"	2781	13833	3808	18471	2070	1738	9746	8725	162	13306	113	16	1555	31011	3041	54044	4002	37404
"FSCN2"	1746	8740	390	13	206	184	0	13	316	174	341	45	0	0	0	0	0	0
"FSCN3"	1890	8156	83	0	35	48	0	0	37	32	0	0	1610	1510	0	1169	0	987
"FSD1"	1860	19254	0	0	0	0	0	0	27	67	0	0	0	0	0	0	0	0
"FSD1L"	4415	101072	429	300	282	147	168	132	508	349	106	202	481	766	468	509	468	135
"FSD2"	2506	46784	0	0	0	0	0	0	43	0	0	0	0	1	0	0	0	0
"FSHB"	1938	4262	0	0	0	0	0	0	0	0	0	0	0	0	0	0	0	0
"FSHR"	2391	191979	0	0	0	0	0	0	0	0	0	0	0	0	0	0	0	0
"FSIP1"	2823	182807	0	0	0	0	0	0	0	0	0	0	0	0	0	0	0	0
"FSIP2"	4596	45671	0	0	0	0	0	0	0	0	0	0	0	0	0	0	0	0
"FST"	1371	5309	0	0	0	0	0	0	0	0	0	0	0	38	44	168	10	17
"FSTL1"	3850	56858	0	0	0	0	0	0	0	0	0	0	0	10	0	0	0	0
"FSTL3"	2516	7005	41	0	28	13	0	0	87	101	0	0	48	40	87	553	83	102
"FSTL4"	5398	416073	0	0	0	0	0	0	210	114	0	0	0	0	0	0	0	0
"FSTL5"	4844	780137	0	0	0	0	0	0	0	0	0	0	0	0	0	0	0	0
"FT002"	2460	2460	289	0	143	146	0	0	45	46	37	42	0	0	0	0	0	0
"FTCD"	1969	19306	0	0	0	0	0	0	18	25	0	0	2	1	0	0	0	0
"FTH1"	1231	3375	1028	3727	580	448	1994	1733	367	2391	665	6010	25268	35173	65081	104421	57537	76096
"FTHL17"	814	814	0	0	0	0	0	0	0	0	0	0	0	0	0	0	0	0
"FTHL3P"	955	955	22	0	0	22	0	0	29	0	0	68	0	0	0	0	0	0
"FTL"	1412	1571	843	1104	245	598	590	514	495	0	617	849	150056	135088	328295	353321	294016	250141
"FTMT"	873	873	0	0	0	0	0	0	0	0	0	0	0	0	0	0	0	0
"FTO"	4300	410505	4375	3220	2455	1920	1820	1400	3293	2462	641	2322	713	677	476	389	651	343
"FTSJ1"	2065	10205	67	10	39	28	10	0	160	70	20	0	570	441	486	401	599	390
"FTSJ2"	1760	7878	666	404	391	275	240	164	206	134	163	533	260	918	1188	475	1668	779
"FTSJ3"	3578	8238	1083	142	814	269	55	87	588	336	268	169	3464	3046	1486	1138	4709	1149
"FTSJD1"	4173	7307	235	0	145	90	0	0	181	13	109	0	1091	23	1187	284	1250	414
"FTSJD2"	4146	48377	749	93	427	322	34	59	545	107	197	105	1033	984	1394	966	1603	1003
"FUBP1"	2966	31186	3741	5515	2106	1635	2970	2545	1612	419	1052	3666	1797	2326	1029	1155	946	642
"FUBP3"	3176	58781	2684	449	1455	1229	258	191	1440	694	874	1372	1037	898	1483	1134	1310	920
"FUCA1"	2085	23249	28	0	11	17	0	0	14	0	0	0	791	709	1418	577	630	955
"FUCA2"	2101	16619	592	65	314	278	34	31	349	56	100	0	2436	1655	2042	1327	2388	1258
"FUK"	3948	25680	270	0	172	98	0	0	281	158	179	19	298	271	367	356	532	347
"FUNDC1"	1174	19337	0	0	0	0	0	0	16	0	0	0	233	200	169	95	274	231
"FUNDC2"	2968	30128	62	337	47	15	178	159	152	249	0	79	786	1000	1061	1028	1104	827
"FURIN"	4196	14804	10810	1877	5874	4936	1011	866	3980	673	8846	824	33731	22769	39398	25717	55857	29410
"FUS"	2020	11646	6663	5574	3664	2999	2981	2593	2347	2235	3738	4190	5635	7793	6859	6842	9707	6273
"FUS/CHOP"	1984	11646	6663	5574	3664	2999	2981	2593	2347	2235	3738	4190	5635	7793	6859	6842	9707	6273
"FUS1"	1657	3329	26	0	20	6	0	0	63	13	0	0	501	421	571	439	846	487
"FUSIP1"	2246	13884	2184	3362	1301	883	1885	1477	1055	1597	892	2517	516	4359	2185	2649	2031	1737
"FUT1"	4248	7379	0	0	0	0	0	0	0	26	0	0	0	0	0	0	0	0
"FUT10"	3550	102320	598	0	346	252	0	0	963	23	0	0	93	196	232	50	301	190
"FUT11"	2683	2834	141	35	51	90	21	14	102	28	0	29	1685	1348	720	650	781	1959
"FUT2"	3100	9964	0	0	0	0	0	0	35	0	0	0	0	0	0	0	0	0
"FUT3"	2593	8588	0	0	0	0	0	0	51	0	0	0	0	0	0	0	0	0
"FUT4"	6047	6047	697	748	389	308	341	407	287	402	249	448	1184	2663	1451	2154	1678	1200
"FUT5"	2694	38189	361	15	219	142	15	0	346	138	308	75	814	651	1151	1048	1455	1074
"FUT6"	3140	9107	0	0	0	0	0	0	37	0	0	0	0	0	0	0	0	0
"FUT7"	2416	2668	43	0	0	43	0	0	94	62	92	0	719	379	511	191	880	338
"FUT8"	3769	332123	0	0	0	0	0	0	36	0	0	0	37	38	82	40	81	36
"FUT9"	12800	199644	0	0	0	0	0	0	0	0	0	0	0	0	0	0	0	0
"FUZ"	1632	6321	90	2	29	61	2	0	197	108	0	47	601	541	418	458	788	556
"FXC1"	2844	3235	644	531	373	271	304	227	669	428	198	334	1166	1316	1111	812	1272	739
"FXN"	7181	43516	44	0	26	18	0	0	277	12	0	12	236	176	285	236	350	294
"FXR1"	3118	64498	2053	2378	1135	918	1357	1021	1074	1529	271	1701	1274	1650	1604	1803	1864	1607
"FXR2"	2860	23525	288	60	154	134	50	10	333	161	53	61	683	660	909	712	1185	754
"FXYD1"	554	3563	0	0	0	0	0	0	14	0	0	0	0	0	0	0	0	0
"FXYD2"	2736	4671	0	144	0	0	92	52	60	171	0	0	0	122	0	20	0	0
"FXYD3"	1589	8497	0	0	0	0	0	0	59	19	0	0	14	11	4	0	4	3
"FXYD4"	780	4693	0	0	0	0	0	0	29	34	0	0	0	0	0	0	0	0
"FXYD5"	1639	15160	1086	24	614	472	12	12	436	102	526	162	3239	2346	2039	1515	2872	1649
"FXYD6"	1858	39676	0	229	0	0	125	104	0	168	0	0	16	235	47	244	10	41
"FXYD7"	1119	6446	0	0	0	0	0	0	46	33	0	0	0	0	0	0	0	0
"FYB"	4846	114311	6694	669	3774	2920	336	333	6248	495	1413	220	2557	5010	2495	3465	3589	1137
"FYCO1"	8522	77913	92	37	42	50	15	22	258	25	0	0	187	488	653	622	672	337
"FYN"	2662	212142	6965	5378	3882	3083	2961	2417	3622	2307	1227	4472	939	865	400	766	1219	398
"FYTTD1"	3833	34058	941	485	548	393	291	194	561	372	449	446	2568	2961	2778	2390	2928	2004
"FZD1"	4350	4350	256	161	148	108	72	89	22	162	0	199	1819	4619	1276	3172	2417	2686
"FZD10"	3254	3254	0	0	0	0	0	0	0	0	0	0	0	0	0	0	0	0
"FZD2"	1984	1984	173	0	101	72	0	0	61	0	0	0	2485	911	2334	472	3804	1225
"FZD3"	3918	70188	47	0	26	21	0	0	55	11	10	0	193	201	94	56	172	71
"FZD4"	7384	9713	0	0	0	0	0	0	0	0	0	0	0	0	0	0	0	0
"FZD5"	6564	6833	154	0	98	56	0	0	160	17	0	0	271	202	289	64	472	222
"FZD6"	3767	34427	0	0	0	0	0	0	0	0	0	0	0	0	3	0	0	0
"FZD7"	3852	3852	0	0	0	0	0	0	15	11	0	0	97	71	154	166	139	121
"FZD8"	3187	3187	0	0	0	0	0	0	0	0	0	0	0	0	0	0	0	0
"FZD9"	2342	2342	0	0	0	0	0	0	0	0	0	0	0	0	0	0	0	0
"FZR1"	3629	30462	2881	4200	2402	479	2091	2109	732	11715	766	52916	253	510	655	744	986	720
"Fe65L2"	2591	6109	216	72	61	155	36	36	78	35	10	0	147	93	237	142	132	134
"G0S2"	964	1066	73	1426	48	25	678	748	0	573	0	6554	298	9898	218	349	101	1830
"G0S24"	1701	2512	777	2599	439	338	1324	1275	178	1087	518	1991	1592	18246	1795	15789	2296	26180
"G2A"	1027	10032	1391	2738	810	581	30	2708	292	3171	105	18273	22	1203	43	1104	47	928
"G2AD"	3004	8504	1753	924	641	1112	569	355	1036	594	2170	1088	2101	2239	2297	2315	5110	2816
"G2E3"	5596	60719	1017	247	547	470	150	97	815	285	54	318	425	523	532	351	561	356
"G3BP"	2753	33439	3153	3217	1796	1357	1726	1491	1095	1782	599	2812	5263	5839	4268	4692	4268	3365
"G3BP1"	2911	33439	3153	3217	1796	1357	1726	1491	1095	1782	599	2812	5263	5839	4268	4692	4268	3365
"G3BP2"	4420	30714	1459	2947	818	641	1601	1346	672	1196	25	1297	1001	1805	1818	1625	6486	1303
"G6E"	640	1731	0	0	0	0	0	0	19	15	0	0	1	1	0	0	0	0
"G6PC"	3101	12573	0	0	0	0	0	0	0	0	0	0	0	0	0	0	0	0
"G6PC2"	3085	8761	0	0	0	0	0	0	0	0	0	0	0	0	0	0	0	0
"G6PC3"	1758	5595	85	0	25	60	0	0	71	12	0	0	636	437	766	763	971	881
"G6PD"	2408	15629	1939	558	1246	693	302	256	820	592	1369	1412	12692	9580	14325	11106	14110	8564
"G6VTS76519"	2128	37398	0	0	0	0	0	0	0	0	0	0	0	9	0	0	0	8
"G6e"	655	1726	0	0	0	0	0	0	19	15	0	0	1	1	0	0	0	0
"G72"	1109	25168	0	0	0	0	0	0	0	0	0	0	0	0	0	0	0	0
"G7c"	1635	8315	0	0	0	0	0	0	43	14	0	0	0	0	4	0	10	8
"G8"	708	4848	510	152	283	227	74	78	264	186	118	248	1086	1121	402	817	1129	894
"GA17"	847	18623	662	647	382	280	342	305	454	379	88	691	2853	2916	2666	2502	3410	2455
"GAA"	3794	18325	2447	610	1314	1133	357	253	1134	421	2541	656	5987	4967	10625	9069	7614	5283
"GAB1"	7920	137736	1258	157	713	545	59	98	1397	197	43	146	266	241	408	178	1582	1086
"GAB2"	6062	126585	26168	13179	14847	11321	6985	6194	15654	9733	14206	12967	655	1013	1361	1389	5218	987
"GAB2-like"	2214	42122	0	0	0	0	0	0	8	0	0	0	0	0	0	0	0	0
"GAB3"	4750	75823	6011	899	3277	2734	482	417	2794	614	2108	1038	1209	755	1209	655	1585	675
"GAB4"	2637	46285	0	0	0	0	0	0	8	14	0	0	0	0	0	0	0	0
"GABARAP"	895	2015	162	127	84	78	55	72	81	35	29	38	6893	6705	3168	7004	10678	3635
"GABARAPL1"	2334	10235	537	441	336	201	261	180	243	118	184	159	1381	1170	2044	1689	1990	1452
"GABARAPL2"	1005	11531	1134	1791	589	545	940	851	482	584	408	1170	2364	2986	2117	1318	2359	1502
"GABARAPL3"	1885	2916	0	0	0	0	0	0	9	0	0	0	0	0	0	0	0	0
"GABBR1"	4560	30960	9	20	7	2	12	8	174	95	10	0	43	107	241	129	600	312
"GABBR2"	5501	420811	0	0	0	0	0	0	116	17	0	0	87	101	0	0	0	0
"GABPA"	5189	37443	407	35	246	161	17	18	313	67	0	73	1186	1114	1767	1288	1955	1131
"GABPB1"	3060	78217	814	1001	408	406	580	421	799	1467	203	1765	1015	897	723	747	706	514
"GABPB2"	1962	47929	199	65	89	110	36	29	120	23	0	26	112	138	120	111	148	90
"GABRA1"	4420	52025	0	0	0	0	0	0	0	0	0	0	0	0	0	0	0	0
"GABRA2"	2782	139817	0	0	0	0	0	0	0	0	0	0	0	0	0	0	0	0
"GABRA3"	2795	284199	0	0	0	0	0	0	0	0	0	0	0	0	0	0	0	0
"GABRA4"	11136	74663	0	0	0	0	0	0	0	0	0	0	0	0	0	0	0	0
"GABRA5"	2363	81947	0	0	0	0	0	0	99	24	0	0	0	0	0	0	0	0
"GABRA6"	2528	16942	0	0	0	0	0	0	0	0	0	0	0	0	0	0	0	0
"GABRB1"	2218	395152	0	0	0	0	0	0	11	0	0	0	0	0	0	0	0	0
"GABRB2"	7470	259691	0	0	0	0	0	0	0	0	0	0	0	0	0	0	0	0
"GABRB3"	7212	259696	0	0	0	0	0	0	111	24	0	0	0	0	0	0	0	0
"GABRD"	1934	11426	0	0	0	0	0	0	29	21	0	0	0	0	0	0	0	0
"GABRE"	3160	21556	0	0	0	0	0	0	0	0	0	0	0	0	0	0	0	0
"GABRG1"	6775	88295	0	0	0	0	0	0	0	0	0	0	0	0	0	0	0	0
"GABRG2"	4087	87898	0	0	0	0	0	0	0	0	0	0	0	0	0	0	0	0
"GABRG3"	1687	561619	0	0	0	0	0	0	35	12	0	0	0	0	0	0	0	0
"GABRP"	3317	30327	0	0	0	0	0	0	0	0	0	0	0	0	0	0	0	0
"GABRQ"	2009	15190	0	0	0	0	0	0	0	0	0	0	0	0	0	0	0	0
"GABRR1"	3171	40275	0	0	0	0	0	0	0	0	0	0	0	0	0	0	0	0
"GABRR2"	1640	57730	101	72	68	33	42	30	85	8	9	45	62	131	10	11	21	15
"GABRR3"	1411	48307	0	0	0	0	0	0	0	0	0	0	0	0	0	0	3	0
"GAD1"	3489	44459	3	0	0	3	0	0	22	0	0	0	4	4	0	0	0	0
"GAD2"	2841	88257	0	0	0	0	0	0	10	0	0	0	0	0	0	0	0	0
"GADD45A"	1359	3138	332	2904	164	168	1583	1321	21	1046	0	973	334	6205	509	5295	601	3255
"GADD45B"	1367	2124	68	438	18	50	219	219	16	230	62	358	275	4294	395	7266	503	10375
"GADD45G"	1178	1397	81	0	31	50	0	0	44	68	0	35	354	113	519	219	577	227
"GADD45GIP1"	744	3079	15	0	15	0	0	0	18	15	0	0	1625	1535	479	384	581	408
"GADL1"	3670	168463	0	0	0	0	0	0	0	0	0	0	0	0	0	0	0	0
"GAGE1"	959	7337	0	0	0	0	0	0	0	0	0	0	0	0	0	0	0	0
"GAGE10"	554	16188	1	0	0	1	0	0	0	0	0	0	0	0	0	0	0	0
"GAGE12B"	589	7386	0	0	0	0	0	0	0	0	0	0	0	0	0	0	0	0
"GAGE12E"	589	7377	0	0	0	0	0	0	0	0	0	0	0	0	0	0	0	0
"GAGE12F"	469	15768	0	0	0	0	0	0	0	0	0	0	0	0	0	0	0	0
"GAGE12I"	559	77965	0	0	0	0	0	0	0	0	0	0	0	0	0	0	0	0
"GAGE12J"	578	116083	0	0	0	0	0	0	0	0	0	0	0	0	0	0	0	0
"GAGE13"	544	135169	0	0	0	0	0	0	0	0	0	0	0	0	0	0	0	0
"GAGE2A"	575	97039	0	0	0	0	0	0	0	0	0	0	0	0	0	0	0	0
"GAGE2B"	528	26365	0	0	0	0	0	0	0	0	0	0	0	0	0	0	0	0
"GAGE2C"	575	16868	0	0	0	0	0	0	0	0	0	0	0	0	0	0	0	0
"GAGE2D"	575	26391	0	0	0	0	0	0	0	0	0	0	0	0	0	0	0	0
"GAGE2E"	564	7360	1	0	0	1	0	0	0	0	0	0	0	0	0	0	0	0
"GAGE4"	578	35915	0	0	0	0	0	0	0	0	0	0	0	0	0	0	0	0
"GAGE6"	589	7388	0	0	0	0	0	0	0	0	0	0	0	0	0	0	0	0
"GAGE7"	559	7320	0	0	0	0	0	0	0	0	0	0	0	0	0	0	0	0
"GAGE8"	937	16842	0	0	0	0	0	0	0	0	0	0	0	0	0	0	0	0
"GAK"	4558	83110	11138	9645	5920	5218	5193	4452	4383	6348	11132	13142	2093	2755	2982	2925	4907	2552
"GAL"	783	6661	0	0	0	0	0	0	22	0	0	0	30	27	4	4	31	11
"GAL3ST1"	1795	10254	0	0	0	0	0	0	23	0	0	0	0	0	0	0	0	0
"GAL3ST2"	1453	27464	0	0	0	0	0	0	69	41	0	0	0	0	0	0	0	0
"GAL3ST3"	3322	8416	1	0	1	0	0	0	0	15	0	0	3	0	0	0	0	0
"GAL3ST4"	3166	8871	1	2	1	0	0	2	43	39	0	1	0	0	3	0	0	0
"GALC"	4190	60549	77	0	42	35	0	0	185	4	37	0	1123	1174	1134	1019	1034	820
"GALE"	1834	5207	84	69	33	51	19	50	134	91	37	158	273	304	422	421	433	329
"GALK1"	1417	13607	14	0	0	14	0	0	91	7	0	0	486	371	519	463	680	567
"GALK2"	3355	159561	1713	164	926	787	110	54	1583	211	109	62	359	444	425	387	458	377
"GALM"	2489	68858	5074	544	2928	2146	310	234	2339	511	2714	242	2572	2113	2700	2339	3649	2198
"GALNS"	2547	43233	3895	1955	2105	1790	1086	869	2101	1764	4353	3976	779	467	1066	1116	1614	1166
"GALNT1"	3882	130021	5576	3374	3195	2381	1987	1387	2925	1857	1004	1823	3614	4074	4236	3918	4475	3364
"GALNT10"	5610	229516	1064	247	653	411	133	114	1247	339	35	362	836	976	1113	953	1400	886
"GALNT11"	3867	12462	7258	6423	4059	3199	3491	2932	3388	3785	1999	5182	396	706	906	692	994	646
"GALNT12"	2740	42379	4044	450	2288	1756	271	179	2192	187	4094	327	2683	1885	6231	4419	6201	4939
"GALNT13"	5676	582064	2	0	0	2	0	0	0	0	0	0	0	0	0	0	0	0
"GALNT14"	2860	228239	0	0	0	0	0	0	77	20	0	0	0	0	0	0	5	0
"GALNT2"	4567	224341	4812	1210	2700	2112	758	452	3413	1804	1253	860	1615	1556	2564	2402	2870	2157
"GALNT3"	3278	46492	104	3774	75	29	2102	1672	0	1458	0	278	48	480	61	155	105	90
"GALNT4"	5345	5345	68	20	35	33	0	20	29	27	0	34	418	338	358	571	310	212
"GALNT5"	3222	53574	0	0	0	0	0	0	10	0	0	0	0	0	0	0	0	0
"GALNT6"	4532	39369	160	11	50	110	0	11	201	44	59	0	886	762	533	454	716	633
"GALNT7"	4318	155215	7374	1943	4123	3251	1057	886	3330	1526	1022	1392	1382	1667	1674	1540	1987	1251
"GALNT8"	2146	52142	0	0	0	0	0	0	0	0	0	0	0	0	1	0	1	0
"GALNT9"	2673	224989	0	0	0	0	0	0	682	268	0	0	1	0	0	0	0	0
"GALNTL1"	5387	91547	0	0	0	0	0	0	83	42	0	0	0	0	0	0	0	0
"GALNTL2"	4650	55070	3	0	0	3	0	0	20	0	0	0	0	0	0	0	0	0
"GALNTL4"	2526	351142	99201	80433	54931	44270	43265	37168	46245	38988	62028	70146	3590	4828	602	602	3344	2370
"GALNTL5"	1992	52720	0	0	0	0	0	0	24	0	0	0	0	0	0	0	0	0
"GALNTL6"	2860	1226983	0	0	0	0	0	0	13	0	0	0	0	0	0	0	0	0
"GALP"	944	9757	0	0	0	0	0	0	0	0	0	0	0	0	0	0	0	0
"GALR1"	2786	20088	0	0	0	0	0	0	37	0	0	0	0	0	0	0	0	0
"GALR2"	1300	2683	0	0	0	0	0	0	0	0	0	0	0	0	0	0	0	0
"GALR3"	1159	2115	0	0	0	0	0	0	0	0	0	0	0	0	0	0	0	0
"GALT"	1788	3938	158	20	72	86	12	8	239	110	83	51	387	409	564	397	813	445
"GAMT"	1063	4465	0	0	0	0	0	0	36	13	0	0	2	3	0	8	0	0
"GAN"	4553	65232	154	57	90	64	40	17	75	55	15	0	89	91	98	46	63	22
"GANAB"	3946	21806	1327	325	765	562	164	161	559	300	732	326	7505	8054	8187	7579	9345	6497
"GANC"	4609	79499	4671	940	2568	2103	518	422	3801	524	1317	682	1413	1492	1408	1074	1890	1031
"GAP43"	2108	98185	0	0	0	0	0	0	0	0	0	0	0	0	0	0	0	0
"GAPD"	1323	3881	889	202	467	422	149	53	265	211	706	249	19836	17636	26415	24177	35831	9918
"GAPDH"	1447	3881	889	202	467	422	149	53	265	211	706	249	19836	17636	26415	24177	35831	9918
"GAPDHS"	1503	11909	84	12	70	14	12	0	152	53	48	33	73	8	49	4	94	0
"GAPT"	2219	4857	0	0	0	0	0	0	0	0	0	0	14	45	73	54	21	0
"GAPVD1"	7055	103180	2813	551	1486	1327	319	232	1394	507	614	712	2334	2380	2431	1835	2533	1594
"GAR1"	1272	9227	30	0	9	21	0	0	39	17	0	0	131	215	206	175	258	186
"GARNL3"	3764	129072	0	3	0	0	0	3	94	25	0	0	14	10	4	0	4	5
"GARS"	2764	39467	1065	2187	594	471	1212	975	588	1094	120	1144	1753	2815	1944	1960	2906	2194
"GART"	3591	38958	453	54	261	192	23	31	246	40	50	28	1043	1107	1201	1032	1376	942
"GAS1"	2827	2827	0	0	0	0	0	0	0	0	0	0	0	0	0	0	0	0
"GAS11"	3263	22373	0	0	0	0	0	0	113	41	0	0	4	5	10	10	50	28
"GAS2"	2249	144894	0	0	0	0	0	0	0	0	0	0	0	0	0	0	0	0
"GAS2L1"	3386	5728	143	23	64	79	1	22	127	130	112	44	868	611	703	572	1115	710
"GAS2L2"	3013	8362	0	0	0	0	0	0	40	23	0	0	1	0	0	0	0	0
"GAS2L3"	2752	31289	5146	7943	2844	2302	4251	3692	2312	2001	436	1752	1861	2084	1666	1693	1545	1397
"GAS5"	1703	4087	807	2157	455	352	1127	1030	341	1017	0	246	376	478	282	295	454	328
"GAS6"	2518	43524	19014	18859	10395	8619	9991	8868	6784	10385	18851	21623	6656	7602	7140	7691	10632	5939
"GAS7"	8225	287944	19711	4247	10987	8724	2462	1785	10531	5364	15627	5015	3437	3401	5148	5104	5059	3228
"GAS8"	3319	22373	0	0	0	0	0	0	127	41	0	0	4	5	10	10	50	28
"GASP"	2871	101256	28134	43209	15616	12518	23068	20141	9041	17160	12399	41132	319	6482	720	1026	811	516
"GAST"	437	3609	0	0	0	0	0	0	16	10	0	0	0	0	0	0	0	0
"GATA1"	1483	7735	0	0	0	0	0	0	19	26	0	0	0	8	21	20	3	3
"GATA2"	3482	9110	0	0	0	0	0	0	91	103	0	0	330	346	575	559	272	91
"GATA3"	3074	20497	0	0	0	0	0	0	42	12	0	0	10	3	0	0	4	0
"GATA4"	3415	55794	0	0	0	0	0	0	31	58	1	0	34	22	0	0	0	0
"GATA5"	2602	12475	0	0	0	0	0	0	50	15	0	0	0	2	0	0	0	0
"GATA6"	3501	32813	0	0	0	0	0	0	10	9	0	0	0	0	0	0	0	0
"GATAD1"	3960	11979	880	216	509	371	127	89	489	190	312	144	1434	1227	1033	676	1258	709
"GATAD2A"	5794	81406	15736	12364	9010	6726	6572	5792	5996	8859	12266	19746	2496	1962	2224	1776	2480	1727
"GATAD2B"	7486	118249	11540	3067	6448	5092	1622	1445	4461	1558	8404	5029	1490	1035	1228	564	1650	841
"GATC"	414	13479	653	128	360	293	83	45	251	331	239	437	3099	3122	431	362	489	291
"GATF-C"	2328	13733	0	0	0	0	0	0	0	0	0	0	0	0	0	0	0	0
"GATM"	3919	17420	0	23	0	0	14	9	10	0	0	0	595	645	700	750	386	383
"GATS"	2742	71578	965	55	499	466	22	33	763	241	164	118	536	565	778	708	1095	678
"GATSL1"	999	59722	0	0	0	0	0	0	0	0	0	0	0	0	5	0	24	0
"GATSL2"	999	59738	0	0	0	0	0	0	0	0	0	0	0	0	5	0	17	0
"GATSL3"	1630	4510	0	195	0	0	118	77	38	127	0	258	50	45	36	96	108	106
"GB14"	3219	4426	210	0	115	95	0	0	91	9	66	0	1582	1282	2204	1487	2625	1449
"GBA"	2565	10246	151	5	95	56	5	0	373	60	73	15	1037	911	1571	2779	5164	3515
"GBA2"	3784	12363	2289	1346	1196	1093	807	539	672	749	1240	1406	1281	1295	2795	2860	3997	2877
"GBA3"	2149	126645	0	57	0	0	29	28	35	37	0	0	1767	2344	2381	2376	2875	2190
"GBAS"	1984	35577	1318	110	778	540	62	48	663	115	477	387	2885	2794	2350	2076	2926	2036
"GBDR1"	2005	28412	2312	267	1328	984	156	111	1346	115	1718	119	1439	1054	1596	1252	2203	1095
"GBE1"	3115	272102	606	386	404	202	226	160	400	460	36	171	520	392	651	551	526	428
"GBF1"	6416	137342	7324	4898	4012	3312	2597	2301	3458	2959	3501	5790	1791	2282	2508	2183	3569	2269
"GBGT1"	1991	10961	566	136	245	321	83	53	510	172	871	294	78	117	165	143	193	392
"GBL"	1563	3677	128	64	97	31	39	25	83	89	92	24	632	485	691	649	789	735
"GBP1"	3061	13058	135	2101	61	74	1123	978	16	1536	0	1340	265	5470	713	5608	586	1536
"GBP2"	3793	44417	957	9149	541	416	4975	4174	244	3984	30	4984	2285	10805	1326	9034	1514	3575
"GBP3"	3131	16184	73	13	34	39	13	0	64	120	0	99	306	390	762	914	709	758
"GBP4"	6155	17803	7	895	0	7	517	378	0	459	0	81	85	1459	140	423	109	109
"GBP5"	4722	10123	406	2142	231	175	1104	1038	158	1623	0	650	574	6470	618	3630	1032	958
"GBP6"	4878	24285	0	0	0	0	0	0	0	0	0	0	0	0	0	0	0	0
"GBP7"	2465	44291	0	0	0	0	0	0	0	1	0	0	0	0	0	0	0	0
"GBX1"	1325	19192	0	0	0	0	0	0	64	56	0	0	0	0	0	0	0	0
"GBX2"	1375	2347	0	0	0	0	0	0	0	0	0	0	0	0	0	0	0	0
"GC"	1791	42477	0	0	0	0	0	0	0	0	0	0	0	0	0	0	0	0
"GC-S-beta-1"	3415	48658	0	0	0	0	0	0	0	0	0	0	26	58	13	28	13	17
"GC1"	973	2351	24	0	14	10	0	0	3	25	0	0	37	28	32	30	58	31
"GCA"	3231	18565	2563	674	1453	1110	374	300	1174	104	647	144	4008	3118	2296	1278	2875	1486
"GCAT"	1623	9230	0	0	0	0	0	0	53	0	0	0	0	0	0	4	0	0
"GCC1"	4133	4973	101	35	40	61	22	13	95	77	0	41	0	0	0	318	0	1
"GCC2"	6999	60278	2229	275	1292	937	162	113	1322	116	433	132	1476	1658	1794	1457	1952	1152
"GCDH"	2105	8810	27	0	17	10	0	0	139	68	0	0	223	195	322	310	412	295
"GCET2"	3474	12431	0	0	0	0	0	0	0	0	0	0	0	0	0	0	0	0
"GCFC"	4027	37958	2178	795	1292	886	403	392	1144	446	678	511	1356	986	1458	812	1039	485
"GCG"	1133	9370	0	0	0	0	0	0	0	0	0	0	0	0	0	0	0	0
"GCGR"	2207	9865	0	0	0	0	0	0	18	34	0	0	1	1	0	0	0	0
"GCH1"	2931	60820	445	10712	296	149	5799	4913	0	7936	0	14456	36	1573	17	3216	54	944
"GCHFR"	716	3628	211	0	142	69	0	0	146	0	0	0	123	78	108	118	270	129
"GCK"	2743	45154	0	0	0	0	0	0	104	24	0	0	0	0	0	0	0	0
"GCKR"	2205	26844	0	0	0	0	0	0	0	21	0	0	0	0	0	5	0	3
"GCLC"	3783	13108	3221	699	1779	1442	353	346	1363	220	542	126	1809	1438	1969	1162	1960	1196
"GCLM"	3081	22424	110	0	54	56	0	0	65	9	0	26	116	134	434	296	633	247
"GCM1"	2768	21864	0	0	0	0	0	0	0	0	0	0	0	0	0	0	0	0
"GCM2"	2367	8641	0	0	0	0	0	0	0	0	0	0	0	0	0	0	0	0
"GCN1L1"	8724	67499	2212	1029	1206	1006	528	501	1749	940	1712	1067	2508	2574	4072	3268	4333	3043
"GCNT1"	5975	65750	3930	603	2226	1704	375	228	1778	173	454	63	1760	1134	908	257	1202	366
"GCNT2"	4674	73653	6832	81746	3853	2979	43866	37880	925	39743	44	71016	330	4624	138	2452	212	1065
"GCNT3"	2366	8229	0	0	0	0	0	0	0	0	0	0	0	9	0	3	0	0
"GCNT4"	3436	3436	0	0	0	0	0	0	0	0	0	0	0	99	0	172	0	0
"GCNT7"	2069	34435	810	1948	494	316	1098	850	611	1870	0	3069	1839	2302	1916	1982	2229	1767
"GCOM1"	6099	125640	244	167	147	97	85	82	440	124	8	58	1243	1263	1454	943	2237	1106
"GCS1"	2943	4227	745	242	340	405	141	101	268	168	689	276	1276	1119	1724	1452	2117	1418
"GCSH"	1164	14051	0	0	0	0	0	0	10	0	0	0	0	0	90	167	114	170
"GDA"	5443	102848	0	0	0	0	0	0	0	0	0	0	0	0	0	4	0	5
"GDAP1"	3893	16717	11	0	8	3	0	0	11	0	0	0	67	79	100	83	32	17
"GDAP1L1"	2305	33105	9	0	9	0	0	0	48	0	0	0	0	0	0	0	0	0
"GDAP2"	8890	66196	3726	914	1974	1752	500	414	1960	405	718	414	1098	1205	1077	739	1345	786
"GDE1"	2941	20435	43	0	29	14	0	0	104	0	0	0	1855	1431	1684	1069	1921	1254
"GDF10"	2676	13378	0	0	0	0	0	0	11	11	0	0	0	0	0	0	3	0
"GDF11"	4262	9602	247	11	150	97	0	11	213	199	29	146	32	39	0	0	5	26
"GDF15"	1202	3020	0	0	0	0	0	0	81	15	0	0	20	25	207	289	153	215
"GDF2"	1938	3763	0	0	0	0	0	0	0	13	0	0	0	0	0	0	0	0
"GDF3"	1225	5980	0	0	0	0	0	0	0	0	0	0	0	0	0	0	0	0
"GDF5"	2572	21421	2610	547	1584	1026	337	210	1790	503	1048	811	295	316	350	264	398	211
"GDF5OS"	1736	2423	0	0	0	0	0	0	0	0	0	0	0	0	0	0	0	0
"GDF6"	3701	18462	0	0	0	0	0	0	0	11	0	0	0	0	0	0	0	0
"GDF7"	1996	4828	0	0	0	0	0	0	0	0	0	0	0	0	0	0	0	0
"GDF9"	2022	3601	0	0	0	0	0	0	0	0	0	0	904	872	1350	1295	1715	1225
"GDI1"	2490	6555	696	486	408	288	304	182	328	262	488	375	2118	2575	3146	3319	3985	3263
"GDI2"	2589	4884	9493	2782	5102	4391	1567	1215	3513	1830	4361	2973	11464	12263	13537	12143	15853	11030
"GDNF"	858	20177	0	0	0	0	0	0	0	12	0	0	0	0	0	0	0	0
"GDPD1"	1831	54041	0	0	0	0	0	0	0	0	0	0	10	28	20	24	24	3
"GDPD2"	2335	10241	0	0	0	0	0	0	0	14	0	0	0	0	0	0	0	0
"GDPD3"	1334	8748	20	0	7	13	0	0	55	9	0	0	0	0	19	0	31	0
"GDPD4"	2548	70861	5	0	0	5	0	0	10	0	0	0	0	0	0	0	0	0
"GDPD5"	3313	44849	1869	316	1005	864	174	142	1405	524	714	268	593	617	716	473	1148	669
"GEFT"	2597	5809	1	0	1	0	0	0	14	0	0	0	0	0	0	0	0	0
"GEM"	2196	13072	0	54	0	0	42	12	12	52	0	41	56	318	92	2181	78	838
"GEMIN4"	3743	7842	6	90	0	6	48	42	103	261	0	176	395	799	516	814	493	464
"GEMIN5"	5432	50802	12	0	0	12	0	0	48	23	0	0	445	450	590	354	628	358
"GEMIN6"	1213	30430	10	0	5	5	0	0	0	0	0	0	203	116	189	86	234	92
"GEMIN7"	1650	12254	332	24	230	102	14	10	228	159	168	215	252	292	314	154	390	182
"GEMIN8"	3263	23191	15	0	15	0	0	0	51	0	0	0	221	134	153	132	175	131
"GEN1"	6381	31220	1096	362	563	533	189	173	447	197	43	107	552	602	397	310	433	229
"GFAP"	3090	9923	0	0	0	0	0	0	23	12	0	0	0	0	0	0	0	0
"GFER"	2410	3600	56	0	35	21	0	0	59	49	0	0	263	234	312	282	420	285
"GFI1"	2793	12116	38	0	22	16	0	0	11	0	0	20	61	56	52	7	73	12
"GFI1B"	2001	13191	0	0	0	0	0	0	55	14	0	0	0	0	9	0	19	13
"GFM1"	3483	48043	749	189	422	327	101	88	533	291	21	123	1220	1432	1774	1611	1575	1188
"GFM2"	3233	46013	691	13	350	341	13	0	489	31	40	0	911	508	1629	1219	1127	573
"GFOD1"	2996	123970	16008	3130	8938	7070	1624	1506	7710	917	8308	1037	1523	1571	1036	907	978	627
"GFOD2"	5297	38656	332	14	206	126	0	14	275	92	61	17	331	236	310	94	404	184
"GFPP"	1382	7965	105	9	66	39	0	9	246	4	60	0	731	541	743	370	771	364
"GFPT1"	8660	67479	2523	320	1525	998	189	131	974	53	346	119	1295	1523	1501	1141	1720	1270
"GFPT2"	3030	52617	0	0	0	0	0	0	80	29	0	0	0	0	0	0	0	0
"GFRA1"	9572	216684	0	0	0	0	0	0	8	0	0	0	0	0	0	0	0	0
"GFRA2"	3339	96818	55	0	55	0	0	0	936	170	0	0	349	378	411	585	501	327
"GFRA3"	1937	22184	0	0	0	0	0	0	0	0	0	0	0	0	0	0	0	0
"GFRA4"	1521	4108	0	0	0	0	0	0	23	0	0	0	0	0	0	0	0	0
"GFRAL"	1920	75026	0	0	0	0	0	0	0	0	0	0	0	0	0	0	0	0
"GGA1"	3223	24525	4141	1071	2418	1723	620	451	1632	848	3452	1548	1323	1212	2722	2140	3661	2123
"GGA2"	5202	46166	2637	444	1520	1117	275	169	1810	319	1643	337	1052	987	5701	4605	4974	3317
"GGA3"	3863	24984	2362	618	1152	1210	329	289	898	492	1379	875	2413	1908	2827	1800	2308	2166
"GGCT"	1167	8215	478	120	265	213	57	63	340	17	0	54	1167	714	623	945	447	257
"GGCX"	3262	12466	272	15	170	102	4	11	174	83	192	74	421	287	500	556	603	551
"GGH"	1497	23969	0	0	0	0	0	0	0	0	0	0	39	61	43	38	55	42
"GGN"	2158	3678	45	10	29	16	0	10	104	140	0	0	0	0	0	0	0	0
"GGNBP2"	2790	45472	1979	1645	1064	915	896	749	1118	691	667	1506	1391	1668	1490	1364	1926	1022
"GGPS1"	4169	15513	175	45	88	87	19	26	166	42	0	1	800	761	631	390	764	430
"GGT1"	2701	25860	0	0	0	0	0	0	70	14	2	0	166	128	403	272	285	245
"GGT2"	767	1512	0	0	0	0	0	0	0	0	0	0	0	0	0	0	0	0
"GGT3P"	2331	31792	0	0	0	0	0	0	22	0	0	0	0	0	91	66	47	28
"GGT5"	2508	25489	4138	1275	2256	1882	709	566	1023	744	4262	3421	1285	2630	1408	630	2064	756
"GGT6"	2650	3654	0	0	0	0	0	0	24	19	0	0	2	1	0	0	0	0
"GGT7"	2724	13417	543	198	292	251	129	69	294	107	405	163	347	389	253	203	493	236
"GGT8P"	2486	6787	0	25	0	0	25	0	11	98	0	106	0	0	3	0	0	0
"GGTA1"	1762	44989	13437	11522	7395	6042	6176	5346	5782	4515	11850	14216	6615	2905	5598	2647	2926	4294
"GGTLC1"	1051	3727	0	0	0	0	0	0	17	13	0	0	0	0	0	0	0	0
"GGTLC2"	954	1588	0	0	0	0	0	0	12	0	0	0	0	0	58	48	39	38
"GH1"	826	1636	0	0	0	0	0	0	23	14	0	0	0	0	0	0	0	0
"GH2"	1082	1653	29	37	29	0	17	20	23	35	0	0	0	0	0	0	0	0
"GHDC"	2701	5151	0	1	0	0	0	1	110	28	0	0	457	384	613	552	805	546
"GHITM"	2458	14128	760	1094	422	338	618	476	329	530	80	479	5645	9361	5558	4739	6248	5584
"GHR"	4369	297901	0	0	0	0	0	0	0	0	0	0	0	0	0	0	0	0
"GHRH"	568	10748	0	14	0	0	10	4	30	4	0	2	0	0	0	0	0	0
"GHRHR"	1630	9995	0	0	0	0	0	0	53	15	0	0	0	0	0	0	0	0
"GHRL"	1108	7199	841	1411	490	351	720	691	405	438	1075	970	0	40	12	13	39	5
"GHRLOS"	1302	6036	690	699	400	290	334	365	405	438	1075	643	0	18	12	12	39	5
"GHSR"	1103	3254	0	0	0	0	0	0	0	0	0	0	0	0	0	0	0	0
"GIDRP88"	1579	110274	9200	6472	5131	4069	3695	2777	4484	3838	2585	5347	900	1153	919	778	1121	739
"GIF"	1520	16228	0	0	0	0	0	0	0	0	0	0	0	0	0	0	0	0
"GIG18"	2130	33904	83	0	30	53	0	0	94	0	9	0	610	423	598	457	765	605
"GIG24"	1891	2789	0	0	0	0	0	0	36	0	0	0	0	0	0	0	0	0
"GIGYF1"	6353	9742	1585	737	945	640	402	335	441	442	696	718	1270	272	1721	919	1076	1353
"GIGYF2"	7983	163272	8142	2567	4575	3567	1473	1094	4399	1296	2151	1613	2496	2453	2926	2103	2865	1717
"GIMAP1"	1285	35459	84	10	70	14	0	10	125	0	0	0	729	417	839	339	779	324
"GIMAP2"	1443	7934	68	10	54	14	0	10	125	0	0	0	625	403	681	301	631	285
"GIMAP4"	2009	6584	10	0	10	0	0	0	24	0	0	0	577	424	722	430	704	522
"GIMAP5"	1864	6287	26	8	14	12	0	8	11	29	0	0	135	79	211	142	236	209
"GIMAP6"	3647	7216	0	0	0	0	0	0	0	0	0	0	190	105	236	96	236	105
"GIMAP7"	1230	6217	23	0	10	13	0	0	0	0	0	0	223	134	331	114	260	121
"GIMAP8"	3947	28522	0	0	0	0	0	0	18	0	0	0	85	56	237	29	170	74
"GIN1"	3557	34140	100	0	52	48	0	0	220	0	0	25	206	156	148	68	215	72
"GINS1"	3419	40870	0	0	0	0	0	0	0	0	0	0	21	62	14	4	9	8
"GINS2"	1184	11309	230	28	125	105	16	12	106	43	47	0	0	0	0	0	5	0
"GINS3"	2394	13751	0	0	0	0	0	0	0	0	0	0	141	94	95	28	178	75
"GINS4"	3847	15840	0	26	0	0	13	13	38	4	0	0	119	167	102	125	131	78
"GIOT-2"	3348	47257	2306	1339	1341	965	716	623	1042	674	1122	1912	397	588	307	330	403	210
"GIP"	717	10039	0	0	0	0	0	0	19	0	0	0	0	0	0	0	0	0
"GIPC1"	1937	18374	1	0	0	1	0	0	65	33	0	0	369	325	364	296	743	547
"GIPC2"	2828	91524	2	0	0	2	0	0	0	0	0	0	555	595	0	0	0	0
"GIPC3"	4322	7971	38	10	33	5	6	4	16	13	0	0	168	189	488	388	845	610
"GIPR"	2038	14217	259	48	123	136	43	5	232	154	75	0	28	96	0	0	91	7
"GIT1"	3781	16125	919	69	435	484	49	20	547	157	473	11	2160	1276	2195	1365	3005	1786
"GIT2"	5641	66589	8528	1706	4510	4018	1002	704	3942	712	6140	1616	5437	4612	4584	2730	5394	4088
"GITA/7p fusion"	4218	167948	1234	639	774	460	367	272	1053	499	332	425	395	434	510	503	482	394
"GIYD1"	1591	3674	39	0	19	20	0	0	18	0	0	0	24	12	2169	1828	2732	1697
"GIYD2"	1116	3665	39	0	19	20	0	0	18	0	0	0	24	12	2169	1828	2732	1697
"GJA1"	3131	14129	0	0	0	0	0	0	0	0	0	0	0	0	0	0	0	0
"GJA10"	1631	1631	0	0	0	0	0	0	0	0	0	0	0	0	0	0	0	0
"GJA3"	5207	22790	0	0	0	0	0	0	0	14	0	0	0	0	0	0	0	0
"GJA4"	1786	3177	0	0	0	0	0	0	15	0	0	0	0	0	0	0	0	0
"GJA5"	3179	17154	0	0	0	0	0	0	0	0	0	0	0	0	0	0	0	0
"GJA8"	1376	6459	0	0	0	0	0	0	0	0	0	0	0	0	0	0	0	0
"GJA9"	2787	8024	481	50	288	193	28	22	283	53	146	83	4	0	13	20	15	10
"GJB1"	1656	2011	0	0	0	0	0	0	0	0	0	0	0	0	0	0	0	0
"GJB2"	2332	5510	0	80	0	0	51	29	0	92	0	149	157	893	178	2003	219	1250
"GJB3"	3679	3679	0	0	0	0	0	0	0	0	0	0	0	0	0	0	0	0
"GJB4"	2842	3985	0	0	0	0	0	0	17	0	0	0	0	0	0	0	0	0
"GJB5"	1284	3394	0	0	0	0	0	0	0	14	0	0	0	0	0	0	0	0
"GJB6"	2150	10434	0	0	0	0	0	0	0	0	0	0	0	0	0	0	0	0
"GJB7"	2283	46301	1	0	1	0	0	0	41	0	33	0	3	6	8	1	2	0
"GJC1"	7882	9437	0	0	0	0	0	0	10	0	0	0	1	0	0	0	0	0
"GJC2"	2243	9974	11	0	0	11	0	0	53	63	0	28	1	1	0	0	0	0
"GJC3"	841	6076	0	0	0	0	0	0	11	0	0	0	0	0	0	0	0	0
"GJD2"	968	2012	0	0	0	0	0	0	0	0	0	0	0	0	0	0	0	0
"GJD3"	4040	4040	0	0	0	0	0	0	18	0	0	0	149	156	192	109	228	140
"GJD4"	1582	3527	0	0	0	0	0	0	0	0	0	0	0	0	0	0	0	0
"GK"	3911	77250	3239	8345	1886	1353	4618	3727	991	1584	216	3311	743	1074	1291	1280	1465	1386
"GK002"	1296	13089	424	314	218	206	250	64	315	202	44	64	371	1399	1152	338	420	902
"GK004"	928	241838	425	17	198	227	0	17	705	70	237	41	891	834	1173	861	1249	845
"GK2"	1866	1866	0	0	0	0	0	0	0	0	0	0	0	0	0	0	0	0
"GK5"	9832	68061	149	21	86	63	14	7	24	36	16	6	491	531	233	197	267	92
"GKAP1"	1885	78417	0	0	0	0	0	0	0	0	0	0	6	1	0	0	0	0
"GKN1"	825	6408	0	0	0	0	0	0	0	0	0	0	0	0	0	0	0	0
"GKN2"	1578	7660	0	0	0	0	0	0	0	0	0	0	0	0	0	0	0	0
"GKT-ATA37"	1972	9241	36	612	0	36	81	531	56	701	0	241	12	272	20	169	47	95
"GL002"	2312	9330	180	65	117	63	24	41	168	24	0	0	338	355	365	280	435	309
"GLA"	1425	10224	102	373	48	54	201	172	80	111	74	165	1992	2677	1455	2517	2640	2333
"GLB1"	2749	100596	6881	1085	3721	3160	591	494	3308	726	2994	1324	3809	2724	5730	4792	5646	3116
"GLB1L"	2522	8628	54	0	24	30	0	0	109	16	57	0	267	211	496	279	377	142
"GLB1L2"	3383	44451	0	0	0	0	0	0	132	88	0	0	0	0	0	0	0	0
"GLB1L3"	2963	43184	0	0	0	0	0	0	43	8	0	0	1	0	0	0	0	0
"GLCCI1"	4750	120286	307	131	179	128	93	38	359	95	0	30	219	246	151	142	209	162
"GLCE"	5048	111573	769	0	465	304	0	0	554	22	0	0	1036	1049	739	533	1187	598
"GLDC"	3832	113228	0	0	0	0	0	0	0	0	0	0	0	0	0	0	0	0
"GLDN"	5091	66496	0	0	0	0	0	0	0	0	0	0	0	0	0	0	6	0
"GLE1"	3357	37610	525	63	369	156	44	19	348	48	470	24	1650	1305	1679	1133	2061	1281
"GLG1"	9353	159716	7958	7292	4557	3401	3947	3345	2980	4498	2595	12168	3874	3994	4892	3707	6395	3943
"GLI1"	3628	12129	167	51	84	83	0	51	84	10	0	0	2	2	0	335	0	0
"GLI2"	6781	195363	0	0	0	0	0	0	892	329	0	0	0	0	0	0	0	0
"GLI3"	8227	276070	0	0	0	0	0	0	21	0	0	0	0	0	0	0	0	0
"GLI4"	1345	9494	590	173	341	249	73	100	324	132	359	347	145	76	198	135	493	200
"GLIPR1"	3912	21204	2649	2219	1368	1281	1121	1098	1374	1118	499	1555	5865	7573	7580	5922	6815	5054
"GLIPR1L1"	992	35706	0	0	0	0	0	0	25	0	0	0	0	4	0	0	0	0
"GLIPR1L2"	1830	40704	0	0	0	0	0	0	0	0	0	0	0	0	0	0	0	0
"GLIPR2"	2269	27161	3928	1570	2182	1746	869	701	1572	1033	3670	3608	6224	6177	5342	4793	7256	5223
"GLIS1"	2826	227973	0	0	0	0	0	0	836	264	0	0	0	0	0	0	0	0
"GLIS2"	3720	7384	116	0	32	84	0	0	172	97	0	0	375	207	325	186	329	183
"GLIS3"	7661	475909	0	9	0	0	9	0	0	9	0	0	0	0	0	0	0	0
"GLMN"	2049	52611	864	427	504	360	253	174	665	172	81	70	302	273	163	120	177	125
"GLO1"	2050	27250	85	0	51	34	0	0	86	0	0	0	2050	2362	1319	1200	1686	1263
"GLOD4"	2331	18384	349	143	195	154	84	59	275	148	85	140	981	956	1233	1071	1372	906
"GLOD5"	1258	5239	0	0	0	0	0	0	14	9	0	0	0	0	0	0	0	0
"GLOMULIN"	1963	52611	864	427	504	360	253	174	665	172	81	70	302	273	163	120	177	125
"GLP1R"	3135	38964	0	0	0	0	0	0	102	60	0	0	0	0	0	0	0	0
"GLP2R"	1675	63643	0	0	0	0	0	0	28	10	0	0	0	0	0	0	0	0
"GLRA1"	1829	102324	0	0	0	0	0	0	10	26	0	0	0	0	0	0	0	0
"GLRA2"	3452	202513	0	0	0	0	0	0	0	0	0	0	0	0	0	0	0	0
"GLRA3"	3647	187269	0	0	0	0	0	0	10	26	0	0	0	0	0	0	0	0
"GLRA4"	1844	10052	0	0	0	0	0	0	0	0	0	0	0	0	0	0	0	0
"GLRB"	3068	95967	0	0	0	0	0	0	0	0	0	0	0	0	0	0	0	0
"GLRX"	1649	9025	588	1914	332	256	1097	817	297	568	26	1944	1368	994	1002	3314	1070	3350
"GLRX2"	1133	9646	168	0	106	62	0	0	167	0	0	4	197	238	196	164	262	163
"GLRX3"	1933	48123	1498	560	905	593	265	295	877	684	585	906	487	592	694	597	964	531
"GLRX5"	1173	9734	41	0	27	14	0	0	55	72	0	37	640	571	624	506	769	534
"GLS"	4808	45789	18350	18555	10064	8286	10107	8448	8880	5040	7614	8685	7042	9105	8166	6876	8621	5410
"GLS2"	2713	17446	181	8	105	76	0	8	220	101	0	161	238	310	0	0	48	19
"GLT1D1"	2952	120830	0	0	0	0	0	0	102	7	0	0	0	1	0	0	0	0
"GLT25D1"	3605	27456	2849	1135	1519	1330	586	549	1030	469	2039	839	7839	6965	10619	8102	10197	6900
"GLT25D2"	5193	101898	52	176	30	22	98	78	195	140	0	241	27	29	5	5	7	3
"GLT6D1"	1531	15886	0	0	0	0	0	0	0	0	0	0	0	0	0	0	0	0
"GLT8D1"	2334	11545	131	27	65	66	27	0	251	141	0	0	959	1380	344	1179	1283	1235
"GLT8D2"	2139	75198	18	0	0	18	0	0	49	20	0	19	554	1594	5597	5078	6457	5353
"GLT8D3"	7494	63025	858	14	443	415	14	0	771	44	110	43	893	714	1128	501	1079	516
"GLT8D4"	1549	87137	0	0	0	0	0	0	0	0	0	0	1	0	0	0	0	3448
"GLTP"	2360	29546	577	542	308	269	244	298	351	683	356	1185	1041	1241	605	746	1285	894
"GLTPD1"	2195	4134	1	0	1	0	0	0	128	97	0	0	349	186	433	204	533	283
"GLTPD2"	1027	1433	19	0	0	19	0	0	10	13	0	0	115	0	32	17	51	0
"GLTSCR1"	5763	24316	3532	222	1959	1573	123	99	1840	425	2347	834	330	201	480	287	548	316
"GLTSCR2"	1647	11644	205	214	126	79	112	102	128	211	0	315	1132	926	2545	2165	3515	2525
"GLUD1"	3049	44379	2910	1112	1618	1292	620	492	1346	647	505	1043	3662	3791	3055	4587	6472	2027
"GLUD2"	2334	2334	102	0	63	39	0	0	18	0	0	0	1698	1821	762	619	865	558
"GLUL"	4306	9257	1872	446	1050	822	233	213	1236	229	1396	87	859	8640	26095	18111	18291	9934
"GLYAT"	2060	23218	0	0	0	0	0	0	0	0	0	0	0	0	0	0	0	0
"GLYATL1"	2075	13796	0	0	0	0	0	0	0	0	0	0	0	0	0	0	0	0
"GLYATL2"	1521	10457	0	0	0	0	0	0	0	0	0	0	0	0	0	0	0	0
"GLYCAM1"	785	2277	0	0	0	0	0	0	0	0	0	0	0	0	0	0	0	0
"GLYCTK"	3802	7437	1005	381	627	378	243	138	432	377	410	363	90	94	182	163	215	114
"GLYCTK1"	2797	7437	1005	381	627	378	243	138	432	377	410	363	90	94	182	163	215	114
"GLYR1"	3747	44100	2872	1589	1600	1272	907	682	1196	1059	1765	2498	3697	3467	5036	4320	6383	3932
"GM2A"	3690	17340	4665	1912	2679	1986	1047	865	3226	884	1483	622	20400	18320	35405	36856	22682	19372
"GMCL1"	2363	49914	201	0	139	62	0	0	104	8	0	0	562	467	619	375	612	263
"GMDS"	1682	621806	788	172	467	321	82	90	1301	740	47	605	150	156	156	161	196	169
"GMEB1"	1970	46143	256	752	151	105	360	392	136	615	51	1815	690	1057	362	608	482	425
"GMEB2"	4568	32276	205	166	102	103	118	48	285	683	0	1088	542	635	599	799	775	740
"GMFB"	4132	14537	599	160	331	268	110	50	334	160	39	69	2927	3161	443	353	3342	2124
"GMFG"	1113	7728	729	138	415	314	58	80	395	126	1052	518	2725	2558	2535	2041	3990	2069
"GMIP"	3537	14171	2510	1093	1470	1040	566	527	821	578	1920	1730	4819	2850	2503	2267	5781	2314
"GML"	726	12046	0	0	0	0	0	0	0	0	0	0	0	0	0	0	0	0
"GMNN"	1220	11114	60	0	40	20	0	0	85	0	0	0	150	98	162	96	170	92
"GMPPA"	1849	8083	245	39	120	125	13	26	277	90	0	8	475	214	830	718	680	637
"GMPPB"	1650	2454	184	49	32	152	23	26	174	58	0	22	665	614	678	623	782	640
"GMPR"	1522	56969	196	131	132	64	70	61	72	37	0	135	18	26	105	65	157	166
"GMPR2"	2218	6799	299	965	137	162	567	398	114	90	272	153	1627	3169	3092	2461	3614	1459
"GMPS"	2470	67195	1757	105	919	838	64	41	916	31	400	119	1505	1188	1229	859	1547	813
"GNA11"	1604	27046	7	0	0	7	0	0	244	111	0	0	406	412	400	125	750	456
"GNA12"	4386	116218	6723	5191	3657	3066	2914	2277	3154	4210	2984	6981	2430	155	3382	158	3584	75
"GNA13"	6313	47513	6247	22157	3443	2804	11800	10357	2166	8915	1689	10073	5413	8903	5448	6097	5805	3876
"GNA14"	2497	225238	0	0	0	0	0	0	20	0	0	0	4	0	0	0	0	0
"GNA15"	2139	27577	1092	786	595	497	406	380	619	688	187	1778	1925	2400	1762	1995	2651	1918
"GNAI1"	3326	84587	0	0	0	0	0	0	12	0	0	0	3	0	0	0	4	3
"GNAI2"	2997	33064	7425	2548	3978	3447	1314	1234	2874	1613	7714	4789	23455	21517	21223	20097	33909	21583
"GNAI3"	4739	47268	2771	6756	1710	1061	3571	3185	1319	4052	146	6698	3068	4358	3056	3669	3446	2691
"GNAL"	4039	131584	207	102	121	86	53	49	167	25	0	0	2308	2252	2559	1702	3062	1917
"GNAO1"	6218	156861	0	0	0	0	0	0	293	143	0	0	0	0	0	0	0	0
"GNAQ"	3776	3776	66127	49010	36885	29242	26601	22409	29439	21474	31484	29440	3867	5524	756	4413	5332	3733
"GNAS"	3777	58215	3784	1757	2063	1721	931	826	1868	949	1928	1222	14760	14258	15674	14563	20722	9630
"GNAS1"	1161	31986	0	0	0	0	0	0	96	36	0	0	2	19	0	0	0	0
"GNAT1"	3608	6088	1	0	1	0	0	0	0	29	0	0	8	2	0	1	0	0
"GNAT2"	1372	9817	815	1029	472	343	575	454	431	637	255	1078	100	284	0	62	61	0
"GNAT3"	1071	53255	0	0	0	0	0	0	0	0	0	0	0	0	0	0	0	0
"GNAZ"	3211	54554	0	0	0	0	0	0	400	203	0	0	0	0	0	0	0	0
"GNB1"	3139	105767	21317	26573	11942	9375	14122	12451	6808	14004	18493	37795	3712	4885	13560	13629	16849	12365
"GNB1L"	1683	66407	617	0	290	327	0	0	828	223	161	36	404	99	700	160	820	273
"GNB2"	1790	2334	1476	247	800	676	83	164	197	166	580	524	4869	4410	5349	5008	5745	4272
"GNB2L1"	1650	6980	6221	10988	3525	2696	5770	5218	730	2804	1166	1332	9265	11289	10798	11212	18079	13153
"GNB3"	2877	7440	0	0	0	0	0	0	59	31	0	0	0	0	1	0	0	0
"GNB4"	6437	55496	6955	1603	3954	3001	904	699	3232	762	2302	915	7051	8277	8856	6278	8848	5371
"GNB5"	3097	70444	5	0	0	5	0	0	76	4	0	0	234	104	77	47	147	67
"GNE"	5317	44051	885	466	544	341	289	177	704	376	0	182	892	1146	723	721	925	541
"GNG1"	1944	319501	0	0	0	0	0	0	0	0	0	0	0	6	0	0	0	3
"GNG10"	1246	8665	601	183	315	286	102	81	203	129	320	158	864	1039	2703	2574	3156	2566
"GNG11"	954	4810	0	0	0	0	0	0	0	0	0	0	0	0	0	0	0	0
"GNG12"	4400	131995	0	0	0	0	0	0	0	0	0	0	0	0	0	0	0	0
"GNG13"	984	2691	0	0	0	0	0	0	25	27	0	0	0	8	12	12	0	0
"GNG2"	4308	122567	148	1329	69	79	672	657	169	694	0	121	494	567	591	570	713	460
"GNG3"	905	1565	357	25	209	148	13	12	217	54	122	41	64	3	51	44	0	3
"GNG4"	5108	102308	0	0	0	0	0	0	89	54	0	0	0	0	0	0	0	0
"GNG5"	809	8257	984	410	571	413	215	195	442	229	443	425	2040	1918	1428	1140	2602	791
"GNG7"	4251	191530	509	0	284	225	0	0	1285	537	827	125	400	353	203	185	539	367
"GNG8"	214	607	0	0	0	0	0	0	0	0	0	0	0	0	0	0	0	3
"GNGT1"	631	4667	0	0	0	0	0	0	0	0	0	0	0	0	0	0	0	0
"GNGT2"	1043	3148	0	0	0	0	0	0	0	0	0	0	17	22	41	36	16	20
"GNL1"	3019	11317	377	165	140	237	89	76	157	205	41	237	645	792	615	588	871	493
"GNL2"	2417	29174	805	906	502	303	508	398	367	773	46	1301	1304	1754	1515	1721	1699	1425
"GNL3"	2152	8574	557	514	243	314	292	222	239	326	268	363	2225	2458	1522	1881	2573	1647
"GNL3L"	6842	35331	1225	390	692	533	243	147	646	250	385	344	1395	1756	814	750	958	714
"GNLY"	993	4462	237	189	125	112	85	104	89	119	61	173	142	198	346	370	817	593
"GNMT"	1073	3119	1	0	1	0	0	0	57	11	0	0	0	1	15	6	16	15
"GNN"	2389	16186	31	0	2	29	0	0	47	0	0	0	0	0	0	0	4	0
"GNPAT"	2695	36801	589	14	287	302	4	10	528	72	15	22	1144	920	1092	805	1707	792
"GNPDA1"	2991	12123	86	26	22	64	15	11	140	24	0	0	997	923	1335	1057	1620	1008
"GNPDA2"	5438	23351	167	0	96	71	0	0	161	2	0	0	160	136	152	79	129	102
"GNPNAT1"	3933	16476	313	14	137	176	0	14	221	0	0	0	580	425	368	229	339	189
"GNPTA"	2261	7919	1548	638	865	683	365	273	702	873	177	502	155	284	456	353	408	186
"GNPTAB"	5635	85356	3193	1205	1692	1501	653	552	1661	1211	326	639	1830	3588	3889	2716	3682	1802
"GNPTG"	1223	11421	2020	1110	1095	925	541	569	717	587	1895	1868	749	1926	2769	2526	3078	2206
"GNRH1"	2151	5782	86	66	32	54	30	36	84	8	0	0	28	0	50	0	27	0
"GNRH2"	427	2125	0	0	0	0	0	0	31	0	0	0	0	0	0	0	0	0
"GNRHR"	5833	18700	138	23	60	78	10	13	515	55	0	0	0	1	0	0	0	0
"GNRHR2"	6258	6258	0	0	0	0	0	0	58	17	0	0	909	1419	1146	960	1180	829
"GNS"	5237	46004	4264	4179	2393	1871	2326	1853	2372	2778	2414	2094	19755	21984	28786	27793	23560	17289
"GOLGA1"	4904	62814	769	0	432	337	0	0	606	97	119	115	720	707	1072	860	1130	763
"GOLGA2"	4285	20161	651	249	392	259	131	118	510	202	130	247	922	1076	1237	1120	1520	1039
"GOLGA2L1"	4454	10301	0	0	0	0	0	0	40	0	0	0	2	0	0	0	6	0
"GOLGA2LY1"	1070	4865	0	0	0	0	0	0	0	0	0	0	0	0	0	0	0	0
"GOLGA3"	9276	59795	5879	3407	3268	2611	1863	1544	2608	2175	3717	3666	7528	7924	4803	4981	6569	4969
"GOLGA4"	7725	123505	6272	7437	3603	2669	4047	3390	3333	4019	1025	5632	2476	3615	3451	3327	3982	2227
"GOLGA5"	2904	45656	632	20	349	283	17	3	452	26	14	67	702	891	1288	880	1346	916
"GOLGA6"	3135	12631	0	0	0	0	0	0	65	0	0	0	0	0	0	0	0	0
"GOLGA6A"	3194	12695	0	0	0	0	0	0	0	0	0	0	0	0	0	0	0	0
"GOLGA6B"	3196	12702	5	3	5	0	2	1	15	0	0	0	0	0	0	0	0	0
"GOLGA6D"	3465	12966	4	5	3	1	2	3	0	0	0	0	0	1	0	0	0	0
"GOLGA6L1"	3831	9758	0	0	0	0	0	0	0	0	0	0	0	0	0	0	0	0
"GOLGA6L5"	7318	12342	0	0	0	0	0	0	0	0	0	0	0	0	0	17	64	27
"GOLGA6L6"	4100	10022	0	0	0	0	0	0	0	0	0	0	0	0	0	0	0	0
"GOLGA6L9"	4381	9401	0	0	0	0	0	0	0	0	0	0	0	0	9	14	62	37
"GOLGA7"	2030	20326	284	174	159	125	111	63	245	282	0	192	2291	2589	1978	1963	2488	1928
"GOLGA7B"	2898	17787	0	0	0	0	0	0	15	0	0	0	0	0	55	34	0	5
"GOLGA8A"	4277	10731	178	3372	18	160	1869	1503	1116	1064	1605	1958	1539	2369	8162	6103	7017	5937
"GOLGA8B"	5214	8891	704	566	685	19	14	552	127	167	176	364	3	603	4245	3192	6511	2554
"GOLGA8E"	5357	13445	0	0	0	0	0	0	0	0	0	0	0	0	16	0	10	0
"GOLGA8F"	5288	13389	0	0	0	0	0	0	0	0	0	0	0	0	0	0	0	0
"GOLGA8G"	5300	13389	0	0	0	0	0	0	0	0	0	0	0	0	0	0	0	0
"GOLGA9P"	1911	7503	0	0	0	0	0	0	0	0	0	0	0	0	45	42	84	39
"GOLGB1"	11248	86554	3720	3351	2069	1651	1799	1552	1672	1330	418	1444	4183	5025	5086	4302	5909	3404
"GOLIM4"	2857	85765	3272	564	1979	1293	300	264	1944	477	250	352	733	930	693	548	667	340
"GOLM1"	3086	73444	684	52	354	330	21	31	875	43	254	41	1927	393	899	812	834	657
"GOLPH3"	2680	49603	4575	3628	2603	1972	2013	1615	2008	1875	1774	3385	2766	452	627	2237	2908	1890
"GOLPH3L"	3176	50973	152	54	68	84	43	11	104	1	10	0	335	329	336	160	494	245
"GOLSYN"	3241	117612	0	0	0	0	0	0	0	0	0	0	0	0	0	0	0	0
"GOLT1A"	1582	15931	0	0	0	0	0	0	61	0	0	0	0	0	0	0	0	0
"GOLT1B"	3277	16640	284	41	170	114	15	26	424	95	0	0	1418	1560	1463	1174	1590	1084
"GON4L"	7746	109683	5058	3913	2940	2118	2164	1749	2264	2558	2770	5183	1977	2288	3348	2701	3876	2404
"GOPC"	4610	42248	2222	177	1294	928	115	62	1052	181	84	165	1340	1257	1470	936	1868	1051
"GORAB"	2890	21713	351	304	141	210	213	91	167	116	12	238	389	527	416	404	329	278
"GORASP1"	3066	11041	1009	571	646	363	331	240	542	308	869	464	2271	2027	2596	1940	3484	1995
"GORASP2"	2508	37930	935	298	529	406	171	127	597	239	187	344	1629	1275	1789	1421	2160	1361
"GOSR1"	5239	49407	2335	3416	1372	963	1847	1569	1255	1679	523	2848	1312	2029	1254	1161	1241	893
"GOSR2"	3324	18248	1805	1044	1058	747	567	477	873	804	1064	1575	1385	1520	1721	1397	1728	1158
"GOT1"	2135	33904	83	0	30	53	0	0	94	0	9	0	610	423	598	457	765	605
"GOT1L1"	1386	5849	0	0	0	0	0	0	15	0	0	0	0	0	0	0	0	0
"GOT2"	2457	27213	92	0	74	18	0	0	93	0	0	0	1280	1556	1113	965	1966	1458
"GP1BA"	2464	2734	196	37	87	109	0	37	96	160	0	73	0	3940	92	2939	216	3602
"GP1BB"	2795	4008	0	0	0	0	0	0	17	26	0	0	0	0	0	5	0	3
"GP2"	2442	17025	0	0	0	0	0	0	0	0	0	0	0	0	0	0	0	0
"GP3ST"	2287	8449	0	1	0	0	0	1	80	47	0	0	0	0	0	0	0	0
"GP5"	3495	4447	0	0	0	0	0	0	0	0	0	0	0	0	0	0	0	0
"GP6"	2272	24557	48	26	37	11	12	14	153	69	0	54	0	0	0	0	0	0
"GP9"	861	1610	0	0	0	0	0	0	0	0	0	0	0	0	0	0	0	0
"GPA33"	2800	37788	0	0	0	0	0	0	0	0	0	0	0	0	0	0	0	0
"GPAA1"	2078	3596	233	58	96	137	40	18	148	41	0	66	1395	1215	1461	1375	2046	1113
"GPAM"	6397	33905	7	0	3	4	0	0	17	0	14	0	205	136	263	70	307	17
"GPAT2"	3476	13300	32	0	10	22	0	0	82	30	0	0	308	254	606	551	1439	1032
"GPATCH1"	3382	49534	73	0	38	35	0	0	74	3	49	0	230	137	260	69	318	132
"GPATCH2"	3198	22874	2444	385	1513	931	224	161	1764	463	124	211	271	363	175	167	154	200
"GPATCH3"	2135	9984	138	46	67	71	28	18	173	47	0	21	337	248	220	256	152	307
"GPATCH4"	1972	6990	210	69	108	102	47	22	110	134	56	128	176	789	653	721	591	494
"GPATCH8"	7276	69813	7334	2489	4142	3192	1256	1233	3517	1550	3210	3612	2171	1950	2370	1691	2923	1683
"GPBAR1"	2005	2846	0	28	0	0	0	28	30	45	0	0	83	55	73	55	119	8
"GPBP1"	3600	89637	7095	26412	4166	2929	14327	12085	2122	12772	2105	18773	2486	5310	2141	2994	2460	2071
"GPBP1L1"	3749	59326	6588	2263	3654	2934	1259	1004	3126	1164	2830	2958	2587	2248	3580	2811	4015	2896
"GPC1"	3694	32381	19	0	14	5	0	0	258	119	0	0	11	26	29	20	26	3
"GPC2"	2541	7762	0	1	0	0	1	0	10	0	0	0	0	2	0	0	8	0
"GPC3"	2387	449892	0	0	0	0	0	0	0	8	0	0	0	0	0	0	0	0
"GPC4"	3723	114143	11	25	0	11	10	15	0	8	0	30	212	250	192	343	218	270
"GPC5"	2886	1468552	0	131	0	0	96	35	0	148	0	187	3	0	0	3	0	0
"GPC6"	7105	1181191	0	0	0	0	0	0	11	0	0	0	0	0	0	0	0	0
"GPD1"	2882	7294	0	0	0	0	0	0	57	20	0	0	52	10	189	196	60	46
"GPD1L"	3918	62054	3636	374	2101	1535	193	181	1567	212	399	133	4108	4652	2932	1839	3625	1910
"GPD2"	6045	150951	9218	6212	5115	4103	3559	2653	3748	3153	1028	4222	2214	3318	1984	1960	1907	1478
"GPER"	2974	7010	0	0	0	0	0	0	87	16	0	0	0	0	0	0	0	0
"GPErik"	2626	31449	0	0	0	0	0	0	0	0	0	0	0	0	0	0	0	0
"GPHA2"	749	1417	0	0	0	0	0	0	0	22	0	0	0	1	0	0	0	0
"GPHB5"	393	4922	0	0	0	0	0	0	0	0	0	0	0	0	0	0	0	0
"GPHN"	4364	674400	951	379	570	381	200	179	1247	295	74	246	259	298	287	229	308	175
"GPI"	2225	35540	7850	3160	4499	3351	1677	1483	2946	1050	6705	2756	7413	5441	7284	5992	8396	6157
"GPI1"	3079	11604	323	27	162	161	8	19	268	134	190	133	442	422	699	639	895	697
"GPI7"	3216	40332	2465	794	1357	1108	496	298	1413	556	1115	974	1010	913	1328	908	2068	889
"GPIHBP1"	2284	3977	0	0	0	0	0	0	30	38	0	0	0	0	0	0	0	0
"GPKOW"	1662	9735	40	22	34	6	19	3	63	78	0	0	413	249	363	379	406	409
"GPLD1"	3514	61447	49	0	17	32	0	0	0	0	0	0	0	3	2	0	0	1
"GPM6A"	3615	180095	0	0	0	0	0	0	0	0	0	0	0	0	0	0	0	0
"GPM6B"	3262	46253	0	10	0	0	10	0	83	0	0	0	85	0	11	0	0	0
"GPN1"	1846	21850	231	54	146	85	32	22	153	98	139	91	1510	1596	1000	718	1239	719
"GPN2"	1515	10998	462	227	227	235	107	120	258	153	230	186	556	120	405	424	457	353
"GPN3"	1501	15779	0	0	0	0	0	0	18	20	0	0	213	229	236	194	256	165
"GPNMB"	2776	28414	293	183	140	153	128	55	235	57	0	7	3849	2965	18739	20568	11180	11682
"GPP34R"	3043	50973	152	54	68	84	43	11	104	1	10	0	335	329	336	160	494	245
"GPR1"	2565	42729	0	0	0	0	0	0	0	0	0	0	0	0	0	0	0	0
"GPR101"	1527	1527	0	0	0	0	0	0	0	0	0	0	0	0	0	0	0	0
"GPR107"	7098	86465	4962	5961	2670	2292	3142	2819	2429	4995	2381	11625	2801	3827	3422	3970	3918	3058
"GPR108"	2230	7379	174	341	80	94	174	167	140	333	91	714	770	1218	890	1577	1373	1328
"GPR110"	4699	25731	0	0	0	0	0	0	0	0	0	0	0	0	0	0	0	0
"GPR111"	3409	39481	0	0	0	0	0	0	0	0	0	0	0	0	0	0	0	0
"GPR112"	9957	115927	0	0	0	0	0	0	0	0	0	0	0	0	0	0	0	0
"GPR113"	4409	10931	66	0	32	34	0	0	58	143	74	86	13	2	14	19	17	5
"GPR114"	3770	34499	58	25	51	7	6	19	173	61	0	32	26	31	14	29	70	66
"GPR115"	3172	23470	0	0	0	0	0	0	0	0	0	0	0	0	0	0	0	0
"GPR116"	5838	69474	0	0	0	0	0	0	0	0	0	0	0	0	0	0	0	0
"GPR119"	1007	1007	0	0	0	0	0	0	0	0	0	0	0	0	0	0	0	0
"GPR12"	4848	5583	0	0	0	0	0	0	0	0	0	0	0	0	0	0	0	0
"GPR120"	1192	20944	1863	0	1002	861	0	0	856	30	92	0	850	341	374	89	1015	274
"GPR123"	6019	60747	0	0	0	0	0	0	493	316	0	0	0	0	0	0	0	0
"GPR124"	6018	47070	0	0	0	0	0	0	232	124	0	0	6	3	5	26	3	43
"GPR125"	4579	128675	0	0	0	0	0	0	0	0	0	0	0	0	0	0	0	0
"GPR126"	6985	144347	0	0	0	0	0	0	0	0	0	0	94	90	61	24	96	18
"GPR127"	958	22803	2020	354	1155	865	197	157	953	239	202	155	340	232	524	571	532	391
"GPR128"	3154	85890	0	1	0	0	0	1	0	0	0	0	0	0	0	0	0	0
"GPR132"	3718	6767	2316	12305	1528	788	3271	9034	487	9276	277	18273	117	1217	633	6496	837	4375
"GPR133"	5504	187556	0	0	0	0	0	0	962	330	0	0	0	0	0	3	3	0
"GPR135"	2547	36321	383	0	195	188	0	0	748	44	35	23	22	25	3	3	24	0
"GPR137"	1696	3634	568	116	372	196	74	42	491	382	451	699	619	598	713	700	993	941
"GPR137B"	2048	66378	11904	38903	6599	5305	20795	18108	3585	22368	4688	34681	2507	4985	2060	3939	2579	2372
"GPR137C"	3943	84566	0	0	0	0	0	0	20	0	0	0	33	13	3	4	33	3
"GPR139"	1340	42059	0	0	0	0	0	0	0	0	0	0	0	0	0	0	0	0
"GPR141"	919	919	3505	3034	2298	1207	1690	1344	1355	1203	270	2199	1474	3819	1393	1998	1003	1051
"GPR142"	1612	5217	0	0	0	0	0	0	23	11	0	0	0	0	0	0	0	0
"GPR143"	1616	40465	9	0	0	9	0	0	19	59	0	0	0	2	0	0	0	6
"GPR144"	2911	25957	3	0	3	0	0	0	111	55	0	0	0	0	0	0	0	0
"GPR146"	1935	3942	247	32	143	104	19	13	366	151	94	0	676	499	2067	1278	1353	774
"GPR148"	1188	1188	0	0	0	0	0	0	0	0	0	0	0	0	0	0	0	0
"GPR149"	2326	92044	0	0	0	0	0	0	0	0	0	0	0	0	0	0	0	0
"GPR15"	1082	1082	0	0	0	0	0	0	0	0	0	0	0	0	0	0	0	0
"GPR150"	1306	1306	0	0	0	0	0	0	0	0	0	0	0	0	0	0	0	0
"GPR151"	1261	1261	0	0	0	0	0	0	0	0	0	0	0	0	0	0	0	0
"GPR152"	1429	1429	0	0	0	0	0	0	33	13	0	0	17	16	17	16	19	9
"GPR153"	2711	2711	243	86	116	127	35	51	138	253	0	292	420	505	651	895	507	486
"GPR155"	7489	55437	3114	459	1698	1416	239	220	2006	188	948	49	1577	2110	1078	984	1530	730
"GPR156"	2833	77447	0	0	0	0	0	0	0	0	0	0	0	0	0	3	0	0
"GPR157"	2915	20069	0	0	0	0	0	0	32	9	0	39	0	28	6	6	26	6
"GPR158"	6671	426867	0	0	0	0	0	0	0	0	0	0	0	0	0	0	0	0
"GPR160"	2817	47448	991	54	584	407	40	14	463	11	0	0	714	772	464	360	868	569
"GPR161"	2961	52824	2	0	0	2	0	0	23	0	0	0	0	1	0	0	0	0
"GPR162"	2521	5622	29	0	22	7	0	0	129	81	0	0	97	85	30	13	31	57
"GPR17"	2602	6775	49	511	24	25	158	353	110	819	6	722	0	0	0	0	0	0
"GPR171"	1791	5364	0	0	0	0	0	0	15	0	0	0	35	65	24	0	38	0
"GPR172A"	2197	2695	88	0	28	60	0	0	89	45	0	0	840	728	759	702	1326	691
"GPR172B"	2502	2831	0	0	0	0	0	0	0	0	0	0	0	0	0	0	0	0
"GPR173"	1699	28738	0	0	0	0	0	0	21	0	0	0	0	0	0	0	0	0
"GPR174"	1259	1259	0	47	0	0	31	16	10	0	0	0	11	131	0	64	23	0
"GPR175"	1727	17529	915	4320	512	403	2288	2032	348	4113	179	6529	517	593	849	2179	849	730
"GPR176"	2819	120164	0	3	0	0	3	0	20	0	0	0	0	0	0	0	0	0
"GPR177"	2777	107214	0	0	0	0	0	0	0	0	0	0	9	12	28	36	3	15
"GPR179"	7990	18201	0	0	0	0	0	0	48	39	0	0	0	0	0	0	0	0
"GPR18"	1821	3874	846	351	430	416	197	154	688	145	286	184	35	27	0	7	6	0
"GPR180"	3929	27842	105	0	39	66	0	0	99	0	0	0	292	303	317	209	328	161
"GPR182"	1571	2115	0	0	0	0	0	0	0	0	0	0	0	0	0	0	0	0
"GPR183"	1786	12961	2713	12071	1513	1200	6678	5393	907	5669	135	4929	2079	29523	3	1323	75	439
"GPR19"	1844	8921	0	0	0	0	0	0	0	0	0	0	0	0	0	0	0	0
"GPR20"	1526	10778	1443	45	756	687	28	17	868	164	1286	0	980	222	255	0	1671	123
"GPR21"	1681	2108	1419	490	966	453	225	265	360	254	132	610	0	0	0	0	0	2
"GPR22"	2967	5623	199	168	112	87	90	78	175	85	0	65	0	0	0	0	0	0
"GPR25"	1087	1087	0	0	0	0	0	0	0	0	0	0	0	0	0	0	0	0
"GPR26"	10305	31042	0	0	0	0	0	0	16	9	0	0	0	0	0	0	0	0
"GPR27"	1128	1128	0	0	0	0	0	0	0	0	0	0	1	622	137	65	155	31
"GPR3"	2110	3165	0	0	0	0	0	0	21	9	0	0	0	0	0	0	0	0
"GPR31"	960	960	0	0	0	0	0	0	0	0	0	0	0	0	0	0	0	0
"GPR32"	1071	1071	0	0	0	0	0	0	20	0	0	0	0	0	0	0	0	0
"GPR34"	2060	8305	34	0	20	14	0	0	18	26	0	28	105	126	286	300	58	76
"GPR35"	2254	25829	841	762	539	302	421	341	470	714	484	1518	2032	5442	3117	5625	4396	5530
"GPR37"	2958	19567	0	0	0	0	0	0	0	0	0	0	0	0	0	0	0	0
"GPR37L1"	2460	6606	0	0	0	0	0	0	47	0	0	0	1	0	0	0	0	0
"GPR39"	2822	230023	0	0	0	0	0	0	11	0	0	0	0	0	0	0	0	0
"GPR4"	3047	12443	0	0	0	0	0	0	14	10	0	0	1	2	0	0	0	0
"GPR44"	2912	5048	0	0	0	0	0	0	0	0	0	0	171	151	194	173	277	181
"GPR45"	1726	1726	0	0	0	0	0	0	11	0	0	0	0	0	0	0	0	0
"GPR50"	2012	4873	0	0	0	0	0	0	0	0	0	0	0	0	0	0	0	0
"GPR52"	1473	1473	279	209	192	87	100	109	111	93	111	179	0	0	0	0	0	0
"GPR55"	3829	17899	0	0	0	0	0	0	258	76	0	0	90	56	44	0	201	33
"GPR56"	4058	25739	4	0	4	0	0	0	360	111	0	0	62	109	14	49	101	107
"GPR6"	1898	2414	0	0	0	0	0	0	0	0	0	0	0	0	0	0	0	0
"GPR61"	2826	5963	0	0	0	0	0	0	20	0	0	0	1	0	0	0	0	0
"GPR62"	2191	2191	0	0	0	0	0	0	0	0	0	0	0	0	0	0	0	0
"GPR63"	2200	39466	0	0	0	0	0	0	0	0	0	0	0	0	0	0	0	0
"GPR64"	4802	133252	6	27	5	1	13	14	21	19	0	0	0	0	6	0	0	0
"GPR65"	1755	6920	0	0	0	0	0	0	20	0	0	0	296	173	360	160	278	153
"GPR68"	2861	11977	1422	1025	769	653	548	477	614	703	716	779	408	1216	247	135	1096	418
"GPR73"	1980	68804	0	0	0	0	0	0	0	0	0	0	0	0	0	0	0	0
"GPR75"	2161	7122	93	174	55	38	91	83	188	124	0	48	0	88	0	64	0	0
"GPR77"	1436	9870	0	0	0	0	0	0	0	25	60	23	196	131	111	118	141	72
"GPR78"	3334	39197	0	0	0	0	0	0	184	119	0	0	0	0	0	0	0	0
"GPR81"	2977	2977	112	1347	74	38	756	591	49	609	0	383	1026	9909	347	3446	1746	2731
"GPR82"	2146	4911	48	14	48	0	0	14	52	28	0	0	86	0	96	9	87	0
"GPR83"	4286	24110	0	0	0	0	0	0	0	0	0	0	0	0	0	0	0	0
"GPR84"	1497	2029	0	0	0	0	0	0	10	53	0	121	0	171	0	903	0	304
"GPR85"	4939	7367	0	0	0	0	0	0	0	0	0	0	0	0	0	0	0	0
"GPR87"	1522	22762	0	0	0	0	0	0	0	0	0	0	0	0	0	0	0	0
"GPR88"	3466	3856	0	0	0	0	0	0	0	0	0	0	0	0	0	0	0	0
"GPR89A"	2891	26748	81	8	52	29	0	8	69	13	0	0	72	58	553	400	615	433
"GPR89B"	2131	65250	22	0	15	7	0	0	20	0	0	0	11	8	99	90	96	76
"GPR89C"	1769	25166	0	0	0	0	0	0	0	0	0	0	0	0	394	290	465	293
"GPR97"	2680	21133	1	0	1	0	0	0	196	74	0	0	4	0	32	53	3	0
"GPR98"	19422	605417	0	0	0	0	0	0	0	8	0	0	0	0	0	0	0	0
"GPRASP1"	5973	7716	65	0	35	30	0	0	43	0	0	0	0	0	0	0	1	0
"GPRASP2"	4201	5371	0	0	0	0	0	0	0	0	0	0	40	39	0	0	34	3
"GPRC5A"	2853	22644	0	0	0	0	0	0	0	0	0	0	0	0	0	0	0	0
"GPRC5B"	3052	26539	0	0	0	0	0	0	20	0	0	0	0	0	0	0	0	0
"GPRC5C"	2672	10837	0	0	0	0	0	0	54	33	0	0	0	0	0	0	0	0
"GPRC5D"	1039	9609	0	0	0	0	0	0	0	0	0	0	0	0	0	0	0	0
"GPRC6A"	2866	36952	0	0	0	0	0	0	0	0	0	0	0	0	0	0	0	0
"GPRIN1"	4210	14330	0	0	0	0	0	0	41	11	0	0	0	0	0	0	0	0
"GPRIN2"	6053	6053	0	0	0	0	0	0	104	108	0	0	0	0	0	0	0	0
"GPRIN3"	6354	63734	2349	122	1472	877	74	48	1804	75	77	0	1320	1066	19	0	13	264
"GPS1"	2360	5585	136	34	76	60	16	18	243	123	66	47	1103	949	1147	932	1398	633
"GPS2"	2503	6551	471	63	232	239	63	0	175	458	153	196	704	769	1219	1162	1700	1009
"GPSM1"	3647	32127	106	45	67	39	19	26	462	363	122	104	80	95	109	79	235	130
"GPSM2"	5625	57356	1218	420	685	533	218	202	439	164	68	116	915	841	392	282	412	236
"GPSM3"	1479	2141	642	168	331	311	94	74	234	172	538	806	2233	1907	2453	2243	3100	422
"GPT"	1896	3091	1216	519	659	557	257	262	280	258	1048	442	1264	1460	2234	1362	2058	1382
"GPT2"	3969	46894	9	0	9	0	0	0	210	59	10	0	230	186	147	77	318	228
"GPX1"	1180	1182	324	168	186	138	81	87	140	131	119	145	9181	11	13052	13341	2026	13718
"GPX2"	1203	3661	281	23	195	86	23	0	261	55	58	0	0	0	0	0	1	0
"GPX3"	1763	8556	2952	31473	1655	1297	18	31455	389	14	591	31836	4533	595	3372	5591	5303	4733
"GPX4"	1010	2139	341	122	207	134	80	42	81	204	136	202	6514	4961	7448	5999	7111	6715
"GPX5"	1527	6622	0	0	0	0	0	0	0	0	0	0	0	0	0	0	0	0
"GPX6"	1715	12499	0	0	0	0	0	0	0	0	0	0	0	0	0	0	0	0
"GPX7"	1231	6681	0	0	0	0	0	0	0	0	0	5	0	0	0	0	0	0
"GPX8"	3753	7147	0	0	0	0	0	0	0	0	0	0	0	0	0	0	0	0
"GQ129257"	258	258	0	0	0	0	0	0	0	0	0	0	0	0	0	0	0	0
"GRAMD1A"	2660	26129	2972	11036	1593	1379	5826	5210	575	6737	552	11753	1415	5776	1305	8644	2183	3761
"GRAMD1B"	2803	96992	22	0	11	11	0	0	167	49	0	0	226	242	3	4	9	9
"GRAMD1C"	3984	32717	30	0	30	0	0	0	17	15	0	0	784	770	0	147	427	0
"GRAMD2"	3303	37990	0	0	0	0	0	0	69	12	0	41	5	0	0	0	0	0
"GRAMD3"	2990	70984	0	141	0	0	94	47	7	292	0	193	67	256	34	160	67	109
"GRAMD4"	4343	53041	4002	718	2188	1814	387	331	1711	647	2700	1060	1684	1918	2417	2177	2281	1627
"GRAP"	2037	26347	141	0	65	76	0	0	120	61	0	0	171	131	429	193	588	228
"GRAP2"	2603	83272	38	16	15	23	0	16	0	27	0	8	0	10	14	16	6	20
"GRAPL"	971	31368	5	7	0	5	0	7	0	1	0	3	0	0	107	34	142	30
"GRASP"	1940	8925	0	38	0	0	17	21	0	202	0	258	9	227	16	615	14	322
"GRASP65"	3214	10738	1009	571	646	363	331	240	542	308	869	464	2271	2027	2596	1940	3484	1995
"GRB10"	5455	202908	0	25	0	0	14	11	329	441	0	42	37	66	74	97	231	168
"GRB14"	2444	129029	0	0	0	0	0	0	0	0	0	0	0	0	0	0	0	0
"GRB2"	3309	87634	22339	26389	12553	9786	14204	12185	7485	15072	14684	29072	11308	12584	11891	11332	12450	9772
"GRB7"	2266	7319	0	0	0	0	0	0	37	38	0	0	0	0	0	0	0	0
"GREB1"	8515	108672	0	0	0	0	0	0	142	50	0	0	0	0	0	0	0	0
"GREB1L"	6083	280588	347	58	205	142	42	16	184	35	0	0	0	0	0	0	0	0
"GREM1"	4136	16663	0	0	0	0	0	0	14	0	0	0	0	18	0	0	0	0
"GREM2"	4183	122589	0	0	0	0	0	0	0	0	0	0	0	0	0	0	0	0
"GRHL1"	3728	50621	0	0	0	0	0	0	14	79	0	0	2	560	7	177	0	87
"GRHL2"	5243	177284	0	0	0	0	0	0	0	0	0	0	0	0	0	0	0	0
"GRHL3"	2815	35928	0	0	0	0	0	0	82	19	0	0	0	0	0	0	0	0
"GRHPR"	1938	2611	414	49	218	196	40	9	369	125	124	0	766	528	1361	882	1288	777
"GRIA1"	5803	323346	0	0	0	0	0	0	0	9	0	0	0	0	0	0	0	0
"GRIA2"	5768	145490	0	0	0	0	0	0	0	0	0	0	0	0	0	0	0	0
"GRIA3"	5308	306666	0	0	0	0	0	0	7	0	0	0	0	0	0	0	0	0
"GRIA4"	5638	372021	0	0	0	0	0	0	0	0	0	0	0	0	0	0	0	0
"GRID1"	5865	766940	0	0	0	0	0	0	587	206	0	0	0	0	0	0	0	0
"GRID2"	3297	1468100	0	0	0	0	0	0	0	0	0	0	0	0	0	0	0	0
"GRID2IP"	4653	54659	0	0	0	0	0	0	163	75	0	0	0	0	0	0	0	0
"GRIK1"	3539	403028	6394	3902	3624	2770	2126	1776	4151	2047	827	2402	24	82	0	3	7	4
"GRIK2"	4696	671054	0	0	0	0	0	0	0	0	0	0	0	0	0	0	0	0
"GRIK3"	9235	238718	0	0	0	0	0	0	624	182	0	0	0	0	0	0	0	0
"GRIK4"	3231	421826	0	0	0	0	0	0	350	58	0	0	0	0	0	0	0	0
"GRIK5"	3547	67486	0	0	0	0	0	0	302	163	0	0	0	1	0	5	3	0
"GRIN1"	4502	26267	1197	355	624	573	192	163	2399	1313	1012	1352	3411	2961	3987	3767	6530	4275
"GRIN2A"	14695	428998	0	0	0	0	0	0	0	0	0	0	0	0	0	0	0	0
"GRIN2B"	5954	418614	0	0	0	0	0	0	13	0	0	0	0	0	0	0	0	0
"GRIN2C"	4949	10273	7	0	0	7	0	0	126	13	0	0	0	0	0	0	0	0
"GRIN2D"	5105	50057	43	2	26	17	2	0	324	74	14	0	124	75	96	14	175	62
"GRIN3A"	7779	169229	57	0	41	16	0	0	42	0	0	0	29	18	3	0	0	0
"GRIN3B"	3263	9288	49	0	30	19	0	0	67	48	0	0	1473	5	20	0	3108	11
"GRINA"	1975	3359	16	373	12	4	371	2	206	465	568	953	3750	4368	4479	6603	5571	5200
"GRINL1A"	4316	10853	147	159	96	51	85	74	169	124	0	58	983	909	1136	711	1587	793
"GRIP1"	5071	331703	0	0	0	0	0	0	0	16	0	56	96	0	0	0	0	0
"GRIP2"	3497	19700	92	5	33	59	5	0	254	74	0	34	0	0	0	0	0	0
"GRIPAP1"	3261	25342	3956	2895	2200	1756	1616	1279	1104	1325	2826	3337	2767	2658	3286	3370	3916	3340
"GRK1"	2104	117041	0	4	0	0	4	0	134	80	0	0	0	0	0	0	0	0
"GRK4"	2330	77133	27	3	17	10	3	0	7	0	2	0	92	84	156	167	48	0
"GRK5"	2622	247935	7	11	0	7	0	11	1338	568	0	55	59	63	60	58	104	70
"GRK6"	2963	16163	2929	219	1549	1380	127	92	1109	226	2088	549	1389	1196	2590	2266	2966	2495
"GRK7"	1748	38849	0	0	0	0	0	0	0	0	0	0	0	0	0	0	0	0
"GRLF1"	8884	86392	2593	607	1429	1164	340	267	1638	555	734	686	1761	1598	1966	1447	2567	1416
"GRM1"	6949	409951	0	0	0	0	0	0	0	0	0	0	0	0	0	0	0	0
"GRM2"	3518	11544	0	0	0	0	0	0	88	8	0	0	0	0	0	0	0	0
"GRM3"	4265	220963	0	0	0	0	0	0	0	0	0	0	0	0	0	0	0	0
"GRM4"	4191	41389	0	0	0	0	0	0	1379	560	0	0	0	0	0	0	0	0
"GRM5"	7935	559073	0	0	0	0	0	0	0	0	0	0	0	0	0	0	0	0
"GRM6"	6149	16794	0	0	0	0	0	0	57	0	0	0	0	0	0	0	0	0
"GRM7"	4250	880418	0	0	0	0	0	0	0	0	0	0	0	0	0	0	0	0
"GRM8"	4141	814497	0	0	0	0	0	0	0	0	0	0	0	0	0	0	0	0
"GRN"	2318	7981	2632	985	1402	1230	544	441	926	489	1840	590	28403	19191	41402	29674	49134	21035
"GRP"	848	10602	0	0	0	0	0	0	10	0	0	0	0	0	0	0	0	0
"GRP94c"	2043	17516	1178	675	692	486	371	304	632	216	152	0	6883	7632	22951	22566	13685	10712
"GRPEL1"	2207	7546	136	53	73	63	40	13	136	112	0	40	822	91	324	278	243	239
"GRPEL2"	4108	9170	0	0	0	0	0	0	70	17	0	0	230	46	218	4	180	5
"GRPR"	2683	30218	0	0	0	0	0	0	0	0	0	0	0	0	0	4	0	0
"GRRP1"	1525	3609	0	0	0	0	0	0	0	0	0	0	0	0	0	0	0	0
"GRSF1"	6641	24130	1370	720	760	610	359	361	548	388	399	471	3107	3456	3178	2192	3766	2050
"GRTP1"	1623	39087	0	0	0	0	0	0	94	1	0	1	0	0	0	0	0	0
"GRWD1"	5577	11250	233	365	134	99	181	184	148	376	0	485	547	828	653	855	667	592
"GRXCR1"	993	137391	0	0	0	0	0	0	0	0	0	0	0	0	0	0	0	0
"GRXCR2"	750	13237	0	0	0	0	0	0	0	0	0	0	0	0	0	0	0	0
"GSC"	1191	1940	0	0	0	0	0	0	0	0	0	0	0	0	0	0	0	0
"GSC2"	620	1293	0	0	0	0	0	0	0	0	0	0	0	0	0	0	0	0
"GSDMA"	2176	14795	0	0	0	0	0	0	0	0	0	0	18	8	8	16	0	0
"GSDMB"	1632	12945	12	0	12	0	0	0	42	0	21	30	26	48	83	43	129	47
"GSDMC"	2727	38693	0	0	0	0	0	0	0	0	0	0	0	0	0	0	0	0
"GSDMD"	2327	9674	172	41	65	107	16	25	71	111	90	0	731	519	836	856	929	829
"GSG1"	2185	19578	0	0	0	0	0	0	0	0	0	0	0	0	0	0	0	0
"GSG1L"	4929	275982	0	0	0	0	0	0	239	64	0	0	0	0	0	0	0	0
"GSG2"	2795	2795	340	281	168	172	157	124	357	234	851	524	48	58	201	126	0	167
"GSK3A"	3538	11709	426	96	208	218	13	83	293	171	46	223	910	1135	1239	1284	1475	1013
"GSK3B"	7128	272462	18652	12977	10666	7986	7229	5748	8660	6963	4635	9122	769	810	1053	869	1093	676
"GSN"	3484	131361	31681	14834	17525	14156	7908	6926	9063	5163	21905	13472	43452	51725	34552	25492	38863	26191
"GSPT1"	7187	48534	2771	2588	1599	1172	1437	1151	1303	1501	942	2914	3096	3814	4214	2873	3802	2764
"GSPT2"	2534	2534	0	0	0	0	0	0	0	0	0	0	423	301	308	156	323	180
"GSR"	2275	49010	985	85	475	510	42	43	465	74	428	109	3204	1118	2367	2390	2166	1740
"GSS"	2107	18297	309	61	145	164	36	25	216	137	33	103	982	1065	883	879	834	847
"GSTA1"	1265	12487	0	0	0	0	0	0	0	0	0	0	0	0	0	0	0	0
"GSTA2"	1313	13475	0	0	0	0	0	0	0	0	0	0	0	0	0	0	0	0
"GSTA3"	918	13057	0	0	0	0	0	0	0	0	0	0	0	0	0	0	0	0
"GSTA4"	1347	17433	0	0	0	0	0	0	0	16421	0	0	0	0	0	0	0	0
"GSTA5"	851	14354	0	0	0	0	0	0	0	0	0	0	0	0	0	0	0	0
"GSTCD"	4133	136913	29	0	15	14	0	0	76	0	0	34	187	218	165	159	185	89
"GSTK1"	1232	5701	1335	532	766	569	273	259	439	182	916	254	5452	4868	6852	4391	8917	5688
"GSTM1"	4389	6021	0	1	0	0	1	0	14	0	0	0	182	410	209	201	6	10
"GSTM2"	1486	15976	156	171	73	83	93	78	181	134	0	90	727	1049	746	744	1031	691
"GSTM3"	4136	7108	0	0	0	0	0	0	0	3	0	0	57	207	35	43	64	43
"GSTM4"	1433	5634	133	163	50	83	93	70	127	123	0	90	687	963	631	649	930	638
"GSTM5"	1576	6026	0	1	0	0	1	0	14	0	0	0	0	0	8	0	0	10
"GSTO1"	787	12533	842	321	484	358	204	117	479	261	386	442	3139	1689	3165	2666	4138	2220
"GSTO2"	1500	30546	17	0	0	17	0	0	82	32	0	0	1	756	0	0	0	0
"GSTP1"	964	3059	343	55	191	152	22	33	107	83	126	47	7459	5141	8505	4881	10615	5054
"GSTT1"	1264	2016	2174	521	1223	951	263	258	714	59	0	0	3526	2073	4025	2443	2859	4266
"GSTT2"	1122	3792	0	0	0	0	0	0	14	0	0	0	0	1	36	11	93	49
"GSTT2B"	1080	3792	0	0	0	0	0	0	0	0	0	0	0	1	28	10	71	27
"GSTTP1"	724	6664	0	0	0	0	0	0	0	12	0	0	0	0	5	0	0	0
"GSTTP2"	2075	15963	4	1	1	3	1	0	0	0	0	0	1	1	17	13	7	7
"GSTZ1"	1530	10711	233	4	113	120	0	4	189	54	0	12	60	112	200	216	239	194
"GSX1"	849	1311	0	0	0	0	0	0	10	0	0	0	0	0	0	0	0	0
"GSX2"	1214	1876	0	0	0	0	0	0	0	0	0	0	0	0	0	0	0	0
"GTDC1"	2833	386448	8726	6102	4931	3795	3365	2737	6610	4619	851	3651	736	609	811	576	529	356
"GTF2A1"	1813	40902	1035	359	608	427	216	143	575	93	244	137	156	192	412	250	379	182
"GTF2A1L"	1677	61800	0	0	0	0	0	0	0	0	0	0	0	0	0	0	0	0
"GTF2A2"	1585	19476	1130	118	656	474	84	34	606	39	238	102	1742	1503	1528	1419	2084	1595
"GTF2B"	1651	38981	1947	4297	1121	826	2316	1981	752	1766	567	3376	818	1432	693	876	1233	832
"GTF2E1"	3037	40359	3029	128	2299	730	37	91	676	59	160	24	733	577	1120	372	731	401
"GTF2E2"	1543	79708	2123	379	1206	917	216	163	1093	330	508	494	565	238	466	880	583	553
"GTF2F1"	2564	13713	86	96	33	53	54	42	73	101	16	16	1155	410	1088	740	1451	907
"GTF2F2"	1466	163595	3285	641	1892	1393	366	275	1730	703	440	671	569	819	559	578	783	606
"GTF2H1"	3531	44776	1388	1127	766	622	581	546	744	763	250	885	1486	1156	1356	1065	1886	1001
"GTF2H2"	2064	32546	13	0	2	11	0	0	15	0	0	0	159	215	760	545	568	605
"GTF2H2B"	2101	32668	16	0	16	0	0	0	0	0	0	0	14	0	585	443	651	568
"GTF2H2C"	2119	32678	25	0	16	9	0	0	3	0	0	0	124	126	662	537	734	681
"GTF2H2D"	2218	32678	9	0	0	9	0	0	3	0	0	0	110	126	610	502	483	585
"GTF2H3"	1518	26955	24	0	24	0	0	0	44	18	8	16	690	682	424	327	354	282
"GTF2H4"	2664	6839	30	3	17	13	0	3	48	0	15	0	168	254	290	235	371	245
"GTF2H5"	7479	30989	8	0	0	8	0	0	29	0	0	0	349	0	310	290	413	279
"GTF2I"	4562	102992	2520	364	1524	996	218	146	1379	229	866	896	1030	1486	1104	1042	1175	871
"GTF2IP1"	4043	266237	0	0	0	0	0	0	0	0	0	0	29	0	7279	5408	7041	4573
"GTF2IRD1"	3501	148792	38	10	28	10	10	0	813	242	51	0	93	63	199	178	218	187
"GTF2IRD2"	3567	57359	0	1	0	0	0	1	15	0	0	0	0	0	49	32	59	35
"GTF2IRD2B"	3600	57277	0	0	0	0	0	0	15	0	0	0	0	0	49	32	59	35
"GTF3A"	1949	10300	330	8	189	141	0	8	207	38	123	0	1561	1319	1480	1374	1746	1401
"GTF3C1"	7143	89318	1101	176	673	428	112	64	989	249	230	75	1313	1096	1604	1379	1957	1545
"GTF3C2"	4006	30640	2124	323	1289	835	176	147	1029	212	1305	680	2247	1257	2294	1747	3218	1828
"GTF3C3"	2951	35322	953	81	551	402	24	57	505	15	57	84	805	548	839	714	895	610
"GTF3C4"	3907	19742	7	0	7	0	0	0	73	19	16	0	930	487	567	241	618	249
"GTF3C5"	2451	27828	658	72	365	293	52	20	879	234	56	81	835	603	1100	924	1283	895
"GTF3C6"	954	9328	18	0	18	0	0	0	31	95	0	44	557	709	309	908	906	866
"GTPBP1"	5057	27785	4995	18123	3024	1971	9600	8523	893	9473	614	12314	954	1109	1010	4363	3925	3293
"GTPBP10"	3422	40662	1248	24	737	511	24	0	779	55	860	311	314	250	199	115	236	153
"GTPBP2"	2990	8719	954	719	504	450	351	368	364	329	527	732	1117	1152	1733	1468	2012	1294
"GTPBP3"	2693	5185	201	21	104	97	0	21	138	91	100	0	319	281	261	166	385	212
"GTPBP4"	2645	29051	514	1972	298	216	1090	882	288	1180	63	1579	852	1714	961	1612	963	960
"GTPBP5"	2941	19729	875	129	465	410	82	47	535	364	282	543	709	663	592	439	720	443
"GTPBP6"	1455	7371	0	0	0	0	0	0	0	0	0	0	0	0	1116	747	1226	594
"GTPBP8"	1678	24108	1503	836	838	665	508	328	679	304	86	114	1925	2099	1498	956	2021	1030
"GTSE1"	3123	34070	1	0	0	1	0	0	98	57	0	0	0	0	0	0	4	0
"GTSF1"	820	17651	14	3	2	12	1	2	0	0	0	3	7	5	0	0	0	0
"GTSF1L"	842	842	0	0	0	0	0	0	0	0	0	0	0	0	0	0	0	0
"GUCA1A"	2279	24650	1	0	0	1	0	0	22	0	0	0	143	124	316	228	467	445
"GUCA1B"	2273	11673	0	0	0	0	0	0	0	10	0	0	0	0	2	6	0	4
"GUCA1C"	969	46037	0	0	0	0	0	0	0	0	0	0	0	0	0	0	0	0
"GUCA2A"	578	2035	0	0	0	0	0	0	0	0	0	0	0	0	0	0	0	0
"GUCA2B"	600	2405	0	0	0	0	0	0	27	0	0	0	0	0	0	0	0	0
"GUCY1A2"	3056	331263	0	0	0	0	0	0	0	0	0	0	153	227	55	89	92	71
"GUCY1A3"	9449	70352	0	0	0	0	0	0	0	0	0	0	6	27	8	42	4	3
"GUCY1B2"	3037	71646	0	0	0	0	0	0	0	0	0	0	0	0	0	0	0	0
"GUCY1B3"	3578	48658	0	0	0	0	0	0	0	0	0	0	26	58	13	28	13	17
"GUCY2C"	3867	83951	27	0	14	13	0	0	43	0	0	0	139	180	222	165	174	92
"GUCY2D"	3643	17672	0	0	0	0	0	0	59	0	0	0	0	0	0	4	0	0
"GUCY2E"	2819	41624	0	18	0	0	18	0	140	195	0	224	0	7	0	12	0	0
"GUCY2F"	3717	109151	0	0	0	0	0	0	0	0	0	0	0	0	0	0	0	0
"GUCY2G"	2992	48418	0	0	0	0	0	0	0	0	0	0	0	0	0	0	0	0
"GUF1"	4232	22265	585	46	335	250	24	22	450	51	67	43	889	793	763	556	751	423
"GUK1"	1395	8726	1105	1001	646	459	505	496	417	856	938	1838	2044	2114	2506	2948	3629	2735
"GULP1"	7440	25033	0	0	0	0	0	0	0	0	0	0	0	0	0	0	0	0
"GUSB"	2253	21573	639	77	372	267	47	30	301	123	829	74	1521	806	2870	3475	2348	2026
"GUSBL2"	2234	15365	386	42	218	168	15	27	425	173	48	129	56	67	285	165	400	114
"GVIN1"	8729	8729	18	0	18	0	0	0	70	22	0	21	135	140	211	76	61	23
"GW112"	2313	23214	0	0	0	0	0	0	0	8	0	0	0	0	0	0	0	0
"GX"	2795	7394	0	0	0	0	0	0	44	20	0	16	7	13	3	0	0	14
"GYG1"	1812	36045	825	23	466	359	15	8	521	8	134	5	1165	1226	1514	1101	1894	1256
"GYG2"	3407	54000	0	0	0	0	0	0	0	0	0	0	0	0	0	0	0	0
"GYLTL1B"	2542	7453	0	0	0	0	0	0	15	11	0	0	0	0	0	0	0	0
"GYPA"	2750	31449	0	0	0	0	0	0	0	0	0	0	0	0	0	0	0	0
"GYPB"	750	23241	0	0	0	0	0	0	0	0	0	0	0	0	0	0	0	0
"GYPC"	1893	40563	0	25	0	0	12	13	18	237	0	20	49	55	83	126	87	81
"GYPE"	1701	34698	0	0	0	0	0	0	0	0	0	0	0	0	0	0	0	0
"GYS1"	3633	25229	1167	805	614	553	394	411	543	568	650	2003	1245	1662	1101	1613	1064	1195
"GYS2"	3146	68658	0	0	0	0	0	0	0	0	0	0	0	1	0	0	0	0
"GZF1"	4921	10865	557	72	305	252	45	27	359	62	43	0	915	518	1173	485	1308	467
"GZMA"	900	7607	0	0	0	0	0	0	0	0	0	0	125	181	83	103	152	123
"GZMB"	944	3273	0	0	0	0	0	0	0	0	0	0	5	10	17	27	27	11
"GZMH"	907	3173	0	0	0	0	0	0	0	0	0	0	2	8	19	24	28	21
"GZMK"	1050	9855	0	0	0	0	0	0	0	0	0	0	9	32	28	11	47	41
"GZMM"	952	5894	0	0	0	0	0	0	80	12	0	0	35	26	16	22	48	46
"Glc-T"	4042	71876	359	51	218	141	21	30	242	71	18	86	677	739	751	612	720	498
"Gli2"	1248	177820	0	0	0	0	0	0	862	282	0	0	0	0	0	0	0	0
"GluR4c"	3173	48373	0	0	0	0	0	0	0	0	0	0	0	0	0	0	0	0
"GnRHRII"	1192	6148	0	0	0	0	0	0	41	17	0	0	909	1419	1146	960	1180	829
"GnT-IX"	871	13809	0	0	0	0	0	0	43	17	0	0	0	0	0	0	0	0
"H10BH"	2205	15128	273	46	166	107	46	0	226	57	0	12	26	82	49	24	57	30
"H19"	2309	2661	0	0	0	0	0	0	46	44	0	0	0	0	0	0	0	0
"H1F0"	2330	2330	0	0	0	0	0	0	33	17	0	0	514	598	1166	872	1142	724
"H1FNT"	1300	1300	0	0	0	0	0	0	12	0	0	0	0	0	0	0	0	0
"H1FOO"	1071	8148	1	0	1	0	0	0	26	82	0	0	1	0	0	0	0	0
"H1FX"	1507	1507	0	0	0	0	0	0	0	0	0	0	1155	1007	1331	1487	1685	1336
"H2A/l"	1663	14901	575	69	307	268	36	33	449	71	260	106	685	466	526	251	666	376
"H2AFB2"	517	517	0	0	0	0	0	0	0	0	0	0	2	0	1	0	0	0
"H2AFB3"	516	516	0	0	0	0	0	0	0	0	0	0	0	0	0	0	0	0
"H2AFJ"	3666	3666	0	0	0	0	0	0	0	14	0	0	342	218	403	405	563	335
"H2AFV"	3760	21239	802	266	450	352	106	160	378	131	398	168	4	2915	2127	1906	2697	1672
"H2AFX"	1592	1592	31	0	20	11	0	0	46	41	0	51	631	391	663	403	645	411
"H2AFY"	2005	64859	20202	11406	11121	9081	6091	5315	2291	6879	16311	13332	7412	11530	13413	9730	10109	7059
"H2AFY2"	2187	59684	0	0	0	0	0	0	37	0	0	0	24	21	157	127	59	56
"H2AFZ"	1845	2271	94	61	52	42	33	28	39	0	0	0	1934	2283	2732	2497	3474	2719
"H2BFM"	1884	2506	0	0	0	0	0	0	0	0	0	0	0	0	0	0	0	0
"H2BFWT"	892	2537	0	0	0	0	0	0	0	0	0	0	0	0	0	0	0	0
"H2BFXP"	833	2285	0	0	0	0	0	0	0	0	0	0	0	0	0	0	0	0
"H3F3B"	2707	3345	2274	2264	1232	1042	1254	1010	1070	1268	953	1692	9714	13129	18684	8917	21439	16148
"H3F3C"	1056	1056	0	0	0	0	0	0	0	0	0	0	378	427	0	0	0	0
"H6PD"	9118	36531	5855	2651	3287	2568	1577	1074	2147	1277	5176	3753	4854	4602	7965	5787	8825	6302
"H91620"	1806	308538	37833	32013	21031	16802	17190	14823	14802	14837	20631	34103	481	996	801	1870	635	989
"HAAO"	1293	25523	329	46	240	89	24	22	215	160	0	133	377	247	225	192	320	187
"HABP2"	3029	36582	0	0	0	0	0	0	13	0	0	0	0	0	0	0	0	0
"HABP4"	2695	41205	9	0	0	9	0	0	47	0	0	0	100	110	132	86	164	79
"HACE1"	5333	59323	10	9	10	0	6	3	53	0	0	0	193	238	150	115	153	62
"HACL1"	2044	40890	134	0	100	34	0	0	162	8	0	0	263	258	507	430	338	406
"HADH"	1971	45392	41	8	16	25	8	0	90	0	26	0	444	403	515	505	633	402
"HADHA"	3056	54091	2113	613	1062	1051	378	235	1067	397	584	746	4701	5241	8722	8417	11709	8421
"HADHB"	2287	45718	1950	979	1052	898	566	413	1063	614	1001	974	4545	4310	6256	5388	5951	4726
"HADHSC"	1630	45392	41	8	16	25	8	0	90	0	26	0	444	403	515	505	633	402
"HAGH"	1618	18091	1018	78	541	477	68	10	520	32	851	172	1490	1160	1377	1112	2159	1273
"HAGHL"	1786	2759	78	0	36	42	0	0	49	52	33	0	326	95	276	182	380	259
"HAL"	3160	22931	3	0	0	3	0	0	49	0	0	0	6	1	10	0	0	0
"HAMP"	427	2635	15	0	15	0	0	0	29	0	0	0	17	6	146	112	40	37
"HAND1"	1739	3293	0	0	0	0	0	0	0	0	0	0	0	0	0	0	0	0
"HAND2"	2370	3728	0	0	0	0	0	0	0	0	0	0	0	0	0	0	0	0
"HAO1"	1754	57464	0	0	0	0	0	0	11	0	0	0	0	0	0	0	0	0
"HAO2"	1705	25351	0	0	0	0	0	0	0	0	0	0	0	0	0	0	0	0
"HAP1"	4102	12009	0	0	0	0	0	0	132	14	0	0	0	0	0	0	0	0
"HAPLN1"	4682	82880	0	0	0	0	0	0	0	0	0	0	0	0	0	0	0	0
"HAPLN2"	1778	6433	0	0	0	0	0	0	20	0	0	0	0	0	0	0	0	0
"HAPLN3"	3091	18252	0	0	0	0	0	0	38	24	0	0	22	38	23	4	19	8
"HAPLN4"	4421	17623	0	0	0	0	0	0	132	11	0	0	2	0	0	0	0	0
"HAR"	2192	10954	0	0	0	0	0	0	0	0	0	0	0	0	0	0	0	0
"HAR1A"	2796	3095	0	0	0	0	0	0	35	0	0	0	0	0	0	0	0	0
"HAR1B"	898	6828	0	0	0	0	0	0	48	0	0	0	0	0	0	0	0	0
"HARBI1"	1524	13922	0	0	0	0	0	0	14	0	0	0	45	26	76	29	102	52
"HARS"	3506	11434	632	120	362	270	92	28	308	93	0	162	1030	918	880	710	1083	855
"HARS2"	2502	7873	537	79	324	213	55	24	339	123	119	30	1305	720	1111	608	1639	670
"HARSL"	2378	7873	537	79	324	213	55	24	339	123	119	30	1305	720	1111	608	1639	670
"HAS1"	2092	10858	0	0	0	0	0	0	0	0	0	0	0	0	0	0	0	0
"HAS2"	3279	28361	0	0	0	0	0	0	0	0	0	0	0	0	0	0	0	0
"HAS2AS"	1644	5349	0	0	0	0	0	0	0	0	0	0	0	0	0	0	0	0
"HAS3"	4289	12103	262	128	92	170	72	56	220	126	89	212	37	3927	3773	243	4961	3269
"HAT1"	2548	66835	175	429	90	85	263	166	197	266	0	355	970	1135	668	907	1010	799
"HAUS1"	1173	24002	76	26	58	18	14	12	43	1	5	1	133	54	307	248	391	266
"HAUS2"	3948	21179	36	291	15	21	119	172	43	251	0	172	742	1351	180	366	199	272
"HAUS3"	5877	13766	157	0	92	65	0	0	183	9	0	0	405	142	472	140	417	97
"HAUS4"	1781	10879	622	154	299	323	88	66	317	37	440	69	1152	1791	2077	888	2035	1168
"HAUS5"	4328	12607	19	0	12	7	0	0	157	47	0	8	117	133	110	128	174	115
"HAUS6"	6337	49762	87	0	49	38	0	0	157	0	0	12	262	329	523	251	639	255
"HAUS7"	2550	26426	224	0	145	79	0	0	496	100	49	0	286	258	272	288	405	279
"HAUS8"	1465	25772	290	5	183	107	0	5	167	39	19	168	237	151	302	172	319	135
"HAVCR1"	1849	28958	0	0	0	0	0	0	0	0	0	0	0	0	5	8	6	0
"HAVCR2"	2327	23297	2666	191	1542	1124	100	91	1391	94	1607	52	1500	3725	4516	3245	4148	2864
"HAX1"	1354	3312	60	0	15	45	0	0	49	25	0	0	704	778	707	733	925	930
"HBA1"	608	4676	0	0	0	0	0	0	28	18	0	0	0	0	8	7	18	10
"HBA2"	607	864	0	0	0	0	0	0	0	0	0	0	0	0	8	6	18	10
"HBB"	629	1607	0	0	0	0	0	0	0	0	0	0	9	5	0	14	11	10
"HBBP1"	660	1637	0	0	0	0	0	0	0	0	0	0	0	0	0	0	0	0
"HBD"	777	1801	0	0	0	0	0	0	0	0	0	0	13	26	17	17	33	26
"HBE1"	961	237304	0	0	0	0	0	0	0	0	0	0	0	0	0	0	0	0
"HBE269"	3036	23475	0	0	0	0	0	0	34	0	0	0	9	3	21	16	44	21
"HBEGF"	2363	13761	0	0	0	0	0	0	12	16	0	0	94	129	122	146	110	118
"HBG1"	971	6895	0	0	0	0	0	0	0	0	0	0	0	0	11	6	8	7
"HBG2"	1555	391491	270	0	176	94	0	0	215	13	30	0	620	493	1119	822	1077	872
"HBII-52-24"	72	72	0	0	0	0	0	0	0	13	0	0	0	0	0	0	0	0
"HBII-52-27"	77	77	0	0	0	0	0	0	0	0	0	0	0	0	0	0	0	0
"HBII-52-28"	75	75	0	0	0	0	0	0	0	0	0	0	0	0	0	0	0	0
"HBII-52-45"	53	53	0	0	0	0	0	0	0	0	0	0	0	0	0	0	0	0
"HBII-52-46"	34	34	0	0	0	0	0	0	0	0	0	0	0	0	0	0	0	0
"HBM"	513	796	0	0	0	0	0	0	0	0	0	0	0	0	0	0	0	0
"HBP1"	3325	32757	2128	1990	1181	947	1084	906	1211	1082	406	868	2579	3207	1551	1112	1649	1082
"HBP2"	6561	36483	30	18	15	15	8	10	133	34	0	14	1013	1312	955	866	1045	726
"HBQ1"	653	844	0	0	0	0	0	0	0	0	0	0	0	0	0	0	0	0
"HBS1L"	7180	94521	726	502	397	329	314	188	408	462	86	494	700	854	776	770	795	839
"HBT8"	4101	4101	16	14	16	0	0	14	32	0	0	0	33	15	0	0	0	0
"HBXBP"	807	7206	8	16	8	0	0	16	208	59	0	0	28	61	56	51	238	107
"HBXIP"	850	6669	98	114	60	38	74	40	13	39	0	55	257	106	877	884	992	814
"HBZ"	592	1652	0	0	0	0	0	0	0	0	0	0	0	0	0	0	0	0
"HCA56"	1366	7819	35	5	9	26	2	3	38	36	0	0	79	90	240	270	352	239
"HCA58"	413	51474	925	1000	450	475	559	441	541	812	437	2129	80	149	107	122	113	107
"HCA66"	1933	38540	712	60	411	301	47	13	265	223	350	239	720	478	1302	799	1399	925
"HCC-10"	2703	38088	5719	24519	3223	2496	13176	11343	1226	8112	695	14778	2194	7530	1876	3265	2341	2577
"HCC1"	1159	65295	3956	3449	2259	1697	1909	1540	1486	2697	1682	5439	124	266	525	513	683	619
"HCCA1"	2741	29333	3694	3485	2270	1424	1955	1530	1658	1731	2403	4139	1772	2150	2551	2432	2840	2078
"HCCA2"	1711	17285	4894	2425	2570	2324	1337	1088	3681	2955	3185	5206	12107	8977	57623	50525	30632	28500
"HCCC11"	1161	1573	0	0	0	0	0	0	0	0	0	0	0	0	0	0	0	0
"HCCS"	2351	11788	43	0	35	8	0	0	25	0	0	16	911	806	969	836	1156	835
"HCDI"	1324	3074	1046	1028	1021	25	642	386	13	474	852	978	4335	3964	4991	3239	7188	3814
"HCE1"	4298	353361	4125	2065	2389	1736	1088	977	2568	1860	279	1754	787	823	739	613	779	191
"HCF-2"	5688	42062	211	36	122	89	29	7	211	3	32	21	472	417	606	277	645	308
"HCFC1"	8450	23811	1771	712	980	791	486	226	993	790	885	1097	2702	2445	2321	2713	4090	2497
"HCFC1R1"	1004	1663	45	0	0	45	0	0	50	36	0	0	365	200	627	388	597	236
"HCFC2"	5742	42062	211	36	122	89	29	7	211	3	32	21	472	417	606	277	645	308
"HCG11"	5678	5678	31	0	17	14	0	0	29	0	0	0	560	311	33	0	75	0
"HCG18"	6819	39755	8752	9288	4836	3916	5102	4186	3551	4212	5822	8852	279	2186	802	1009	829	640
"HCG22"	5672	5672	0	0	0	0	0	0	0	0	0	0	0	0	0	0	0	0
"HCG26"	1180	1180	76	110	76	0	60	50	18	100	76	41	113	3398	0	23	49	102
"HCG27"	1721	6209	0	0	0	0	0	0	16	0	0	0	5	26	0	0	0	0
"HCG2P7"	3623	3623	0	5	0	0	1	4	0	0	0	0	0	1	0	0	0	0
"HCG4"	2043	2043	0	0	0	0	0	0	21	0	0	0	1	0	1	0	161	138
"HCG4P6"	1065	1065	0	0	0	0	0	0	0	0	0	0	0	0	0	0	0	0
"HCG9"	645	3279	23	0	11	12	0	0	87	21	0	0	1	1	0	0	0	0
"HCK"	2165	49600	17744	14614	9735	8009	7727	6887	5636	10397	12517	20522	14934	18490	9844	13380	16279	12614
"HCLS1"	2046	29546	5211	3680	2960	2251	2057	1623	2103	1712	2516	3131	7181	12057	10106	8611	13053	8437
"HCN1"	5376	436869	0	0	0	0	0	0	0	0	0	0	0	0	0	0	0	0
"HCN2"	3414	27266	0	0	0	0	0	0	128	70	0	0	0	3	15	5	7	0
"HCN3"	3725	12266	0	0	0	0	0	0	70	17	0	0	0	13	8	0	13	3
"HCN4"	7235	49406	0	0	0	0	0	0	169	55	0	0	0	0	0	0	0	0
"HCP5"	2539	2629	313	466	218	95	266	200	285	541	0	616	1608	3405	668	1194	1077	1458
"HCRT"	579	1394	0	1	0	0	0	1	14	10	0	0	0	0	0	0	0	0
"HCRTR1"	2010	9620	181	202	120	61	86	116	213	216	0	218	743	914	976	914	1262	871
"HCRTR2"	1986	52407	14621	860	8089	6532	449	411	6622	106	4468	140	633	2060	4368	3179	5935	2682
"HCST"	511	1793	9	25	9	0	8	17	19	17	28	0	4641	1078	7492	8148	2025	2576
"HCTR-6"	3432	62522	0	0	0	0	0	0	0	0	0	0	44	36	8	24	8	0
"HD-PTP"	5159	32442	1278	334	695	583	182	152	830	275	801	415	1484	1094	2073	1530	2623	1523
"HDAC1"	6687	35029	3725	6338	1951	1774	3844	2494	1697	3686	965	21446	5089	7541	5705	6245	7273	6025
"HDAC10"	2724	6221	508	165	290	218	100	65	392	226	559	182	853	809	1177	763	1652	933
"HDAC11"	2927	26210	0	0	0	0	0	0	218	56	0	0	152	168	167	102	273	127
"HDAC2"	6658	35029	2647	5598	1374	1273	3462	2136	1259	3243	499	20732	3261	5333	3073	3901	3890	3690
"HDAC3"	1963	14288	1861	269	1035	826	149	120	765	82	1009	130	2608	1519	1870	981	2266	1472
"HDAC4"	9002	352780	19186	5839	10473	8713	3165	2674	12404	7480	8176	7419	1587	1802	847	807	1814	1040
"HDAC5"	5354	46895	1110	120	562	548	62	58	1265	302	826	37	1385	1096	1282	1149	2090	1312
"HDAC6"	4823	22895	475	152	255	220	77	75	171	179	162	142	731	670	1138	943	1406	909
"HDAC7"	4312	37256	653	43	368	285	27	16	755	317	55	162	405	261	876	623	1796	615
"HDAC8"	2100	99388	4534	1126	2559	1975	620	506	3011	1089	427	835	343	429	307	308	333	264
"HDAC9"	4676	501617	18209	9558	10347	7862	5274	4284	9573	4112	4931	5199	584	514	705	573	572	378
"HDC"	2416	23780	0	0	0	0	0	0	0	15	0	0	530	891	629	886	374	350
"HDDC2"	1621	26788	0	0	0	0	0	0	0	0	0	0	150	129	134	123	148	111
"HDDC3"	1047	1619	17	0	17	0	0	0	11	0	0	0	105	212	173	145	325	102
"HDGF"	2486	24819	498	322	258	240	149	173	219	308	59	727	3520	3877	3665	4879	4479	4321
"HDGF2"	2706	24276	223	28	115	108	16	12	289	65	15	0	732	692	953	833	1279	935
"HDGFL1"	1073	1073	0	0	0	0	0	0	0	0	0	0	0	0	0	0	0	0
"HDGFRP3"	1979	69507	1728	0	945	783	0	0	1682	0	47	0	110	55	48	40	86	21
"HDHD1A"	2214	99272	859	27	401	458	22	5	994	58	81	0	647	634	584	528	1103	729
"HDHD2"	2228	43091	1504	629	781	723	360	269	756	377	23	667	152	751	232	371	831	805
"HDHD3"	1723	2645	0	0	0	0	0	0	24	10	0	0	124	35	175	43	154	72
"HDJ2"	1368	13855	815	2928	488	327	1543	1385	433	1513	255	2691	2901	7164	3754	6914	3563	6076
"HDLBP"	6544	88577	12972	10847	6796	6176	5793	5054	5251	5399	8407	12664	8507	7799	9233	9483	11948	8748
"HDX"	2990	181251	0	230	0	0	133	97	10	480	0	13	25	33	1	32	14	5
"HE2"	556	15107	0	0	0	0	0	0	0	0	0	0	0	0	0	0	0	0
"HEATR1"	6836	53845	798	40	543	255	30	10	618	128	44	96	3691	3716	3958	2920	1031	2431
"HEATR2"	3427	59780	206	9	106	100	9	0	598	133	192	61	438	376	522	468	573	434
"HEATR3"	2621	39494	1032	149	470	562	103	46	683	68	87	90	1283	1018	1015	694	1289	840
"HEATR4"	3483	80460	0	0	0	0	0	0	43	0	0	21	511	314	979	694	1232	825
"HEATR5A"	6915	97218	2585	469	1470	1115	237	232	1851	491	621	870	1107	1167	1744	1645	2122	1041
"HEATR5B"	6828	103334	2653	254	1331	1322	154	100	1495	136	636	149	1130	1289	1310	1113	1865	1127
"HEATR6"	3955	35742	123	0	87	36	0	0	245	0	0	48	341	243	584	283	490	226
"HEATR7A"	5851	104654	4219	1269	2250	1969	621	648	2212	1039	2059	2570	391	568	3168	2985	4248	2783
"HEATR7B1"	1152	4864	0	0	0	0	0	0	0	0	0	0	0	0	0	0	0	0
"HEATR7B2"	5321	73323	0	0	0	0	0	0	0	0	0	0	0	0	0	0	0	0
"HEBP1"	2079	14642	21	0	18	3	0	0	122	0	0	0	416	409	695	669	736	663
"HEBP2"	1286	9248	40	0	9	31	0	0	17	0	4	0	345	377	268	219	428	265
"HECA"	5624	45698	5011	2575	2743	2268	1345	1230	2448	956	2108	2432	3818	3937	2908	1836	3656	2134
"HECTD1"	9177	107367	5379	1766	3037	2342	988	778	2800	872	1026	1740	3277	3656	4556	3179	3708	2790
"HECTD2"	4844	104426	0	49	0	0	35	14	108	47	0	31	95	127	142	174	97	67
"HECTD3"	3648	8808	530	52	274	256	39	13	254	54	258	58	1007	814	1560	1126	2059	864
"HECW1"	6869	450742	0	2	0	0	0	2	25	29	0	0	0	0	0	0	0	0
"HECW2"	6955	393360	0	0	0	0	0	0	0	0	0	0	32	50	72	80	35	22
"HEG1"	9473	90249	184	0	111	73	0	0	256	51	111	0	510	1506	812	702	1404	841
"HEI10"	912	17815	138	50	112	26	35	15	43	37	0	148	119	106	135	91	176	120
"HEL308"	3621	48526	131	11	71	60	3	8	129	0	0	0	284	251	332	171	392	235
"HELB"	3415	35638	217	80	110	107	55	25	221	158	29	202	70	182	103	182	87	109
"HELLS"	3259	56283	0	0	0	0	0	0	13	0	0	0	4	0	0	0	0	0
"HELO1"	2847	81748	9057	33149	4935	4122	17681	15468	2973	20517	1327	27754	4361	2604	4653	2455	5066	4741
"HELQ"	3608	48526	131	11	71	60	3	8	129	0	0	0	284	251	332	171	392	235
"HELT"	1104	1965	0	0	0	0	0	0	0	0	0	0	0	0	0	0	0	0
"HELZ"	13907	169052	5568	2066	3144	2424	1225	841	3065	1392	525	1139	1793	994	2415	2104	2211	1318
"HEMGN"	2191	18061	0	0	0	0	0	0	0	0	0	0	0	0	0	0	0	0
"HEMK1"	5895	15838	2777	886	1519	1258	475	411	1605	722	2708	1098	1195	1158	1779	1373	2396	1279
"HEPACAM"	3550	17162	10	0	10	0	0	0	0	0	0	0	0	0	0	0	0	0
"HEPACAM2"	2172	37884	0	0	0	0	0	0	0	0	0	0	0	0	0	0	0	0
"HEPH"	4875	97481	0	0	0	0	0	0	0	0	0	0	0	0	0	0	0	0
"HEPHL1"	5971	92998	0	0	0	0	0	0	28	0	0	0	0	1	0	0	0	0
"HEPN1"	1429	1429	10	0	10	0	0	0	0	0	0	0	0	0	0	0	0	0
"HER-2"	1550	12331	0	0	0	0	0	0	87	70	0	0	0	0	3	3	3	8
"HERC1"	15274	225331	12357	5119	6966	5391	2953	2166	6275	3445	3858	5356	3480	4850	4735	5048	5615	3476
"HERC2"	15423	211107	3280	1352	1966	1314	807	545	2038	994	736	980	1621	1857	2144	2218	2783	1775
"HERC2P3"	4428	123066	331	193	131	200	99	94	192	89	99	145	251	346	2424	2161	3309	1447
"HERC2P4"	1163	1266	0	0	0	0	0	0	0	0	0	0	0	0	0	0	0	0
"HERC2P7"	1766	3221	0	0	0	0	0	0	0	0	0	0	0	0	101	0	10	0
"HERC3"	4920	116041	12247	2292	6831	5416	1266	1026	6147	1109	3348	1138	2155	3466	2452	2719	3014	2168
"HERC4"	7089	151288	14172	5726	7940	6232	3155	2571	6750	2429	5369	4358	1634	1884	1555	1455	1841	1164
"HERC5"	3527	49039	634	16417	399	235	8753	7664	18	8474	0	3238	90	4943	360	868	108	139
"HERC6"	3911	64359	668	6759	387	281	3701	3058	93	3315	0	1584	290	1383	427	524	245	236
"HERPUD1"	2208	7932	973	156	510	463	103	53	544	162	529	88	2200	1242	3052	1191	2846	1811
"HERPUD2"	3062	62475	2479	478	1357	1122	257	221	1538	401	557	543	1523	778	1753	1042	1676	797
"HERV-FRD"	3192	9237	349	20	152	197	20	0	253	55	108	164	0	0	0	0	0	0
"HES1"	1457	2464	0	0	0	0	0	0	0	0	0	0	0	23	0	8	4	4
"HES2"	4263	4686	0	0	0	0	0	0	0	25	0	0	0	0	0	0	0	0
"HES3"	691	1378	0	0	0	0	0	0	0	0	0	0	0	0	0	0	0	0
"HES4"	1043	1212	0	0	0	0	0	0	0	2	0	0	0	24	0	104	0	15
"HES5"	1308	1501	0	0	0	0	0	0	0	1	0	0	0	0	0	0	0	0
"HES6"	1605	1772	0	0	0	0	0	0	19	0	6	0	227	121	328	248	317	199
"HES7"	1678	3496	0	0	0	0	0	0	17	19	0	0	0	0	0	0	0	0
"HESRG"	3140	7733	0	0	0	0	0	0	0	0	0	0	0	0	0	0	0	0
"HESX1"	1174	2335	0	0	0	0	0	0	0	0	0	0	7	5	0	0	1	0
"HEXA"	2483	32743	5278	986	2841	2437	565	421	2123	418	3635	387	2065	2688	4788	3843	6466	3895
"HEXB"	2033	81265	821	86	469	352	60	26	499	73	105	52	4230	3026	9193	9140	7729	6402
"HEXDC"	2233	24265	2277	262	1195	1082	136	126	476	210	793	291	4649	2857	1553	1242	2455	1419
"HEXIM1"	4785	4785	847	376	479	368	181	195	385	144	231	216	2247	1949	2278	1921	3240	2088
"HEXIM2"	2050	2682	129	50	76	53	27	23	232	93	115	88	62	37	72	0	149	5
"HEY1"	2309	3854	0	0	0	0	0	0	0	0	0	0	0	0	0	0	0	0
"HEY2"	2676	11684	0	0	0	0	0	0	0	0	0	0	0	0	0	0	0	0
"HEYL"	4118	16246	0	0	0	0	0	0	28	9	0	0	0	0	0	0	0	0
"HFE"	2228	7962	0	0	0	0	0	0	0	0	0	0	159	101	71	69	68	33
"HFE2"	2219	4356	0	0	0	0	0	0	0	9	0	0	0	0	0	0	0	0
"HFM1"	4969	144104	0	0	0	0	0	0	0	0	73	0	0	0	0	0	0	0
"HGC6.1.1"	2794	4253	0	0	0	0	0	0	0	0	0	0	0	0	0	0	0	0
"HGC6.2"	1652	12320	0	0	0	0	0	0	0	0	0	0	0	0	0	0	0	0
"HGC6.3"	1017	1017	0	0	0	0	0	0	27	0	0	0	0	0	0	0	0	0
"HGC6.4"	2313	2908	0	0	0	0	0	0	0	0	0	0	0	0	0	0	0	0
"HGD"	2402	23884	2	0	2	0	0	0	19	0	0	11	54	58	43	72	51	29
"HGF"	2822	68009	0	0	0	0	0	0	0	0	0	0	4	9	43	56	3	3
"HGFAC"	2072	7487	0	0	0	0	0	0	60	55	0	0	1	0	0	0	0	0
"HGRHSV1"	568	10517	1003	1065	537	466	623	442	397	455	348	375	230	287	268	267	376	175
"HGS"	2930	18127	2536	1851	1375	1161	998	853	901	1270	1859	2539	1694	1741	2594	2690	3541	2404
"HGSNAT"	5231	62379	3812	1061	2168	1644	686	375	1870	659	1153	955	5003	5518	4083	3447	5531	3368
"HGpMiX"	689	144649	0	0	0	0	0	0	0	0	0	0	0	0	0	0	0	0
"HHAT"	3632	347369	0	10	0	0	5	5	55	9	0	0	149	151	102	69	55	55
"HHATL"	1876	10165	0	0	0	0	0	0	105	48	0	0	0	0	0	0	0	0
"HHEX"	1761	5727	294	0	157	137	0	0	142	11	142	0	1390	97	1107	44	1286	218
"HHIP"	3543	92710	0	0	0	0	0	0	0	0	0	0	0	0	0	0	0	0
"HHIPL1"	3470	31532	0	0	0	0	0	0	67	22	0	0	0	0	0	0	0	0
"HHIPL2"	2583	25844	0	0	0	0	0	0	0	0	0	0	0	0	0	0	0	0
"HHLA1"	4574	19620	0	0	0	0	0	0	0	0	0	0	0	0	0	0	0	0
"HHLA2"	2669	75795	0	0	0	0	0	0	20	18	0	0	14	19	65	43	71	63
"HHLA3"	900	13212	0	0	0	0	0	0	76	0	0	0	6	178	0	0	0	0
"HIAT1"	2647	45140	3869	10507	2132	1737	5712	4795	1228	5908	293	5668	2201	4472	2394	2787	2731	2001
"HIATL1"	3309	86370	2333	419	1237	1096	223	196	1048	340	337	1057	2471	2724	3110	2348	3864	2437
"HIATL2"	1091	39683	2111	881	1300	811	492	389	1225	966	698	1927	241	150	401	307	529	228
"HIBADH"	2395	109742	850	37	496	354	14	23	1012	84	0	23	782	900	1152	1063	1271	859
"HIBCH"	1740	115200	610	69	370	240	39	30	539	113	0	15	189	223	272	257	275	180
"HIBDL"	3575	44100	2872	1589	1600	1272	907	682	1196	1059	1765	2498	3697	3467	5036	4320	6383	3932
"HIC1"	4103	5534	14	0	0	14	0	0	19	0	0	0	0	0	0	0	0	0
"HIC2"	6938	9001	487	0	257	230	0	0	337	111	364	113	339	165	431	268	579	183
"HIF-3A"	5775	45032	0	0	0	0	0	0	62	15	0	0	0	0	0	0	0	0
"HIF1A"	4077	52860	9259	21940	5231	4028	11982	9958	3417	9603	1938	16366	5317	9915	4897	6645	6234	4034
"HIF1AN"	6919	18041	1621	589	918	703	330	259	614	376	1095	638	2104	2081	2242	1599	2796	1464
"HIF3A"	5922	45032	0	0	0	0	0	0	62	15	0	0	0	0	0	0	0	0
"HIGD1A"	2940	21534	249	381	130	119	217	164	240	335	53	649	1381	2283	2029	2147	2220	1922
"HIGD1B"	621	2563	79	0	62	17	0	0	11	26	0	0	0	0	0	0	0	0
"HIGD1C"	296	16508	229	134	169	60	89	45	170	77	164	88	1	5	0	0	0	0
"HIGD2A"	612	968	78	47	55	23	30	17	119	136	0	0	2112	2106	2531	2751	3352	1546
"HIGD2B"	1119	10368	0	0	0	0	0	0	8	0	0	0	0	0	0	0	0	0
"HILS1"	904	1049	0	0	0	0	0	0	0	0	0	0	0	0	0	0	0	0
"HINFP"	2496	3617	211	0	128	83	0	0	333	12	52	0	415	211	348	143	572	214
"HINT1"	975	6161	435	148	230	205	82	66	215	92	0	205	1869	1993	1929	1798	2652	2006
"HINT2"	972	2085	0	0	0	0	0	0	0	0	0	0	221	165	243	188	323	187
"HINT3"	3382	23528	447	1156	256	191	581	575	163	297	0	220	1034	1588	1010	989	1049	876
"HIP1"	7270	204872	3918	1857	2227	1691	1074	783	1999	2514	2508	8012	557	727	2422	2386	2167	1438
"HIP1R"	4505	27470	38	353	25	13	213	140	73	584	0	156	7	42	0	29	13	14
"HIPK1"	8097	48427	3597	1293	2084	1513	609	684	1673	719	1526	1192	5010	5333	5470	3990	6053	3127
"HIPK2"	15142	231281	3726	1836	2227	1499	1009	827	3336	2421	1329	3519	2413	3019	5434	5429	4091	2993
"HIPK3"	4788	96064	10156	7625	5577	4579	4164	3461	4083	4387	2705	6844	7172	8854	7419	5716	6982	4152
"HIPK4"	2455	10917	0	0	0	0	0	0	90	13	0	0	0	0	0	0	0	0
"HIRA"	4132	100997	6004	670	3370	2634	378	292	3370	465	2945	1133	2361	1838	2354	1807	3230	1714
"HIRIP3"	2350	3072	51	12	41	10	12	0	72	114	0	17	30	179	293	103	244	178
"HIRIP5"	782	41500	43	0	43	0	0	0	36	0	0	57	168	198	335	233	353	286
"HISPPD1"	5854	82951	3639	966	1965	1674	489	477	2232	438	384	360	2727	3230	3197	2828	2848	1900
"HISPPD2A"	5728	56772	173	34	66	107	34	0	66	17	12	7	371	57	1110	1061	1357	926
"HIST1H1A"	781	781	0	0	0	0	0	0	0	0	0	0	0	0	0	0	0	0
"HIST1H1B"	790	790	0	0	0	0	0	0	12	0	0	0	0	0	0	0	0	0
"HIST1H1C"	732	732	64	0	42	22	0	0	0	26	0	0	65	85	89	75	66	72
"HIST1H1D"	777	777	10	0	0	10	0	0	33	11	0	0	0	0	0	0	0	0
"HIST1H1E"	785	785	241	134	143	98	65	69	129	141	110	89	0	0	0	0	0	0
"HIST1H1T"	725	725	0	0	0	0	0	0	0	0	0	0	0	0	0	0	0	0
"HIST1H2AA"	500	500	0	0	0	0	0	0	0	0	0	0	0	0	0	0	0	0
"HIST1H2AB"	478	478	0	0	0	0	0	0	0	0	0	0	0	0	0	0	0	0
"HIST1H2AC"	1463	14882	575	69	307	268	36	33	449	71	260	106	685	466	526	251	666	376
"HIST1H2AD"	460	460	84	0	44	40	0	0	86	0	0	40	1	0	7	5	4	6
"HIST1H2AE"	565	565	0	0	0	0	0	0	20	0	0	0	0	0	0	0	0	0
"HIST1H2AG"	498	498	0	19	0	0	19	0	43	15	0	0	0	0	0	0	0	0
"HIST1H2AH"	439	439	64	277	27	37	174	103	25	143	56	229	0	594	0	0	0	0
"HIST1H2AJ"	440	440	0	0	0	0	0	0	0	0	0	0	0	0	0	0	0	0
"HIST1H2AK"	460	460	0	0	0	0	0	0	43	0	0	0	0	0	0	0	0	0
"HIST1H2AL"	470	470	0	0	0	0	0	0	0	0	0	0	0	0	0	0	0	0
"HIST1H2AM"	488	488	0	0	0	0	0	0	18	0	0	0	0	0	0	0	0	0
"HIST1H2BA"	437	437	0	0	0	0	0	0	0	0	0	0	0	0	0	0	0	0
"HIST1H2BB"	431	431	0	0	0	0	0	0	0	0	0	0	0	0	0	0	0	0
"HIST1H2BC"	1145	9523	120	0	54	66	0	0	296	50	0	0	0	0	8	5	0	0
"HIST1H2BD"	813	13227	390	118	208	182	118	0	202	304	232	89	144	141	140	108	129	137
"HIST1H2BE"	435	435	0	0	0	0	0	0	0	11	0	0	0	0	0	0	0	0
"HIST1H2BF"	430	430	0	0	0	0	0	0	19	19	0	0	0	0	0	0	0	0
"HIST1H2BG"	446	446	23	0	23	0	0	0	33	40	0	47	0	0	0	0	0	0
"HIST1H2BH"	425	425	0	0	0	0	0	0	0	0	0	0	0	0	0	0	0	0
"HIST1H2BI"	437	437	0	0	0	0	0	0	14	0	0	0	0	0	0	0	0	0
"HIST1H2BJ"	481	481	0	0	0	0	0	0	18	17	0	0	4	0	0	0	0	1
"HIST1H2BK"	822	8548	142	378	77	65	200	178	134	212	0	485	625	1420	53	76	1118	1057
"HIST1H2BL"	453	453	0	0	0	0	0	0	32	0	0	0	0	0	0	0	0	0
"HIST1H2BM"	446	446	0	0	0	0	0	0	0	0	0	0	0	0	0	0	0	0
"HIST1H2BN"	710	13653	0	0	0	0	0	0	43	0	0	0	0	0	0	0	0	0
"HIST1H2BO"	468	468	0	0	0	0	0	0	18	17	0	0	0	0	0	0	0	0
"HIST1H3A"	470	470	10	0	0	10	0	0	0	23	0	0	0	0	0	0	0	0
"HIST1H3B"	473	473	0	0	0	0	0	0	0	0	0	0	0	0	0	0	0	0
"HIST1H3C"	459	459	0	0	0	0	0	0	0	0	0	0	0	0	0	0	0	0
"HIST1H3D"	865	2453	179	0	95	84	0	0	154	45	62	40	6	0	17	10	8	7
"HIST1H3E"	462	462	12	0	0	12	0	0	41	0	0	0	222	123	140	52	158	68
"HIST1H3F"	1569	2164	12	0	0	12	0	0	44	0	0	0	224	123	143	52	158	68
"HIST1H3G"	467	467	0	0	0	0	0	0	0	0	0	0	0	0	0	0	0	0
"HIST1H3H"	2338	2338	0	0	0	0	0	0	32	0	0	0	23	0	0	0	0	0
"HIST1H3I"	477	477	0	0	0	0	0	0	17	0	0	0	0	0	0	0	0	0
"HIST1H3J"	478	478	0	0	0	0	0	0	0	0	0	0	0	0	0	0	0	0
"HIST1H4A"	372	372	0	0	0	0	0	0	0	0	0	0	0	0	0	0	0	0
"HIST1H4B"	357	357	0	0	0	0	0	0	0	0	0	0	0	0	0	0	0	0
"HIST1H4C"	390	390	0	0	0	0	0	0	0	0	0	0	0	0	0	0	0	0
"HIST1H4D"	367	367	0	0	0	0	0	0	0	0	0	0	0	0	0	0	0	0
"HIST1H4E"	377	377	89	0	89	0	0	0	110	61	0	0	0	0	0	0	0	0
"HIST1H4F"	369	369	0	0	0	0	0	0	24	0	0	0	0	0	0	0	0	0
"HIST1H4G"	367	367	0	0	0	0	0	0	0	0	0	0	0	0	0	0	0	0
"HIST1H4H"	1036	4481	0	17	0	0	0	17	0	29	0	0	8	3	0	11	9	9
"HIST1H4I"	371	371	0	0	0	0	0	0	1	20	0	25	0	55	0	22	0	51
"HIST1H4J"	356	356	0	0	0	0	0	0	0	0	0	0	0	0	0	0	0	0
"HIST1H4K"	354	354	0	0	0	0	0	0	12	0	0	0	0	0	0	0	0	0
"HIST1H4L"	364	364	0	0	0	0	0	0	0	0	0	0	0	0	0	0	0	0
"HIST2H2AA3"	534	534	0	0	0	0	0	0	0	0	0	0	0	0	531	583	640	514
"HIST2H2AB"	448	448	143	99	76	67	49	50	323	470	0	93	0	0	0	0	0	0
"HIST2H2AC"	437	437	143	99	76	67	49	50	323	470	0	93	0	0	0	0	0	0
"HIST2H2BA"	517	8810	0	0	0	0	0	0	0	0	0	0	0	0	0	0	0	0
"HIST2H2BE"	2222	2222	260	384	157	103	194	190	323	470	83	329	259	285	292	213	270	220
"HIST2H2BF"	2117	2117	31	0	31	0	0	0	96	39	0	0	23	19	5	7	21	0
"HIST2H3C"	507	507	0	0	0	0	0	0	0	0	0	0	0	0	0	0	0	0
"HIST2H3D"	410	410	0	0	0	0	0	0	0	11	0	0	0	0	0	0	0	0
"HIST2H4A"	396	396	0	0	0	0	0	0	0	0	0	0	0	0	77	72	171	62
"HIST2H4B"	933	1954	0	0	0	0	0	0	0	0	0	0	0	0	208	178	217	159
"HIST3H2A"	496	496	0	0	0	0	0	0	15	10	0	0	15	16	49	36	61	41
"HIST3H2BB"	452	452	0	0	0	0	0	0	26	10	0	0	0	0	0	0	0	0
"HIST3H3"	482	482	0	0	0	0	0	0	15	0	0	0	0	0	0	0	0	0
"HIST4H4"	412	412	87	0	31	56	0	0	0	0	0	0	0	0	0	0	0	0
"HIVEP1"	8882	152509	265	19789	203	62	10652	9137	114	15351	0	16884	153	586	223	1731	175	83
"HIVEP2"	9733	193735	2138	35925	1216	922	19449	16476	327	20116	86	26023	287	278	415	507	147	39
"HIVEP3"	8880	408813	19122	14060	10627	8495	7408	6652	7015	8654	12514	16205	1091	1786	1577	1739	2731	1188
"HJURP"	3058	17727	0	0	0	0	0	0	0	18	0	0	0	0	0	0	0	0
"HK1"	4020	131881	3074	281	1771	1303	139	142	1973	214	1006	79	2810	3251	5550	4795	5986	4141
"HK1-tc"	727	73991	563	2	326	237	2	0	524	47	64	0	0	99	443	432	558	330
"HK2"	7104	60694	887	290	569	318	112	178	965	565	29	414	1446	1603	2872	3206	2877	2386
"HK3"	3086	18464	2522	1035	1059	1463	546	489	1288	505	2152	864	2865	2506	7198	6472	7508	5394
"HKDC1"	3706	47257	0	0	0	0	0	0	38	10	0	0	1	0	0	0	0	0
"HKE1.5"	1867	5463	1335	1465	512	823	990	475	314	6177	1016	2140	1025	872	1007	2422	1996	1522
"HKMT1069"	2274	9319	481	0	301	180	0	0	194	34	182	36	616	490	881	284	958	526
"HKMT1098"	1116	3005	0	0	0	0	0	0	0	0	0	0	0	0	0	0	0	0
"HKMT1188"	1845	12261	288	0	160	128	0	0	222	10	108	0	963	773	924	638	1199	754
"HKR1"	3489	51618	1559	401	881	678	234	167	824	419	697	462	649	470	466	234	454	224
"HKR3"	2490	3979	1279	104	859	420	63	41	613	118	125	85	1127	333	827	398	1256	534
"HLA DRB4"	335	1207	0	0	0	0	0	0	0	0	0	0	0	0	0	0	0	0
"HLA-A"	1809	2487	1674	5269	868	806	2793	2476	516	1882	280	1392	19558	25785	22096	28033	8892	28968
"HLA-A*0226"	1807	2504	0	0	0	0	0	0	0	0	0	0	0	0	0	0	0	0
"HLA-ABC"	923	1749	0	0	0	0	0	0	0	0	0	0	0	0	0	0	0	0
"HLA-B"	4629	7391	4090	7263	2257	1833	3798	3465	1477	4291	1521	4256	56732	50584	63531	64844	63782	30676
"HLA-B*0707"	1191	1436	0	0	0	0	0	0	0	0	0	0	0	0	0	0	0	0
"HLA-B*15MD"	1414	88581	0	0	0	0	0	0	0	0	0	0	0	0	0	0	0	0
"HLA-C"	1882	3299	904	1708	356	548	894	814	461	1109	553	836	8912	9175	12111	11480	5108	4321
"HLA-Cw"	1882	3299	0	0	0	0	0	0	0	0	0	0	0	0	0	0	0	0
"HLA-DMA"	1345	3489	3366	3405	1771	1595	1866	1539	1334	1931	2189	3297	14731	17396	3995	4257	21497	5936
"HLA-DMB"	4623	6409	5082	3145	2775	2307	1626	1519	1759	1255	2162	2093	13118	14907	13852	5052	12074	7788
"HLA-DOA"	3496	5432	47	280	13	34	137	143	113	255	0	89	2673	3090	1658	2443	3092	2835
"HLA-DOB"	1377	4286	0	19	0	0	0	19	0	78	0	35	34	77	24	63	13	68
"HLA-DPA1"	1333	8757	15614	30441	8694	6920	16286	14155	3398	16158	3165	16331	24236	248782	80372	91205	212260	158271
"HLA-DPB1"	1640	11218	8389	16078	4649	3740	8482	7596	2617	8179	2121	8081	52468	69725	35548	44058	82282	70979
"HLA-DPB2"	1127	6645	0	0	0	0	0	0	15	20	0	0	1938	2054	15	28	8	10
"HLA-DQ"	1061	5070	5026	148	2796	2230	83	65	2124	11204	1589	12229	2160	79926	1570	3367	6968	6885
"HLA-DQA1"	5478	9658	3999	96	2158	1841	45	51	1561	8395	1480	13301	2844	53276	3478	2311	47911	43782
"HLA-DQA2"	1715	6082	19	183	0	19	100	83	24	252	0	268	483	1027	0	1102	627	467
"HLA-DQB"	789	2394	0	0	0	0	0	0	0	0	0	0	0	0	0	0	0	0
"HLA-DQB1"	5491	6938	5026	228	2796	2230	130	98	2124	11217	1589	12236	3279	80141	1698	3557	7031	6947
"HLA-DQB1/DRB1"	422	1895	0	0	0	0	0	0	0	0	0	0	0	0	0	0	0	0
"HLA-DQB2"	2053	7459	31	163	0	31	57	106	107	854	0	778	2827	3722	126	399	2233	2293
"HLA-DRA"	1255	5176	6697	7681	3735	2962	17	7664	1589	6727	1868	8883	19199	423928	235300	307764	305284	244416
"HLA-DRB1"	1170	77014	20982	26253	11916	9066	14165	12088	6655	7607	5629	18934	126061	300190	54431	63210	219031	167431
"HLA-DRB3"	1167	77377	0	0	0	0	0	0	0	0	0	0	0	0	0	0	0	0
"HLA-DRB4"	1193	14968	0	0	0	0	0	0	0	0	0	0	0	0	0	0	0	0
"HLA-DRB5"	1203	72401	20982	26253	11916	9066	14165	12088	6655	7607	5629	18934	126061	300190	54431	63210	219031	167431
"HLA-DRB6"	1312	7291	3214	4949	1717	1497	2701	2248	1022	1661	1191	3472	31033	35567	6923	4330	11812	4545
"HLA-E"	1796	3798	2452	2152	1370	1082	1105	1047	794	1190	1545	1644	24191	25150	14988	15856	15213	16113
"HLA-F"	2663	5991	1119	2394	585	534	1224	1170	439	1111	25	1417	2195	4046	2019	3467	2709	3528
"HLA-G"	1697	3778	2010	5576	1080	930	2961	2615	961	2147	305	1439	20171	26602	22561	30128	28249	30359
"HLA-G2.2"	1139	3288	1	0	0	1	0	0	0	0	0	0	327	3	377	475	165	317
"HLA-G3"	862	3288	1	0	0	1	0	0	0	0	0	0	327	3	377	475	165	317
"HLA-H"	1655	2019	73	108	20	53	62	46	45	113	27	96	3171	3443	524	8041	957	7421
"HLA-J"	1558	3985	0	0	0	0	0	0	0	0	0	0	0	0	0	0	0	0
"HLCS"	6747	211279	3730	1791	2139	1591	975	816	1848	1257	417	1365	589	686	545	444	509	342
"HLF"	5603	60107	0	0	0	0	0	0	17	0	0	0	0	0	0	0	0	0
"HLTF"	5376	56439	17	0	13	4	0	0	23	4	39	0	462	487	549	380	478	253
"HLX"	2280	5657	691	170	389	302	99	71	197	137	166	195	1956	758	1136	559	2427	1163
"HM13"	2821	22121	5870	913	3302	2568	492	421	2589	579	5165	941	4905	4156	5915	4903	6082	4684
"HMBOX1"	3264	162331	5752	3103	3262	2490	1817	1286	3155	2112	932	2075	779	1125	1025	683	1214	654
"HMBS"	1841	8674	111	0	48	63	0	0	139	41	34	0	517	432	620	459	626	392
"HMCN1"	18319	456404	0	0	0	0	0	0	10	0	0	0	0	0	0	0	0	0
"HMFN0656"	1976	14845	250	5080	174	76	2700	2380	116	2811	0	5886	151	3899	356	10926	333	4817
"HMFN1876"	2137	15423	406	197	253	153	99	98	1239	519	333	215	38	169	80	99	185	124
"HMFN2567"	2239	21867	0	0	0	0	0	0	11	0	0	0	0	0	0	0	0	0
"HMFT1638"	4407	19829	349	201	214	135	94	107	311	298	64	150	1828	685	1837	1024	676	2265
"HMFT1716"	2356	21118	0	0	0	0	0	0	45	17	0	0	82	27	116	97	208	268
"HMFT2263"	2256	36326	572	161	283	289	111	50	499	172	24	41	201	280	352	253	278	178
"HMG1"	1856	2741	33	17	33	0	0	17	40	13	0	0	560	921	609	695	630	469
"HMG1L1"	3358	7202	583	235	345	238	120	115	231	41	101	79	4670	4803	2685	2113	3442	1966
"HMG1L10"	3883	5505	583	235	345	238	120	115	231	41	101	79	4670	4803	2685	2113	3442	1966
"HMG20A"	3894	64702	769	327	417	352	200	127	622	822	142	420	1290	1188	1107	836	1333	783
"HMG20B"	2412	6081	1083	1461	601	482	776	685	192	746	576	2251	2917	3446	4271	5974	4833	5444
"HMG2L1"	1410	8153	293	363	196	97	196	167	100	179	0	179	214	260	207	214	234	163
"HMGA1"	2164	9359	155	0	52	103	0	0	113	0	93	21	2468	1909	3049	2532	3890	2590
"HMGA2"	8536	134396	0	0	0	0	0	0	11	0	0	0	0	0	0	0	0	0
"HMGB1"	3450	6500	816	235	472	344	120	115	429	91	101	79	4678	4803	2685	2113	3594	2066
"HMGB1L1"	635	635	0	0	0	0	0	0	0	0	0	0	0	0	0	0	0	0
"HMGB2"	1532	3070	33	17	33	0	0	17	40	13	0	0	560	921	844	695	878	469
"HMGB3"	3644	7355	0	0	0	0	0	0	0	0	0	0	113	89	99	118	92	35
"HMGB3L1"	887	887	0	0	0	0	0	0	0	0	0	0	0	0	0	0	0	0
"HMGB4"	2344	4317	0	0	0	0	0	0	0	0	0	0	0	0	0	0	0	0
"HMGCL"	2170	36744	166	12	66	100	0	12	336	19	17	58	804	581	835	767	1344	903
"HMGCLL1"	2575	144841	0	0	0	0	0	0	0	0	0	0	0	0	0	0	0	0
"HMGCR"	4756	25772	1431	1887	862	569	1093	794	488	945	13	1600	3154	5039	2537	3197	3328	2519
"HMGCS1"	3520	24103	1707	6789	1014	693	3682	3107	415	2309	30	4724	2965	8798	2150	2896	2658	3407
"HMGCS2"	2053	20515	0	0	0	0	0	0	0	0	0	0	0	0	0	0	0	0
"HMGN1"	2709	7025	395	194	224	171	99	95	213	113	0	249	687	1885	3347	937	3797	2459
"HMGN2"	2060	2939	167	18	97	70	0	18	139	15	86	0	781	700	4293	3235	3962	2898
"HMGN3"	1460	33480	1054	437	608	446	259	178	702	226	72	125	909	961	1890	746	789	1404
"HMGN4"	1968	8592	351	199	216	135	108	91	156	161	46	184	2275	2716	1504	1151	2096	1179
"HMGN5"	2133	88243	5	2	0	5	0	2	29	0	0	0	785	41	25	698	1196	856
"HMGXB3"	5425	52538	11966	565	6636	5330	281	284	1132	367	827	360	735	13854	11928	10004	16572	10894
"HMGXB4"	4262	38356	728	905	478	250	513	392	363	638	0	451	738	867	722	704	830	543
"HMHA1"	4287	19455	6260	1956	3378	2882	1008	948	1769	1030	6383	1974	11050	8412	9489	6760	12389	7808
"HMHB1"	384	8558	0	0	0	0	0	0	0	0	0	0	0	0	0	0	0	0
"HMMR"	3157	31434	0	0	0	0	0	0	11	0	0	0	19	30	0	0	5	7
"HMOX1"	1555	13109	358	37	190	168	20	17	411	51	156	0	4969	2672	6118	5283	7291	4000
"HMOX2"	2097	14490	1804	244	1055	749	149	95	1002	267	1073	643	1511	1261	1852	1311	2243	1674
"HMP19"	2339	63459	0	0	0	0	0	0	33	0	0	0	0	0	0	0	0	0
"HMSD"	627	11057	0	0	0	0	0	0	0	0	0	0	0	10	5	7	6	0
"HMX1"	1898	4772	0	0	0	0	0	0	15	0	0	0	0	0	0	0	0	0
"HMX2"	1630	2552	0	0	0	0	0	0	0	0	0	0	0	0	0	0	0	0
"HMX3"	1075	1681	0	0	0	0	0	0	0	0	0	0	0	0	0	0	0	0
"HN1"	1702	19433	229	0	119	110	0	0	215	20	166	0	770	885	1344	1153	1489	1104
"HN1L"	3772	23796	362	28	203	159	17	11	339	173	20	89	987	910	1092	929	1332	768
"HNF1A"	3267	23765	0	0	0	0	0	0	15	0	0	0	0	0	0	0	0	0
"HNF1B"	2844	58663	0	0	0	0	0	0	0	0	0	0	0	0	0	0	0	0
"HNF4A"	3340	30107	0	0	0	0	0	0	107	40	0	0	0	0	0	0	0	0
"HNF4G"	4236	158790	0	0	0	0	0	0	0	0	0	0	0	0	0	0	0	0
"HNF4alpha"	405	139735	0	0	0	0	0	0	0	0	0	0	0	0	0	0	0	0
"HNMT"	3372	52127	4943	968	2797	2146	541	427	2844	957	995	724	2406	2523	2841	2403	2618	1604
"HNOEL-iso"	2148	2848	0	0	0	0	0	0	0	11	0	17	155	139	135	102	190	144
"HNRNPA0"	2966	2966	171	169	103	68	78	91	171	125	57	226	3519	3636	3421	3208	4668	3143
"HNRNPA1"	1934	4542	1650	1463	955	695	730	733	627	686	601	1186	2577	2953	10143	10526	12901	9928
"HNRNPA1L2"	2372	26316	7	0	0	7	0	0	29	0	0	0	165	114	3144	3165	3854	3142
"HNRNPA2B1"	3713	10858	14561	22465	7996	6565	12185	10280	5090	9874	6087	14739	10776	32707	13168	27547	15084	20101
"HNRNPA3"	5819	11265	2957	4165	1668	1289	2280	1885	1262	32585	1182	3004	105	4546	7681	7866	8334	6440
"HNRNPAB"	1870	6651	2109	800	1381	728	417	383	972	741	1229	979	1884	3354	2530	4313	2779	3828
"HNRNPC"	3591	60342	33391	114759	18785	14606	61894	52865	10088	47470	15539	88285	5787	13856	11820	19065	13306	13769
"HNRNPCL1"	3017	60342	33391	114759	18785	14606	61894	52865	10088	47470	15539	88285	5787	13856	11820	19065	13306	13769
"HNRNPD"	2266	20684	4260	4224	2355	1905	2292	1932	1875	1843	2166	3437	2719	4064	4771	3994	4290	3559
"HNRNPF"	2758	11216	2336	1796	1320	1016	940	856	829	819	1086	1893	5993	6378	6707	6584	7607	5852
"HNRNPH1"	3680	10492	6345	14312	184	6161	7793	6519	5554	5620	7255	9428	10638	15207	16005	3457	17297	11165
"HNRNPH2"	2311	5926	127	279	60	67	144	135	32	91	0	28	3813	5232	3955	4113	4295	3410
"HNRNPH3"	2421	11186	2863	2724	1554	1309	1458	1266	1045	1044	1104	1629	2446	3370	3519	3724	3753	2753
"HNRNPK"	3681	7716	2914	2773	1688	1226	1498	1275	1147	1089	1112	1903	7612	9957	8036	8702	10678	7573
"HNRNPL"	3109	5941	3979	4972	2156	1823	2636	2336	1248	1730	1800	4096	4172	875	6173	6863	8158	3519
"HNRNPM"	2545	44193	6217	6357	3435	2782	3385	2972	2512	3053	3928	7167	4262	5934	5103	5117	5598	4507
"HNRNPR"	2751	34578	3416	842	2257	1159	488	354	1938	480	420	973	267	987	1349	2963	1579	1279
"HNRNPU"	6860	14227	4321	9143	1085	3236	4912	4231	3544	145	3281	2021	8286	16380	12472	13104	13889	9978
"HNRNPUL1"	4215	43692	2697	692	1537	1160	390	302	1681	724	938	830	6005	2994	5582	4698	6942	4359
"HNRNPUL2"	3990	37076	3283	772	1853	1430	405	367	1360	473	1506	534	9628	8703	10303	5807	13994	8176
"HNRPA3"	3007	3007	0	0	0	0	0	0	0	0	0	0	0	0	0	0	0	0
"HNRPC"	3136	60342	33391	114759	18785	14606	61894	52865	10088	47470	15539	88285	5787	13856	11820	19065	13306	13769
"HNRPCL1"	3063	60342	33391	114759	18785	14606	61894	52865	10088	47470	15539	88285	5787	13856	11820	19065	13306	13769
"HNRPD"	1745	19243	4260	3786	2355	1905	2033	1753	1875	1796	2166	3314	2719	4064	3618	3133	4290	2675
"HNRPDL"	3622	7031	1539	1109	888	651	596	513	825	260	745	744	4430	5162	2599	2076	2740	2585
"HNRPF"	1048	1048	288	203	288	0	0	203	157	101	151	248	1	2	1	0	7061	0
"HNRPH1"	2456	9492	6160	14312	20	6140	7793	6519	5515	5620	7255	9428	10627	15207	15686	3104	17297	10971
"HNRPH3"	3449	11186	2863	2724	1554	1309	1458	1266	1045	1044	1104	1629	2446	3370	3519	3724	3753	2753
"HNRPK"	3621	7716	2366	2493	1392	974	1366	1127	1147	1089	911	1903	7612	9957	5895	6540	8243	6084
"HNRPLL"	3048	39852	9100	17831	5017	4083	9639	8192	2818	5656	2153	5100	1021	1767	1263	1028	1328	941
"HNRPUL1"	1923	43485	2697	692	1537	1160	390	302	1647	707	938	830	6005	2994	5582	4698	6942	4359
"HNT"	2538	125066	0	0	0	0	0	0	12	0	0	0	0	0	0	0	0	0
"HNTN1"	1313	3009	0	0	0	0	0	0	143	62	0	0	0	0	0	0	0	0
"HOIL-1"	2747	22901	1243	365	688	555	228	137	544	397	927	546	1270	1381	1838	1444	2480	1446
"HOMER1"	4222	139915	738	23608	432	306	13881	9727	27	7665	0	2001	87	955	202	221	164	153
"HOMER2"	1989	103737	25050	4435	12978	12072	2576	1859	11124	1622	20431	4773	10885	10710	3752	2757	4422	2521
"HOMER3"	1990	10436	8	0	7	1	0	0	77	19	0	0	299	170	238	443	393	346
"HOMEZ"	3852	25905	761	34	353	408	34	0	308	57	154	0	350	532	851	400	908	419
"HOOK1"	5878	61518	0	0	0	0	0	0	0	12	0	0	0	0	0	0	0	0
"HOOK2"	2633	12619	195	27	86	109	12	15	97	70	16	18	136	154	163	145	221	126
"HOOK3"	14461	133650	9116	4196	5067	4049	2335	1861	4262	2207	2525	3088	4281	5096	3549	2494	3480	1868
"HOP"	1722	33720	0	0	0	0	0	0	0	0	0	0	116	16	32	30	135	84
"HOPX"	1678	33720	0	0	0	0	0	0	0	0	0	0	116	16	32	30	135	84
"HORMAD1"	1894	22812	178	13	85	93	0	13	24	0	0	0	13	0	4	3	0	0
"HORMAD2"	1902	96607	0	0	0	0	0	0	0	0	0	0	0	0	0	0	0	0
"HOTAIR"	2337	6419	0	0	0	0	0	0	25	19	0	0	0	0	0	0	0	0
"HOXA1"	2547	3011	0	0	0	0	0	0	10	0	0	0	9	0	0	0	0	0
"HOXA10"	2572	3746	0	0	0	0	0	0	25	22	0	0	0	10	0	0	0	0
"HOXA11"	2654	4060	0	0	0	0	0	0	18	14	0	0	0	0	0	0	0	0
"HOXA11AS"	1551	3887	0	0	0	0	0	0	0	0	0	0	0	0	0	0	0	0
"HOXA13"	2516	3228	0	0	0	0	0	0	0	0	0	0	0	0	0	0	0	0
"HOXA2"	1779	2422	372	22	77	295	0	22	403	27	0	0	0	0	52	29	0	0
"HOXA3"	3399	20831	0	0	0	0	0	0	34	0	0	0	0	0	1	1	0	1
"HOXA4"	1729	2274	0	0	0	0	0	0	15	0	0	0	0	0	0	0	0	0
"HOXA5"	1334	2293	0	0	0	0	0	0	0	0	0	0	0	0	0	0	0	0
"HOXA6"	865	2254	0	0	0	0	0	0	0	0	0	0	0	0	0	0	0	0
"HOXA7"	2015	2958	0	0	0	0	0	0	0	29	0	0	0	0	0	0	0	0
"HOXA9"	2058	3093	0	0	0	0	0	0	0	20	0	0	0	0	0	0	0	0
"HOXB1"	1016	1467	0	0	0	0	0	0	27	0	0	0	0	0	0	0	0	0
"HOXB13"	3036	3984	0	0	0	0	0	0	0	0	0	0	0	0	0	0	0	0
"HOXB2"	1602	2374	0	0	0	0	0	0	0	0	0	0	0	0	0	0	0	5
"HOXB3"	3621	25579	0	0	0	0	0	0	26	35	0	0	0	0	0	0	0	0
"HOXB4"	2034	2875	0	0	0	0	0	0	0	0	0	0	0	0	0	0	0	0
"HOXB5"	1822	2485	0	0	0	0	0	0	33	0	0	0	0	0	0	0	0	0
"HOXB6"	2916	2916	0	0	0	0	0	0	120	11	0	0	0	0	0	0	0	0
"HOXB7"	1360	3782	0	0	0	0	0	0	0	0	0	0	0	0	0	0	0	0
"HOXB8"	1824	2594	0	0	0	0	0	0	0	0	0	0	0	0	0	0	0	0
"HOXB9"	2695	5311	0	0	0	0	0	0	25	0	0	0	0	0	0	0	0	0
"HOXC10"	1959	5116	0	0	0	0	0	0	27	0	0	0	0	0	0	0	0	0
"HOXC11"	2038	3293	0	0	0	0	0	0	0	11	0	0	0	0	0	0	0	0
"HOXC12"	849	1636	0	0	0	0	0	0	0	0	0	0	0	0	0	0	0	0
"HOXC13"	2397	7753	0	0	0	0	0	0	0	11	0	0	0	0	0	0	0	0
"HOXC4"	2303	39173	0	0	0	0	0	0	66	19	0	0	0	0	0	0	0	0
"HOXC5"	1640	18502	0	0	0	0	0	0	50	19	0	0	0	0	0	0	0	0
"HOXC6"	2074	13966	0	0	0	0	0	0	36	19	0	0	0	0	0	0	0	0
"HOXC8"	2288	3655	0	0	0	0	0	0	20	0	0	0	0	0	0	0	0	0
"HOXC9"	1544	7827	0	0	0	0	0	0	38	20	0	0	0	0	0	0	0	0
"HOXD1"	2110	2329	0	0	0	0	0	0	0	0	0	0	0	0	0	0	0	0
"HOXD10"	1805	3179	0	0	0	0	0	0	0	0	0	0	0	0	0	0	0	0
"HOXD11"	1463	2232	0	0	0	0	0	0	0	0	0	0	0	0	0	0	0	0
"HOXD12"	843	960	0	0	0	0	0	0	0	0	0	0	0	0	0	0	0	0
"HOXD13"	2329	3136	0	0	0	0	0	0	0	0	0	0	0	0	0	0	0	0
"HOXD3"	2302	9023	0	0	0	0	0	0	0	0	0	0	0	0	0	0	0	0
"HOXD4"	1296	1836	0	0	0	0	0	0	0	0	0	0	0	0	0	0	0	0
"HOXD8"	2226	2601	0	0	0	0	0	0	0	0	0	0	0	0	0	0	0	0
"HOXD9"	1886	2233	0	0	0	0	0	0	0	0	0	0	0	0	0	0	0	0
"HOYS6"	419	502	21	0	14	7	0	0	26	14	34	0	0	132	171	154	0	163
"HOZFP"	1764	31463	10007	2050	9927	80	1142	908	9255	483	3021	162	1350	744	846	506	2032	686
"HP"	1499	4899	0	0	0	0	0	0	0	0	0	0	0	0	0	0	0	0
"HP1BP3"	4784	32278	4564	2402	2498	2066	1382	1020	1998	969	2240	2019	2251	2434	4198	3402	5048	2927
"HP2XM"	2168	12828	0	0	0	0	0	0	55	44	0	0	0	1	0	0	0	0
"HP59"	2331	42122	442	28	253	189	16	12	402	11	162	0	870	722	866	737	896	739
"HPA"	1693	39838	0	0	0	0	0	0	16	17	0	0	0	0	0	0	0	0
"HPCA"	1409	8150	0	6275	0	0	3354	2921	0	920	0	7801	0	1786	0	60	0	1217
"HPCAL1"	5053	103271	18073	1498	10013	8060	911	587	8059	1646	19257	1573	1528	1292	2680	2381	3475	2155
"HPCAL4"	4256	12439	0	0	0	0	0	0	12	0	0	0	0	0	0	0	0	0
"HPD"	1913	49084	0	0	0	0	0	0	106	27	10	0	0	1	3	0	6	3
"HPDL"	1801	1801	0	0	0	0	0	0	17	11	0	0	0	0	0	0	0	0
"HPGD"	2777	32466	0	0	0	0	0	0	0	0	0	0	33	65	24	61	11	10
"HPGDS"	1621	44322	0	0	0	0	0	0	0	0	0	0	22	31	28	35	16	10
"HPN"	2376	26067	14	560	14	0	319	241	76	1081	0	292	0	0	0	32	0	0
"HPR"	1246	14021	27	0	0	27	0	0	47	20	0	0	0	0	0	0	0	0
"HPRG1"	983	983	0	0	0	0	0	0	0	0	0	0	0	0	0	0	0	0
"HPRT1"	1429	40523	161	237	92	69	150	87	47	227	0	225	869	992	678	639	895	704
"HPS1"	3746	30750	5011	1534	2495	2516	803	731	1897	879	4387	1264	3837	3570	5639	5457	6444	3802
"HPS3"	4468	43936	1248	77	756	492	42	35	1346	25	687	38	2276	1593	1586	1099	1660	1059
"HPS4"	6751	32358	635	147	327	308	75	72	361	102	69	13	684	538	783	593	1001	558
"HPS5"	4903	43506	4149	2522	2271	1878	1372	1150	1764	1106	835	700	2748	3043	2067	1923	3581	1525
"HPS6"	2647	2647	58	0	40	18	0	0	23	0	0	0	1369	474	1409	514	1987	596
"HPSE"	1809	39838	0	0	0	0	0	0	16	17	0	0	0	0	0	0	0	0
"HPSE2"	2376	776744	0	1	0	0	1	0	30	0	0	0	0	1	0	0	0	0
"HPT"	3294	22658	587	5	371	216	0	5	340	22	82	15	1096	914	1266	794	1241	788
"HPVC1"	1199	1199	0	0	0	0	0	0	0	0	0	0	0	0	0	0	0	0
"HPX"	1633	9988	0	0	0	0	0	0	12	0	0	0	0	0	0	3	0	0
"HR"	5533	16633	678	34	337	341	17	17	418	116	616	47	1502	1140	846	518	1973	901
"HRAS"	1239	3309	399	294	199	200	117	177	214	263	311	384	157	204	368	223	308	218
"HRASLS"	1065	29727	0	0	0	0	0	0	0	0	0	0	0	0	0	0	0	0
"HRASLS2"	746	10615	0	0	0	0	0	0	11	0	0	0	0	0	0	0	0	0
"HRASLS5"	3119	29806	0	0	0	0	0	0	0	0	0	0	0	0	0	0	0	0
"HRC"	2388	4225	0	0	0	0	0	0	0	26	0	0	0	0	0	0	0	0
"HRCT1"	951	951	0	0	0	0	0	0	0	0	0	0	0	0	0	0	0	0
"HRF2"	1465	224265	0	0	0	0	0	0	0	0	0	0	0	0	0	0	0	0
"HRG"	1958	12226	0	0	0	0	0	0	0	0	0	0	0	0	0	0	0	0
"HRH1"	4559	126161	26529	8556	14759	11770	4412	4144	17069	4376	28046	7162	4157	2873	3737	2172	5373	2638
"HRH2"	3096	3096	1463	1605	785	678	837	768	619	1521	588	76	516	662	594	333	568	314
"HRH3"	2683	5308	0	0	0	0	0	0	29	34	0	0	2	0	0	0	0	0
"HRH4"	3670	19329	103	0	36	67	0	0	13	0	0	0	165	215	145	142	170	73
"HRIHFB2007"	4748	10145	2184	2479	1181	1003	1342	1137	580	1424	1751	4148	1509	2483	2047	3855	3382	2846
"HRIHFB2018"	2165	38976	2578	1504	1387	1191	897	607	1078	1273	1730	2097	923	868	1641	993	2000	1117
"HRIHFB2091"	983	42308	5225	3088	2938	2287	1656	1432	2001	1426	1997	2462	2967	3744	3274	3961	3724	3044
"HRIHFB2216"	4936	6174	43	0	29	14	0	0	0	17	0	0	78	85	78	46	160	55
"HRIHFB2255"	739	80533	0	0	0	0	0	0	0	0	0	0	0	0	0	0	0	0
"HRIHFB2281"	2867	16685	1874	1054	1020	854	509	545	943	800	1569	1754	1475	1450	2517	2277	3156	2049
"HRK"	698	20206	0	0	0	0	0	0	14	11	0	0	0	0	0	0	0	0
"HRMT1L2"	1690	12552	177	139	108	69	67	72	245	234	18	206	505	575	1397	1554	1369	1318
"HRMT1L3"	1601	44989	0	0	0	0	0	0	27	10	0	0	0	0	0	0	0	0
"HRNBP3"	2809	393254	123	0	73	50	0	0	2452	1293	0	0	1	1	0	0	1	0
"HRNR"	9626	12113	0	0	0	0	0	0	28	0	0	0	0	0	0	0	0	0
"HRS"	1006	7842	1408	1090	772	636	552	538	615	1082	1103	1504	311	375	681	581	998	520
"HRSP12"	1017	14853	0	0	0	0	0	0	0	14	0	0	76	93	107	107	144	112
"HRY"	1014	1141	0	0	0	0	0	0	0	0	0	0	0	12	0	6	3	3
"HS1BP3"	2410	33302	1220	85	664	556	69	16	1074	467	315	208	807	625	497	738	527	435
"HS2ST1"	6764	195347	6392	1619	3472	2920	928	691	3594	799	990	907	1686	2003	1409	1382	1548	1143
"HS3ST1"	1966	30550	1945	96	1121	824	59	37	1073	44	440	70	0	0	0	228	1	283
"HS3ST2"	2245	101799	0	0	0	0	0	0	84	20	0	0	100	58	129	119	314	279
"HS3ST3A1"	2529	106240	0	0	0	0	0	0	0	0	0	0	0	0	0	173	29	69
"HS3ST3B1"	2034	44988	1658	9416	922	736	4996	4420	110	5432	0	5105	42	1789	19	810	102	263
"HS3ST4"	3204	445663	0	0	0	0	0	0	37	0	0	0	185	241	1718	1769	0	1200
"HS3ST5"	3236	286791	16	29	0	16	22	7	23	0	0	17	0	78	0	0	1	9
"HS3ST6"	1062	6766	0	0	0	0	0	0	41	19	0	0	0	0	0	0	0	0
"HS6ST1"	3953	53118	1010	128	483	527	80	48	1314	570	772	164	563	412	1555	1287	1303	0
"HS6ST2"	4573	335387	0	0	0	0	0	0	0	12	0	0	0	0	0	0	0	0
"HS6ST3"	7801	748720	0	0	0	0	0	0	0	0	0	0	0	0	0	0	0	0
"HSA"	1774	12818	0	0	0	0	0	0	0	0	0	0	0	0	0	0	0	0
"HSBP1"	1895	5003	45	0	27	18	0	0	33	98	39	68	1238	1328	1751	1530	1952	1304
"HSBP1L1"	752	6240	386	0	231	155	0	0	213	43	50	0	399	94	387	146	478	182
"HSCB"	1086	15447	117	0	85	32	0	0	129	13	0	0	191	126	157	86	162	113
"HSCP1"	1967	28661	631	253	348	283	140	113	384	97	183	41	2020	2348	3192	3219	3537	3000
"HSD11B1"	1421	48746	2254	12818	1274	980	6861	5957	195	6524	11	14522	4205	8085	3186	6569	2221	2415
"HSD11B1L"	1959	7499	0	0	0	0	0	0	123	119	0	0	19	0	11	12	26	8
"HSD11B2"	1885	6418	408	30	240	168	17	13	251	211	0	0	0	0	0	0	0	0
"HSD17B1"	2232	3242	83	0	20	63	0	0	108	26	54	0	347	143	336	76	436	186
"HSD17B10"	969	3119	0	0	0	0	0	0	0	0	0	0	346	558	737	704	962	725
"HSD17B11"	1880	54766	610	14	288	322	14	0	629	0	144	0	2490	1598	1100	1505	1715	1800
"HSD17B12"	2547	176019	3688	1833	2140	1548	1069	764	2224	1764	93	1004	1455	1673	2332	2073	1830	1370
"HSD17B13"	2402	19117	0	0	0	0	0	0	0	0	0	0	0	0	0	2	0	0
"HSD17B14"	1246	23662	0	0	0	0	0	0	92	64	0	0	9	14	30	41	33	25
"HSD17B2"	1438	63282	0	0	0	0	0	0	0	0	0	0	0	0	0	0	0	0
"HSD17B3"	1145	66847	0	0	0	0	0	0	0	0	0	0	0	0	0	0	0	0
"HSD17B4"	2833	89764	1823	446	1077	746	225	221	1270	163	305	103	2557	1868	4665	4485	4732	3643
"HSD17B6"	1517	24468	0	0	0	0	0	0	9	0	0	0	0	0	0	0	0	0
"HSD17B7"	2546	22113	58	0	33	25	0	0	133	19	0	0	184	327	202	168	247	194
"HSD17B7P2"	1408	22126	141	116	66	75	94	22	262	205	137	196	149	362	194	97	309	109
"HSD17B8"	998	2190	0	0	0	0	0	0	42	48	0	0	43	49	58	20	74	42
"HSD3B1"	1697	7742	0	0	0	0	0	0	0	0	0	0	0	0	0	0	0	0
"HSD3B2"	4073	31349	0	0	0	0	0	0	0	0	0	0	0	0	0	0	0	0
"HSD3B7"	2284	3694	110	8	53	57	0	8	88	20	48	0	726	776	1191	1111	1236	963
"HSDL1"	3674	23058	51	0	25	26	0	0	152	64	0	7	368	440	486	412	534	327
"HSDL2"	3221	92335	53	0	19	34	0	0	112	0	0	4	473	527	576	462	475	312
"HSF1"	2205	23116	2283	1238	1289	994	698	540	900	1099	1791	2739	1549	1302	1924	1686	2682	1619
"HSF2"	2710	33570	50	0	22	28	0	0	75	0	0	0	201	112	259	157	141	75
"HSF2BP"	1907	130303	3	2	3	0	2	0	103	29	4	0	15	0	3	3	0	0
"HSF4"	3156	7099	179	54	98	81	27	27	268	116	150	34	307	186	447	374	558	303
"HSF5"	4113	68232	0	0	0	0	0	0	0	0	0	0	0	0	0	0	0	0
"HSFX1"	2015	181592	279	0	112	167	0	0	230	21	11	0	140	104	487	317	656	371
"HSFY1"	1445	1922	0	0	0	0	0	0	0	0	0	0	0	0	0	0	0	0
"HSFY2"	1500	42292	0	0	0	0	0	0	0	0	0	0	0	0	0	0	0	0
"HSFYP1"	1383	1863	0	0	0	0	0	0	0	0	0	0	0	0	0	0	0	0
"HSGT1"	1837	33572	513	1220	279	234	717	503	300	863	105	1079	418	759	467	688	451	422
"HSH2D"	2539	14935	1089	259	523	566	129	130	685	502	723	368	5224	5956	775	260	1420	505
"HSKM-B"	4083	53088	391	65	270	121	41	24	303	25	87	64	432	403	590	462	728	488
"HSMU4"	1784	5674	69	12	44	25	12	0	102	54	19	30	465	412	373	346	551	357
"HSN2"	1931	1931	558	181	282	276	116	65	544	255	260	275	16	0	0	4	4	0
"HSP105 beta"	1364	8388	1814	945	994	820	576	369	785	1808	767	889	2345	2670	3260	4357	3413	2580
"HSP27"	528	718	1	16	0	1	0	16	36	27	0	0	820	687	44	0	57	78
"HSP60"	2457	6487	229	39	133	96	22	17	84	28	0	50	372	367	363	258	321	213
"HSP90AA1"	3895	59012	1284	1600	863	421	894	706	566	783	71	616	32306	40817	29629	21786	29808	13255
"HSP90AB1"	2563	6767	936	1712	507	429	937	775	422	1212	176	2018	21499	2933	25174	31242	21767	24246
"HSP90AB3P"	2435	6767	880	1619	464	416	882	737	377	1184	176	2018	19075	1	23582	29426	20044	22799
"HSP90AB4P"	1521	2024	166	15	126	40	15	0	58	0	0	0	0	0	0	0	0	0
"HSP90B1"	2798	17516	1178	675	692	486	371	304	632	216	152	0	6172	6808	22951	22566	13685	10712
"HSP90Bb"	4889	4889	0	0	0	0	0	0	21	0	35	0	0	4	0	0	0	0
"HSPA12A"	5947	179014	0	0	0	0	0	0	267	60	0	0	0	0	0	0	0	0
"HSPA12B"	3120	20402	165	0	81	84	0	0	259	91	2	0	0	1	0	0	0	0
"HSPA13"	3989	12072	13	23	0	13	12	11	0	11	0	0	677	960	188	719	158	465
"HSPA14"	1818	33479	369	50	170	199	33	17	243	60	0	59	661	578	830	561	741	502
"HSPA1A"	2428	2428	24	60	13	11	0	60	42	93	0	23	1784	4561	11474	44294	11319	39637
"HSPA1B"	2525	2525	40	60	29	11	0	60	80	139	0	23	2179	4949	12175	45448	11888	40474
"HSPA1L"	2539	5440	0	0	0	0	0	0	59	61	0	0	664	1449	11496	44229	11302	39594
"HSPA2"	2768	2768	99	17	72	27	17	0	119	52	0	67	0	16	1	0	0	0
"HSPA4"	3403	53048	1124	612	611	513	336	276	792	578	80	892	2631	3372	4686	3895	4828	3295
"HSPA4L"	3285	51071	0	0	0	0	0	0	0	0	0	0	20	25	3	7	0	0
"HSPA5"	3973	6536	386	391	146	240	204	187	142	215	14	165	9643	11595	12267	16401	11095	10446
"HSPA6"	2876	2896	1	0	1	0	0	0	0	0	0	0	61	21	171	182	243	120
"HSPA7"	2494	2494	650	303	485	165	170	133	87	80	268	165	861	749	450	431	712	420
"HSPA8"	2269	4645	4714	5608	2637	2077	2953	2655	895	3563	321	1698	52605	60485	53887	60112	45187	52923
"HSPA9"	2866	20092	1676	1916	936	740	1040	876	563	936	500	2450	4609	4078	7060	7083	7462	5200
"HSPB1"	896	1737	3	16	0	3	0	16	36	52	0	0	2124	1684	2289	2200	2527	2321
"HSPB11"	2742	24056	497	76	333	164	54	22	395	0	105	0	270	227	319	230	365	280
"HSPB2"	1049	6270	0	0	0	0	0	0	10	7	0	0	0	0	0	0	0	0
"HSPB3"	764	764	0	0	0	0	0	0	0	0	0	0	0	0	0	0	0	0
"HSPB6"	1460	2462	1	0	0	1	0	0	12	25	0	0	0	0	0	0	0	0
"HSPB7"	2910	4764	0	0	0	0	0	0	88	0	0	0	0	0	0	0	0	0
"HSPB8"	2004	15957	0	0	0	0	0	0	24	0	0	0	0	0	0	0	0	0
"HSPB9"	617	617	0	0	0	0	0	0	0	0	0	41	0	0	0	0	0	0
"HSPBAP1"	1944	53806	3894	927	2231	1663	581	346	1823	278	743	264	680	712	693	358	856	361
"HSPBL2"	382	382	0	0	0	0	0	0	0	0	0	0	0	0	0	0	0	0
"HSPBP1"	1915	18161	13	8	0	13	0	8	89	27	0	0	332	320	372	385	511	360
"HSPC047"	387	387	0	0	0	0	0	0	0	0	0	0	0	0	0	0	0	0
"HSPC072"	1956	6615	0	0	0	0	0	0	0	0	0	0	0	0	0	0	0	0
"HSPC157"	1102	6008	158	0	79	79	0	0	76	0	0	0	374	306	269	141	465	211
"HSPC159"	3826	7186	4	0	0	4	0	0	0	0	0	0	16	28	22	162	32	63
"HSPCA"	1764	3715	1006	1418	704	302	894	524	241	756	66	616	32306	33925	14221	16198	15099	9641
"HSPD1"	3006	13332	502	394	301	201	214	180	298	453	127	595	1736	5450	3767	4244	3407	4668
"HSPDE1A"	2352	379932	0	0	0	0	0	0	14	0	0	0	0	0	0	0	0	0
"HSPE1"	956	3467	94	40	56	38	15	25	0	95	0	96	592	912	761	1101	1156	890
"HSPG2"	14387	115014	616	217	347	269	112	105	1336	626	474	174	1709	1575	1653	1587	2469	2057
"HSPH1"	3683	25354	3684	2162	1965	1719	1188	974	1710	1817	1331	1974	7530	9283	7680	9209	7523	5893
"HSSG1"	2945	7895	1482	1476	826	656	823	653	695	864	478	1071	2706	2344	2662	3416	2907	3192
"HSST3"	2242	202877	0	0	0	0	0	0	0	0	0	0	0	0	0	0	0	0
"HT014"	1581	9846	98	42	65	33	4	38	57	8	75	0	802	734	858	770	993	653
"HT015"	2544	5499	122	84	35	87	84	0	78	44	143	168	621	963	328	838	523	408
"HTA"	1079	1424	0	0	0	0	0	0	0	0	0	0	0	0	0	0	0	0
"HTATIP2"	1693	19928	200	40	114	86	15	25	161	32	79	0	1611	1370	1648	1187	2137	1389
"HTATSF1"	3029	15265	0	0	0	0	0	0	0	0	0	0	1133	1203	1362	1138	1511	1061
"HTEX4"	2436	60261	209	27	94	115	22	5	452	126	0	74	1025	1320	137	207	184	263
"HTMP10"	3558	16117	1	0	1	0	0	0	0	0	0	0	0	0	0	0	0	0
"HTN1"	542	8401	0	0	0	0	0	0	0	0	0	0	0	0	0	0	0	0
"HTN3"	584	8127	0	0	0	0	0	0	0	0	0	0	0	0	0	0	0	0
"HTR1A"	1269	1269	0	0	0	0	0	0	0	9	0	0	0	0	0	0	0	0
"HTR1B"	1174	1174	0	0	0	0	0	0	10	0	0	0	0	0	0	0	0	0
"HTR1D"	2835	2835	0	0	0	0	0	0	9	0	0	0	0	0	0	0	0	0
"HTR1E"	2043	79368	0	0	0	0	0	0	0	0	0	0	0	0	0	0	0	0
"HTR1F"	3180	11195	0	0	0	0	0	0	0	0	0	0	0	0	0	0	0	0
"HTR2A"	3449	63539	0	0	0	0	0	0	0	0	0	0	0	0	0	0	0	0
"HTR2B"	2234	16874	714	219	410	304	136	83	417	375	134	292	1	0	0	3	0	1
"HTR2C"	4849	326075	0	0	0	0	0	0	0	0	0	0	0	0	0	0	0	0
"HTR3A"	2339	15237	0	0	0	0	0	0	30	8	0	0	0	0	0	0	0	0
"HTR3B"	1825	41695	0	0	0	0	0	0	0	0	0	0	0	0	0	0	0	0
"HTR3C"	1706	7626	0	0	0	0	0	0	0	0	0	0	0	0	0	0	0	0
"HTR3D"	1766	6539	0	0	0	0	0	0	0	0	0	0	0	0	0	0	0	0
"HTR3E"	2147	9932	0	0	0	0	0	0	20	0	0	0	0	0	0	0	0	0
"HTR4"	26032	59467	0	0	0	0	0	0	8	0	1	0	1	1	0	0	0	0
"HTR5A"	2402	14915	0	0	0	0	0	0	0	0	0	0	0	0	0	0	0	0
"HTR6"	1986	14276	0	0	0	0	0	0	35	22	0	0	0	0	0	0	0	0
"HTR7"	3348	117095	0	0	0	0	0	0	7	0	0	0	16	9	0	12	3	0
"HTR7P"	4388	4388	69	0	27	42	0	0	77	0	0	0	238	183	235	118	245	98
"HTRA1"	2129	53385	0	2	0	0	1	1	15	37	0	0	0	0	0	0	0	0
"HTRA2"	2558	4153	8	60	2	6	6	54	100	175	418	156	3231	394	503	454	709	539
"HTRA3"	2542	37340	0	2	0	0	1	1	204	26	0	0	2	0	0	0	0	0
"HTRA4"	2112	14508	0	0	0	0	0	0	5	0	2	0	0	10	63	43	27	26
"HTT"	13542	169280	18736	7160	10450	8286	3825	3335	8889	3538	11756	6982	7797	8331	11235	10999	12981	8316
"HUAT"	1606	18413	1956	509	987	969	286	223	848	257	1311	531	4047	2980	7506	6132	6699	5202
"HULC"	484	1637	0	0	0	0	0	0	0	0	0	0	0	0	0	0	0	0
"HUNK"	7395	130750	0	0	0	0	0	0	0	0	0	0	0	0	0	0	0	0
"HUS1"	2951	16265	600	364	324	276	182	182	337	224	132	296	105	238	461	361	333	296
"HUS1B"	1026	1026	366	100	225	141	57	43	45	13	0	0	0	0	0	0	0	0
"HUWE1"	14809	154603	9163	10973	5104	4059	5835	5138	4140	5914	613	8429	5420	6278	6976	6586	8753	5374
"HVCN1"	1744	41128	1868	144	1068	800	91	53	1081	280	1673	1021	1319	810	990	712	1302	974
"HVPS41"	3043	21671	1436	878	814	622	553	325	783	496	270	541	565	615	1698	1451	1801	1295
"HYAL1"	2521	3685	10	0	10	0	0	0	123	48	0	0	15	0	0	0	5	0
"HYAL2"	4050	4987	4	0	0	4	0	0	111	38	0	0	796	603	802	563	1133	716
"HYAL3"	1946	6639	39	0	27	12	0	0	214	123	0	0	257	259	283	139	459	294
"HYAL4"	2409	32308	0	0	0	0	0	0	9	0	0	0	0	0	0	0	0	0
"HYALP1"	985	5293	0	0	0	0	0	0	0	0	0	0	0	0	0	0	0	0
"HYDIN"	15770	423281	23	20	23	0	14	6	85	11	0	3	0	0	0	0	0	0
"HYI"	1090	2805	588	203	375	213	71	132	228	85	296	287	383	414	479	59	597	190
"HYLS1"	2061	13587	89	0	56	33	0	0	58	36	0	8	414	353	358	260	529	276
"HYMAI"	4996	5835	13	209	0	13	147	62	12	90	0	173	7	9	1	4	9	4
"HYOU1"	4628	13022	326	71	187	139	37	34	226	93	65	38	2342	2684	3625	3700	3107	2614
"HYST1888"	2034	13037	235	60	130	105	36	24	229	80	59	53	770	855	952	656	1359	735
"HYST2477"	3336	14290	325	104	151	174	69	35	272	103	192	149	184	265	285	240	544	376
"HZF"	2205	15430	1919	409	1054	865	206	203	705	178	1191	154	2260	2452	2792	1079	3053	4565
"HZF10"	642	62154	100	0	54	46	0	0	76	0	138	0	163	52	121	17	105	0
"HZF26"	1887	50633	119	0	54	65	0	0	61	0	0	0	183	122	162	11	14	0
"HZF6"	1166	75250	1345	165	804	541	98	67	1167	153	353	122	532	321	620	244	646	187
"Hfz6"	3765	32910	0	0	0	0	0	0	0	0	0	0	0	0	3	0	0	0
"Hmit"	993	42439	7	11	0	7	0	11	63	57	0	13	26	34	32	40	37	20
"IA4"	1012	28880	61	43	23	38	18	25	138	37	0	40	155	151	245	224	285	156
"IAH1"	1177	22003	2354	3447	1298	1056	2068	1379	966	1153	602	3902	2269	3788	2689	3496	3055	2378
"IAPP"	1978	7113	0	0	0	0	0	0	0	0	0	0	0	0	0	0	0	0
"IARS"	4544	83349	883	458	548	335	250	208	531	319	612	324	1621	1794	3096	2805	2881	2187
"IARS2"	3565	53923	675	104	369	306	53	51	352	69	123	19	2093	2119	3923	3209	5343	3364
"IBRDC1"	2038	120797	4570	277	2538	2032	183	94	2647	208	1272	269	605	679	429	261	558	253
"IBSP"	1596	12899	0	0	0	0	0	0	0	0	0	0	0	0	0	0	0	0
"IBTK"	5832	77494	2993	812	1753	1240	466	346	1868	469	794	613	3233	2775	2914	2698	2906	1741
"ICA1"	2553	148965	29	0	21	8	0	0	84	0	0	0	87	126	137	136	118	80
"ICA1L"	8010	98500	27	0	0	27	0	0	275	51	16	11	87	64	7	5	72	20
"ICAM1"	3253	15776	11810	61647	6581	5229	32417	29230	970	30873	2874	117747	6514	145100	5545	166090	6006	126940
"ICAM2"	1340	18040	0	44	0	0	28	16	91	45	0	0	104	111	85	109	109	88
"ICAM3"	2084	5895	84	45	44	40	39	6	99	57	0	2	36	1052	628	386	1172	589
"ICAM4"	1422	1550	5213	61647	2892	2321	32417	29230	48	30875	2	117724	81	131455	105	2257	147	2311
"ICAM5"	3011	6799	237	30494	141	96	862	29632	144	31416	0	117725	50	195	104	449	224	361
"ICERE-1"	1641	6449	0	26	0	0	14	12	0	0	0	0	23	10	17	17	10	18
"ICHTHYIN"	651	8493	33	22	21	12	9	13	14	28	0	97	0	0	0	0	0	3
"ICK"	6253	60504	0	0	0	0	0	0	61	0	0	0	643	628	608	428	639	397
"ICMT"	4818	14791	172	48	105	67	21	27	158	141	0	67	2642	2507	1998	1588	3477	2206
"ICOS"	2646	24827	0	0	0	0	0	0	0	0	0	0	0	0	0	0	0	0
"ICOSLG"	3243	14112	4089	5192	2224	1865	2712	2480	1047	2692	1399	9630	3947	7765	3455	8481	2007	5618
"ICT1"	884	8577	109	0	73	36	0	0	208	16	2	0	301	187	249	152	336	177
"ID1"	1223	1223	0	1	0	0	1	0	0	12	0	0	0	0	0	0	0	0
"ID2"	1679	5243	455	642	223	232	324	318	248	439	444	523	3731	3176	3891	3055	4447	3653
"ID3"	1548	1548	20	0	11	9	0	0	43	21	0	0	403	12	578	49	686	92
"ID4"	2346	3299	0	0	0	0	0	0	0	0	0	0	0	0	0	0	0	0
"IDE"	3762	120254	833	93	450	383	54	39	707	94	206	80	1541	918	1042	922	1043	750
"IDH1"	2350	17958	1588	128	922	666	65	63	941	20	536	0	6905	6377	7287	10731	9018	9138
"IDH2"	1740	18496	1488	197	785	703	99	98	441	48	338	0	1874	1420	2481	2036	2878	1890
"IDH3A"	2931	21166	841	103	496	345	47	56	365	147	338	194	1859	2052	1807	1497	2143	1766
"IDH3B"	1638	5802	273	102	136	137	51	51	161	100	119	106	1507	1406	1611	995	1842	992
"IDH3G"	1804	8747	972	467	526	446	329	138	459	270	492	583	953	1061	1244	1093	1898	993
"IDH3GL"	2258	292022	0	0	0	0	0	0	0	0	0	0	0	0	0	0	0	0
"IDI1"	2845	5112	975	1508	546	429	809	699	385	570	0	582	3075	4882	2707	843	2910	2502
"IDI2"	1364	6954	1	10	1	0	0	10	0	0	0	0	375	661	63	70	61	78
"IDN3"	3271	14877	506	192	259	247	100	92	318	237	19	74	757	754	939	739	1119	804
"IDN4-GGTR7"	2559	290054	2593	2543	1581	1012	1506	1037	2162	1780	254	1709	394	310	295	173	268	188
"IDO1"	1577	14619	0	0	0	0	0	0	0	0	0	0	6	40	26	7	57	4
"IDO2"	3934	81438	0	0	0	0	0	0	0	0	0	0	0	0	0	0	0	0
"IDS"	6419	55173	2682	1657	1319	1363	826	831	1188	409	990	508	5514	6277	6125	4609	6886	3595
"IDS2"	2354	12180	1112	1072	568	544	536	536	336	231	61	162	2	16	146	269	390	141
"IDUA"	2262	17533	1643	579	884	759	326	253	722	555	1972	987	333	335	831	809	1253	772
"IER2"	2046	4436	721	703	415	306	369	334	286	406	628	867	1402	5817	1948	4580	2163	7798
"IER3"	1241	1352	614	1671	326	288	877	794	102	576	197	1084	2159	20348	1435	24596	1089	22030
"IER3IP1"	1482	21332	44	0	35	9	0	0	76	54	0	40	89	106	903	253	254	214
"IER5"	2341	2341	322	842	181	141	442	400	124	513	106	863	2160	7657	2863	6841	3050	6646
"IER5L"	2711	2711	0	0	0	0	0	0	36	0	79	0	882	14	1800	28	1601	65
"IFFO1"	3282	17104	3340	683	1881	1459	361	322	1452	311	3252	416	1012	694	2693	1468	3254	1500
"IFFO2"	5844	52054	1258	4038	664	594	2085	1953	880	2723	280	1778	673	825	969	877	1081	558
"IFI16"	2743	45263	7430	685	4151	3279	360	325	4174	146	2402	108	5743	4488	6874	2920	6671	3441
"IFI27"	722	5874	0	0	0	0	0	0	0	0	0	0	0	0	83	3	0	13
"IFI27L1"	719	21422	0	0	0	0	0	0	0	0	0	0	19	18	19	4	18	16
"IFI27L2"	470	1840	0	0	0	0	0	0	23	0	0	0	251	199	262	197	383	247
"IFI30"	1039	4350	1364	543	782	582	282	261	385	219	1018	486	25466	14901	57398	36491	34137	32809
"IFI35"	1229	7708	80	42	80	0	21	21	245	155	0	0	464	591	1072	613	304	569
"IFI44"	2044	11664	971	7468	508	463	4109	3359	510	3438	48	2282	493	8039	2084	5260	568	1524
"IFI44L"	5881	25742	0	0	0	0	0	0	80	11	0	0	0	5	300	3	4	8
"IFI6"	865	6154	22	131	6	16	64	67	88	259	0	41	448	906	2728	795	668	564
"IFIH1"	3436	51451	4647	53090	2556	2091	28704	24386	789	20997	26	10837	741	6253	992	5538	810	1798
"IFIT1"	2906	5182	1069	11913	587	482	6297	5616	13	6295	0	1038	37	24269	466	5371	54	1330
"IFIT1L"	1973	7150	0	0	0	0	0	0	0	0	0	0	0	0	0	2	0	0
"IFIT2"	3496	7328	2596	27338	1387	1209	14677	12661	11	10989	0	5936	122	159720	649	61915	269	26980
"IFIT3"	2543	13124	2594	25532	1477	1117	13767	11765	0	9860	0	5169	172	57011	815	20082	168	8612
"IFIT5"	4035	6435	148	7124	85	63	973	6151	68	5649	0	52	486	24240	656	565	840	474
"IFITM1"	718	1282	0	0	0	0	0	0	0	0	0	0	0	0	134	58	122	110
"IFITM2"	731	1304	0	0	0	0	0	0	0	0	0	0	0	0	394	294	404	289
"IFITM3"	670	1243	0	0	0	0	0	0	16	0	0	0	0	369	724	495	946	502
"IFITM4P"	344	344	0	0	0	0	0	0	14	0	0	0	0	0	0	0	0	0
"IFITM5"	2135	9137	0	0	0	0	0	0	35	0	0	0	0	0	510	452	663	369
"IFLTD1"	1886	77203	0	0	0	0	0	0	0	0	0	0	0	0	0	0	0	0
"IFNA1"	877	877	0	0	0	0	0	0	0	0	0	0	0	0	0	0	0	0
"IFNA10"	964	964	0	0	0	0	0	0	0	0	0	0	0	0	0	0	0	0
"IFNA13"	706	706	0	0	0	0	0	0	0	0	0	0	0	0	0	0	0	0
"IFNA14"	988	38758	0	0	0	0	0	0	0	0	0	0	0	0	0	0	0	0
"IFNA16"	940	940	0	0	0	0	0	0	0	0	0	0	0	0	0	0	0	0
"IFNA17"	981	981	0	0	0	0	0	0	0	0	0	0	0	0	0	0	0	0
"IFNA2"	1143	1143	0	0	0	0	0	0	0	0	0	0	0	0	0	0	0	0
"IFNA21"	1025	1025	0	0	0	0	0	0	0	0	0	0	0	0	0	0	0	0
"IFNA4"	982	982	0	0	0	0	0	0	0	0	0	0	0	0	0	0	0	0
"IFNA5"	570	570	0	0	0	0	0	0	0	0	0	0	0	0	0	0	0	0
"IFNA6"	569	569	0	0	0	0	0	0	0	0	0	0	0	0	0	0	0	0
"IFNA7"	738	738	0	0	0	0	0	0	0	0	0	0	0	0	0	0	0	0
"IFNA8"	1040	1040	0	0	0	0	0	0	0	0	0	0	0	0	0	0	0	0
"IFNAR1"	6103	34914	1437	147	787	650	80	67	716	114	307	244	4532	4642	3390	2742	3748	2714
"IFNAR2"	2944	34589	4260	1469	2436	1824	795	674	2371	775	3621	1912	2850	1975	2399	1625	1934	1307
"IFNB1"	840	840	0	108	0	0	63	45	0	101	0	0	0	8269	0	2374	0	1021
"IFNE"	1473	1473	0	0	0	0	0	0	0	0	0	0	0	0	0	0	0	0
"IFNG"	1214	4973	0	0	0	0	0	0	0	0	0	0	0	0	0	0	0	0
"IFNGR1"	2127	21948	6008	1166	3304	2704	587	579	2935	620	4151	1539	9461	6089	13107	6930	11892	7498
"IFNGR2"	2285	34627	12458	16500	6951	5507	8898	7602	4443	10155	11743	29910	7861	14393	8877	17501	11227	13239
"IFNK"	1140	2184	1776	257	1771	5	160	97	818	61	248	19	0	0	0	0	0	0
"IFNW1"	1515	1515	0	0	0	0	0	0	0	0	0	0	0	0	0	0	0	0
"IFP38"	1612	9273	144	58	63	81	33	25	205	193	0	180	346	452	2108	1619	1810	1448
"IFRD1"	2482	53020	951	5299	463	488	2896	2403	579	2633	98	3285	627	3321	716	2347	861	1431
"IFRD2"	2299	5186	87	59	52	35	19	40	73	231	0	97	510	513	588	335	817	664
"IFT122"	4198	80224	132	57	77	55	44	13	240	171	8	15	203	240	274	252	319	223
"IFT140"	5298	101682	118	1	54	64	1	0	847	206	44	20	245	185	266	242	402	272
"IFT172"	5407	45332	42	12	33	9	12	0	86	21	10	0	188	233	251	221	272	180
"IFT20"	1099	7144	18	0	18	0	0	0	64	13	0	0	105	134	298	158	199	261
"IFT52"	1688	56284	39	0	13	26	0	0	20	0	0	0	341	366	294	240	421	280
"IFT57"	3213	61759	7	0	3	4	0	0	11	0	0	7	194	222	168	183	300	195
"IFT74"	2183	115615	13	62	5	8	37	25	136	91	0	339	199	305	233	163	241	158
"IFT80"	4306	142534	378	104	244	134	50	54	265	50	41	130	796	843	887	783	1061	528
"IFT81"	3166	94461	0	0	0	0	0	0	7	1	0	0	12	12	3	3	8	4
"IFT88"	3284	124368	0	0	0	0	0	0	19	0	0	0	31	67	44	56	102	93
"IGBP1"	1865	32874	926	525	392	534	257	268	499	129	0	544	1574	886	939	888	1899	668
"IGDCC3"	4493	50915	0	0	0	0	0	0	152	63	0	0	0	0	0	0	0	0
"IGDCC4"	6505	41587	0	0	0	0	0	0	145	55	0	0	0	0	0	0	0	0
"IGF1"	7375	84735	0	0	0	0	0	0	0	0	0	0	0	0	0	0	0	0
"IGF1R"	11262	314999	14701	7939	8064	6637	4262	3677	8269	6212	4669	8017	1262	1552	1091	1014	1635	993
"IGF2"	5168	9858	0	0	0	0	0	0	174	90	0	0	0	0	0	0	0	0
"IGF2AS"	2863	8159	0	0	0	0	0	0	15	36	0	0	0	0	0	0	0	0
"IGF2BP1"	8782	58733	0	0	0	0	0	0	37	33	0	0	1	3	0	0	0	0
"IGF2BP2"	3704	181301	567	92	325	242	38	54	817	535	101	740	593	572	467	463	885	539
"IGF2BP3"	4173	160168	0	0	0	0	0	0	11	0	0	0	0	0	0	0	0	0
"IGF2R"	9137	137452	15845	10971	8782	7063	6058	4913	5908	3862	6081	4759	9149	10489	15709	16993	15010	10917
"IGFALS"	2200	3320	1	0	1	0	0	0	0	0	0	0	0	0	0	0	0	0
"IGFBP1"	1653	5309	0	0	0	0	0	0	0	0	0	0	0	0	0	0	0	0
"IGFBP2"	4277	30867	0	0	0	0	0	0	73	18	0	0	14	4	12	0	0	0
"IGFBP3"	2630	9023	0	0	0	0	0	0	0	0	0	0	0	0	0	0	0	0
"IGFBP4"	2239	14307	0	0	0	0	0	0	88	32	0	0	34	56	90	31	71	41
"IGFBP5"	6242	23445	0	0	0	0	0	0	161	30	0	0	0	0	0	0	0	0
"IGFBP6"	970	4694	0	0	0	0	0	0	0	16	0	0	0	17	10	16	22	14
"IGFBP7"	1243	78337	46	0	46	0	0	0	85	21	0	0	202	262	27	73	85	64
"IGFBPL1"	1097	15454	0	0	0	0	0	0	8	0	0	0	0	0	0	0	0	0
"IGFL1"	771	1491	0	0	0	0	0	0	0	0	0	0	0	0	0	0	0	0
"IGFL2"	903	13522	0	0	0	0	0	0	0	0	0	0	0	0	0	0	0	0
"IGFL3"	666	4605	0	0	0	0	0	0	0	0	0	0	0	0	0	0	0	0
"IGFL4"	577	1270	0	0	0	0	0	0	0	0	0	0	0	0	0	0	0	0
"IGFN1"	4408	38122	0	0	0	0	0	0	102	12	0	0	0	0	0	0	0	0
"IGH"	354	436	0	0	0	0	0	0	0	0	0	0	0	0	0	0	0	0
"IGH@"	1120	277246	18	25	0	18	25	0	1287	528	54	68	465	446	354	367	865	713
"IGHD"	1740	26364	18	25	0	18	25	0	202	109	54	68	362	386	146	175	198	140
"IGHE"	1471	263186	18	25	0	18	25	0	1175	498	54	68	465	446	354	367	865	711
"IGHMBP2"	3969	36752	628	48	347	281	31	17	518	132	37	39	376	321	415	278	605	331
"IGHV7-81"	1150	1233	0	0	0	0	0	0	0	0	0	0	0	0	0	0	0	0
"IGJ"	1461	11091	0	0	0	0	0	0	0	0	0	0	69	87	33	44	54	25
"IGKV"	302	302	0	0	0	0	0	0	0	0	0	0	0	0	0	0	0	0
"IGL1"	939	19010	0	0	0	0	0	0	18	31	0	0	0	0	39	43	99	88
"IGL@"	1053	8047	0	0	0	0	0	0	0	23	0	0	0	0	0	0	0	16
"IGLL1"	901	7182	0	0	0	0	0	0	0	0	0	0	0	0	0	0	19	29
"IGLL3"	915	2305	0	0	0	0	0	0	18	14	0	0	2	0	0	0	0	0
"IGLON5"	3108	19002	0	0	0	0	0	0	45	55	0	0	0	0	0	0	0	0
"IGLV"	346	466	0	0	0	0	0	0	0	0	0	0	0	0	0	0	0	0
"IGM1"	3409	9406	0	0	0	0	0	0	0	0	0	0	62	0	0	0	0	0
"IGSF1"	5442	305392	0	0	0	0	0	0	8	0	0	0	0	0	0	0	0	0
"IGSF10"	7877	22021	0	0	0	0	0	0	0	0	0	0	84	96	4	5	10	4
"IGSF11"	3569	245419	0	0	0	0	0	0	0	0	0	0	0	0	0	0	0	0
"IGSF2"	3556	34786	8	0	8	0	0	0	17	0	0	0	53	20	140	108	174	166
"IGSF21"	1953	270738	0	0	0	0	0	0	420	189	0	0	0	0	0	0	0	0
"IGSF22"	4357	21927	72	0	49	23	0	0	189	14	0	0	70	203	858	140	914	428
"IGSF3"	7265	93285	0	0	0	0	0	0	62	24	0	0	9	24	84	65	109	26
"IGSF5"	2073	56689	0	0	0	0	0	0	0	0	0	0	0	0	0	0	0	0
"IGSF6"	1229	6267	3029	1868	1733	1296	1079	789	1437	854	1664	1829	16196	16168	15627	16385	9663	7118
"IGSF8"	2271	7272	472	938	287	185	463	475	231	926	0	1228	577	1233	839	2546	1213	1766
"IGSF9"	4065	18559	0	0	0	0	0	0	95	43	0	0	0	0	0	0	0	0
"IGSF9B"	7328	41696	0	0	0	0	0	0	197	167	0	0	0	0	0	0	0	0
"IGVH"	941	1023	0	0	0	0	0	0	0	0	0	0	0	0	0	0	3	0
"IGVK-A2"	302	302	0	0	0	0	0	0	0	0	0	0	0	0	0	0	0	0
"IGnT2"	3530	108034	6832	81746	3853	2979	43866	37880	925	39743	44	71016	330	4624	138	2452	212	1065
"IHH"	2022	6045	0	0	0	0	0	0	38	0	0	0	0	0	0	0	0	0
"IHPK1"	1820	59628	2300	1181	1267	1033	693	488	954	789	1065	2318	1446	135	1601	242	2014	179
"IK"	1954	14682	26	0	26	0	0	0	134	14	0	0	432	773	1060	1055	1234	1116
"IKBKAP"	6150	66809	407	426	204	203	262	164	248	303	76	81	577	795	839	767	944	648
"IKBKAP variant protein"	3683	24923	98	306	57	41	200	106	85	125	0	44	228	317	329	278	316	305
"IKBKB"	3994	61138	13006	12917	7174	5832	6790	6127	4376	6506	9145	15041	2738	3364	3793	3581	4957	2759
"IKBKE"	3285	26428	2411	5371	1378	1033	2849	2522	714	2958	752	6986	857	2355	1162	2852	1298	1727
"IKBKG"	2272	17700	800	359	518	282	183	176	415	368	709	819	846	832	2468	2099	3061	1832
"IKIP"	2921	20557	48	0	31	17	0	0	149	0	0	0	426	195	468	442	428	310
"IKK-beta"	3885	61138	13006	12917	7174	5832	6790	6127	4376	6506	9145	15041	2738	3364	3793	3581	4957	2759
"IKZF1"	6194	128420	29899	67578	16471	13428	36170	31408	10175	44127	15124	44241	7376	12192	6249	11349	6760	5531
"IKZF2"	9880	15585	16	0	9	7	0	0	24	0	38	72	120	196	33	4	0	0
"IKZF3"	2569	99242	95	14	53	42	6	8	27	25	102	31	134	4	9	0	69	18
"IKZF4"	5459	17532	126	0	19	107	0	0	86	42	2	16	340	258	311	203	377	217
"IKZF5"	3850	3850	647	99	302	345	55	44	577	133	0	99	838	678	839	74	756	74
"IL-15"	2044	96859	41	441	22	19	251	190	313	379	0	27	18	24	43	45	69	47
"IL-23R"	2800	90625	0	0	0	0	0	0	0	0	0	0	0	0	0	0	0	0
"IL10"	1634	4893	11	0	11	0	0	0	64	0	0	0	99	78	111	270	86	51
"IL10RA"	5161	14746	20501	56262	11410	9091	29930	26332	5744	26413	11531	38369	17874	67466	18926	48747	23480	36355
"IL10RB"	2259	29289	3386	1143	1926	1460	596	547	1757	498	1635	1099	3679	3051	3640	3069	3445	2362
"IL11"	2359	6059	0	0	0	0	0	0	0	0	0	0	0	2	0	0	0	0
"IL11RA"	3026	11186	400	179	219	181	104	75	267	178	141	269	123	154	191	103	323	125
"IL12A"	1443	7178	0	0	0	0	0	0	0	0	0	0	0	7	0	0	0	0
"IL12B"	2355	15692	0	5913	0	0	3213	2700	0	3293	0	5795	0	211	0	8075	4	3879
"IL12RB1"	2225	39257	2	0	0	2	0	0	139	78	6	0	83	113	109	88	157	109
"IL12RB2"	4055	89537	0	0	0	0	0	0	25	22	0	0	0	2	0	9	0	3
"IL13"	1286	2938	0	0	0	0	0	0	0	0	0	0	0	15	0	12	0	0
"IL13RA1"	4016	66938	5139	1286	3001	2138	690	596	2006	646	691	371	7143	7690	5519	4084	7843	4909
"IL13RA2"	1714	12913	0	0	0	0	0	0	0	0	0	0	0	0	0	0	0	0
"IL15"	1952	96859	41	441	22	19	251	190	313	379	0	27	18	24	43	45	69	47
"IL15RA"	1849	25809	0	0	0	0	0	0	30	194	0	36	2	17	52	358	8	53
"IL16"	8910	130010	2175	1441	1171	1004	696	745	1313	1023	2224	1585	5453	4008	5077	2905	7562	4092
"IL17A"	1862	4253	0	0	0	0	0	0	0	0	0	0	0	0	0	0	0	0
"IL17B"	696	5008	0	0	0	0	0	0	37	0	0	0	0	0	0	0	0	0
"IL17C"	1047	1882	42	0	23	19	0	0	31	53	0	0	0	2	0	3	0	0
"IL17D"	1863	19756	0	0	0	0	0	0	42	36	0	0	0	0	0	0	0	0
"IL17F"	923	2483	0	0	0	0	0	0	0	0	0	0	0	0	0	0	0	0
"IL17RA"	3424	25540	8736	3416	4803	3933	1846	1570	2709	2407	7253	3539	9673	7223	4062	2693	4505	2273
"IL17RB"	2050	19251	168	20	105	63	20	0	97	19	0	0	155	304	385	279	384	168
"IL17RC"	2667	16551	39	0	18	21	0	0	133	62	24	21	389	453	485	332	644	397
"IL17RD"	8751	80321	0	0	0	0	0	0	34	0	0	0	0	0	0	0	0	0
"IL17RE"	2789	13572	0	0	0	0	0	0	26	29	0	0	20	0	5	0	28	3
"IL17REL"	3650	18115	0	6	0	0	0	6	100	50	0	0	2	20	0	0	0	0
"IL18"	1704	7822	505	700	268	237	377	323	206	294	52	481	231	438	155	1154	123	317
"IL18BP"	3634	4692	1709	2335	1	1708	1332	1003	1270	1172	1769	1802	4664	4677	1205	4812	9506	6204
"IL18R1"	3656	87255	31	1961	16	15	1100	861	0	1128	0	1484	118	1419	292	785	77	129
"IL18RAP"	2677	33770	0	0	0	0	0	0	19	11	0	0	50	191	60	70	47	37
"IL19"	1837	14104	62	0	11	51	0	0	102	18	28	0	10	0	0	0	0	0
"IL1A"	2934	11480	670	7392	362	308	4013	3379	11	3719	0	5142	0	9998	0	19395	0	8829
"IL1B"	1505	7021	1254	37706	25	1229	20187	17519	11	19208	48	26493	56	20117	95	50394	206	30243
"IL1F10"	1368	3532	0	0	0	0	0	0	0	0	0	0	0	3	0	0	0	0
"IL1F5"	2696	5633	0	0	0	0	0	0	0	0	0	0	0	1	0	0	0	0
"IL1F6"	479	2172	0	0	0	0	0	0	0	0	0	0	0	0	0	0	0	0
"IL1F7"	774	5910	0	0	0	0	0	0	0	0	0	0	0	4	0	0	0	0
"IL1F8"	1188	30774	0	2	0	0	2	0	0	0	0	0	0	1	0	0	0	0
"IL1F9"	1185	7623	0	0	0	0	0	0	0	7	0	0	0	0	0	0	0	0
"IL1R1"	5154	37089	13578	12773	7612	5966	6900	5873	4940	2467	6697	4284	19336	21467	12623	10247	16612	10465
"IL1R2"	1461	36576	13471	16454	7446	6025	8964	7490	3170	3375	7222	8659	10817	12795	4617	3387	5854	5355
"IL1RAP"	4903	137412	27839	82326	15539	12300	44557	37769	5462	36071	3394	36476	3293	5519	1991	1528	3281	1717
"IL1RAPL1"	2690	1368338	0	0	0	0	0	0	12	0	0	0	0	0	0	0	0	0
"IL1RAPL2"	2996	1200828	0	0	0	0	0	0	0	0	0	0	0	26	0	0	0	0
"IL1RL1"	2513	7465	0	0	0	0	0	0	0	3	0	0	48	183	182	300	22	3
"IL1RL2"	1975	52379	158	23	98	60	23	0	155	56	0	75	345	392	168	63	195	35
"IL1RN"	2143	34655	313	2425	188	125	1344	1081	230	1351	0	4301	7242	16368	11945	27201	7524	18444
"IL2"	798	5022	0	0	0	0	0	0	0	0	0	0	0	0	0	0	0	0
"IL20"	1558	3870	0	0	0	0	0	0	0	0	0	0	0	0	0	0	0	0
"IL20RA"	3688	45191	0	0	0	0	0	0	0	0	0	0	0	0	0	0	0	0
"IL20RB"	2047	53215	376	64	245	131	47	17	138	40	0	172	14	0	19	25	27	13
"IL21"	627	8347	0	0	0	0	0	0	0	0	0	0	0	0	0	0	0	0
"IL21R"	3370	48394	2064	116	1222	842	51	65	1465	432	1148	297	1567	1015	2084	780	2103	1286
"IL22"	1169	5362	0	0	0	0	0	0	0	0	0	0	0	0	0	0	0	0
"IL22RA1"	2861	23352	0	0	0	0	0	0	36	0	0	0	0	0	0	0	0	0
"IL22RA2"	2903	29829	0	0	0	0	0	0	0	0	0	0	33	33	73	54	147	88
"IL23A"	1045	1532	0	18	0	0	18	0	0	0	0	0	2	205	0	574	9	257
"IL23R"	3017	121060	0	0	0	0	0	0	0	0	0	0	0	0	0	0	0	0
"IL24"	1985	6697	0	0	0	0	0	0	9	10	0	0	0	20	0	20	0	21
"IL25"	1362	3589	0	0	0	0	0	0	0	15	0	0	0	0	0	0	0	0
"IL26"	1052	24444	0	0	0	0	0	0	9	0	0	0	0	0	0	0	0	0
"IL27"	1048	7473	2742	530	1431	1311	366	164	138	878	0	203	7305	7587	0	23	0	0
"IL27RA"	3271	21765	1033	289	560	473	173	116	383	150	642	435	4653	3222	3500	2508	5958	3245
"IL28A"	740	1577	0	0	0	0	0	0	0	14	0	0	0	4	0	0	0	0
"IL28B"	634	1375	0	0	0	0	0	0	0	0	0	0	0	5	0	0	0	0
"IL28RA"	4555	33105	0	0	0	0	0	0	52	14	0	0	0	5	45	0	29	11
"IL29"	860	2348	0	91	0	0	78	13	19	68	0	0	4	1969	0	488	3	257
"IL2RA"	2314	50768	0	230	0	0	150	80	11	327	0	248	25	26	8	306	0	3
"IL2RB"	4053	24084	47	4	29	18	0	4	288	169	14	37	198	284	159	129	400	264
"IL2RG"	1459	4146	136	251	78	58	160	91	52	171	0	444	470	3012	696	1908	1759	1418
"IL3"	929	2551	0	0	0	0	0	0	0	13	0	0	0	0	0	0	0	0
"IL31"	906	2170	0	0	0	0	0	0	0	0	0	0	0	0	0	0	0	0
"IL31RA"	2910	71345	1	0	1	0	0	0	16	0	0	0	2	0	0	0	0	0
"IL32"	1341	4313	15	8	0	15	0	8	107	108	0	0	87	108	101	147	234	179
"IL33"	2692	42177	0	0	0	0	0	0	0	0	0	0	0	0	0	0	0	0
"IL34"	1612	14118	0	1	0	0	0	1	13	0	0	0	0	0	0	0	0	0
"IL3RA"	1721	46074	0	0	0	0	0	0	0	0	0	0	0	0	429	507	450	447
"IL4"	925	8997	0	0	0	0	0	0	0	0	0	0	0	0	7	16	0	0
"IL4I1"	4679	42149	8581	30824	4741	3840	8627	22197	2021	7085	4395	21104	5800	20343	5619	13662	7169	9516
"IL4R"	3789	50849	7248	7118	4031	3217	3697	3421	2773	3573	5176	9823	3839	4024	4235	4528	5759	3941
"IL5"	820	2080	0	0	0	0	0	0	0	0	0	0	0	0	0	0	0	0
"IL5RA"	2428	40659	0	0	0	0	0	0	3	0	0	0	3	8	23	23	0	7
"IL6"	1577	3340	736	2830	379	357	1485	1345	0	1517	0	2136	0	9132	0	7849	4	2547
"IL6R"	4186	62521	9233	11496	5167	4066	6170	5326	2853	7530	3213	12085	4550	8459	4177	5566	5282	2445
"IL6ST"	3244	54070	6826	9439	3715	3111	5071	4368	2866	4807	2285	7223	5394	10370	1127	1970	1541	905
"IL7"	2083	72754	104	3809	80	24	1746	2063	58	2291	0	10	141	183	183	109	186	121
"IL7R"	1810	19932	155	2171	98	57	1257	914	6	2006	16	1110	89	5415	168	9307	174	887
"IL8"	1655	3158	148	2685	114	34	1408	1277	0	869	0	633	66	17924	20	10671	50	4728
"IL8RA"	2486	4148	2	0	0	2	0	0	12	1	0	0	603	437	3	107	11	7
"IL8RB"	2862	11231	9	0	5	4	0	0	0	0	0	0	184	89	85	12	154	35
"IL8RBP"	2136	2136	4250	562	2347	1903	324	238	1644	240	2260	317	17779	12165	10438	4632	14352	5511
"IL9"	596	3583	23	29	0	23	10	19	18	9	0	0	76	19	0	3	5	0
"IL9R"	2166	13238	0	0	0	0	0	0	0	0	0	0	0	0	0	0	0	0
"ILDR1"	2798	34861	0	0	0	0	0	0	0	12	0	0	0	2	0	0	0	0
"ILDR2"	2582	56567	0	0	0	0	0	0	0	0	0	0	0	0	0	0	0	0
"ILF2"	1644	8966	328	93	183	145	63	30	119	152	63	108	2533	659	2715	2625	3987	2617
"ILF3"	6139	38158	3697	2984	2031	1666	1454	1530	1438	1630	1023	3806	5868	6120	6762	6608	6978	5310
"ILK"	1921	6892	1492	905	797	695	495	410	423	504	212	1163	3183	1019	3297	3753	4488	3523
"ILKAP"	1454	33282	2120	1198	1141	979	698	500	1026	919	837	1990	808	973	803	798	1085	583
"ILVBL"	2312	10792	31	17	18	13	17	0	113	112	0	238	472	493	833	851	909	718
"IMAA"	3930	38643	45375	15285	24828	20547	8059	7226	16870	7802	37642	15970	113188	103180	83121	71568	114360	67141
"IMMP1L"	1353	57425	38	13	21	17	13	0	62	0	0	0	298	284	19	10	18	21
"IMMP2L"	1525	899239	13271	9821	7888	5383	5518	4303	8675	6004	889	4526	67	93	98	97	98	41
"IMMT"	3015	51839	1821	422	1084	737	261	161	803	181	290	159	1109	2867	2294	2025	2893	2121
"IMP-3"	2968	57133	0	0	0	0	0	0	0	0	0	0	0	0	0	0	0	0
"IMP3"	2027	9620	480	16	274	206	0	16	313	81	136	31	1881	1024	2043	1015	2759	1290
"IMP4"	1058	3710	63	21	27	36	0	21	101	45	0	0	1048	925	805	773	1025	858
"IMP5"	2055	2055	0	0	0	0	0	0	0	15	0	0	0	0	0	0	0	0
"IMPA1"	3607	29440	420	224	210	210	134	90	125	109	0	152	664	910	696	697	689	547
"IMPA2"	1642	49423	4	0	4	0	0	0	152	36	5	0	346	257	251	224	404	270
"IMPACT"	4890	26883	172	0	134	38	0	0	178	0	0	0	1232	961	1120	912	1125	808
"IMPAD1"	7229	35938	609	124	333	276	69	55	453	71	107	113	2318	2464	2458	1960	2216	1583
"IMPDH1"	2628	17707	2000	382	1113	887	172	210	748	518	1564	880	3421	2318	6036	4936	7204	4750
"IMPDH2"	1700	5110	572	325	306	266	191	134	308	84	250	397	1977	1527	1425	1173	879	1382
"IMPG1"	3285	151275	0	0	0	0	0	0	0	0	0	0	0	0	0	0	0	0
"IMPG2"	4818	93955	0	0	0	0	0	0	84	0	0	0	0	0	0	0	0	0
"IMUP"	524	844	35	0	8	27	0	0	62	0	63	0	11	23	28	21	26	21
"INA"	3232	13188	0	0	0	0	0	0	0	0	0	0	0	0	0	0	0	0
"INADL"	8545	421442	0	0	0	0	0	0	8	0	0	0	0	0	0	0	0	0
"INCA1"	1445	9000	11	0	0	11	0	0	31	0	23	0	157	125	113	93	252	98
"INCENP"	4165	29192	176	0	86	90	0	0	248	12	9	0	533	383	499	242	665	284
"INDO"	1576	14619	0	0	0	0	0	0	0	0	0	0	6	40	26	7	57	4
"INDOL1"	1644	28650	0	0	0	0	0	0	0	0	0	0	0	0	0	0	0	0
"INE1"	1007	1007	466	336	284	182	158	178	220	188	0	685	1040	1522	0	0	892	0
"INE2"	1875	1875	0	0	0	0	0	0	0	0	0	0	32	32	0	0	0	0
"INF2"	4733	30006	6791	2300	3518	3273	1117	1183	4185	3760	6488	4944	8843	8452	11980	11141	16204	10064
"ING1"	2855	7797	96	71	40	56	37	34	88	89	77	0	181	140	292	201	324	111
"ING2"	1118	6031	0	0	0	0	0	0	13	0	0	0	266	153	280	108	355	182
"ING3"	6013	24887	204	254	121	83	107	147	123	130	0	33	423	626	438	441	494	378
"ING4"	1455	12605	77	1	57	20	0	1	73	7	26	0	159	368	689	358	522	238
"ING5"	5200	27436	535	151	295	240	67	84	368	236	49	222	426	437	576	392	633	369
"INGX"	1228	1228	0	0	0	0	0	0	0	0	0	0	0	0	0	0	0	0
"INHA"	1425	3475	0	0	0	0	0	0	15	0	0	0	0	0	0	0	0	0
"INHBA"	2176	14105	1278	27519	708	570	14824	12695	35	10228	0	18629	379	953	206	22498	234	1660
"INHBB"	3205	5666	0	0	0	0	0	0	19	5	0	0	1	0	0	0	0	0
"INHBC"	1992	16068	0	0	0	0	0	0	0	9	0	0	0	0	0	0	0	0
"INHBE"	2437	2695	4	0	2	2	0	0	23	23	0	3	7	11	0	0	0	0
"INMT"	2693	59619	0	0	0	0	0	0	186	65	0	0	0	0	0	0	0	0
"INO80"	6260	137261	2516	2447	1455	1061	1368	1079	1292	1468	309	2659	1118	801	1475	1237	1810	1228
"INO80B"	2063	5813	296	46	160	136	36	10	150	123	0	39	448	485	769	657	1154	800
"INO80C"	2212	44667	202	370	113	89	212	158	199	210	0	105	277	476	293	236	270	302
"INO80D"	14146	92462	3765	2853	2125	1640	1610	1243	1807	1567	804	2337	1392	1642	1534	1142	1594	756
"INO80E"	1976	9583	581	49	323	258	27	22	314	154	182	52	610	471	972	633	1297	487
"INPP1"	2350	28196	73	184	35	38	101	83	20	180	88	73	417	504	399	401	410	328
"INPP4A"	6777	146176	12553	2656	7147	5406	1453	1203	7442	1684	8501	3006	1738	2073	2602	2493	3009	1655
"INPP4B"	4148	818422	0	0	0	0	0	0	10	0	0	0	22	15	0	0	0	0
"INPP5A"	2953	245632	2743	273	1553	1190	122	151	4065	2103	1660	1674	371	401	321	329	360	269
"INPP5B"	4478	86362	1822	474	1026	796	268	206	1025	336	830	642	822	835	787	618	751	444
"INPP5D"	4856	191514	24939	4155	14041	10898	2156	1999	8863	2372	15880	3237	8245	8492	8087	6201	12067	7438
"INPP5E"	3382	11183	99	0	32	67	0	0	141	61	13	27	159	145	230	220	300	209
"INPP5F"	4951	103051	105	12	80	25	12	0	284	67	0	28	123	183	308	270	284	210
"INPP5J"	3526	11775	0	0	0	0	0	0	122	0	0	0	22	31	4	0	38	18
"INPP5K"	3385	22312	390	217	203	187	103	114	480	362	133	518	643	385	723	620	1046	864
"INPPL1"	4741	14306	3795	907	2071	1724	490	417	1575	603	3915	1046	4515	5018	7990	6630	9745	6308
"INS"	468	1432	0	0	0	0	0	0	39	0	0	0	0	0	0	0	0	0
"INS-IGF2"	5133	32093	0	0	0	0	0	0	300	129	0	0	0	0	0	0	0	0
"INSC"	2965	134784	0	0	0	0	0	0	11	0	0	0	0	0	0	0	0	0
"INSIG1"	3013	12458	2540	12926	1359	1181	6907	6019	660	6740	159	7579	8825	38952	5293	19333	6697	19115
"INSIG2"	2588	21548	1976	123	1081	895	70	53	985	9	277	0	1064	1002	1141	729	1529	834
"INSL3"	840	5000	0	0	0	0	0	0	0	9	0	0	0	0	0	0	0	0
"INSL4"	616	2549	0	0	0	0	0	0	0	0	0	0	0	0	0	0	0	0
"INSL5"	716	3516	0	0	0	0	0	0	0	0	0	0	0	0	0	0	0	0
"INSL6"	708	21755	0	0	0	0	0	0	0	0	0	0	0	0	0	0	0	0
"INSM1"	2827	2827	0	0	0	0	0	0	0	0	0	0	0	0	0	0	0	0
"INSM2"	3014	3014	0	0	0	0	0	0	0	0	0	0	0	0	0	0	0	0
"INSR"	9081	181747	655	163	350	305	98	65	683	113	277	69	1085	1244	878	845	1017	742
"INSRR"	4168	18002	0	0	0	0	0	0	127	32	0	0	1	0	0	0	0	0
"INT4"	1686	16766	90	33	18	72	24	9	46	23	61	9	115	67	100	105	86	73
"INTS1"	7022	34107	1601	681	756	845	421	260	1293	731	890	503	2361	2033	2100	2128	4469	3100
"INTS10"	2549	34668	1370	103	830	540	36	67	776	181	462	57	1673	1319	2122	1047	2514	1184
"INTS12"	1758	26096	20	0	20	0	0	0	55	8	0	7	282	152	344	223	224	249
"INTS2"	6186	62650	112	36	87	25	25	11	107	38	74	45	524	583	648	357	635	325
"INTS3"	6045	45992	7652	1350	4242	3410	731	619	1686	547	2327	638	14542	4896	3515	2187	22197	6581
"INTS4"	3170	115951	4785	140	4429	356	99	41	497	103	166	97	496	606	667	601	703	665
"INTS4L1"	2565	92998	0	0	0	0	0	0	0	0	0	0	0	0	136	127	194	105
"INTS5"	3285	6454	96	0	61	35	0	0	51	0	0	0	873	9	944	437	36	530
"INTS6"	7768	91575	10619	15334	5964	4655	8398	6936	3696	6298	1473	10298	868	1966	1183	2122	1642	1713
"INTS7"	3482	94188	1308	388	745	563	206	182	600	250	154	406	525	337	613	609	618	520
"INTS8"	3399	57188	914	84	512	402	46	38	627	90	221	73	1017	808	856	796	1120	825
"INTS9"	2776	122520	594	69	316	278	34	35	727	162	46	129	383	546	520	437	839	552
"INTU"	3254	83812	0	0	0	0	0	0	0	0	0	0	9	3	15	3	4	0
"INV"	6936	83520	10	0	0	10	0	0	43	0	0	0	242	390	253	277	386	249
"INVS"	3986	201917	3895	1386	2243	1652	761	625	2055	747	256	425	644	379	452	419	609	314
"IP6K1"	4474	62247	2444	1181	1349	1095	693	488	1055	873	1065	2318	1446	135	1601	1018	2014	179
"IP6K2"	2442	23962	1713	1382	948	765	736	646	728	818	657	2349	892	1022	868	1047	1365	1061
"IP6K3"	2830	25321	0	0	0	0	0	0	153	67	0	0	0	0	0	0	0	0
"IPCEF1"	6869	175597	23429	10470	13115	10314	5835	4635	11630	3917	8366	5823	6961	7334	4223	1954	5639	3275
"IPFK-2"	3983	90664	6742	5467	3729	3013	3005	2462	2406	4486	3501	8819	1279	2019	1234	2350	1537	1350
"IPMK"	1799	72078	820	63	522	298	36	27	723	45	101	46	1	629	133	84	78	18
"IPO11"	4478	209706	230	54	115	115	31	23	317	104	44	75	488	668	672	483	661	421
"IPO13"	4046	21217	433	51	206	227	21	30	333	180	157	39	929	615	1109	808	1516	930
"IPO4"	4733	10374	119	23	79	40	12	11	251	202	62	50	1249	700	975	810	1031	742
"IPO5"	6030	70622	223	59	126	97	42	17	146	38	46	5	2577	2797	2928	2437	3073	1950
"IPO7"	6216	63506	1668	2391	949	719	1336	1055	848	1636	222	2752	3925	4042	5216	4572	5659	3725
"IPO8"	5180	66830	977	51	576	401	33	18	792	17	199	72	1882	1817	1327	1750	2308	626
"IPO9"	11439	55135	2029	1261	1180	849	712	549	1097	502	558	1065	1712	1719	1618	1458	2084	1271
"IPP"	3260	52078	16	13	16	0	13	0	86	3	66	0	887	921	90	79	166	39
"IPPK"	4414	57083	1123	682	643	480	386	296	751	540	189	1282	75	437	508	368	583	451
"IQCA1"	3273	183300	0	0	0	0	0	0	58	0	0	0	0	0	0	0	0	0
"IQCB1"	2609	65318	1568	390	881	687	244	146	988	253	389	337	456	677	533	501	712	426
"IQCC"	2298	3054	69	31	69	0	31	0	124	79	0	64	0	9	6	6	57	4
"IQCD"	1923	21032	0	0	0	0	0	0	99	42	0	2	0	0	28	4	14	7
"IQCE"	6865	55737	600	41	357	243	33	8	891	225	134	0	833	753	953	792	1405	868
"IQCF1"	3415	96659	0	0	0	0	0	0	0	18	0	0	0	0	0	0	0	0
"IQCF2"	631	1797	0	0	0	0	0	0	0	0	0	0	0	0	0	0	0	0
"IQCF3"	1319	3988	0	0	0	0	0	0	0	0	0	0	0	0	0	0	0	0
"IQCF5"	513	1864	0	0	0	0	0	0	0	0	0	0	0	0	0	0	0	0
"IQCF6"	433	433	0	0	0	0	0	0	0	0	0	0	0	0	0	0	0	0
"IQCG"	2269	70941	345	1012	205	140	564	448	209	720	73	689	2024	6179	3481	2821	3257	3780
"IQCH"	4207	246953	37	0	12	25	0	0	22	9	9	0	48	37	5	9	29	0
"IQCJ"	1461	194418	0	0	0	0	0	0	0	0	0	0	0	0	0	0	0	0
"IQCK"	2560	141081	12	0	12	0	0	0	34	7	0	0	3	6	19	16	20	4
"IQGAP1"	7248	114004	18286	14170	10118	8168	7548	6622	8081	7029	6793	10444	22257	26774	28360	23435	30189	19211
"IQGAP2"	5803	304808	2797	1485	1592	1205	823	662	2520	1414	587	1020	1307	1490	2195	2078	2189	1486
"IQGAP3"	6089	47200	0	0	0	0	0	0	133	19	0	0	0	3	0	10	0	0
"IQSEC1"	7226	175900	27195	45230	14937	12258	24398	20832	10362	28617	19225	61235	6118	6731	6161	6206	8372	1727
"IQSEC2"	6025	88465	1372	186	733	639	129	57	1499	34	563	144	848	663	1337	745	1699	920
"IQSEC3"	4780	38891	0	0	0	0	0	0	498	228	0	0	0	0	0	0	0	0
"IQUB"	3525	80766	0	0	0	0	0	0	0	0	0	0	0	0	3	0	0	0
"IRAK1"	3585	9387	1717	535	936	781	394	141	642	356	1520	1144	2933	2400	5078	4578	4915	3474
"IRAK1BP1"	1774	78970	1553	1616	864	689	890	726	666	522	323	537	2291	2779	2259	1736	2238	1506
"IRAK2"	3482	78866	3207	31926	1740	1467	17191	14735	73	14880	0	30297	147	2979	134	2753	101	609
"IRAK3"	8346	65416	1409	2493	804	605	1418	1075	1669	2993	137	3147	1758	2846	2086	3393	1690	1266
"IRAK4"	4422	30601	1119	341	598	521	216	125	750	138	386	158	1290	1090	687	413	807	457
"IRE1b"	2069	12827	0	0	0	0	0	0	0	0	0	0	0	0	0	0	0	0
"IREB2"	6389	63282	2597	1176	1540	1057	737	439	1523	862	620	1048	3501	2919	3780	2485	3561	2040
"IRF1"	3564	9166	3626	6230	1984	1642	3297	2933	1094	5697	1065	6257	1013	10798	1117	13523	1847	10922
"IRF2"	2293	86850	8215	8242	4286	3929	4368	3874	4047	4628	2818	8855	406	2095	609	561	871	639
"IRF2BP1"	2512	2512	0	0	0	0	0	0	15	11	0	0	291	102	351	162	413	220
"IRF2BP2"	4663	5256	1995	1109	1070	925	585	524	1140	525	978	479	5173	1668	4980	1225	5661	1238
"IRF3"	2386	6287	1139	118	621	518	86	32	402	156	373	238	1204	1086	1476	955	1993	933
"IRF4"	5454	19692	9324	9499	5072	4252	5113	4386	3830	4659	8174	11271	9704	11619	7566	6137	12598	6373
"IRF5"	2889	12094	4455	1649	2450	2005	832	817	1419	555	3582	1606	6761	4449	6384	3313	8909	3574
"IRF6"	2179	18219	0	0	0	0	0	0	13	0	0	0	0	0	0	0	0	0
"IRF7"	2059	3174	421	190	319	102	125	65	491	180	671	235	538	529	1145	630	775	748
"IRF8"	2668	23437	3411	22366	1871	1540	11977	10389	705	15635	893	33097	1904	11113	2763	42104	2369	16529
"IRF9"	2378	6045	1278	540	740	538	341	199	612	426	882	603	1537	838	2319	998	2567	1190
"IRGC"	1606	3955	0	0	0	0	0	0	0	0	0	0	0	0	0	0	0	0
"IRGM"	1659	2146	0	0	0	0	0	0	0	0	0	0	0	28	0	0	0	0
"IRGQ"	9690	11770	679	1464	359	320	801	663	235	917	273	2074	756	3810	657	2816	744	1814
"IRP1"	2679	51796	507	1047	333	174	562	485	439	5515	53	57	450	961	644	818	686	522
"IRS1"	8737	67474	0	0	0	0	0	0	0	0	0	0	0	0	0	0	0	0
"IRS2"	6998	32730	0	17	0	0	0	17	76	10	0	0	317	122	432	219	403	169
"IRS4"	3882	3882	0	0	0	0	0	0	0	0	0	0	0	0	0	0	0	0
"IRT1 homologue"	1920	4439	237	156	112	125	69	87	100	172	35	381	2400	408	2890	3040	506	624
"IRTA1"	3130	24332	1	0	1	0	0	0	0	0	0	0	0	0	0	0	0	0
"IRX1"	1861	5350	0	0	0	0	0	0	0	0	0	0	0	0	0	0	0	0
"IRX2"	3059	5490	0	0	0	0	0	0	0	0	0	0	0	0	0	0	0	0
"IRX3"	2312	3168	0	0	0	0	0	0	30	0	0	0	0	0	0	0	0	0
"IRX4"	2264	5341	0	0	0	0	0	0	17	0	0	0	0	0	0	0	0	0
"IRX5"	2239	2411	0	0	0	0	0	0	0	10	0	0	0	0	0	0	0	0
"IRX6"	2334	6202	0	0	0	0	0	0	0	0	0	0	0	0	0	0	0	0
"ISCA1"	2005	18028	29	9	0	29	0	9	45	27	0	0	503	476	655	109	740	476
"ISCA1L"	1878	1970	0	0	0	0	0	0	0	0	0	0	0	0	85	39	0	0
"ISCA2"	1065	1823	0	0	0	0	0	0	12	16	0	0	511	352	561	294	668	386
"ISCU"	2212	6825	394	21	214	180	21	0	139	72	0	62	2100	1886	2352	1687	2654	1771
"ISG15"	664	1070	313	1280	181	132	667	613	0	743	0	350	194	6351	532	4744	168	2621
"ISG20"	2835	16842	687	5521	323	364	2979	2542	86	3264	0	2312	6	3806	25	1245	11	232
"ISG20L2"	2054	5294	437	134	235	202	85	49	143	153	0	62	1138	1292	266	255	955	331
"ISL1"	2717	11601	0	0	0	0	0	0	0	0	0	0	0	0	0	0	0	0
"ISL2"	1804	5671	143	87	72	71	71	16	53	56	0	0	164	164	62	65	174	156
"ISLR"	2297	3127	0	0	0	0	0	0	53	10	0	0	0	0	0	0	0	0
"ISLR2"	4819	7428	0	0	0	0	0	0	55	19	0	0	0	0	0	0	0	0
"ISM1"	2598	78881	0	0	0	0	0	0	25	0	0	0	0	0	0	0	0	0
"ISM2"	3101	24472	0	0	0	0	0	0	12	0	2	0	0	0	0	0	0	0
"ISOC1"	1943	19277	229	407	109	120	223	184	125	130	0	149	693	982	758	836	873	720
"ISOC2"	1173	8703	51	17	26	25	0	17	105	78	0	0	233	327	445	700	874	734
"ISPD"	5534	333797	0	0	0	0	0	0	13	0	0	0	0	0	0	0	0	0
"ISX"	3385	21250	0	0	0	0	0	0	0	0	0	0	0	0	0	0	0	0
"ISY1"	5031	73613	3196	953	1812	1384	586	367	1920	701	2082	1473	1451	1385	3930	2835	5646	3542
"ISYNA1"	1961	2947	919	563	515	404	297	266	289	224	1018	418	3478	2636	3317	2501	3242	3166
"ITCH"	6528	148137	8834	5234	4912	3922	2983	2251	4156	2450	4251	5281	3508	3640	3615	3054	3465	2302
"ITFG1"	2246	305717	8873	5043	5198	3675	2761	2282	5721	3334	1186	2842	1168	1485	1363	1412	1445	1490
"ITFG2"	2167	12245	1567	426	852	715	244	182	595	226	916	256	711	612	696	485	873	486
"ITFG3"	2964	31319	404	88	251	153	60	28	420	239	157	139	960	885	1263	1110	1762	1233
"ITGA1"	7436	51877	4	0	4	0	0	0	75	17	0	0	403	231	374	195	357	152
"ITGA10"	5199	18879	0	0	0	0	0	0	13	0	0	0	0	0	0	0	1	0
"ITGA11"	5034	130444	895	92	476	419	51	41	1061	164	256	18	1010	375	926	525	941	429
"ITGA2"	7939	105454	0	0	0	0	0	0	8	0	0	0	2	5	0	0	0	0
"ITGA2B"	3364	17325	1	1	0	1	1	0	133	31	0	0	39	47	93	86	147	117
"ITGA3"	5052	34510	20	0	11	9	0	0	105	11	11	0	229	136	552	631	429	499
"ITGA4"	6102	80849	491	219	299	192	117	102	436	114	0	112	948	1095	1243	1085	1310	862
"ITGA5"	4278	24005	6204	10418	3277	2927	5517	4901	1764	3836	4348	7951	5818	7114	5562	6561	8691	4783
"ITGA6"	5836	78869	121	469	82	39	227	242	124	303	28	746	319	418	629	1099	279	443
"ITGA7"	4157	23332	0	0	0	0	0	0	83	70	0	0	14	7	10	0	102	3
"ITGA7 variant protein"	1982	11862	0	0	0	0	0	0	16	8	0	0	7	7	7	0	96	3
"ITGA8"	3291	202684	0	0	0	0	0	0	0	0	0	0	0	0	0	0	0	0
"ITGA9"	3988	367468	0	0	0	0	0	0	29	18	0	0	0	3	4	11	0	5
"ITGAD"	3945	33195	87	65	49	38	32	33	322	223	62	36	19	35	59	6	77	13
"ITGAE"	3891	86619	1737	656	930	807	364	292	1508	639	2338	916	1627	1135	3730	3768	3628	3295
"ITGAL"	5239	50524	1185	342	757	428	165	177	531	195	913	381	1937	1840	2157	1844	2006	1593
"ITGAM"	4773	72925	31446	10491	17373	14073	5821	4670	11552	4078	34920	12809	31258	29471	28652	25631	48056	27269
"ITGAV"	7061	90839	3102	1496	1749	1353	838	658	1579	673	265	876	2699	3500	2601	2353	2395	1561
"ITGAX"	4679	27811	64839	93267	35681	29158	49443	43824	18930	43554	56341	102065	28312	47545	40225	51151	49054	37864
"ITGB1"	3884	58047	7185	3477	3967	3218	1915	1562	2876	1265	2974	2475	6060	6999	11774	11993	12785	9650
"ITGB1BP1"	2132	16591	1280	276	703	577	150	126	588	257	730	527	2571	2083	2016	1703	2677	1605
"ITGB1BP2"	1502	3569	0	0	0	0	0	0	0	0	0	0	0	13	0	0	0	0
"ITGB1BP3"	1132	9313	75	0	75	0	0	0	104	77	0	0	0	0	0	0	0	0
"ITGB2"	3017	35099	20688	4863	11653	9035	2587	2276	7012	2701	26939	9608	33602	25446	40266	39626	58447	46094
"ITGB3"	4908	58870	159	29	76	83	18	11	178	23	16	16	67	86	88	72	83	63
"ITGB3BP"	2071	6991	0	0	0	0	0	0	58	0	0	0	38	55	32	21	72	66
"ITGB4"	5958	36384	14	0	0	14	0	0	155	86	0	0	1	4	5	0	0	5
"ITGB5"	3386	124350	16	0	0	16	0	0	155	21	0	0	368	335	571	546	769	712
"ITGB6"	2585	98532	32	2348	23	9	1316	1032	176	1406	93	1171	0	202	0	223	0	79
"ITGB7"	2786	15894	51	35	23	28	22	13	148	61	0	32	52	59	56	86	129	87
"ITGB8"	8860	85055	0	1354	0	0	706	648	14	456	0	78	155	276	407	627	116	49
"ITGBL1"	2796	266167	0	0	0	0	0	0	24	0	0	0	0	0	0	0	0	0
"ITIH1"	2932	14471	0	0	0	0	0	0	62	46	0	0	0	0	0	0	0	0
"ITIH2"	3209	46248	118	0	60	58	0	0	30	0	0	0	16	0	0	0	0	0
"ITIH3"	3059	14243	0	0	0	0	0	0	113	103	0	0	0	0	0	0	0	0
"ITIH4"	3290	17681	76	6	45	31	6	0	281	163	0	49	60	45	129	87	215	107
"ITIH5"	6332	107300	0	0	0	0	0	0	0	0	0	0	0	0	0	0	0	0
"ITIH5L"	4981	49343	0	0	0	0	0	0	32	20	0	0	0	0	0	0	5	0
"ITK"	4383	74204	9	0	9	0	0	0	12	13	0	0	23	69	0	12	29	12
"ITLN1"	1188	8630	0	0	0	0	0	0	0	0	0	0	0	0	0	0	0	0
"ITLN2"	1167	9774	0	0	0	0	0	0	22	0	0	0	0	0	0	0	0	0
"ITM2A"	1836	7166	0	0	0	0	0	0	0	0	0	0	28	24	43	17	25	29
"ITM2B"	1902	28960	1833	323	949	884	189	134	1244	159	238	56	8700	8742	8117	7999	8133	6804
"ITM2C"	2078	14343	0	0	0	0	0	0	65	24	0	0	136	149	86	87	180	119
"ITPA"	1131	14450	750	112	430	320	35	77	523	82	663	184	1056	816	778	726	1382	877
"ITPK1"	3382	176196	37752	8296	20592	17160	4621	3675	14368	5338	41028	10211	7470	6526	8721	8056	10025	8291
"ITPKA"	1778	9625	0	0	0	0	0	0	10	0	0	0	0	0	0	0	0	3
"ITPKB"	6169	107486	18552	17141	10190	8362	9254	7887	7533	8602	14606	13660	1617	643	3484	1865	3646	1035
"ITPKC"	3390	23757	53	9	25	28	0	9	98	234	0	223	236	417	263	452	372	370
"ITPR1"	9917	354254	5362	2261	3018	2344	1199	1062	2644	1711	759	2275	1328	1327	1338	1219	1350	921
"ITPR2"	12623	497846	29596	27323	16358	13238	15176	12147	17742	18908	2391	14199	4848	6484	4582	5702	5842	3377
"ITPR3"	9082	75187	52	13	13	39	13	0	671	321	0	25	29	62	77	60	245	84
"ITPRIP"	4365	21764	1672	1350	974	698	692	658	832	1134	571	1444	7	3	15	19	1528	9
"ITPRIPL1"	2157	2157	468	92	218	250	59	33	141	35	63	30	3206	1401	2068	565	3496	1209
"ITPRIPL2"	7696	7696	3247	1216	1778	1469	661	555	1356	419	3036	625	7243	4813	8282	3402	8819	3755
"ITR"	3904	27842	105	0	39	66	0	0	99	0	0	0	292	303	317	209	328	161
"ITSN"	6058	170509	4491	1180	2601	1890	603	577	3140	991	1287	1153	643	656	1103	1042	1158	728
"ITSN1"	6479	246827	4491	1180	2601	1890	603	577	3140	991	1287	1153	643	656	1103	1042	1158	728
"ITSN2"	6152	157664	9475	7056	5146	4329	3905	3151	4940	4765	2002	6951	2987	4353	4373	3990	4932	3022
"IVD"	4677	15828	671	91	425	246	42	49	358	66	130	18	1444	993	1299	886	1751	1070
"IVL"	2136	3324	0	0	0	0	0	0	0	0	0	0	0	0	0	0	0	0
"IVNS1ABP"	4210	20939	9519	20241	5243	4276	10954	9287	2979	5294	2764	8213	6967	10757	7354	11329	8637	7267
"IWS1"	3014	45706	2409	2207	1364	1045	1249	958	1485	1311	464	1552	1939	2374	2010	1805	2677	1740
"IYD"	7519	35738	0	0	0	0	0	0	0	0	0	0	0	0	0	0	0	0
"IZUMO1"	1629	6021	0	0	0	0	0	0	45	0	0	0	0	0	0	0	0	0
"Icap-1a"	1977	17822	1280	276	703	577	150	126	588	257	730	527	2571	2083	2016	1703	2677	1605
"Id2B"	1173	1233	0	0	0	0	0	0	0	0	0	0	0	0	0	0	0	0
"IgK"	83	83	0	0	0	0	0	0	11	11	0	0	0	0	0	0	0	0
"Ig[alpha]1-[alpha]2m"	360	639	0	0	0	0	0	0	0	0	0	0	0	0	0	0	0	2
"Ig[kappa]"	1212	8946	0	0	0	0	0	0	0	9	0	0	14	12	88	102	19	13
"Ini1"	363	11630	793	490	421	372	246	244	304	370	364	767	191	421	624	522	726	509
"Itch"	6261	148137	8834	5234	4912	3922	2983	2251	4156	2450	4251	5281	3508	3640	3615	3054	3465	2302
"JAG1"	6013	36364	5954	13478	3359	2595	7231	6247	1909	6943	2187	8649	2778	6007	3352	8850	3307	6472
"JAG2"	5102	27086	9	11	9	0	11	0	257	149	0	1	31	20	9	10	17	21
"JAGN1"	1658	3760	0	0	0	0	0	0	30	12	0	0	564	477	532	451	752	500
"JAK1"	5078	133283	14258	45847	7917	6341	24666	21181	5083	27241	4558	51934	7340	9493	8229	7847	10467	4390
"JAK2"	5309	142939	27484	33850	15178	12306	18366	15484	12601	15940	7342	12439	2416	3385	2782	2334	4006	2213
"JAK3"	5456	23248	237	13	169	68	7	6	321	271	302	534	569	660	438	290	621	484
"JAKMIP1"	3032	174394	0	0	0	0	0	0	309	100	0	21	0	0	0	3	0	0
"JAKMIP2"	3367	191548	0	0	0	0	0	0	0	0	0	0	10	0	5	6	3	0
"JAKMIP3"	6511	80001	8	0	4	4	0	0	320	147	0	0	0	0	0	0	0	0
"JAM1"	4460	25902	213	0	135	78	0	0	198	60	75	20	1513	1518	813	743	1846	1124
"JAM2"	1893	75648	0	0	0	0	0	0	0	10	0	0	0	0	0	0	0	0
"JAM3"	3674	82831	0	0	0	0	0	0	67	0	0	0	7	2	1	0	0	0
"JARID1A variant protein"	1376	65856	4770	1627	2613	2157	794	833	2178	873	2340	2076	458	574	835	579	939	493
"JARID1C"	3701	35490	545	178	367	178	83	95	273	143	0	0	1187	1180	1836	1334	0	0
"JARID2"	5773	275727	62402	39037	34703	27699	20927	18110	23377	13463	37162	27316	2675	2747	2798	2450	3760	2223
"JAZF1"	3201	350243	13548	6732	7695	5853	3619	3113	7711	5352	1614	5607	786	903	511	475	765	496
"JDP2"	3993	44344	218	69	162	56	26	43	276	301	70	212	312	282	263	274	398	272
"JHDM1D"	9196	92195	17611	8598	9786	7825	4532	4066	10361	3860	9838	8747	6478	9149	6065	5217	6956	4601
"JK"	3945	28394	0	0	0	0	0	0	0	0	0	0	0	0	0	0	0	0
"JKAMP"	2777	20795	1169	79	615	554	29	50	771	19	404	0	2369	1760	2456	1857	2588	1950
"JKTBP"	3538	7031	1539	1109	888	651	596	513	825	260	745	744	4430	5162	2599	2076	2740	2585
"JM1"	1859	14090	246	3	169	77	3	0	175	108	61	27	468	403	812	681	853	686
"JM23"	1538	10205	67	10	39	28	10	0	160	70	20	0	570	441	486	401	599	390
"JM4"	1767	8746	294	0	147	147	0	0	149	117	97	16	632	487	969	995	1230	850
"JMJD1C"	8764	298734	18398	13483	10431	7967	7561	5922	8473	6570	3810	8308	2447	2520	2467	1768	2364	1317
"JMJD2C"	1421	57508	773	568	495	278	309	259	517	485	164	859	159	124	116	209	195	131
"JMJD4"	2600	4223	178	0	111	67	0	0	110	14	86	49	186	201	366	235	304	259
"JMJD5"	2529	17795	153	0	87	66	0	0	222	30	17	0	205	121	215	126	273	138
"JMJD6"	5430	13969	780	794	445	335	448	346	314	537	435	1540	762	1202	539	938	974	1020
"JMJD7"	4073	12147	1006	477	586	420	247	230	432	396	271	341	227	335	526	395	528	267
"JMJD7-PLA2G4B"	3391	20064	1244	651	715	529	346	305	732	589	379	418	341	460	751	607	800	408
"JMJD8"	2051	2774	212	54	115	97	30	24	130	91	147	66	1573	1569	1874	1565	2380	1672
"JMY"	9109	91084	60	12	39	21	6	6	76	0	22	0	390	349	598	213	335	161
"JOSD1"	3438	14912	484	1389	273	211	725	664	195	698	45	1250	1800	436	1339	1869	1865	1590
"JOSD2"	864	5220	71	0	45	26	0	0	118	81	55	75	254	106	366	266	292	71
"JPH1"	4377	86623	0	0	0	0	0	0	0	0	0	0	0	0	0	0	0	0
"JPH2"	4791	75883	0	0	0	0	0	0	13	0	0	0	0	0	0	0	0	0
"JPH3"	3999	95262	96	0	30	66	0	0	523	258	0	0	0	0	48	0	101	0
"JPH4"	4411	10767	0	15	0	0	15	0	1112	62	0	0	61	42	6	562	1232	627
"JRK"	9118	12528	725	31	380	345	17	14	458	99	443	55	616	223	765	154	913	168
"JRKL"	3571	3571	17	0	17	0	0	0	28	0	0	0	240	219	279	313	276	176
"JSRP1"	1144	4166	0	0	0	0	0	0	24	21	0	0	1	0	0	0	0	0
"JSX"	3014	3704	0	0	0	0	0	0	0	0	0	0	0	10	0	0	0	0
"JTB"	1577	3706	128	0	73	55	0	0	8	12	0	0	2379	2240	2237	2698	3330	2557
"JUB"	4238	11438	0	0	0	0	0	0	0	10	0	0	0	0	0	0	0	0
"JUN"	3323	3323	1484	2525	798	686	1328	1197	298	1330	493	1733	5591	20080	5713	24573	7907	30260
"JUNB"	1816	1816	506	1085	268	238	553	532	113	578	277	713	5465	29589	5889	37217	7396	36903
"JUND"	1871	1871	291	243	155	136	127	116	175	163	554	553	4065	3754	3726	3806	4707	4428
"JUP"	3522	32107	2085	1436	1173	912	736	700	2281	1332	784	1004	10019	16201	14693	21673	18234	18272
"K-sam"	1739	83337	0	0	0	0	0	0	12	11	0	0	0	0	0	0	0	0
"KA35"	1748	8477	0	0	0	0	0	0	0	0	0	0	0	0	0	0	0	0
"KA36"	2111	9287	0	0	0	0	0	0	0	0	0	0	0	0	0	0	0	0
"KAAG1"	1383	1383	0	0	0	0	0	0	0	0	0	0	0	0	0	0	0	0
"KAL1"	6327	203313	0	0	0	0	0	0	0	0	0	0	0	0	0	0	0	0
"KALI"	1637	34166	67	17	61	6	0	17	63	11	0	86	28	55	36	34	60	23
"KALRN"	10866	626479	0	0	0	0	0	0	43	11	0	0	0	0	0	0	0	0
"KANK1"	6895	229407	21	771	12	9	397	374	26	515	0	150	7	126	4	472	8	66
"KANK2"	5419	33282	0	0	0	0	0	0	110	12	0	0	0	3	0	4	0	0
"KANK3"	2797	20679	11	0	11	0	0	0	99	50	0	0	162	4	0	2067	35	562
"KANK4"	5486	83247	0	0	0	0	0	0	31	10	0	0	0	0	0	0	0	0
"KAONASHI1"	3575	57188	914	84	512	402	46	38	627	90	221	73	1017	808	856	796	1120	825
"KARS"	2206	19963	244	176	155	89	116	60	165	140	0	65	1870	2619	3033	2635	3762	2433
"KAT2A"	3130	8255	234	86	137	97	54	32	127	155	30	35	523	517	878	815	910	530
"KAT2B"	4840	114372	2726	1218	1535	1191	724	494	1439	794	621	1173	1346	1578	1437	1412	1580	1220
"KAT5"	2326	7587	707	638	394	313	339	299	282	325	377	498	1305	1253	1466	1363	1793	1206
"KATNA1"	1746	53680	275	107	147	128	72	35	188	156	10	267	289	514	299	203	594	221
"KATNAL1"	7524	104818	390	0	206	184	0	0	316	21	0	17	488	608	239	184	518	292
"KATNAL2"	2847	101828	609	55	442	167	24	31	457	174	38	51	62	91	76	96	94	36
"KATNB1"	2666	21504	52	5	42	10	5	0	367	64	45	5	337	237	476	395	602	487
"KAZ"	3400	107473	0	0	0	0	0	0	309	172	0	0	0	0	4	0	0	0
"KAZALD1"	2518	4353	0	0	0	0	0	0	65	17	0	0	2	0	0	0	0	0
"KBTBD10"	2470	16562	0	0	0	0	0	0	17	0	0	0	0	0	0	0	0	0
"KBTBD11"	6718	33066	79	0	54	25	0	0	87	0	0	0	446	308	458	229	515	226
"KBTBD12"	5272	64613	2	0	0	2	0	0	0	0	0	0	0	0	0	0	0	0
"KBTBD2"	3714	23692	1587	1249	907	680	735	514	800	529	397	1251	1503	2041	1491	243	1538	1448
"KBTBD3"	4234	26641	0	6	0	0	0	6	60	0	9	0	0	84	37	74	32	89
"KBTBD4"	3082	6593	409	113	222	187	57	56	238	41	164	152	1158	901	170	797	1429	94
"KBTBD5"	2425	6929	0	0	0	0	0	0	14	24	0	0	0	0	0	0	0	0
"KBTBD6"	5229	5229	0	0	0	0	0	0	10	0	0	0	164	0	157	0	178	0
"KBTBD7"	2993	2993	0	0	0	0	0	0	0	10	0	0	338	34	270	0	324	27
"KBTBD8"	4684	12905	97	94	59	38	66	28	120	26	0	0	1016	990	1270	829	987	641
"KC6"	1716	40325	0	0	0	0	0	0	0	0	0	0	0	0	0	0	0	0
"KCC1"	2215	17130	757	56	427	330	26	30	663	178	858	65	286	389	576	511	843	610
"KCHIP3"	3674	16574	0	0	0	0	0	0	79	74	0	0	0	0	0	0	0	0
"KCMF1"	7559	88365	5264	4060	2837	2427	2151	1909	2142	1981	1890	4342	1476	1550	1222	1035	1549	1123
"KCNA1"	7983	8349	0	0	0	0	0	0	0	0	0	0	0	0	0	0	0	0
"KCNA10"	1960	1960	45	0	24	21	0	0	38	0	0	0	0	0	0	2	0	2
"KCNA2"	2252	3200	36	0	23	13	0	0	133	17	0	16	0	1	0	4	0	3
"KCNA3"	3347	3347	100	552	69	31	292	260	0	200	0	313	0	365	0	0	0	74
"KCNA3B"	2651	6728	1	0	1	0	0	0	0	10	0	0	2	1	0	0	5	0
"KCNA4"	3614	6724	0	0	0	0	0	0	0	0	0	0	0	0	0	0	0	0
"KCNA5"	2865	2865	0	0	0	0	0	0	0	16	0	0	0	0	0	0	0	0
"KCNA6"	5979	41937	0	0	0	0	0	0	43	0	0	0	0	0	0	0	0	0
"KCNA7"	4373	5524	1	0	1	0	0	0	28	0	0	0	0	0	0	0	0	0
"KCNAB1"	4532	248153	3715	143	2299	1416	80	63	1165	0	1063	26	537	182	264	0	342	31
"KCNAB2"	3573	66182	17467	3358	9543	7924	1826	1532	8095	1983	19195	3150	8847	7925	12354	10984	13543	10335
"KCNAB3"	1622	6728	1	0	1	0	0	0	0	10	0	0	2	1	0	0	5	0
"KCNB1"	3773	111987	0	0	0	0	0	0	154	20	0	0	0	0	0	0	0	0
"KCNB2"	3583	400958	0	0	0	0	0	0	10	0	0	0	0	0	0	0	0	0
"KCNC1"	6792	41883	0	0	0	0	0	0	228	122	0	0	0	0	0	0	0	0
"KCNC2"	3515	169616	0	0	0	0	0	0	0	0	0	0	0	0	0	0	0	0
"KCNC3"	4412	12142	2358	919	1343	1015	525	394	650	512	2448	1367	823	958	1420	1224	1634	1044
"KCNC4"	3703	22602	0	0	0	0	0	0	140	71	0	0	0	0	6	0	47	10
"KCND1"	4726	9614	47	7	29	18	7	0	58	40	0	0	1	24	0	25	6	43
"KCND2"	5339	476667	0	0	0	0	0	0	0	0	0	0	0	0	0	0	0	0
"KCND3"	2701	213325	1	0	0	1	0	0	142	59	0	0	0	0	0	0	0	0
"KCNE1"	3573	65586	1719	2052	986	733	1111	941	1048	1139	579	2036	356	701	480	1294	380	581
"KCNE1L"	1464	1464	0	0	0	0	0	0	0	0	0	0	0	0	0	0	0	0
"KCNE2"	805	7119	0	0	0	0	0	0	0	0	0	0	0	0	0	0	0	0
"KCNE3"	3071	12714	405	0	226	179	0	0	215	0	0	0	1105	389	1038	266	626	169
"KCNE4"	2961	3493	0	0	0	0	0	0	0	0	0	0	0	0	0	0	0	0
"KCNF1"	2289	2289	0	0	0	0	0	0	0	0	0	0	0	0	0	0	0	0
"KCNG1"	2222	19483	0	0	0	0	0	0	33	18	0	0	0	3	0	0	0	0
"KCNG2"	1402	36149	583	646	318	265	371	275	331	570	95	484	0	15	5	0	2	0
"KCNG3"	3824	52080	0	0	0	0	0	0	0	0	0	0	0	0	0	0	0	0
"KCNG4"	2201	4344	0	0	0	0	0	0	71	0	0	0	0	0	0	0	0	0
"KCNH1"	8117	455802	0	0	0	0	0	0	16	0	0	0	186	189	0	0	0	0
"KCNH2"	4729	15916	0	0	0	0	0	0	247	196	0	0	0	0	0	0	0	4
"KCNH3"	3868	19139	3	3	3	0	3	0	164	55	57	1	29	27	41	50	115	77
"KCNH4"	3940	24388	0	0	0	0	0	0	250	107	0	1	0	0	0	0	0	0
"KCNH5"	3308	338010	0	0	0	0	0	0	0	0	0	0	0	0	0	0	0	0
"KCNH6"	3416	22907	6	0	5	1	0	0	71	77	1	0	6	0	0	0	0	0
"KCNH7"	4241	467325	214	0	109	105	0	0	86	0	0	1	18	0	2	11	19	9
"KCNH8"	6011	387120	0	0	0	0	0	0	7	0	0	0	0	0	0	0	0	0
"KCNIP1"	2175	232588	1255	552	710	545	301	251	2082	999	1076	894	66	244	134	342	301	186
"KCNIP2"	2598	17947	1128	503	620	508	278	225	553	401	366	330	13	13	4	0	16	12
"KCNIP3"	2922	88754	0	0	0	0	0	0	427	212	0	0	6	10	0	0	0	0
"KCNIP4"	2410	969081	158	0	83	75	0	0	194	9	53	0	19	0	0	2	0	2
"KCNJ1"	2753	29355	9	0	9	0	0	0	89	37	0	0	55	56	143	143	73	82
"KCNJ10"	4442	31930	0	0	0	0	0	0	64	0	0	0	0	0	0	0	0	0
"KCNJ11"	3410	3410	0	15	0	0	0	15	18	39	0	49	0	30	0	0	0	0
"KCNJ12"	5233	43482	0	2	0	0	0	2	736	499	0	0	0	0	0	0	0	0
"KCNJ13"	3264	10417	1122	382	662	460	193	189	530	164	96	170	0	1	0	2	1	0
"KCNJ14"	3122	4863	41	79	19	22	53	26	61	234	0	100	50	170	0	51	0	20
"KCNJ15"	2918	44876	0	0	0	0	0	0	0	0	0	0	0	0	0	0	0	0
"KCNJ16"	4013	30751	0	0	0	0	0	0	0	0	0	0	0	0	0	0	0	0
"KCNJ2"	5404	11369	110	1308	50	60	733	575	10	798	0	1115	290	12193	190	4480	148	4288
"KCNJ3"	2893	157923	0	0	0	0	0	0	0	0	0	0	0	0	0	0	0	0
"KCNJ4"	2064	28872	0	0	0	0	0	0	92	76	0	0	0	0	0	0	0	0
"KCNJ5"	2990	26638	7	0	0	7	0	0	113	18	0	0	116	103	513	464	299	314
"KCNJ6"	2488	291912	0	0	0	0	0	0	47	30	0	0	0	0	0	0	0	0
"KCNJ8"	2383	9859	0	0	0	0	0	0	0	0	0	0	0	0	0	0	0	0
"KCNJ9"	3032	7854	0	46	0	0	24	22	25	244	0	206	0	0	0	0	0	0
"KCNK1"	2366	42907	0	0	0	0	0	0	0	0	0	0	0	0	0	0	0	0
"KCNK10"	7515	143141	0	0	0	0	0	0	28	8	0	0	0	0	0	0	0	0
"KCNK12"	1424	49555	0	0	0	0	0	0	26	10	0	0	0	0	0	0	0	0
"KCNK13"	2519	124089	25294	4341	14069	11225	2440	1901	8579	2095	13640	3540	1661	1352	1828	1329	2601	1867
"KCNK15"	1246	5180	0	0	0	0	0	0	0	0	0	0	0	0	0	0	0	0
"KCNK16"	1413	7857	0	0	0	0	0	0	13	39	0	0	0	0	0	0	0	0
"KCNK17"	1722	15461	0	0	0	0	0	0	63	19	0	0	0	0	0	0	0	0
"KCNK18"	1157	12811	0	0	0	0	0	0	12	13	0	0	0	0	0	0	0	0
"KCNK2"	3603	231552	0	0	0	0	0	0	0	0	0	0	0	0	0	0	0	0
"KCNK3"	3980	38487	1	0	0	1	0	0	163	31	0	0	0	0	0	0	0	0
"KCNK4"	2741	13046	0	0	0	0	0	0	55	61	0	0	2	2	0	0	0	0
"KCNK5"	3787	40505	3	0	3	0	0	0	130	461	0	0	0	84	0	139	0	0
"KCNK6"	2652	9161	4219	727	2564	1655	402	325	1517	271	3326	1006	8647	6236	3518	1901	4464	2437
"KCNK7"	1564	3142	92	39	38	54	17	22	58	152	59	349	1	0	6	0	4	0
"KCNK9"	2946	18262	0	0	0	0	0	0	420	121	0	0	0	0	0	0	0	0
"KCNMA1"	12023	768220	0	0	0	0	0	0	422	84	0	0	97	79	0	0	0	0
"KCNMB1"	1712	6960	491	424	266	225	227	197	362	459	323	569	66	235	118	225	274	99
"KCNMB2"	2547	307994	0	0	0	0	0	0	0	0	0	0	0	0	0	0	0	0
"KCNMB3"	2132	20144	231	139	130	101	77	62	98	40	0	43	467	655	23	279	236	80
"KCNMB4"	1633	64917	0	0	0	0	0	0	0	0	0	0	0	10	0	0	0	0
"KCNN1"	2667	47820	0	0	0	0	0	0	79	42	0	0	1	0	0	0	0	0
"KCNN2"	2522	134182	0	0	0	0	0	0	0	0	0	0	0	0	0	0	0	0
"KCNN3"	3053	162839	0	0	0	0	0	0	395	162	0	0	0	0	0	0	0	0
"KCNN4"	2247	14724	855	214	487	368	103	111	296	562	897	1812	1301	861	1700	1430	2146	1452
"KCNQ1"	3261	404120	43409	25966	23864	19545	14050	11916	11763	8757	19505	20208	2867	2349	1281	1286	2084	1683
"KCNQ1DN"	1093	2072	0	0	0	0	0	0	0	0	0	0	0	0	0	0	0	0
"KCNQ1OT1"	59462	59462	11795	10519	6360	5435	5621	4898	2866	3099	6520	7720	86	102	97	93	62	116
"KCNQ2"	3268	66453	0	0	0	0	0	0	560	307	0	0	0	0	0	0	0	0
"KCNQ3"	3111	351749	0	0	0	0	0	0	30	7	0	0	0	0	0	0	0	0
"KCNQ4"	2349	54678	0	0	0	0	0	0	425	131	0	0	0	0	0	0	0	0
"KCNQ5"	6652	577002	10	0	0	10	0	0	20	0	0	0	0	0	0	0	0	0
"KCNRG"	1627	5669	2500	2466	1583	917	1431	1035	1844	2478	861	1126	556	517	438	238	577	270
"KCNS1"	4543	8804	0	37	0	0	0	37	18	168	0	97	0	0	0	0	0	0
"KCNS2"	3166	3773	0	0	0	0	0	0	0	0	0	0	0	0	0	0	0	0
"KCNS3"	2403	55112	0	0	0	0	0	0	0	0	0	0	0	0	0	0	0	0
"KCNT1"	4841	90963	0	0	0	0	0	0	695	415	0	0	0	0	0	0	0	0
"KCNT2"	5937	382588	0	0	0	0	0	0	0	0	0	0	0	0	0	0	0	0
"KCNU1"	3767	151801	0	0	0	0	0	0	0	0	0	0	0	0	0	0	0	0
"KCNV1"	3622	8843	0	0	0	0	0	0	0	0	0	0	0	0	0	0	0	0
"KCNV2"	1884	12233	15	0	15	0	0	0	0	0	0	0	0	0	0	0	0	0
"KCP"	4763	33854	371	289	204	167	159	130	631	400	84	327	1747	1661	4855	5594	4415	4844
"KCTD1"	3433	93625	25	0	0	25	0	0	39	0	0	0	283	149	106	7	70	22
"KCTD10"	5629	28697	1355	1188	805	550	634	554	735	1174	865	2082	2372	2472	2016	2000	2605	1708
"KCTD11"	3054	3054	49	0	20	29	0	0	60	17	0	0	359	325	440	458	614	418
"KCTD12"	6238	6238	896	495	520	376	237	258	454	257	607	152	10310	7792	13603	8435	11240	5731
"KCTD13"	1717	19884	1717	481	875	842	302	179	627	263	965	730	602	609	486	439	616	372
"KCTD14"	1672	7560	0	0	0	0	0	0	0	0	0	0	0	0	0	0	0	0
"KCTD15"	4938	18916	0	0	0	0	0	0	47	21	0	0	442	353	358	222	550	314
"KCTD16"	5648	272106	0	0	0	0	0	0	0	0	0	0	0	0	0	0	0	0
"KCTD17"	1771	11652	824	305	429	395	183	122	507	326	860	295	1390	1233	1526	1192	2582	1479
"KCTD18"	2942	21108	278	10	124	154	10	0	188	0	0	9	454	387	544	316	633	325
"KCTD19"	4740	37270	0	0	0	0	0	0	20	14	0	0	0	0	0	0	0	0
"KCTD2"	3702	18702	203	0	120	83	0	0	181	59	74	51	2707	733	3026	1844	3880	2003
"KCTD20"	5020	47771	2592	2273	1401	1191	1199	1074	1343	1566	1385	3747	5511	6634	3663	3528	4348	2597
"KCTD21"	3377	17365	236	40	139	97	23	17	182	60	0	0	539	258	526	197	535	197
"KCTD3"	4019	54414	185	160	135	50	83	77	274	129	11	32	611	523	734	536	701	436
"KCTD4"	2119	8187	200	0	117	83	0	0	133	16	0	0	1	0	0	0	1	0
"KCTD5"	2467	26536	2696	976	1456	1240	537	439	1098	463	1983	341	2093	1623	2262	1501	2901	1654
"KCTD6"	1833	3995	941	0	539	402	0	0	557	16	1028	0	891	117	1361	126	1213	215
"KCTD7"	4849	14144	2635	611	1510	1125	332	279	1139	220	2215	545	1468	548	1987	647	2421	713
"KCTD8"	2593	274904	0	0	0	0	0	0	0	0	0	0	0	0	0	0	0	0
"KCTD9"	3347	30556	314	111	151	163	73	38	311	41	0	43	362	438	525	120	182	464
"KChIP2b"	2627	17947	1128	503	620	508	278	225	553	401	366	330	13	13	4	0	16	12
"KDELC1"	2260	14774	0	0	0	0	0	0	0	0	0	0	0	0	0	0	0	0
"KDELC2"	4387	19400	11	55	11	0	34	21	0	107	0	12	547	681	443	442	440	276
"KDELR1"	1606	8287	167	41	83	84	11	30	121	32	0	0	1763	1754	2075	825	1440	1830
"KDELR2"	2864	23138	623	254	331	292	109	145	313	362	237	466	2220	2156	2409	571	2471	1810
"KDELR3"	1709	15363	2398	2747	2295	103	1492	1255	1498	828	1281	0	0	1	0	7516	0	0
"KDM1A"	3128	64245	1475	321	894	581	174	147	992	109	193	196	1616	3073	1842	1314	2300	1392
"KDM1B"	3893	68467	1580	95	880	700	25	70	1167	82	178	37	1204	1493	949	897	1630	936
"KDM2A"	7390	138804	13753	5164	7751	6002	2997	2167	5646	2695	7388	6355	4455	4204	4520	3576	6302	3455
"KDM2B"	5327	152020	14630	26165	8201	6429	13626	12539	4543	18156	9629	49211	2626	4020	2174	3812	2674	2781
"KDM3A"	4915	51569	4735	424	2569	2166	270	154	2769	246	1638	378	2485	1123	2286	872	2905	1077
"KDM3B"	6837	84433	5033	1262	2729	2304	635	627	2336	496	1295	1289	4184	3530	4253	2743	5244	2804
"KDM4A"	4530	55393	1637	141	905	732	74	67	1026	149	529	87	901	863	1560	782	1657	927
"KDM4B"	5624	184484	12584	4801	6876	5708	2536	2265	6692	4064	9899	8326	1928	1540	1510	1121	2433	1190
"KDM4C"	4691	418008	20548	18355	11472	9076	10245	8110	10669	9510	2991	11583	1063	1317	999	1019	1509	795
"KDM4D"	2973	25831	0	0	0	0	0	0	0	0	0	0	0	0	0	0	0	0
"KDM4DL"	2340	2340	0	0	0	0	0	0	0	0	0	0	0	0	0	0	0	0
"KDM5A"	10961	109399	9154	3848	5121	4033	2050	1798	4246	1968	3456	3429	1478	4096	2195	2663	2354	2659
"KDM5B"	6518	81018	784	230	499	285	133	97	719	202	106	273	884	792	972	677	1317	793
"KDM5C"	6887	34102	2723	1885	1501	1222	921	964	888	747	1440	2285	2532	2616	3289	3109	6142	3612
"KDM5D"	5607	39524	773	178	513	260	83	95	343	226	0	0	1584	1646	2727	2068	0	0
"KDM6A"	5954	239422	13721	15734	7814	5907	8663	7071	6226	7727	7426	18206	951	992	934	833	1706	1001
"KDM6B"	6726	14885	5063	34603	2616	2447	18178	16425	334	17019	229	42715	1197	29879	1069	11986	1491	26204
"KDR"	6084	47337	0	0	0	0	0	0	0	0	0	0	0	0	0	0	0	0
"KDSR"	5207	39536	123	33	66	57	9	24	95	41	0	13	1077	333	1050	945	1074	776
"KEAP1"	2598	17260	286	60	159	127	25	35	154	62	89	211	1839	956	1791	1007	2181	1207
"KEL"	2564	21302	0	0	0	0	0	0	0	0	0	0	1	3	0	0	0	0
"KERA"	2531	7860	0	0	0	0	0	0	0	0	0	0	0	0	0	0	0	0
"KGFLP1"	3615	60821	0	0	0	0	0	0	0	0	0	0	0	0	2	0	3	4
"KGFLP2"	4709	60783	0	0	0	0	0	0	0	0	0	0	0	0	15	7	30	15
"KHDC1"	1630	53438	0	0	0	0	0	0	20	0	0	0	683	754	0	0	0	0
"KHDC1L"	635	1907	0	0	0	0	0	0	0	0	0	0	0	0	0	0	0	0
"KHDRBS1"	2693	29982	4954	5460	2679	2275	3031	2429	1935	2851	2567	6227	3112	4110	3311	3560	3914	2652
"KHDRBS2"	2309	606237	0	0	0	0	0	0	0	0	0	0	0	0	0	0	0	0
"KHDRBS3"	1963	190132	0	0	0	0	0	0	37	0	0	0	192	246	13	26	0	0
"KHK"	2426	14010	0	0	0	0	0	0	62	11	0	0	44	75	62	28	51	57
"KHSRP"	3268	11703	1037	427	570	467	216	211	402	325	545	864	3936	3435	4815	4183	6397	4092
"KIAA0020"	2237	39977	765	540	457	308	308	232	378	426	128	262	450	457	638	751	622	522
"KIAA0023"	3246	46416	1380	472	708	672	229	243	1376	432	353	724	1272	1119	1374	1115	1767	1189
"KIAA0040"	4726	36108	1669	328	965	704	175	153	905	224	158	132	2385	2036	1915	1175	3186	1839
"KIAA0087"	4322	5706	0	0	0	0	0	0	12	0	0	0	0	0	0	0	0	0
"KIAA0090"	4260	33463	1142	316	668	474	220	96	583	449	312	362	679	575	1186	887	1016	702
"KIAA0100"	7469	30716	29220	8450	12854	16366	4580	3870	14820	3343	29076	8827	31066	33672	34328	24929	54950	27470
"KIAA0101"	1488	16491	1	0	1	0	0	0	0	0	0	0	6	8	0	0	7	0
"KIAA0141"	4969	18228	2007	1199	1108	899	680	519	845	566	1121	906	2158	1862	1898	1574	2553	1443
"KIAA0146"	3504	458956	9660	6733	5399	4261	3894	2839	6335	4432	2108	5235	1043	839	1019	859	1007	816
"KIAA0167"	858	1686	24	0	11	13	0	0	33	0	0	0	89	46	68	49	87	61
"KIAA0171"	2905	4274	385	1493	209	176	778	715	136	2191	0	2195	1685	2822	2058	3454	572	2282
"KIAA0174"	2625	38436	4472	6171	2608	1864	3367	2804	1842	2818	2474	6812	4658	5636	5583	6313	6640	4952
"KIAA0182"	7409	62888	13224	4233	7122	6102	2163	2070	4810	2739	14071	6832	3403	3516	4170	2457	5736	2807
"KIAA0195"	5493	43868	768	147	405	363	72	75	890	234	644	212	1125	999	1542	1337	2232	1403
"KIAA0196"	4192	67558	2446	347	1399	1047	228	119	1498	383	433	387	1724	1754	2350	2000	2933	1695
"KIAA0226"	6979	78311	6773	2585	3909	2864	1407	1178	2922	1378	4134	1201	1012	1076	2056	1561	3094	2250
"KIAA0232"	7865	101440	9502	1970	5261	4241	1118	852	4410	1753	3519	2828	3347	2835	4217	1987	4479	2037
"KIAA0240"	6527	47504	2291	923	1275	1016	516	407	1053	377	1162	847	1043	669	910	394	1192	427
"KIAA0247"	5590	103551	36159	68615	20095	16064	36874	31741	10605	27118	21492	70161	7021	13497	6933	9842	7902	6816
"KIAA0257"	1579	181658	16847	15277	9494	7353	8244	7033	8224	9249	4298	13487	668	851	1673	1575	1711	1046
"KIAA0284"	6699	31434	1	0	1	0	0	0	266	176	0	16	0	1	0	0	0	0
"KIAA0286"	5363	23149	1538	3189	870	668	1751	1438	848	297	330	1439	356	963	1845	4202	2474	2610
"KIAA0288"	1202	28559	5595	999	3113	2482	616	383	3454	1234	1903	716	182	156	111	126	254	126
"KIAA0289"	2182	56796	0	0	0	0	0	0	0	0	0	0	0	0	0	0	0	0
"KIAA0290"	1634	10118	959	14	660	299	14	0	308	21	384	72	1040	560	1082	593	1203	818
"KIAA0297"	6170	139441	321	51	182	139	51	0	640	245	152	38	561	470	615	485	886	461
"KIAA0298"	1219	27537	1578	508	917	661	267	241	932	419	117	128	22	22	62	36	179	63
"KIAA0300"	4891	11759	112	13	48	64	0	13	268	68	60	0	0	13	4	10	0	0
"KIAA0302"	1716	2829	0	0	0	0	0	0	64	0	0	0	0	0	0	0	0	0
"KIAA0305"	5710	25691	8304	4010	4665	3639	2280	1730	4674	816	4285	2032	4654	5219	3311	2820	4692	2876
"KIAA0308"	2321	127354	13881	5550	7798	6083	3028	2522	5939	1792	4629	2160	1058	1483	1557	1290	1192	775
"KIAA0310"	2346	7814	345	453	191	154	239	214	241	416	432	883	1539	1854	1626	454	2256	1713
"KIAA0312"	1051	7208	378	346	203	175	222	124	217	235	172	395	589	908	786	813	1068	755
"KIAA0314"	1164	21598	1434	433	825	609	190	243	1076	382	1377	625	382	399	478	397	695	272
"KIAA0317"	5463	51852	1706	1611	1013	693	884	727	912	1227	166	1840	2021	2030	2497	2052	1253	773
"KIAA0319"	6918	102053	0	0	0	0	0	0	0	0	0	0	0	0	0	0	0	0
"KIAA0319L"	4832	123947	4184	1023	2482	1702	605	418	2216	486	1048	825	1522	1492	1883	1537	2280	1227
"KIAA0320"	9589	104185	245	213	119	126	102	111	523	288	49	14	489	526	637	671	658	320
"KIAA0321"	9028	70071	2977	880	1578	1399	413	467	1587	461	726	500	2022	1791	3029	2287	3714	2151
"KIAA0322"	4027	326858	0	0	0	0	0	0	25	29	0	0	0	0	0	0	0	0
"KIAA0323"	6301	11406	2185	1912	1658	527	1042	870	580	772	1846	1497	5932	5203	7090	4447	9674	4928
"KIAA0325"	2816	8700	973	431	577	396	214	217	543	111	553	192	1712	1459	1493	1227	2209	1099
"KIAA0328"	506	37581	980	740	519	461	390	350	449	379	0	258	49	70	70	74	82	62
"KIAA0330"	1521	44957	5387	1052	3070	2317	564	488	2834	940	5362	2322	1871	1711	2938	2193	4548	3138
"KIAA0332"	7549	59188	1790	1252	936	854	714	538	1168	813	356	718	2316	3022	2686	2061	2813	1606
"KIAA0334"	3992	17005	2402	10247	1352	1050	1909	8338	1207	195	354	7063	1123	208	1137	193	207	115
"KIAA0339"	1051	6560	173	9	77	96	0	9	144	37	88	85	217	126	127	111	249	98
"KIAA0344"	428	7560	1207	468	455	752	277	191	514	241	289	234	46	103	200	169	518	2478
"KIAA0348"	3460	11683	136	23	74	62	0	23	147	55	23	36	547	399	535	341	890	651
"KIAA0349"	4143	74056	3392	616	1782	1610	370	246	2095	493	1325	523	2251	1788	2308	1359	2479	1403
"KIAA0353"	3974	30515	0	0	0	0	0	0	25	8	0	0	0	7	0	0	0	0
"KIAA0355"	6696	101016	673	146	365	308	70	76	613	119	172	247	497	489	590	462	761	474
"KIAA0356"	2857	48203	1899	816	1094	805	433	383	1334	638	1263	1210	793	592	1094	827	1820	894
"KIAA0359"	1410	33483	16	0	0	16	0	0	22	12	0	34	148	151	155	148	210	118
"KIAA0361"	423	1419	28	6	26	2	0	6	33	5	0	0	60	40	100	69	41	45
"KIAA0365"	3528	36718	3229	1416	2006	1223	774	642	1650	475	1700	1896	1428	2775	2155	2176	3217	1866
"KIAA0366"	862	14023	0	0	0	0	0	0	0	0	0	0	0	0	0	0	0	0
"KIAA0368"	7442	124054	6544	5493	3633	2911	3034	2459	3268	3413	1381	4399	3441	3522	3845	3453	5230	3099
"KIAA0369"	6628	86757	0	0	0	0	0	0	0	0	0	0	0	0	0	0	0	0
"KIAA0375"	5008	71889	805	0	432	373	0	0	860	47	288	13	490	486	930	693	885	765
"KIAA0378"	3809	442254	0	0	0	0	0	0	116	15	0	0	59	84	8	5	0	4
"KIAA0379"	2979	9413	27	5029	19	8	2821	2208	10	946	0	88	36	122	57	84	70	57
"KIAA0385"	1097	2431	135	0	66	69	0	0	103	0	120	0	217	161	358	51	301	156
"KIAA0387"	1939	29977	0	0	0	0	0	0	180	61	0	0	0	0	0	0	0	0
"KIAA0388"	1017	12493	135	51	80	55	36	15	103	61	33	92	60	98	195	165	183	136
"KIAA0389"	6555	25608	0	0	0	0	0	0	12	0	0	0	0	0	0	0	0	5
"KIAA0391"	3844	194899	2671	4757	1587	1084	2591	2166	1902	3098	284	5889	1819	3490	2708	4015	3198	2982
"KIAA0393"	4802	44388	1450	684	739	711	351	333	491	239	263	146	1068	1426	2731	2197	2887	1428
"KIAA0399"	3195	9322	2288	725	1247	1041	322	403	1368	584	880	646	873	1784	1613	1238	2051	1125
"KIAA0402"	1086	15425	275	143	155	120	61	82	204	59	69	84	125	151	165	148	236	109
"KIAA0404"	882	3604	34	0	9	25	0	0	66	48	0	51	91	78	85	92	82	84
"KIAA0406"	3921	50410	1735	423	953	782	237	186	1068	314	504	325	953	793	753	491	984	511
"KIAA0407"	3979	10949	0	0	0	0	0	0	113	55	24	0	4	0	3	3	13	3
"KIAA0408"	8639	37309	0	0	0	0	0	0	0	0	0	0	0	0	0	0	0	0
"KIAA0411"	2240	202020	0	0	0	0	0	0	164	0	0	0	0	0	9	0	15	8
"KIAA0415"	3150	16135	2116	2776	1190	926	1356	1420	621	1758	1536	3526	961	1631	2116	3184	2547	2479
"KIAA0416"	1213	2880	269	186	155	114	89	97	277	399	92	429	0	0	0	0	0	0
"KIAA0418"	1403	104649	2799	769	1601	1198	367	402	2197	1431	383	548	1362	1509	1782	1776	1952	1308
"KIAA0419"	2623	3313	2	0	2	0	0	0	20	0	0	0	13	6	6	7	10	1
"KIAA0421"	2132	12008	1137	1237	564	573	589	648	730	344	227	442	305	452	555	614	600	322
"KIAA0422"	2215	4014	0	0	0	0	0	0	26	0	0	0	0	0	8	8	3	9
"KIAA0423"	6251	112219	274	22	109	165	22	0	341	43	73	50	324	386	431	289	491	249
"KIAA0424"	5314	120145	567	54	334	233	34	20	463	78	56	0	234	214	205	129	338	173
"KIAA0427"	5823	324153	4267	1727	2510	1757	888	839	5187	3389	1080	2497	666	568	739	590	1123	649
"KIAA0428"	2550	34411	94698	94594	70117	24581	51206	43388	23799	59326	15943	42202	1588	2716	1728	2166	1656	1020
"KIAA0430"	7754	48766	2096	233	1325	771	120	113	1412	260	959	199	3079	2724	2229	1973	2514	1060
"KIAA0433"	5960	82951	3639	966	1965	1674	489	477	2232	438	384	360	2727	3230	3197	2828	2848	1900
"KIAA0435"	3485	216130	151	213	107	44	100	113	133	69	5	126	100	103	51	41	51	36
"KIAA0439"	6085	35543	0	179	0	0	74	105	6	167	21	486	3	15	13	51	73	73
"KIAA0441"	5665	20723	460	10	239	221	0	10	253	24	0	15	189	192	506	87	581	69
"KIAA0444"	7766	42364	4	3	4	0	3	0	361	137	0	1	4	2	0	0	0	0
"KIAA0445"	2430	4778	135	53	75	60	32	21	704	306	148	50	314	313	468	423	639	422
"KIAA0446"	3567	18858	1590	1415	900	690	819	596	756	839	1085	2142	1820	2032	1819	1544	2323	1565
"KIAA0447"	5144	8640	294	54	191	103	42	12	238	59	265	73	1706	1425	2164	1457	2917	1552
"KIAA0449"	3174	4289	5	0	1	4	0	0	48	20	14	0	17	18	28	45	32	17
"KIAA0453"	5690	144373	3940	3684	2280	1660	2014	1670	3146	3024	878	3099	1205	1319	1623	1329	2032	1165
"KIAA0454"	2121	5462	93	27	48	45	0	27	9	43	0	11	89	70	144	192	161	91
"KIAA0457"	2614	239877	2390	1024	1450	940	612	412	2977	1502	407	967	70	81	106	121	160	77
"KIAA0458"	2721	288869	5547	1919	3183	2364	1062	857	4732	1703	1490	2239	141	195	192	193	319	166
"KIAA0460"	4602	109044	2936	403	1525	1411	203	200	1098	183	710	424	2061	1530	1692	939	2283	1260
"KIAA0462"	3502	30410	2155	1994	1181	974	1050	944	1114	1564	891	1904	1663	1482	2019	2278	3196	1587
"KIAA0463"	5625	6963	0	0	0	0	0	0	22	10	0	0	0	0	3	8	0	7
"KIAA0464"	4573	300234	0	0	0	0	0	0	11	0	0	0	0	0	0	0	0	0
"KIAA0465"	5434	73265	7251	6340	4015	3236	3528	2812	3539	2808	2896	3323	2756	3810	3996	4097	4439	2369
"KIAA0467"	10301	29536	3846	1444	2130	1716	751	693	2269	1021	2268	1523	1498	1753	1823	1520	2374	1447
"KIAA0471"	1534	25821	343	124	192	151	70	54	314	83	66	77	263	142	160	75	118	45
"KIAA0478"	2167	10560	1138	494	645	493	286	208	397	196	123	188	341	372	403	412	650	243
"KIAA0479"	4918	31040	0	0	0	0	0	0	9	0	0	0	0	0	0	0	0	0
"KIAA0483"	5314	47960	843	183	401	442	72	111	535	352	105	668	1429	1378	1331	930	1378	891
"KIAA0491"	6238	43611	2504	1548	1517	987	895	653	1374	705	449	857	4445	4039	3516	2703	4188	2571
"KIAA0494"	5777	43906	2337	1297	1362	975	758	539	1392	1329	466	1941	6133	7142	7173	6064	8159	5271
"KIAA0495"	6360	11338	255	0	167	88	0	0	216	99	277	54	254	217	231	234	283	199
"KIAA0513"	7375	66453	1957	151	1085	872	91	60	1704	400	2175	386	1371	1179	2039	1283	2087	1550
"KIAA0516"	1323	15947	1669	7375	931	738	4406	2969	437	1175	228	1369	24	45	105	133	86	52
"KIAA0517"	2659	20757	0	0	0	0	0	0	0	0	0	0	0	0	0	0	0	0
"KIAA0523"	5672	44056	0	0	0	0	0	0	32	21	0	0	0	0	0	0	0	0
"KIAA0524"	1932	33775	38	11	16	22	3	8	135	40	42	0	69	80	148	91	151	112
"KIAA0528"	4586	95928	1471	281	877	594	175	106	961	199	224	110	989	979	1288	876	1266	816
"KIAA0529"	1026	43182	5290	3483	3034	2256	1944	1539	2986	1903	885	2645	444	655	404	328	366	224
"KIAA0531"	4848	26826	0	0	0	0	0	0	28	0	0	0	0	0	0	0	0	0
"KIAA0534"	5254	647131	0	0	0	0	0	0	0	0	0	0	0	0	0	0	0	0
"KIAA0535"	4545	6049	428	268	265	163	101	167	149	40	0	36	6	5	18	10	3	0
"KIAA0538"	4294	14392	176	116	79	97	77	39	458	265	564	426	368	322	5121	2996	8499	4659
"KIAA0540"	2257	4520	711	299	413	298	158	141	317	170	234	114	841	889	1145	1025	1258	977
"KIAA0541"	3516	228782	7455	4428	4233	3222	2418	2010	4311	2707	1099	1697	705	660	986	846	841	561
"KIAA0542"	3817	122274	2673	1124	1603	1070	580	544	1181	419	1284	603	875	903	1524	966	2060	1080
"KIAA0544"	3771	66150	7500	5763	4129	3371	2989	2774	3225	4211	6435	10759	3714	3661	3825	3225	5808	3338
"KIAA0551"	1072	16197	0	121	0	0	71	50	10	388	0	150	10	25	30	26	33	7
"KIAA0556"	6650	230225	1029	585	516	513	311	274	1332	622	271	534	642	730	1003	850	1327	841
"KIAA0558"	2583	2982	0	0	0	0	0	0	30	19	0	0	0	0	3	0	9	0
"KIAA0562"	6480	45154	438	3	211	227	3	0	599	10	115	14	562	528	558	612	963	566
"KIAA0564"	7204	394261	4080	1703	2419	1661	944	759	3127	1296	644	1560	885	1019	967	895	1205	1047
"KIAA0565"	7157	92828	162	140	81	81	67	73	834	590	0	0	0	0	992	917	1426	658
"KIAA0569"	2963	8960	152975	214623	85043	67932	115800	98823	68614	74553	72505	141832	8859	25497	16283	13375	10107	7777
"KIAA0570"	2743	53558	4715	3508	2811	1904	1822	1686	2509	1758	1202	1920	800	1775	3900	2931	4846	2682
"KIAA0572"	2291	12028	609	278	380	229	144	134	441	387	277	494	1171	1888	1106	968	2024	1748
"KIAA0573"	5172	119867	6615	5844	3614	3001	3190	2654	3475	3568	1275	4326	1429	1869	1998	1760	1906	1540
"KIAA0576"	2614	11681	643	440	368	275	210	230	512	179	0	237	304	359	260	235	224	83
"KIAA0583"	5531	93444	8	0	8	0	0	0	270	82	0	0	4	3	12	3	22	3
"KIAA0586"	6050	121430	334	112	208	126	59	53	226	26	20	0	450	686	576	540	544	433
"KIAA0588"	4513	168947	91	0	55	36	0	0	124	55	0	0	8	10	38	0	24	22
"KIAA0591"	1585	63705	1319	6060	780	539	3464	2596	249	2850	69	5177	162	305	229	374	206	167
"KIAA0593"	1082	19586	1561	3259	865	696	1726	1533	767	1187	749	1905	319	574	469	643	447	294
"KIAA0594"	3358	8296	381	763	205	176	406	357	189	191	0	137	925	1303	599	652	633	453
"KIAA0595"	3863	11233	1120	1502	620	500	843	659	501	836	436	1517	1068	1948	1294	2638	1522	1679
"KIAA0596"	7020	53421	2154	1364	1173	981	729	635	1233	1997	652	2781	637	1081	892	980	1228	927
"KIAA0597"	5852	81665	4851	5164	2586	2265	2823	2341	2300	2791	1076	3836	1956	3011	3201	3068	3397	2046
"KIAA0600"	1777	3786	146	39	82	64	19	20	26	48	160	0	303	289	348	259	563	308
"KIAA0604"	2306	15430	6	3	2	4	2	1	75	3	0	0	1	3	0	0	0	0
"KIAA0609"	1451	256179	0	0	0	0	0	0	48	0	0	12	0	6	0	0	0	0
"KIAA0611"	5620	100730	3	0	0	3	0	0	32	0	0	0	0	3	3	0	3	3
"KIAA0612"	1584	5153	52	81	28	24	54	27	83	41	39	8	35	54	38	39	112	81
"KIAA0613"	1930	31385	0	0	0	0	0	0	236	129	0	0	0	0	0	0	0	0
"KIAA0614"	2407	25297	430	257	198	232	137	120	249	195	422	239	112	192	288	270	280	200
"KIAA0617"	1186	5483	310	405	159	151	230	175	176	64	182	232	412	321	360	316	377	286
"KIAA0622"	7946	311700	10020	3303	5769	4251	1766	1537	6301	2794	2145	3069	1490	850	1767	1519	1961	1388
"KIAA0627"	7324	222109	11030	8610	6255	4775	4538	4072	5829	4888	2087	6077	2832	3953	3167	2939	3567	2441
"KIAA0631"	2306	63712	10	0	9	1	0	0	144	59	0	0	1	0	0	0	0	0
"KIAA0638"	4691	50292	312	7202	207	105	3946	3256	412	5886	0	8308	36	1370	37	2246	65	617
"KIAA0639"	4432	31964	1306	230	795	511	180	50	1214	535	331	657	531	502	1119	1058	1271	953
"KIAA0641"	3033	5128	203	52	93	110	30	22	154	145	0	255	45	112	31	82	231	176
"KIAA0642"	7600	126160	8142	2567	4575	3567	1473	1094	4399	1296	2151	1613	2496	2453	2926	2103	2865	1717
"KIAA0645"	5101	152933	3796	1261	2231	1565	767	494	1680	675	958	1166	718	799	908	813	987	766
"KIAA0647"	1232	3873	478	35	249	229	35	0	38	23	53	0	31	31	81	49	101	23
"KIAA0649"	4936	9093	269	0	140	129	0	0	95	0	0	0	538	369	746	420	1134	511
"KIAA0650"	7200	104283	4123	1832	2206	1917	1030	802	2835	1058	704	952	1780	2070	1889	1649	2079	1331
"KIAA0651"	1838	4435	1090	1287	674	416	843	444	245	868	349	6150	1520	194	2431	375	2673	2844
"KIAA0652"	4784	57543	892	105	514	378	65	40	716	117	306	214	1781	1885	1946	1695	2483	1809
"KIAA0653"	3091	14112	4089	5192	2224	1865	2712	2480	1047	2692	1399	9630	3947	7765	3455	8481	2007	5618
"KIAA0654"	4522	31617	13	0	13	0	0	0	228	126	12	0	18	16	32	6	14	22
"KIAA0655"	879	14842	10	48	10	0	36	12	9	257	0	22	0	5	0	0	6	3
"KIAA0656"	895	91818	0	0	0	0	0	0	0	0	0	0	0	0	0	0	0	0
"KIAA0657"	2255	4349	0	0	0	0	0	0	79	63	0	0	0	0	0	0	2	0
"KIAA0664"	5250	22249	1228	749	655	573	381	368	609	519	586	671	1856	1616	2865	2629	3637	2421
"KIAA0666"	1689	14590	128	29	75	53	29	0	136	60	0	30	539	703	245	255	393	226
"KIAA0669"	4045	50827	6771	6660	3696	3075	3652	3008	2804	2989	1038	3493	876	1189	1118	1078	988	832
"KIAA0670"	3644	11052	1179	656	491	688	496	160	1265	570	509	271	2319	3743	3922	3471	5105	2872
"KIAA0672"	4310	202132	0	0	0	0	0	0	68	13	0	0	295	16	0	0	20	0
"KIAA0673"	3653	116519	190	14	118	72	8	6	750	111	33	50	79	82	163	168	169	117
"KIAA0674"	2173	42768	3096	302	1737	1359	214	88	1975	188	930	179	1174	890	2522	1660	2391	1520
"KIAA0676"	3201	4801	901	372	500	401	280	92	596	210	946	448	3223	645	3916	2977	5616	3625
"KIAA0677"	2991	55393	1637	141	905	732	74	67	1026	149	529	87	901	863	1560	782	1657	927
"KIAA0678"	1502	2116	243	49	97	146	37	12	158	25	13	27	233	208	325	219	265	100
"KIAA0679"	3485	15014	4314	2787	2646	1668	1516	1271	963	899	2959	1699	3607	3938	3681	2679	4383	2197
"KIAA0681"	1755	2315	2	0	2	0	0	0	25	7	0	0	15	2	10	11	18	3
"KIAA0684"	5426	148280	1798	589	1011	787	310	279	1309	368	436	630	1340	1467	1575	1425	1807	1113
"KIAA0686"	1450	264955	0	0	0	0	0	0	0	0	0	0	0	0	0	0	0	0
"KIAA0687"	523	49276	1427	3328	815	612	1919	1409	716	2717	309	1139	427	407	609	612	574	410
"KIAA0690"	3431	17037	10	7	6	4	2	5	229	59	0	0	344	318	383	384	516	371
"KIAA0691"	2878	12033	872	314	503	369	113	201	597	356	903	680	868	798	1182	970	1804	1031
"KIAA0693"	2519	37137	1949	186	1151	798	89	97	1101	609	1357	506	606	658	796	335	492	317
"KIAA0700"	2338	3193	184	63	98	86	37	26	147	70	224	68	365	322	572	536	918	580
"KIAA0705"	2358	515553	0	0	0	0	0	0	0	0	0	0	0	0	0	0	0	0
"KIAA0708"	2018	10791	179	13	102	77	13	0	261	92	22	38	150	127	397	381	415	414
"KIAA0709"	3206	12133	2051	1048	1066	985	540	508	747	768	1412	739	2086	2104	2811	2749	4858	3026
"KIAA0713"	1226	72228	6930	1969	3898	3032	1157	812	3222	994	1467	1205	239	405	320	316	303	237
"KIAA0715"	2443	52007	0	0	0	0	0	0	0	0	0	0	0	0	0	0	0	0
"KIAA0716"	3246	343525	57437	198887	31974	25463	107022	91865	14752	86214	13771	162645	394	606	518	577	479	298
"KIAA0720"	1550	2004	277	151	8	269	76	75	244	52	450	123	462	21	775	0	34	0
"KIAA0725"	1240	16818	76	16	36	40	0	16	72	4	0	25	146	146	214	192	190	135
"KIAA0728"	2417	8879	120	0	56	64	0	0	33	8	0	28	76	117	104	83	157	101
"KIAA0734"	1262	7761	2	0	1	1	0	0	85	17	0	0	0	1	0	0	0	0
"KIAA0736"	2359	3649	0	0	0	0	0	0	0	23	0	0	0	0	0	0	0	0
"KIAA0737"	4509	21984	769	441	442	327	319	122	383	298	12	433	1850	2646	1548	1595	2213	1519
"KIAA0739"	3390	71158	726	58	413	313	30	28	356	18	295	0	28	30	31	15	23	23
"KIAA0740"	2453	8618	0	0	0	0	0	0	0	0	0	0	62	53	223	185	109	54
"KIAA0741"	1645	6005	327	59	200	127	59	0	99	118	0	0	1052	1223	1103	877	1124	790
"KIAA0743"	7002	1691895	0	0	0	0	0	0	42	9	0	0	0	0	0	0	0	0
"KIAA0744"	805	52741	2227	2432	1345	882	1353	1079	1168	928	218	1222	3	0	22	14	17	8
"KIAA0745"	965	55109	2595	142	1360	1235	92	50	1735	168	153	236	394	453	479	358	563	298
"KIAA0746"	1864	20733	9	0	6	3	0	0	13	0	0	0	173	142	608	670	415	423
"KIAA0748"	2021	34593	0	0	0	0	0	0	20	18	0	0	55	63	58	43	56	29
"KIAA0750"	5339	41167	6417	1509	3497	2920	857	652	3823	996	2254	1865	2284	2693	2025	1749	2836	1942
"KIAA0751"	612	6515	0	0	0	0	0	0	0	0	0	0	0	0	0	0	0	0
"KIAA0752"	1323	60926	0	0	0	0	0	0	0	0	0	0	0	0	0	0	0	0
"KIAA0753"	4703	62603	813	21	448	365	11	10	696	31	310	30	262	231	288	274	401	277
"KIAA0754"	6980	6980	698	591	411	287	372	219	391	308	169	390	155	205	89	65	236	61
"KIAA0755"	4199	44001	3480	991	1958	1522	525	466	1848	679	349	474	3058	3071	3317	2410	2950	2141
"KIAA0756"	7915	36148	0	0	0	0	0	0	229	77	0	0	0	0	0	0	0	0
"KIAA0759"	1183	24298	742	48	377	365	31	17	365	78	284	129	1209	968	790	578	909	471
"KIAA0765"	1857	38882	6189	3627	3461	2728	1954	1673	2293	1611	2946	3084	4180	4757	4840	4665	5064	3727
"KIAA0769"	4436	305354	25097	31386	14258	10839	16854	14532	9496	16334	7396	29106	1918	1304	1903	1524	2469	1371
"KIAA0770"	4195	7532	594	273	325	269	161	112	348	161	186	167	1541	1559	2239	1696	2813	1667
"KIAA0771"	3548	12804	416	85	224	192	40	45	184	84	45	112	357	202	203	113	369	207
"KIAA0772"	3805	57691	1358	376	760	598	197	179	1407	386	824	716	940	862	1127	923	1308	919
"KIAA0774"	6952	481337	0	398	0	0	216	182	182	211	0	95	0	0	0	0	0	0
"KIAA0776"	4235	33449	267	18	158	109	18	0	222	29	22	0	1199	1183	1339	847	1433	886
"KIAA0778"	1071	2203	0	0	0	0	0	0	0	10	0	0	0	0	0	0	0	0
"KIAA0780"	3275	407718	20088	18241	11198	8890	10198	8043	10505	9384	2956	11522	759	923	655	765	949	459
"KIAA0782"	800	5465	2826	733	2374	452	418	315	756	181	812	71	778	560	1753	1625	1756	1406
"KIAA0783"	3487	129768	2057	1128	1128	929	581	547	1301	508	116	321	382	502	447	360	541	389
"KIAA0786"	3185	686263	0	0	0	0	0	0	0	0	0	0	0	0	0	0	0	0
"KIAA0788"	3412	3691	8708	2033	4131	4577	1141	892	6001	733	6360	893	6746	4458	6154	3480	12151	4062
"KIAA0792"	705	11031	240	251	144	96	157	94	238	40	236	108	142	177	180	311	199	319
"KIAA0794"	971	32346	218	83	109	109	32	51	136	9	8	75	45	96	60	65	53	41
"KIAA0795"	4603	63977	2125	217	1220	905	70	147	1203	218	270	314	1141	849	1124	676	1564	876
"KIAA0796"	3956	67721	220	295	128	92	145	150	227	133	17	106	491	526	760	772	776	666
"KIAA0797"	4614	51567	2517	1235	1349	1168	777	458	1530	688	1145	861	2313	2306	1950	1464	2398	1700
"KIAA0800"	1328	58602	350	235	170	180	130	105	357	150	85	772	277	328	279	228	311	175
"KIAA0802"	6109	115408	5720	1077	3147	2573	578	499	2851	725	1180	847	649	764	1026	853	1190	828
"KIAA0803"	3999	18685	837	404	492	345	234	170	465	273	98	314	965	1084	1015	977	1457	1029
"KIAA0807"	4163	29882	1010	333	537	473	203	130	1080	272	82	253	916	870	980	1026	1317	1003
"KIAA0809"	4798	122016	2117	461	1237	880	252	209	1206	299	759	569	485	505	604	600	716	500
"KIAA0811"	4848	27879	129	0	84	45	0	0	197	0	0	0	0	2	1	0	5	0
"KIAA0819"	6806	28012	59	24	37	22	24	0	251	224	0	0	169	202	158	161	137	85
"KIAA0820"	780	39411	23	0	13	10	0	0	158	0	0	0	93	86	35	14	37	4
"KIAA0823"	1335	24884	329	116	149	180	48	68	255	102	65	717	4	1	6	3	0	0
"KIAA0826"	3690	9251	451	201	286	165	110	91	430	251	33	69	1121	1422	1473	1370	1720	1133
"KIAA0827"	9568	11783	14462	54760	8075	6387	29437	25323	4382	16884	5092	41901	2449	5541	2601	3362	2751	1645
"KIAA0831"	4752	45468	1404	1029	832	572	532	497	744	352	159	609	1225	376	1193	686	1287	654
"KIAA0833"	3985	24870	6413	5344	3536	2877	2869	2475	2606	2629	1015	5024	212	393	435	498	514	412
"KIAA0834"	244	226920	0	12	0	0	0	12	10	74	0	383	7	1	24	23	34	16
"KIAA0835"	2088	2503	0	0	0	0	0	0	0	0	0	0	0	0	0	0	0	0
"KIAA0837"	597	22772	0	0	0	0	0	0	42	11	0	0	0	0	0	0	0	0
"KIAA0838"	2962	37782	9336	6993	4964	4372	3845	3148	4332	1653	3180	2893	5227	6516	5531	4417	6262	3947
"KIAA0839"	7360	124235	3410	1453	1889	1521	818	635	1724	1182	367	1268	4348	4886	3989	3378	5077	3543
"KIAA0844"	3455	28302	0	0	0	0	0	0	0	0	0	0	0	0	0	0	0	0
"KIAA0845"	1724	2012	0	0	0	0	0	0	15	0	0	0	337	323	241	231	237	166
"KIAA0850"	4348	20939	9519	20241	5243	4276	10954	9287	2979	5294	2764	8213	6967	10757	7354	11329	8637	7267
"KIAA0851"	3598	56148	3653	381	2048	1605	206	175	1725	104	524	85	2201	1937	1878	1339	2378	1284
"KIAA0853"	2676	12360	202	112	88	114	68	44	85	30	0	52	1286	1354	1140	783	1278	850
"KIAA0856"	1717	2651	231	229	108	123	133	96	112	179	0	0	592	776	817	1150	957	742
"KIAA0857"	2904	6638	0	0	0	0	0	0	28	0	0	0	0	2	0	0	0	0
"KIAA0858"	932	44099	0	0	0	0	0	0	0	0	0	0	9	9	5	4	0	3
"KIAA0860"	2292	50286	1038	310	567	471	208	102	709	578	458	744	1351	1166	1025	1054	1388	967
"KIAA0861"	2827	101793	4874	3937	2707	2167	2105	1832	1492	1013	739	1508	4457	4673	2688	2239	3304	2320
"KIAA0864"	4948	20901	1105	545	609	496	318	227	656	330	386	535	1617	1855	1406	1281	1615	1221
"KIAA0866"	3461	34366	0	0	0	0	0	0	46	13	0	0	0	0	0	0	0	0
"KIAA0877"	546	16652	13	0	0	13	0	0	79	0	0	0	917	1041	1082	1007	1154	808
"KIAA0878"	1430	1603	0	0	0	0	0	0	0	0	1	0	0	4	23	18	7	9
"KIAA0880"	633	63607	2077	269	747	1330	151	118	1813	136	1983	37	385	338	657	644	762	387
"KIAA0885"	3961	33292	4660	6141	2787	1873	3294	2847	2177	1183	1199	3629	9562	18049	16349	15640	18192	15213
"KIAA0890"	2195	39772	852	303	478	374	161	142	534	369	538	426	379	451	575	512	599	413
"KIAA0892"	4871	37934	3665	782	2011	1654	403	379	1863	967	3139	1760	1788	1549	2186	1287	2758	1561
"KIAA0895"	4472	43093	0	0	0	0	0	0	0	0	0	0	0	0	0	1	0	0
"KIAA0895L"	3597	8439	414	146	212	202	80	66	184	138	119	43	443	421	674	558	823	490
"KIAA0896"	2500	14160	756	450	330	426	262	188	344	327	361	302	529	557	664	453	692	422
"KIAA0897"	4552	15778	0	0	0	0	0	0	97	49	0	0	0	0	0	0	0	0
"KIAA0899"	2329	80778	16444	4269	9055	7389	2412	1857	8173	1423	11376	1941	4237	3602	5912	3610	7252	3356
"KIAA0901"	4729	11622	475	152	255	220	77	75	171	179	162	142	731	670	1138	943	1406	909
"KIAA0905"	1832	7010	435	555	249	186	294	261	255	259	141	244	686	806	290	129	314	116
"KIAA0907"	4510	21354	1401	1444	838	563	683	761	495	769	258	1642	391	1113	1214	1296	1300	1027
"KIAA0909"	1726	7954	824	359	430	394	188	171	355	243	789	417	734	855	492	785	625	467
"KIAA0910"	3527	13393	967	434	508	459	216	218	485	250	198	194	1146	1209	1383	955	1545	929
"KIAA0911"	2239	4526	1620	271	902	718	138	133	460	444	682	509	2055	4347	654	3190	3020	3610
"KIAA0913"	5860	15947	2135	1085	1194	941	620	465	832	645	1228	1369	1683	1776	2242	2544	3188	1949
"KIAA0914"	3106	11616	4297	1050	2468	1829	609	441	1962	374	391	384	57	277	493	252	455	294
"KIAA0916"	4574	48676	637	424	320	317	218	206	404	245	35	268	840	1283	1348	1248	1441	1028
"KIAA0917"	2092	113499	5018	1716	2874	2144	949	767	3051	1171	674	821	1358	1372	1415	1106	1631	1141
"KIAA0922"	5052	170364	3310	1257	1917	1393	688	569	1722	1885	250	1914	676	738	664	557	846	554
"KIAA0923"	5878	46376	12	0	0	12	0	0	22	0	0	0	211	180	153	67	136	100
"KIAA0927"	893	32751	0	0	0	0	0	0	9	0	0	0	0	0	0	11	0	11
"KIAA0928"	7168	19997	3270	1443	1880	1390	796	647	1911	802	653	739	3278	3085	5291	4073	4254	2530
"KIAA0934"	2066	17652	54	0	24	30	0	0	356	216	4	25	194	194	231	262	195	110
"KIAA0939"	6106	79524	2948	5266	1611	1337	2858	2408	1596	2147	762	4820	753	1441	1014	1311	1282	1056
"KIAA0943"	2975	36239	4002	1377	2161	1841	698	679	1756	705	2958	1342	1531	1506	2840	1965	3203	1685
"KIAA0946"	1218	62978	2255	326	1284	971	173	153	1351	164	467	234	180	150	221	154	217	135
"KIAA0947"	7936	67532	1590	724	898	692	416	308	1169	535	185	324	1660	1675	1909	1295	2194	1105
"KIAA0948"	3418	7365	1088	1318	554	534	702	616	521	752	984	1304	1098	1336	1327	1262	1825	1330
"KIAA0950"	4689	37087	526	0	259	267	0	0	889	209	789	42	2276	2089	1131	1028	3179	2157
"KIAA0952"	4475	8707	343	43	179	164	21	22	174	19	0	34	1075	1077	1010	633	1027	643
"KIAA0955"	5350	41762	5109	1145	2735	2374	647	498	2290	418	2434	392	2684	2650	2355	1598	2554	1126
"KIAA0956"	4152	24330	2384	865	1250	1134	476	389	1408	575	254	377	2448	2996	2503	2211	2699	1734
"KIAA0957"	4827	66851	24	0	24	0	0	0	47	26	0	0	1010	79	183	91	137	136
"KIAA0958"	2528	13483	286	95	152	134	54	41	143	181	50	179	209	214	308	298	415	267
"KIAA0959"	1744	276196	16371	11583	9355	7016	6339	5244	7482	6313	1860	7987	2407	4267	2388	2998	2168	1494
"KIAA0960"	1762	5211	0	0	0	0	0	0	0	0	0	0	0	0	0	0	0	0
"KIAA0962"	2941	32853	53	0	31	22	0	0	136	33	0	0	623	571	629	403	691	406
"KIAA0963"	2018	24601	3657	1534	1969	1688	857	677	1308	1243	3481	2899	3746	3465	3807	2804	5968	3498
"KIAA0964"	3807	36254	906	327	495	411	178	149	708	399	1083	576	1090	914	1451	1056	1830	1241
"KIAA0965"	5112	81812	7910	15123	4407	3503	8168	6955	3205	3261	1534	5326	2724	3922	1476	1172	3082	1576
"KIAA0968"	379	5959	0	0	0	0	0	0	33	21	0	0	0	0	0	0	0	0
"KIAA0969"	752	8687	12	0	12	0	0	0	114	53	0	0	5	13	16	4	41	43
"KIAA0970"	6149	232977	4192	2439	2441	1751	1300	1139	4043	2492	619	1564	1935	2420	3163	3068	2512	1868
"KIAA0973"	1749	10534	0	0	0	0	0	0	39	25	0	0	0	1	0	0	0	0
"KIAA0974"	3143	74063	215	20	98	117	0	20	309	103	0	13	400	402	549	382	649	372
"KIAA0975"	2576	5633	1774	686	952	822	339	347	617	308	1511	356	3785	2971	3519	2068	5097	2454
"KIAA0976"	1875	86697	0	0	0	0	0	0	0	0	0	0	0	0	0	0	0	0
"KIAA0977"	2154	141620	0	0	0	0	0	0	0	10	0	3	2	0	3	4	0	4
"KIAA0979"	7482	191565	4412	1049	2545	1867	701	348	2745	753	1336	693	1520	1523	1401	983	1601	905
"KIAA0980"	1652	6276	0	0	0	0	0	0	13	0	0	0	27	18	25	32	50	33
"KIAA0982"	7404	58395	11829	4301	6609	5220	2343	1958	5128	1600	6795	3645	2979	2234	2867	1554	3357	1882
"KIAA0983"	469	6920	24	5	19	5	5	0	15	0	28	4	82	100	121	105	175	102
"KIAA0984"	2303	54003	0	0	0	0	0	0	19	0	0	0	33	37	12	28	37	33
"KIAA0986"	2169	26334	75	67	29	46	34	33	85	49	79	31	69	167	136	119	125	47
"KIAA0987"	1076	196742	2742	5092	1494	1248	2750	2342	790	3369	15	5425	534	471	522	430	407	209
"KIAA0993"	2176	41980	970	1038	547	423	537	501	673	508	200	367	289	318	551	534	595	374
"KIAA0994"	4027	52693	0	0	0	0	0	0	122	82	0	0	27	27	7	3	0	0
"KIAA0996"	4742	9658	0	0	0	0	0	0	0	0	0	0	0	0	0	0	0	0
"KIAA0998"	2378	84344	909	576	611	298	293	283	712	448	70	418	226	202	212	214	200	141
"KIAA0999"	6036	254875	13408	22051	7733	5675	11760	10291	6557	13381	3822	19617	893	914	1178	974	1524	847
"KIAA1001"	1176	20705	847	522	513	334	238	284	463	310	244	518	520	564	121	107	140	124
"KIAA1002"	2227	46982	11266	6276	6553	4713	3527	2749	4602	2857	6595	7303	1219	1359	1285	979	1292	920
"KIAA1003"	1837	2392	202	188	103	99	100	88	92	198	41	88	358	298	438	306	642	370
"KIAA1004"	6938	138804	13753	5164	7751	6002	2997	2167	5646	2695	7388	6355	4455	4204	4520	3576	6302	3455
"KIAA1005"	1172	32351	0	0	0	0	0	0	0	0	0	0	2	0	0	0	0	0
"KIAA1007"	3023	13215	5682	7110	3257	2425	3827	3283	2184	3664	2190	7567	4148	4229	5435	4784	6403	3993
"KIAA1008"	3784	23164	554	281	327	227	162	119	290	257	122	372	1296	1590	1177	725	1129	747
"KIAA1009"	5164	103376	59	7	50	9	0	7	121	0	4	0	111	175	167	130	208	112
"KIAA1010"	3567	22710	7	0	3	4	0	0	6	0	0	15	114	193	308	181	267	185
"KIAA1011"	6916	85108	52	41	9	43	25	16	28	8	49	35	76	185	67	78	204	84
"KIAA1012"	6282	113956	5238	675	2976	2262	371	304	2511	379	1099	415	1711	1963	2314	1687	2577	1547
"KIAA1013"	2940	372589	25579	16918	14105	11474	9329	7589	11723	8932	7562	13112	1449	1107	1357	1204	1704	1144
"KIAA1014"	2591	43415	2889	4512	1603	1286	2460	2052	1148	1689	1441	2641	316	674	1384	1578	1597	865
"KIAA1019"	2507	34464	11754	12061	6481	5273	6443	5618	5189	5241	5373	7855	13419	17351	17903	16230	19106	10865
"KIAA1021"	6885	44892	3103	2150	1709	1394	1186	964	2428	1747	1826	2225	2779	3555	4435	4296	4700	3364
"KIAA1022"	5827	32738	0	0	0	0	0	0	86	16	0	0	0	0	0	0	0	0
"KIAA1023"	2406	48559	534	41	309	225	33	8	752	118	134	0	297	197	305	277	487	287
"KIAA1024"	6787	16204	0	0	0	0	0	0	24	0	0	0	9	12	0	0	0	0
"KIAA1026"	6036	519332	0	0	0	0	0	0	840	272	0	0	0	0	5	0	0	0
"KIAA1028"	1169	2052	174	182	97	77	105	77	70	39	0	443	17	21	11	4	15	22
"KIAA1031"	5421	35282	430	287	214	216	157	130	517	410	60	563	66	146	185	203	223	56
"KIAA1033"	5840	61414	8064	7167	4658	3406	3925	3242	5329	3243	1730	2820	4974	6095	5832	4848	5308	3293
"KIAA1035"	2807	134797	8214	5808	4589	3625	3224	2584	4609	3444	1735	4303	2034	2544	1937	1756	1767	1356
"KIAA1037"	3223	47287	481	181	283	198	77	104	428	212	252	212	1390	1510	1486	1377	2089	1499
"KIAA1038"	6388	90270	726	491	397	329	303	188	408	436	86	494	666	818	753	733	762	811
"KIAA1045"	5856	24352	0	0	0	0	0	0	53	11	0	0	0	0	0	0	0	0
"KIAA1047"	1940	26392	2770	1013	1531	1239	590	423	1873	697	715	875	1300	1433	1493	1274	1708	1189
"KIAA1048"	1097	99608	9414	1371	5337	4077	724	647	4328	602	4804	287	86	117	144	73	85	69
"KIAA1049"	1958	26804	4862	4662	2601	2261	2491	2171	1856	2636	5197	6167	2770	3335	3893	3959	5442	3863
"KIAA1052"	3866	47964	2114	619	1218	896	279	340	1823	716	737	641	958	878	1487	1134	2398	1290
"KIAA1053"	3667	47142	18	10	16	2	10	0	41	0	0	20	2	14	36	51	23	28
"KIAA1059"	1661	75141	0	0	0	0	0	0	0	0	0	0	0	0	0	0	0	0
"KIAA1060"	4205	47910	0	2	0	0	0	2	0	0	0	0	0	0	0	0	0	0
"KIAA1061"	4390	29467	0	0	0	0	0	0	0	0	0	0	0	0	0	0	0	0
"KIAA1062"	3547	6088	468	338	224	244	171	167	289	192	780	290	567	827	933	851	1172	865
"KIAA1064"	3266	47372	2690	2248	1443	1247	1259	989	1204	1492	660	2762	1158	395	416	373	1751	401
"KIAA1066"	2747	41057	4448	1327	2413	2035	675	652	2282	849	6247	1888	527	574	1198	975	1476	813
"KIAA1067"	4840	22567	1628	981	940	688	476	505	891	444	1789	1321	2691	2804	1681	3247	4824	1393
"KIAA1068"	4871	99096	3192	641	1825	1367	308	333	2254	557	1244	800	2842	2931	1194	968	1673	1058
"KIAA1075"	3558	5884	20	2	0	20	0	2	174	160	0	11	677	557	7	36	0	4
"KIAA1077"	4525	68004	38	0	3	35	0	0	0	0	0	7	0	0	0	0	0	0
"KIAA1080"	1681	35585	1768	324	991	777	166	158	1307	178	1132	245	772	846	1946	1550	1694	1011
"KIAA1086"	1474	47691	0	0	0	0	0	0	217	122	0	0	0	0	0	0	0	0
"KIAA1088"	3714	36682	5407	2105	2850	2557	1044	1061	2087	1939	5365	4048	889	1078	1452	1574	2160	1155
"KIAA1091"	3116	119656	10526	101536	5767	4759	54455	47081	1621	40755	1008	78685	992	2897	2010	4306	2127	1738
"KIAA1096"	2873	13684	1339	1364	734	605	769	595	606	663	540	622	2553	3749	3081	2646	3586	2470
"KIAA1098"	4112	26432	461	0	265	196	0	0	226	8	96	0	605	304	561	163	713	317
"KIAA1100"	3917	11328	1290	495	627	663	291	204	814	246	1624	647	2414	2111	3041	1770	4040	592
"KIAA1102"	3278	7089	0	0	0	0	0	0	0	0	0	0	19	25	40	3	6	0
"KIAA1103"	7091	33507	7873	4895	4290	3583	2698	2197	3533	4610	3368	5921	6915	8055	8067	6347	7769	4484
"KIAA1104"	3179	35085	2641	1176	1522	1119	700	476	820	868	480	645	2734	3120	3610	3147	3433	2185
"KIAA1106"	2390	39387	0	0	0	0	0	0	55	7	0	0	0	0	0	0	0	0
"KIAA1107"	4564	17672	0	0	0	0	0	0	4	0	0	0	10	20	9	0	23	9
"KIAA1109"	15650	192149	2565	1113	1378	1187	623	490	2511	1062	483	580	1733	2515	2909	2779	3173	1817
"KIAA1112"	3949	132052	1	0	0	1	0	0	71	36	0	0	0	0	0	0	0	0
"KIAA1113"	1596	2776	218	66	111	107	35	31	96	48	0	64	128	232	248	187	237	135
"KIAA1114"	1417	10615	0	0	0	0	0	0	14	0	0	0	0	0	0	0	0	0
"KIAA1118"	1265	4531	13	0	7	6	0	0	101	33	0	0	88	89	131	135	256	159
"KIAA1121"	2121	83525	0	0	0	0	0	0	0	0	0	0	0	0	0	0	0	0
"KIAA1123"	1766	8067	1	0	1	0	0	0	111	26	0	7	2	0	5	6	5	22
"KIAA1125"	4885	147095	7630	1401	4253	3377	746	655	4205	1364	3105	2509	738	883	1070	852	1066	511
"KIAA1127"	1715	363495	0	0	0	0	0	0	0	0	0	0	0	0	0	0	0	0
"KIAA1128"	7601	189868	9046	22307	5036	4010	11866	10441	3197	9394	575	13202	2126	2694	1620	1441	1920	1233
"KIAA1129"	6022	88937	598	661	341	257	354	307	607	668	269	819	564	740	401	369	781	395
"KIAA1131"	4597	29191	1624	701	991	633	383	318	895	251	254	284	1907	2019	2508	1831	1729	2104
"KIAA1132"	1698	299152	53	913	28	25	531	382	532	321	0	0	0	0	0	0	0	0
"KIAA1138"	2163	6141	234	170	112	122	73	97	149	122	41	121	174	282	349	302	461	334
"KIAA1139"	1727	10228	7	0	2	5	0	0	40	70	1	0	5	3	0	0	0	0
"KIAA1140"	3908	81906	22388	4635	12303	10085	2512	2123	8068	1716	15638	2343	4182	4339	4498	3713	7303	4349
"KIAA1143"	5141	12936	42	0	31	11	0	0	43	44	0	21	768	761	275	211	355	167
"KIAA1147"	7303	45425	1129	424	577	552	190	234	702	323	359	327	131	112	210	1654	213	221
"KIAA1149"	276	1327	38	4	17	21	0	4	34	22	0	0	228	1090	547	270	3404	210
"KIAA1152"	2508	48438	7255	10162	3955	3300	5448	4714	3370	5211	2447	10454	2949	4178	1778	2598	1628	1243
"KIAA1153"	2211	12689	322	91	179	143	38	53	177	93	9	147	574	762	475	523	592	601
"KIAA1160"	1230	27530	201	16	109	92	11	5	127	27	16	25	406	465	584	455	737	497
"KIAA1161"	4201	7988	197	0	105	92	0	0	142	40	0	0	7	0	243	45	1103	374
"KIAA1164"	4902	86341	241	21	107	134	0	21	238	0	0	0	518	395	313	215	261	101
"KIAA1165"	4216	50698	0	0	0	0	0	0	0	0	0	13	194	302	233	220	241	144
"KIAA1166"	1996	60076	0	0	0	0	0	0	0	0	0	0	0	9	3	5	0	0
"KIAA1168"	3259	12342	165	67	102	63	29	38	156	67	20	83	646	716	424	379	558	369
"KIAA1169"	2737	4467	4667	1453	2545	2122	738	715	3653	1170	6815	1525	3138	2993	6795	5753	5257	4331
"KIAA1170"	4161	30183	0	0	0	0	0	0	13	0	0	0	10	18	31	18	28	21
"KIAA1171"	3164	5249	261	0	125	136	0	0	183	13	0	0	410	329	376	270	467	272
"KIAA1172"	3085	17925	3202	1927	1812	1390	1064	863	1943	1320	473	1914	649	475	795	759	803	567
"KIAA1174"	1197	8606	747	22	425	322	20	2	389	81	894	144	476	359	1222	589	1057	578
"KIAA1176"	1295	20610	0	34	0	0	13	21	115	42	0	0	0	0	0	0	0	0
"KIAA1179"	1817	9790	11	0	11	0	0	0	18	8	0	0	74	92	92	88	99	72
"KIAA1181"	3623	19020	628	206	342	286	135	71	771	311	158	134	2365	2631	3028	2811	3534	2560
"KIAA1186"	4201	28346	609	60	391	218	32	28	593	148	213	129	418	529	495	575	710	483
"KIAA1191"	2834	15743	518	143	297	221	80	63	308	256	166	169	1230	1390	1048	967	1241	864
"KIAA1199"	7209	172289	509	48	296	213	35	13	857	94	42	55	38	0	51	22	40	0
"KIAA1200"	4626	8002	14	0	0	14	0	0	0	0	0	0	225	284	0	0	0	0
"KIAA1201"	2364	2364	0	0	0	0	0	0	0	0	0	0	0	0	0	0	0	0
"KIAA1203"	9032	24256	605	60	345	260	24	36	285	26	76	52	475	519	417	319	588	406
"KIAA1206"	2352	8746	0	0	0	0	0	0	161	53	0	0	1	0	0	0	0	0
"KIAA1207"	5024	74968	3975	2927	2258	1717	1601	1326	1744	1712	1359	2129	4619	5161	5344	4851	7557	6175
"KIAA1210"	7837	71945	0	0	0	0	0	0	0	0	0	0	0	0	0	0	0	0
"KIAA1211"	7024	160531	0	0	0	0	0	0	28	0	0	0	4	30	3	0	0	5
"KIAA1212"	4543	9073	6427	5714	3517	2910	3738	1976	2553	1918	2177	4653	6344	3746	3514	3771	3703	5287
"KIAA1216"	2371	6440	870	24	435	435	24	0	465	42	16	32	926	659	1112	680	887	630
"KIAA1217"	7774	339053	0	0	0	0	0	0	45	0	0	0	0	0	0	0	0	0
"KIAA1218"	2744	64549	1059	1404	612	447	831	573	900	1704	142	1083	226	232	226	208	277	121
"KIAA1219"	8095	85931	4339	2315	2432	1907	1330	985	2517	1684	1429	2243	2355	2642	2799	1915	3158	1734
"KIAA1220"	5697	766940	0	0	0	0	0	0	587	206	0	0	0	0	0	0	0	0
"KIAA1224"	4302	10430	2283	1434	1236	1047	786	648	764	680	1138	1237	5350	4826	5358	3797	6466	3722
"KIAA1228"	4384	12067	691	1759	440	251	961	798	268	1274	107	348	1699	1915	1524	1721	1744	1244
"KIAA1231"	890	1530	22	22	22	0	12	10	0	4	0	0	33	47	57	41	58	26
"KIAA1234"	5361	6265	5820	3283	3127	2693	1704	1579	1792	1903	2108	1896	4995	5765	3619	2728	5635	2945
"KIAA1237"	5746	36311	52	0	22	30	0	0	119	29	23	0	124	1020	477	418	966	609
"KIAA1239"	7483	204398	0	0	0	0	0	0	8	0	0	0	0	0	0	0	0	0
"KIAA1240"	6916	83933	12132	11191	6764	5368	5995	5196	5540	5812	3557	8397	1725	2224	851	862	1742	529
"KIAA1244"	8881	176714	0	0	0	0	0	0	0	0	0	0	0	0	4	0	0	0
"KIAA1245"	6950	126242	575	112	327	248	64	48	521	99	206	305	27	15	1486	3108	1992	1604
"KIAA1248"	1987	8343	2533	376	1421	1112	187	189	550	129	2216	410	5867	3128	3302	2435	8595	4464
"KIAA1250"	2130	24341	1864	642	1032	832	366	276	1042	381	288	483	335	448	561	456	562	280
"KIAA1252"	5024	11989	4569	6182	2609	1960	3492	2690	1680	2181	2033	6024	8843	12086	7983	7352	8440	6271
"KIAA1253"	2075	3668	393	283	181	212	178	105	166	108	120	131	6292	8841	4835	4442	3960	4190
"KIAA1255"	7862	100609	4007	1015	2254	1753	584	431	2454	843	1781	656	3058	3064	4505	3038	4973	2926
"KIAA1256"	4177	19162	1981	1103	1110	871	694	409	809	1048	292	570	1676	2505	1812	1833	2358	1557
"KIAA1257"	2416	84212	365	41	239	126	23	18	308	82	43	24	259	186	311	258	312	267
"KIAA1258"	5485	102848	0	0	0	0	0	0	0	0	0	0	0	0	0	4	0	5
"KIAA1259"	6131	137261	2516	2447	1455	1061	1368	1079	1292	1468	309	2659	1118	801	1475	1237	1810	1228
"KIAA1261"	4902	154781	11216	12123	6167	5049	6571	5552	6110	6281	1944	7494	1286	1499	1697	1516	1953	1251
"KIAA1267"	5363	162885	23286	7683	13153	10133	4212	3471	10174	3656	8700	5636	1800	1224	1376	834	1808	972
"KIAA1268"	8328	35415	8688	35233	4862	3826	18912	16321	3688	16132	3567	10148	4963	11367	7766	6123	7401	4774
"KIAA1271"	11489	21558	3847	1419	2131	1716	793	626	1477	593	2994	1259	4341	4344	2734	2074	3674	1767
"KIAA1272"	5211	56823	169	47	107	62	28	19	89	137	0	66	156	192	160	166	212	90
"KIAA1274"	4588	89643	12401	2144	6788	5613	1219	925	3752	1167	6527	2297	2086	1782	1265	812	2832	1397
"KIAA1277"	3415	84117	0	0	0	0	0	0	30	0	0	0	0	0	0	0	0	0
"KIAA1278"	2101	6191	0	0	0	0	0	0	0	0	0	0	22	44	47	28	129	52
"KIAA1279"	2531	28243	148	28	63	85	13	15	128	21	2	0	666	641	686	537	840	481
"KIAA1280"	5989	64754	626	245	393	233	131	114	520	303	196	200	969	1336	860	884	1097	739
"KIAA1281"	3146	108257	0	0	0	0	0	0	0	0	0	0	0	0	0	6	0	0
"KIAA1283"	2508	10666	0	0	0	0	0	0	62	2	0	0	10	1	0	12	4	0
"KIAA1284"	3320	83812	0	0	0	0	0	0	0	0	0	0	9	3	15	3	4	0
"KIAA1286"	5020	32494	112	179	45	67	140	39	213	169	0	170	381	528	653	1042	713	531
"KIAA1288"	6174	112168	49	0	27	22	0	0	40	11	0	0	315	196	601	540	203	338
"KIAA1294"	1239	135971	0	0	0	0	0	0	10	0	0	0	0	0	0	0	0	0
"KIAA1296"	6292	170899	0	0	0	0	0	0	30	0	0	0	0	15	4	0	19	0
"KIAA1300"	7382	31265	403	109	186	217	41	68	253	183	74	41	285	489	358	350	682	352
"KIAA1303"	2467	313301	3168	993	1777	1391	526	467	3830	1867	1234	1700	291	327	384	434	504	270
"KIAA1305"	7865	20503	1	1	1	0	1	0	84	60	0	1	4	2	0	0	0	0
"KIAA1307"	2180	6003	937	1013	449	488	473	540	452	0	172	810	375	335	599	531	716	297
"KIAA1308"	4637	23455	2662	2357	1187	1475	1224	1133	1388	2684	3045	7105	2212	4188	4947	11784	5256	7668
"KIAA1309"	3036	75078	0	0	0	0	0	0	0	0	0	0	0	0	0	0	0	0
"KIAA1310"	5297	45201	2504	1837	1380	1124	1013	824	1368	952	1418	2018	496	1224	1877	1752	1845	498
"KIAA1319"	2959	4551	0	47	0	0	20	27	0	45	0	0	0	89	0	145	0	20
"KIAA1320"	4801	131828	10	9	10	0	6	3	53	0	0	0	193	238	150	115	153	62
"KIAA1324"	6827	92684	1	0	0	1	0	0	0	0	0	0	0	0	3	0	0	0
"KIAA1324L"	3846	179778	0	137	0	0	66	71	0	125	0	48	5	4	0	0	9	9
"KIAA1328"	4863	396209	40	32	20	20	23	9	121	40	0	0	33	35	14	13	31	7
"KIAA1330"	5734	9128	0	0	0	0	0	0	0	19	0	0	0	0	0	0	0	0
"KIAA1331"	3141	44854	209	394	141	68	202	192	218	95	0	250	402	630	515	575	647	515
"KIAA1332"	2966	23098	895	1936	483	412	1134	802	407	1218	239	3774	87	81	119	119	132	158
"KIAA1333"	1197	48948	925	216	478	447	119	97	710	285	54	318	60	175	251	183	269	147
"KIAA1334"	1419	137345	0	0	0	0	0	0	0	0	0	0	0	0	0	0	3	0
"KIAA1335"	4825	12537	411	424	255	156	220	204	256	189	105	84	626	128	144	112	165	489
"KIAA1336"	6840	79855	4	0	3	1	0	0	8	0	0	0	27	21	20	13	34	18
"KIAA1337"	761	2645	0	0	0	0	0	0	0	10	0	0	0	0	0	0	0	0
"KIAA1338"	4401	44432	533	69	320	213	31	38	379	58	72	38	2790	3011	786	688	1123	718
"KIAA1340"	6575	22787	179	33	110	69	17	16	134	229	0	46	674	750	558	552	654	377
"KIAA1341"	2651	26055	0	0	0	0	0	0	0	0	0	0	0	14	0	0	0	0
"KIAA1342"	3036	9607	0	0	0	0	0	0	0	0	0	0	0	0	0	0	0	0
"KIAA1343"	3454	4146	3502	486	2003	1499	237	249	1917	215	341	151	1113	797	1311	568	1488	626
"KIAA1345"	3352	64639	1768	179	939	829	131	48	2915	278	1231	234	0	0	0	0	4	0
"KIAA1351"	2443	22836	956	314	628	328	171	143	472	255	264	357	1643	1728	2141	1836	2300	1535
"KIAA1352"	4600	19602	362	48	208	154	30	18	227	99	117	44	1047	972	1109	1104	1357	1029
"KIAA1354"	733	11300	476	374	252	224	211	163	413	234	41	191	1546	1846	1636	1446	1518	838
"KIAA1355"	3572	5432	0	0	0	0	0	0	46	32	0	0	0	0	0	0	0	0
"KIAA1356"	4360	6308	0	0	0	0	0	0	0	0	0	0	0	0	0	0	0	0
"KIAA1359"	991	1333	35	0	21	14	0	0	19	0	0	0	9	11	64	113	69	37
"KIAA1369"	2374	35606	731	245	423	308	140	105	404	151	115	96	695	2563	989	2201	4073	2337
"KIAA1370"	4473	97310	2631	84	1495	1136	38	46	1807	115	239	116	702	853	676	734	861	600
"KIAA1371"	4117	18590	691	411	405	286	204	207	621	220	182	245	256	382	476	453	467	161
"KIAA1373"	10511	37954	590	8	348	242	0	8	753	20	17	10	347	374	382	232	299	210
"KIAA1374"	5421	142534	15	0	7	8	0	0	72	0	16	0	77	126	97	75	101	40
"KIAA1377"	7425	45270	0	0	0	0	0	0	0	0	0	0	0	0	0	0	0	0
"KIAA1380"	8053	101861	6512	5157	3685	2827	2770	2387	3499	2551	971	1749	2396	2474	2420	1718	2306	1317
"KIAA1383"	5456	5456	0	0	0	0	0	0	0	0	0	0	94	0	109	0	78	0
"KIAA1384"	2937	69380	0	0	0	0	0	0	0	0	0	0	0	0	0	0	0	0
"KIAA1394"	2170	3567	38	8	17	21	0	8	60	94	0	43	0	0	0	0	0	0
"KIAA1395"	1610	9808	0	0	0	0	0	0	57	58	0	0	15	7	51	47	55	50
"KIAA1398"	2206	6141	1593	1199	864	729	656	543	860	1056	666	730	1553	1479	2525	2191	2416	2011
"KIAA1407"	3991	92476	44	0	14	30	0	0	140	280	0	25	71	94	79	47	142	35
"KIAA1409"	8521	374126	0	0	0	0	0	0	29	0	0	0	50	48	22	0	25	0
"KIAA1410"	4671	15712	499	257	303	196	128	129	551	320	241	152	111	288	433	525	578	418
"KIAA1411"	2611	22961	174	12	95	79	12	0	189	32	10	44	154	185	193	204	204	160
"KIAA1412"	6513	85520	572	2829	367	205	1563	1266	284	1375	25	883	1125	1986	1430	2259	1380	1416
"KIAA1414"	1669	6660	107	0	35	72	0	0	81	0	13	0	67	0	16	119	54	69
"KIAA1416"	2282	9027	105	50	35	70	28	22	71	9	20	9	61	61	73	66	74	35
"KIAA1417"	3676	35692	1670	348	983	687	217	131	848	182	383	112	1857	1136	1093	960	1203	747
"KIAA1418"	4124	30716	603	332	337	266	174	158	586	492	359	562	1140	945	1711	1327	2472	1309
"KIAA1419"	5312	17391	0	0	0	0	0	0	14	0	0	0	0	0	0	0	0	0
"KIAA1423"	1104	17929	717	111	438	279	55	56	312	112	481	312	63	99	118	79	113	46
"KIAA1424"	6551	39227	665	546	397	268	346	200	978	607	126	442	2015	2122	3623	3049	4547	2835
"KIAA1425"	1223	2074	297	113	166	131	46	67	125	79	69	95	347	296	505	303	480	254
"KIAA1426"	5367	54476	2023	308	1134	889	170	138	1598	542	1566	700	795	561	1072	634	1349	633
"KIAA1429"	5810	65090	491	127	255	236	82	45	315	51	44	57	1605	1365	1638	973	1772	1006
"KIAA1430"	4880	44361	13	0	0	13	0	0	16	0	0	0	542	551	741	458	708	430
"KIAA1432"	6461	119973	7756	5081	4416	3340	2831	2250	4738	2207	1402	2299	1727	1984	1795	1654	1858	1227
"KIAA1438"	540	173467	15491	11535	9189	6302	6203	5332	4296	8630	3961	13489	195	433	371	245	637	289
"KIAA1439"	7722	56227	0	0	0	0	0	0	9	0	0	0	100	109	69	21	2	5
"KIAA1440"	3107	11635	758	277	365	393	188	89	640	338	262	156	965	845	1035	1129	2308	1564
"KIAA1442"	2812	67231	0	0	0	0	0	0	98	16	0	0	0	0	0	0	0	0
"KIAA1445"	4748	119411	0	0	0	0	0	0	149	71	0	0	0	0	0	0	0	0
"KIAA1449"	3782	44644	1238	605	802	436	368	237	726	294	224	697	2530	2522	2726	2134	3421	2241
"KIAA1450"	1504	65260	29152	65847	16142	13010	37064	28783	7036	28308	7685	53165	627	888	771	927	842	439
"KIAA1452"	2455	31091	655	364	320	335	217	147	500	476	35	307	649	583	622	606	903	557
"KIAA1453"	2837	6884	835	553	483	352	501	52	374	72	612	301	608	61	146	92	119	618
"KIAA1461"	4489	55272	48	0	32	16	0	0	84	0	0	0	156	250	173	158	164	118
"KIAA1462"	7737	101038	47	217	47	0	143	74	108	78	29	40	1675	735	904	904	387	304
"KIAA1464"	5295	83551	1310	227	790	520	130	97	861	506	254	420	548	534	227	473	833	510
"KIAA1467"	4722	39068	9	0	0	9	0	0	26	0	0	0	195	282	156	66	216	93
"KIAA1468"	5482	119832	6097	1804	3457	2640	978	826	3865	646	1458	898	1477	1807	1937	1296	2171	1180
"KIAA1477"	2688	54673	0	0	0	0	0	0	0	0	0	0	0	0	0	0	0	0
"KIAA1482"	2754	21261	3169	2284	1789	1380	1277	1007	1419	705	781	1235	3135	3697	1706	1361	2170	1590
"KIAA1485"	1793	87883	86	181	54	32	113	68	443	244	0	60	100	27	112	91	140	90
"KIAA1486"	4596	253134	0	0	0	0	0	0	0	9	0	0	0	0	0	0	0	0
"KIAA1491"	2275	121154	982	709	484	498	424	285	569	643	56	778	281	299	348	275	419	316
"KIAA1493"	4696	43120	0	0	0	0	0	0	0	0	0	0	0	0	0	0	0	0
"KIAA1494"	1687	40412	0	0	0	0	0	0	0	0	0	5	15	4	9	4	7	11
"KIAA1498"	2635	40753	865	281	497	368	153	128	463	337	268	343	182	189	420	439	458	222
"KIAA1499"	5847	6991	5171	9205	2857	2314	4904	4301	2369	5920	2967	12029	744	3731	3765	1834	4438	1319
"KIAA1500"	2221	27684	0	0	0	0	0	0	15	0	0	0	0	0	0	0	0	0
"KIAA1501"	5454	46221	0	0	0	0	0	0	211	34	0	0	64	50	13	0	159	14
"KIAA1513"	3630	14987	2350	797	1353	997	419	378	990	498	578	661	3647	3087	4303	3031	4818	2828
"KIAA1515"	4346	77660	292	85	171	121	47	38	197	10	85	14	614	723	597	448	819	431
"KIAA1516"	2519	40750	12	0	12	0	0	0	9	0	0	0	0	0	0	1	0	0
"KIAA1517"	1952	5741	3	26	3	0	23	3	69	22	12	0	107	207	291	263	387	150
"KIAA1519"	1242	26936	17	0	4	13	0	0	74	16	60	22	0	9	7	13	26	20
"KIAA1520"	3007	35169	79	0	35	44	0	0	487	146	53	0	305	190	293	206	522	414
"KIAA1522"	5419	33061	702	19	393	309	16	3	558	261	319	121	917	740	863	550	1690	935
"KIAA1524"	4284	39773	27	13	13	14	0	13	0	0	0	0	108	89	96	122	80	70
"KIAA1527"	3290	145264	8365	5391	4590	3775	3020	2371	4129	2458	2258	3861	1183	1549	1166	913	1199	870
"KIAA1528"	380	5121	325	18	175	150	16	2	170	23	394	79	119	59	293	171	270	153
"KIAA1529"	6738	126497	79	27	42	37	14	13	208	50	0	0	23	33	15	36	64	23
"KIAA1530"	4678	40734	3224	857	1843	1381	414	443	3175	1464	2626	1344	513	958	825	718	1318	658
"KIAA1532"	1407	2273	2677	368	1390	1287	227	141	1302	848	1768	811	16168	17567	19130	19133	21642	14964
"KIAA1533"	1901	13215	1559	6897	811	748	4207	2690	276	5056	89	7800	955	3844	977	5457	1548	2561
"KIAA1534"	333	2789	33	15	33	0	10	5	129	73	100	7	65	20	64	54	59	49
"KIAA1535"	2452	11126	0	0	0	0	0	0	70	17	0	0	0	13	8	0	13	3
"KIAA1536"	2803	16406	826	230	438	388	118	112	566	188	677	82	864	1095	1744	1393	2867	1428
"KIAA1537"	932	23245	116	2	47	69	0	2	31	23	76	78	53	38	53	37	59	18
"KIAA1539"	5779	7453	679	0	336	343	0	0	330	62	347	20	1204	1013	2107	1358	2607	1492
"KIAA1542"	3623	5156	1092	266	642	450	130	136	657	312	861	315	1348	1043	1524	1056	2181	1415
"KIAA1543"	4202	22408	3	0	0	3	0	0	64	51	0	0	8	6	0	0	0	0
"KIAA1544"	4107	195988	0	0	0	0	0	0	18	0	0	0	42	66	19	9	30	3
"KIAA1547"	601	8595	43	1518	12	31	775	743	382	18	927	2237	164	256	114	153	148	91
"KIAA1549"	12545	88443	0	0	0	0	0	0	34	0	0	0	1	0	0	0	0	0
"KIAA1554"	4354	10030	1870	1371	1012	858	742	629	2385	678	668	717	3103	4061	5136	3513	5558	3929
"KIAA1555"	8008	75306	10326	4990	5746	4580	2659	2331	3741	3366	8411	6384	1091	829	1577	1739	2706	1172
"KIAA1556"	3509	7353	28	0	28	0	0	0	46	29	0	0	17	19	26	13	97	85
"KIAA1558"	899	93541	10833	13310	6013	4820	7035	6275	4656	6698	5580	15061	406	552	480	470	419	270
"KIAA1562"	3269	13574	0	0	0	0	0	0	0	0	0	0	0	0	0	0	0	0
"KIAA1563"	4732	44167	93	0	50	43	0	0	106	16	30	10	315	326	529	392	569	344
"KIAA1565"	8242	111359	7168	2266	3984	3184	1345	921	3150	1524	2166	1912	4631	6521	5740	4941	6521	3927
"KIAA1568"	6401	607369	0	0	0	0	0	0	0	9	0	0	0	0	0	0	0	0
"KIAA1569"	7370	86326	5703	1511	3177	2526	803	708	3298	828	2510	2402	1000	1150	1310	1076	1258	846
"KIAA1584"	3606	52301	2078	389	1200	878	219	170	1517	193	157	173	855	793	679	415	668	326
"KIAA1586"	2898	8639	92	0	41	51	0	0	51	0	0	0	197	92	144	61	212	66
"KIAA1588"	766	17302	2045	1273	1155	890	673	600	726	601	606	1268	479	326	436	319	474	245
"KIAA1592"	1597	21200	183	27	118	65	15	12	305	91	12	0	447	518	598	627	847	641
"KIAA1595"	2720	17583	458	53	248	210	39	14	233	66	141	98	202	129	309	240	392	192
"KIAA1597"	5011	32246	0	0	0	0	0	0	10	0	21	0	14	39	10	3	19	7
"KIAA1598"	3958	120782	8047	5245	4466	3581	2861	2384	5733	2672	4079	3595	3545	1837	5091	4285	4164	5142
"KIAA1601"	2881	39182	686	164	387	299	90	74	475	199	139	186	853	918	629	583	877	650
"KIAA1602"	4632	6250	666	15	460	206	15	0	391	98	569	48	919	690	1206	828	357	987
"KIAA1603"	5595	78817	0	0	0	0	0	0	0	0	0	0	0	0	0	0	0	0
"KIAA1606"	1151	2183	58	0	41	17	0	0	34	22	7	24	64	184	486	322	605	335
"KIAA1607"	2226	35628	100377	63268	60494	39883	32267	31001	40547	44064	22347	32060	10572	12772	8848	6723	18776	9904
"KIAA1608"	4818	418863	15181	11425	8324	6857	6094	5331	10695	9769	2997	11659	430	424	452	466	576	398
"KIAA1609"	5267	28322	166	19	90	76	19	0	288	148	11	69	272	377	263	231	394	262
"KIAA1614"	4164	32928	84	0	57	27	0	0	222	47	0	0	45	20	34	0	0	0
"KIAA1618"	5332	60595	11058	4163	6091	4967	2198	1965	5537	2007	7058	2802	1578	2051	3419	2955	3492	1432
"KIAA1626"	3091	71920	453	366	217	236	200	166	1277	2170	207	1354	375	370	724	1042	554	407
"KIAA1627"	2117	25503	200	47	122	78	15	32	174	19	30	66	592	591	675	425	717	438
"KIAA1630"	2379	40318	489	84	226	263	50	34	417	77	8	34	1126	723	590	335	733	453
"KIAA1632"	12741	119732	4474	6407	2445	2029	3613	2794	2465	3615	1002	3800	1533	1831	2166	2234	2366	1637
"KIAA1633"	6342	191291	1228	310	647	581	193	117	1304	418	291	448	847	705	916	797	1157	702
"KIAA1634"	3240	5004	0	0	0	0	0	0	0	0	0	0	0	0	0	0	0	0
"KIAA1636"	3289	36971	0	1	0	0	1	0	12	5	0	0	5	3	17	19	6	4
"KIAA1637"	3043	9550	401	740	301	100	380	360	272	1893	88	484	1787	2118	1693	1729	2149	1489
"KIAA1638"	4439	103407	32	11	12	20	6	5	26	16	0	0	49	114	134	131	123	102
"KIAA1639"	1962	8300	0	0	0	0	0	0	64	27	0	0	0	0	0	0	15	5
"KIAA1641"	2832	7253	0	9	0	0	9	0	41	31	0	0	0	23	162	117	279	141
"KIAA1642"	1018	4092	0	0	0	0	0	0	0	0	0	0	0	0	0	0	0	0
"KIAA1644"	6746	69176	0	0	0	0	0	0	342	188	0	0	0	0	0	0	0	0
"KIAA1645"	1462	8793	502	0	230	272	0	0	220	41	161	36	348	56	582	78	750	170
"KIAA1647"	5433	24116	0	0	0	0	0	0	88	33	48	0	0	0	0	0	0	0
"KIAA1648"	5112	83303	0	0	0	0	0	0	264	11	0	1	91	31	9	14	50	4
"KIAA1649"	3432	31236	1834	1026	920	914	561	465	900	682	826	1316	3219	2343	2866	2438	3746	2434
"KIAA1653"	5871	8157	0	0	0	0	0	0	13	0	0	0	0	0	0	0	0	0
"KIAA1664"	3072	211760	134	0	89	45	0	0	502	130	0	15	183	82	100	19	157	5
"KIAA1665"	4670	18630	960	357	511	449	195	162	399	358	520	584	74	2552	3216	3025	4581	3186
"KIAA1669"	6103	27284	1104	626	644	460	308	318	903	668	1183	587	726	1047	1619	995	2418	1326
"KIAA1670"	1413	3867	762	477	455	307	251	226	266	234	530	427	957	1024	1644	1117	1438	1006
"KIAA1671"	10503	169474	14623	16334	8154	6469	8572	7762	4127	7755	3324	10493	1444	2190	538	259	2592	976
"KIAA1672"	1496	105366	0	0	0	0	0	0	9	0	0	0	0	0	0	0	0	0
"KIAA1674"	8479	49398	709	0	426	283	0	0	559	71	132	0	352	119	259	101	447	163
"KIAA1676"	241	595	0	0	0	0	0	0	0	0	0	0	0	0	0	0	0	0
"KIAA1679"	1880	898032	0	0	0	0	0	0	9	10	0	0	0	0	0	0	0	0
"KIAA1680"	2696	795999	8146	4246	4660	3486	2281	1965	6071	3632	20	278	19570	21618	52047	47865	62540	48194
"KIAA1683"	4745	4745	102	0	59	43	0	0	269	100	37	0	8	5	0	0	0	0
"KIAA1688"	5156	84327	0	0	0	0	0	0	497	232	0	0	3	1	0	0	0	0
"KIAA1689"	5581	45497	1272	483	739	533	258	225	684	242	409	255	1222	1546	1115	988	1298	775
"KIAA1690"	2479	272949	0	0	0	0	0	0	11	0	0	0	0	0	0	0	0	0
"KIAA1695"	1786	49411	0	0	0	0	0	0	26	0	0	0	24	32	0	0	34	0
"KIAA1696"	8962	42046	1348	334	759	589	199	135	797	332	166	327	1194	955	889	583	1228	725
"KIAA1699"	4216	812392	20318	17740	11350	8968	9915	7825	14256	13351	2576	11268	1538	1909	2477	2265	2330	2070
"KIAA1700"	3140	45568	1828	3127	921	907	1778	1349	632	1139	355	1283	298	1169	248	280	423	157
"KIAA1702"	4384	4384	583	421	273	310	220	201	430	212	62	235	279	345	230	204	205	67
"KIAA1704"	2426	40979	78	39	59	19	30	9	78	69	0	54	491	445	451	337	486	283
"KIAA1705"	2724	8814	81	19	49	32	17	2	29	32	5	0	73	100	102	123	109	100
"KIAA1708"	3541	19599	0	0	0	0	0	0	0	0	0	0	4	3	0	0	0	0
"KIAA1711"	5794	66721	7049	12656	4073	2976	6521	6135	3171	4485	1199	4581	3009	5612	3434	3757	3976	2250
"KIAA1712"	4926	49478	284	10	136	148	10	0	322	55	11	35	453	417	364	211	450	200
"KIAA1714"	4914	215536	0	0	0	0	0	0	0	0	0	0	0	0	0	0	0	0
"KIAA1715"	6146	77106	446	9	250	196	0	9	438	14	36	44	311	350	1043	812	1224	705
"KIAA1716"	1955	10867	946	389	486	460	149	240	470	402	787	799	324	368	500	464	809	424
"KIAA1718"	8140	34473	3360	3570	1776	1584	1836	1734	5829	1676	2828	2574	6333	8879	5702	4777	6524	4306
"KIAA1719"	4119	5293	0	0	0	0	0	0	86	15	0	0	0	0	0	0	0	0
"KIAA1720"	4131	15185	620	20	344	276	0	20	300	76	177	0	1042	721	1636	1049	1904	1085
"KIAA1721"	818	59881	404	47	234	170	34	13	376	151	59	138	80	100	121	83	92	56
"KIAA1724"	8047	49807	1504	1165	855	649	680	485	804	1014	196	1609	733	1139	830	890	855	567
"KIAA1728"	790	2826	0	0	0	0	0	0	0	0	0	0	0	0	0	0	0	0
"KIAA1731"	8074	68708	1632	950	1087	545	513	437	513	3080	30	138	585	2272	719	428	1011	491
"KIAA1732"	1639	27449	2512	648	1522	990	387	261	1200	451	744	541	1028	1390	824	759	1409	892
"KIAA1737"	4351	19053	480	50	285	195	31	19	454	146	0	15	1435	921	1819	842	2010	831
"KIAA1740"	3008	6006	10	9	0	10	9	0	71	0	5	0	93	118	6	3	51	10
"KIAA1747"	1083	22881	0	0	0	0	0	0	0	0	0	0	0	0	0	0	0	0
"KIAA1751"	4728	50526	2	0	2	0	0	0	337	180	0	0	0	0	0	0	0	0
"KIAA1752"	3671	410505	4375	3220	2455	1920	1820	1400	3293	2462	641	2322	713	677	476	389	651	343
"KIAA1753"	1368	9397	613	584	388	225	277	307	335	323	223	709	88	176	104	169	124	86
"KIAA1755"	6426	50269	0	0	0	0	0	0	79	8	0	1	0	0	0	0	0	0
"KIAA1757"	5482	36026	5364	5761	3035	2329	3102	2659	2038	2719	2123	4601	2036	2726	2459	2569	3029	1771
"KIAA1764"	1138	24821	0	0	0	0	0	0	0	0	0	0	42	47	25	17	43	22
"KIAA1766"	1003	26523	428	116	260	168	55	61	380	157	100	85	59	54	62	70	71	53
"KIAA1767"	5959	365211	1813	962	1154	659	503	459	1740	997	335	693	699	712	868	751	834	690
"KIAA1772"	2972	57694	30	0	14	16	0	0	27	0	0	0	0	0	0	0	0	0
"KIAA1776"	2646	24557	0	0	0	0	0	0	49	0	0	0	0	0	0	0	0	0
"KIAA1783"	9715	38788	4306	2187	2429	1877	1115	1072	1742	1460	6483	5185	775	955	2665	3202	2196	1331
"KIAA1787"	2626	6551	624	114	351	273	88	26	352	588	399	226	852	1022	1537	1424	2237	1258
"KIAA1790"	7661	145601	23169	9769	12939	10230	5187	4582	8723	5955	10089	9255	2273	3259	3111	2604	4877	2765
"KIAA1791"	4518	34728	2479	1577	1414	1065	948	629	1033	583	818	1039	1399	1215	1446	1101	1708	940
"KIAA1793"	3745	20945	0	0	0	0	0	0	39	11	0	0	0	0	0	0	0	0
"KIAA1794"	4417	73170	414	328	179	235	178	150	181	35	44	181	444	1024	527	522	674	442
"KIAA1797"	6141	337647	644	317	322	322	179	138	1419	435	248	204	883	850	1034	923	1431	941
"KIAA1800"	2883	44161	1262	135	682	580	37	98	697	100	312	79	1143	1040	1254	859	1362	814
"KIAA1803"	2065	78877	0	0	0	0	0	0	0	0	0	0	0	0	0	0	0	0
"KIAA1804"	5818	57381	399	6	244	155	6	0	546	8	11	23	861	671	792	428	793	371
"KIAA1806"	1185	26182	375	176	216	159	87	89	206	150	154	348	124	202	128	126	58	27
"KIAA1808"	1964	18123	0	0	0	0	0	0	64	34	0	0	0	0	0	0	0	0
"KIAA1813"	3261	5333	0	0	0	0	0	0	139	0	105	0	320	195	557	274	585	297
"KIAA1814"	3662	6718	233	1018	107	126	501	517	220	3432	135	1692	233	310	380	1197	373	413
"KIAA1818"	4046	17995	1120	349	613	507	212	137	525	389	665	507	830	908	1017	724	1188	829
"KIAA1824"	1624	35012	1672	43	933	739	22	21	795	50	236	59	31	43	55	45	56	48
"KIAA1826"	4089	14326	167	41	82	85	23	18	169	19	74	0	161	106	196	244	245	310
"KIAA1830"	980	24104	1586	126	886	700	73	53	779	61	515	105	516	496	456	281	493	158
"KIAA1835"	1541	7422	205	233	74	131	110	123	187	185	8	185	317	1094	353	404	497	417
"KIAA1837"	1531	97577	2975	543	1757	1218	346	197	1602	161	596	379	334	379	520	481	569	371
"KIAA1838"	578	40344	5830	2925	3323	2507	1635	1290	2510	1591	1840	2409	150	301	168	142	214	87
"KIAA1839"	732	35031	38	15	16	22	6	9	5	3	0	0	11	24	74	42	91	67
"KIAA1840"	2166	21863	3961	4693	2442	1519	2458	2235	1742	1950	2950	2409	3507	4581	3471	3428	3547	3055
"KIAA1841"	4596	58407	895	39	516	379	19	20	555	24	56	27	504	440	554	443	648	353
"KIAA1842"	3356	12905	97	94	59	38	66	28	120	26	0	0	1016	990	1270	829	987	641
"KIAA1845"	2689	12377	728	91	376	352	48	43	416	151	740	79	344	240	803	557	989	549
"KIAA1849"	6023	89052	6	70	1	5	32	38	252	229	0	0	216	262	0	0	3	0
"KIAA1852"	2991	5732	103	0	39	64	0	0	112	23	48	0	134	43	83	12	170	0
"KIAA1855"	1018	7309	0	0	0	0	0	0	39	0	0	0	0	0	0	0	0	0
"KIAA1856"	1167	5987	988	283	482	506	149	134	487	207	1094	301	436	202	595	300	434	516
"KIAA1861"	3644	126686	4250	280	2329	1921	164	116	2792	139	180	144	1055	1094	1255	950	1349	836
"KIAA1862"	3781	19562	51	0	31	20	0	0	204	86	69	0	112	97	146	89	232	110
"KIAA1863"	4610	31488	99	17	49	50	0	17	220	211	28	34	514	395	695	567	927	597
"KIAA1864"	4709	79090	0	0	0	0	0	0	0	0	0	0	0	0	0	0	0	0
"KIAA1867"	2068	454179	0	0	0	0	0	0	263	38	0	0	0	0	0	0	0	0
"KIAA1870"	5452	143007	4	0	0	4	0	0	669	234	0	0	0	0	0	0	0	0
"KIAA1872"	5119	47462	0	0	0	0	0	0	134	60	0	0	2	0	0	0	0	0
"KIAA1873"	1713	16553	182	0	107	75	0	0	169	4	58	40	289	388	454	275	425	202
"KIAA1875"	7142	10591	11	4	1	10	4	0	110	53	0	0	3	1	11	7	14	9
"KIAA1879"	5716	80452	0	0	0	0	0	0	107	0	0	0	0	0	0	0	0	0
"KIAA1885"	3381	11648	109	29	61	48	19	10	171	54	71	13	307	326	430	309	551	337
"KIAA1888"	7062	58473	523	791	269	254	430	361	186	183	116	170	318	563	318	264	371	221
"KIAA1891"	5321	37072	426	19	228	198	19	0	321	56	123	0	1240	920	1286	581	1486	764
"KIAA1894"	1994	27508	0	0	0	0	0	0	0	0	0	0	0	0	0	0	0	0
"KIAA1898"	2218	11638	350	259	153	197	144	115	318	166	204	131	414	604	563	436	768	340
"KIAA1899"	2332	14433	140	47	59	81	28	19	96	0	22	26	90	169	217	181	201	140
"KIAA1900"	2873	216136	0	0	0	0	0	0	12	0	0	0	0	0	0	0	0	0
"KIAA1902"	3686	30325	2100	2761	1063	1037	1495	1266	943	838	663	2103	1727	2797	1065	1124	2145	1308
"KIAA1903"	2429	26661	1258	47	750	508	15	32	694	34	224	10	646	496	784	392	675	315
"KIAA1905"	3080	83024	0	0	0	0	0	0	0	0	0	0	7	20	30	31	20	21
"KIAA1908"	5811	19552	515	35	277	238	11	24	541	44	165	0	399	283	494	335	677	333
"KIAA1911"	4636	71433	2500	449	1497	1003	279	170	1088	289	249	257	743	818	681	666	727	449
"KIAA1915"	4250	4250	3624	2131	1664	1960	1454	677	1185	974	1230	2095	556	818	2104	1635	1838	1020
"KIAA1918"	4355	208165	0	0	0	0	0	0	0	0	0	0	0	0	0	0	0	0
"KIAA1919"	3920	9779	554	78	357	197	48	30	336	78	262	0	144	126	147	88	141	77
"KIAA1922"	5383	25267	1691	641	951	740	353	288	840	380	520	396	331	226	225	23	327	22
"KIAA1924"	3036	11099	142	73	58	84	57	16	467	249	105	138	135	172	134	120	314	175
"KIAA1927"	5886	38992	2066	553	1150	916	347	206	1205	308	671	412	3171	3013	3738	2999	4000	2331
"KIAA1928"	2982	31867	418	79	217	201	61	18	405	16	10	50	554	507	457	244	493	226
"KIAA1931"	4612	34749	2570	327	1452	1118	208	119	1528	615	1974	621	624	421	936	581	1460	678
"KIAA1933"	667	4719	128	0	62	66	0	0	129	56	109	31	94	57	115	57	31	42
"KIAA1937"	2850	53045	0	0	0	0	0	0	130	36	0	0	7	4	0	0	3	0
"KIAA1939"	5555	260985	3552	1565	1972	1580	867	698	5481	2376	360	1627	615	901	1163	1059	853	782
"KIAA1941"	1156	53737	0	0	0	0	0	0	46	33	0	0	0	0	0	0	0	0
"KIAA1949"	4602	11508	3177	4967	1750	1427	2605	2362	586	2527	2147	6451	7206	18925	7973	18352	10067	15225
"KIAA1950"	4203	27235	89	63	55	34	18	45	209	183	0	0	5	4	0	0	44	10
"KIAA1954"	5035	36992	121	0	84	37	0	0	166	25	0	0	369	284	496	246	488	226
"KIAA1955"	1903	33071	173	0	127	46	0	0	236	3	0	0	266	208	478	445	351	310
"KIAA1958"	2772	173460	482	36	329	153	24	12	471	20	42	29	291	384	145	89	50	20
"KIAA1967"	3992	15426	1627	1082	868	759	550	532	874	597	813	1137	2655	2313	2816	2257	4110	2494
"KIAA1970"	3489	28830	173	16	94	79	0	16	201	21	16	0	529	130	361	216	380	231
"KIAA1973"	4581	16567	57	0	41	16	0	0	34	0	0	0	29	18	3	0	0	0
"KIAA1975"	1315	31369	2	0	0	2	0	0	8	0	0	0	0	0	0	0	0	0
"KIAA1977"	2217	3793	243	2	122	121	0	2	271	271	183	95	72	57	128	62	144	85
"KIAA1978"	1705	2159	90	57	65	25	26	31	49	30	0	0	785	583	764	593	1025	708
"KIAA1979"	1870	20868	13	8	6	7	8	0	217	9	0	0	412	242	254	120	180	72
"KIAA1982"	1982	48395	3118	1338	1748	1370	697	641	1429	557	946	987	734	683	683	312	817	292
"KIAA1984"	1717	11392	419	136	221	198	66	70	333	202	562	408	86	117	182	225	387	295
"KIAA1987"	3078	10965	139	11	77	62	5	6	164	32	111	39	107	142	115	112	153	99
"KIAA1988"	972	10899	60	128	37	23	75	53	36	69	29	98	217	231	219	263	234	185
"KIAA1990"	5393	15528	1573	1026	831	742	569	457	832	478	1839	1082	3740	3201	1895	1055	4969	2613
"KIAA1992"	1733	33512	77	23	46	31	14	9	83	9	0	9	147	172	120	111	161	113
"KIAA1996"	3561	45369	432	0	245	187	0	0	228	0	0	12	831	812	1084	870	1064	741
"KIAA2000"	1577	48280	127	25	78	49	10	15	303	19	98	19	151	201	186	92	282	127
"KIAA2011"	862	3335	0	0	0	0	0	0	54	48	0	0	1	0	0	0	0	0
"KIAA2012"	5145	62148	0	0	0	0	0	0	30	0	0	0	354	377	0	0	0	0
"KIAA2013"	2536	4250	267	54	142	125	28	26	128	41	0	0	2153	1524	2912	1991	3625	2228
"KIAA2015"	2587	36697	1827	3872	966	861	2052	1820	385	1130	129	2026	188	1191	77	294	102	109
"KIAA2017"	2894	10670	9	0	0	9	0	0	78	0	0	0	0	0	0	0	0	0
"KIAA2018"	13712	48260	666	365	391	275	193	172	461	229	0	125	1265	1475	1314	927	1278	587
"KIAA2022"	11720	192597	0	0	0	0	0	0	0	0	0	0	0	0	0	0	0	0
"KIAA2023"	2292	16060	335	90	184	151	37	53	270	23	123	17	196	256	265	179	242	147
"KIAA2024"	5421	151217	5195	4561	3046	2149	2645	1916	3007	2061	592	1948	1683	1744	2026	1794	2114	1541
"KIAA2026"	7210	88995	2967	452	1692	1275	229	223	1387	363	137	485	780	361	913	902	293	649
"KIAA2029"	299	4262	0	0	0	0	0	0	0	0	0	0	0	0	0	0	0	0
"KIAA2033"	959	18355	874	425	506	368	217	208	569	348	285	629	315	377	250	208	244	158
"KIAA2035"	2708	5906	33	16	0	33	16	0	68	0	0	0	20	29	25	8	13	5
"KIDINS220"	7391	108770	6133	2514	3383	2750	1377	1137	3432	1481	1791	2031	4408	5374	5876	5175	5863	3678
"KIF11"	5098	62327	9	0	9	0	0	0	62	0	8	0	108	75	45	10	65	16
"KIF12"	2580	7589	0	0	0	0	0	0	10	0	0	0	0	0	0	0	0	0
"KIF13A"	5978	223876	3990	369	2294	1696	200	169	3020	392	883	417	1268	1378	1704	1383	1539	1153
"KIF13B"	8805	195816	1735	489	1059	676	364	125	1658	716	527	829	876	952	1875	1866	2103	1533
"KIF14"	7307	69239	0	0	0	0	0	0	0	0	0	0	0	2	0	4	0	0
"KIF15"	4870	91539	0	0	0	0	0	0	21	0	0	0	8	5	0	0	10	0
"KIF16B"	5287	301331	1862	1121	1058	804	654	467	1720	996	185	654	605	618	704	591	1030	630
"KIF17"	3791	53810	50	37	30	20	16	21	225	50	90	22	70	68	74	146	243	171
"KIF18A"	3480	87585	0	0	0	0	0	0	0	0	0	0	2	3	0	0	0	0
"KIF18B"	4219	11649	0	0	0	0	0	0	120	34	0	0	0	0	0	0	0	0
"KIF19"	3662	29609	0	0	0	0	0	0	209	43	0	0	0	0	0	0	0	0
"KIF1A"	9167	106441	0	0	0	0	0	0	1084	466	0	0	0	0	0	0	0	0
"KIF1A variant protein"	5538	11083	0	0	0	0	0	0	119	69	0	0	0	0	0	0	0	0
"KIF1B"	10716	169987	5208	15873	3003	2205	8818	7055	1740	6407	848	10853	3057	4835	2797	4212	3089	2271
"KIF1C"	4209	26722	1031	120	581	450	79	41	756	342	361	305	2282	2143	1920	1757	3611	2394
"KIF20A"	3489	8988	0	0	0	0	0	0	0	9	0	0	0	0	0	0	3	0
"KIF20B"	6463	73335	0	8	0	0	5	3	26	4	0	0	260	257	278	103	239	90
"KIF21A"	6404	149889	0	0	0	0	0	0	0	0	0	0	6	18	9	13	3	0
"KIF21B"	9969	54310	45	0	23	22	0	0	397	128	17	23	84	207	350	398	293	138
"KIF22"	2271	14419	180	11	123	57	11	0	132	17	0	47	426	281	501	262	562	223
"KIF23"	3636	34073	0	0	0	0	0	0	0	0	0	0	78	115	98	41	78	35
"KIF24"	6239	76821	1483	1745	834	649	973	772	556	1213	350	1631	1609	1793	1749	1677	2137	1572
"KIF25"	1519	27218	0	0	0	0	0	0	24	14	0	0	0	0	0	0	0	0
"KIF26A"	6771	42176	0	0	0	0	0	0	299	148	0	0	0	0	0	0	0	0
"KIF26B"	7302	548143	0	0	0	0	0	0	189	9	0	0	0	0	0	0	0	0
"KIF27"	4667	84727	3	0	0	3	0	0	40	25	0	0	5	28	97	28	71	15
"KIF2A"	3469	80222	3496	1372	1945	1551	773	599	1614	668	739	1542	596	1875	1608	1171	2319	1176
"KIF2B"	2336	2336	0	0	0	0	0	0	0	0	0	0	0	0	0	0	0	0
"KIF2C"	2965	21353	0	0	0	0	0	0	39	21	0	0	35	15	39	19	21	14
"KIF3A"	6355	44942	3	0	0	3	0	0	22	0	0	0	28	34	38	20	35	8
"KIF3B"	6107	57344	92	0	43	49	0	0	60	17	0	34	746	796	734	624	923	646
"KIF3C"	5564	55990	0	0	0	0	0	0	38	3	0	0	194	164	84	79	236	162
"KIF4A"	4725	130804	0	0	0	0	0	0	0	8	0	0	0	0	0	0	0	0
"KIF4B"	4427	4427	0	0	0	0	0	0	0	0	0	0	0	0	0	0	0	0
"KIF5A"	3926	34709	3	1	2	1	1	0	81	11	0	0	0	1	0	0	0	0
"KIF5B"	5913	47433	4535	2343	2534	2001	1320	1023	2444	1182	841	1609	7336	9005	6909	9053	5548	3275
"KIF5C"	6957	250456	0	0	0	0	0	0	62	29	0	0	0	0	0	0	0	0
"KIF6"	3995	390307	0	0	0	0	0	0	0	0	0	0	0	0	0	0	0	0
"KIF7"	4577	27483	0	0	0	0	0	0	36	0	0	0	0	0	0	0	0	0
"KIF9"	3624	54822	0	0	0	0	0	0	69	30	0	0	50	14	16	36	21	63
"KIFAP3"	3015	153409	87	0	55	32	0	0	119	50	0	37	346	450	311	269	404	230
"KIFC1"	2713	18386	0	0	0	0	0	0	116	47	0	0	15	26	9	6	24	10
"KIFC2"	3264	7762	1309	500	722	587	307	193	411	286	1251	678	1246	1555	1916	1604	3438	1783
"KIFC3"	3747	24096	8441	3908	4429	4012	2059	1849	3413	2055	9288	5388	2967	2217	3732	2512	4071	2087
"KILLIN"	4277	4277	0	8	0	0	8	0	0	12	0	0	0	0	0	0	0	0
"KIN"	1918	32578	279	48	174	105	36	12	336	83	57	68	272	172	295	174	246	153
"KIN13A"	2005	18892	2007	150	1097	910	79	71	1374	225	548	118	816	1033	1146	886	1045	779
"KIP3"	404	12108	0	1	0	0	1	0	0	14	0	0	1	0	0	0	0	0
"KIR-K15"	1564	78760	0	0	0	0	0	0	16	12	0	0	3	17	0	0	0	0
"KIR-K3"	596	33486	0	0	0	0	0	0	9	0	0	0	0	0	0	0	0	0
"KIR-K36"	798	14571	0	0	0	0	0	0	23	1	0	0	3	5	0	0	0	0
"KIR103"	1198	8570	0	0	0	0	0	0	0	0	0	0	0	0	0	0	0	0
"KIR2DL1"	1685	14515	0	0	0	0	0	0	0	0	0	0	0	0	0	0	0	0
"KIR2DL2"	1595	14540	0	0	0	0	0	0	9	0	0	0	0	0	0	0	0	0
"KIR2DL3"	1608	45806	0	0	0	0	0	0	9	0	0	0	0	0	0	0	0	0
"KIR2DL4"	1891	21478	0	0	0	0	0	0	14	0	0	0	0	0	0	0	0	0
"KIR2DL5A"	1641	57769	0	0	0	0	0	0	0	0	0	0	0	0	0	0	0	0
"KIR2DL5B"	1695	9557	0	0	0	0	0	0	0	0	0	0	0	0	0	0	0	0
"KIR2DS1"	1108	14015	0	0	0	0	0	0	0	0	0	0	0	0	0	0	0	0
"KIR2DS2"	1567	14298	0	0	0	0	0	0	0	0	0	0	0	0	0	0	0	0
"KIR2DS3"	1609	15022	0	0	0	0	0	0	0	0	0	0	0	0	0	0	0	0
"KIR2DS4"	1571	15851	0	0	0	0	0	0	1	9	0	0	0	17	0	0	0	0
"KIR2DS5"	1576	74655	0	0	0	0	0	0	0	0	0	0	0	0	0	0	0	0
"KIR3DL1"	1909	14341	0	0	0	0	0	0	1	0	0	0	3	4	0	0	0	0
"KIR3DL1/2V"	1913	14341	0	0	0	0	0	0	1	0	0	0	3	4	0	0	0	0
"KIR3DL2"	1885	16765	0	0	0	0	0	0	0	4	0	0	0	0	0	0	0	0
"KIR3DL3"	1699	12021	0	0	0	0	0	0	0	0	0	0	0	0	0	0	0	0
"KIR3DP1"	1300	43266	0	0	0	0	0	0	9	0	0	0	0	0	0	0	0	0
"KIR3DS1"	1915	50770	0	0	0	0	0	0	2	12	0	0	3	17	0	0	0	0
"KIR3DX1"	1512	11288	2	0	0	2	0	0	17	0	0	0	0	0	0	0	0	0
"KIR411"	971	14298	0	0	0	0	0	0	0	0	0	0	0	0	0	0	0	0
"KIRREL"	3625	102781	0	0	0	0	0	0	269	49	0	0	0	0	0	0	0	0
"KIRREL2"	3007	10239	0	4	0	0	3	1	77	102	0	0	0	5	0	0	0	0
"KIRREL3"	3793	577371	30	30	22	8	30	0	901	391	0	37	0	2	1	0	2	21
"KISS1"	716	6151	0	0	0	0	0	0	132	41	0	0	0	0	0	0	0	0
"KISS1R"	1629	3674	1	2	1	0	2	0	0	0	0	0	0	0	0	0	0	0
"KIT"	5195	82786	0	0	0	0	0	0	22	0	0	0	0	6	0	0	4	0
"KITLG"	5442	87671	0	0	0	0	0	0	5	10	0	23	17	173	0	457	4	4
"KL"	5010	49712	0	0	0	0	0	0	0	0	0	0	28	8	0	0	5	0
"KLB"	6082	44680	0	0	0	0	0	0	0	0	0	13	0	0	0	0	0	0
"KLC1"	2830	123271	14627	9171	8120	6507	4904	4267	7085	5381	12254	12894	4751	4908	5557	4920	7524	4460
"KLC2"	3768	6948	87	9	54	33	5	4	245	120	0	94	125	135	152	130	238	168
"KLC3"	1832	6122	18	0	18	0	0	0	77	28	0	0	1	16	0	0	0	0
"KLC4"	2795	15202	60	8	33	27	3	5	207	44	14	0	173	190	305	201	362	259
"KLF1"	1615	2780	0	0	0	0	0	0	24	12	0	0	0	0	0	0	7	0
"KLF10"	3237	5165	9	150	0	9	78	72	43	60	0	94	1536	1056	1484	523	1414	1767
"KLF11"	4034	11283	206	213	115	91	148	65	204	207	45	163	1872	1864	1892	1094	2091	1118
"KLF12"	11011	448246	9233	5464	5231	4002	3018	2446	2502	1584	349	1474	933	1046	288	105	663	150
"KLF13"	6801	51020	9045	2348	4983	4062	1177	1171	3839	1769	7361	4850	7987	5481	8114	3847	10412	4884
"KLF14"	1384	1384	0	0	0	0	0	0	0	0	0	0	0	0	0	0	0	0
"KLF15"	2528	14760	0	0	0	0	0	0	0	14	0	0	0	0	0	0	0	0
"KLF16"	2888	11167	457	1	197	260	1	0	219	105	360	97	997	457	1251	503	1684	755
"KLF17"	3130	16287	0	0	0	0	0	0	20	0	0	0	0	0	0	0	0	0
"KLF2"	1650	2688	0	0	0	0	0	0	0	0	0	0	85	67	131	111	118	83
"KLF3"	5620	37340	968	0	557	411	0	0	1056	103	172	0	1407	694	2205	1055	2336	1175
"KLF4"	3037	4914	501	218	287	214	116	102	77	189	399	24	2348	685	2651	784	3029	538
"KLF5"	3353	18535	9	0	9	0	0	0	37	0	0	0	131	140	240	95	320	49
"KLF6"	4665	9286	9020	12328	4915	4105	6516	5812	3018	5796	4698	6488	7027	12193	6284	14068	8659	10515
"KLF7"	1643	85087	2605	36850	1523	1082	19500	17350	400	20073	77	19003	47	913	77	773	73	152
"KLF8"	5425	55500	305	0	162	143	0	0	152	12	0	0	406	456	212	178	419	196
"KLF9"	5208	30060	1327	3622	807	520	1935	1687	364	2138	62	1533	1351	2513	335	1642	1412	1108
"KLHDC1"	2690	59979	132	0	121	11	0	0	174	7	41	0	67	98	73	38	100	51
"KLHDC10"	4481	63246	2205	135	1326	879	93	42	1513	113	573	228	1263	1118	1507	872	1629	917
"KLHDC2"	1818	15070	582	157	395	187	109	48	382	250	83	208	1187	423	626	708	1162	496
"KLHDC3"	1887	7054	399	28	193	206	16	12	277	71	200	0	2426	2251	2599	1721	3446	2230
"KLHDC4"	2462	52777	808	246	393	415	126	120	809	437	364	493	283	243	213	172	412	221
"KLHDC5"	6471	22787	179	33	110	69	17	16	134	229	0	46	674	750	558	552	654	377
"KLHDC6"	4134	64259	2	0	0	2	0	0	0	0	0	0	0	0	0	0	0	0
"KLHDC7A"	5056	5056	0	0	0	0	0	0	0	0	0	0	0	0	0	0	0	0
"KLHDC7B"	2991	2991	0	0	0	0	0	0	0	12	0	0	3	2	0	0	0	0
"KLHDC8A"	2758	20520	0	0	0	0	0	0	62	10	0	0	0	0	0	0	0	0
"KLHDC8B"	1940	4852	0	0	0	0	0	0	40	0	0	0	7	0	40	0	40	13
"KLHDC9"	1365	1982	0	0	0	0	0	0	0	15	0	0	0	0	0	0	0	0
"KLHL1"	4160	407901	0	0	0	0	0	0	0	0	0	0	0	0	0	0	0	0
"KLHL10"	2012	10556	0	0	0	0	0	0	0	0	0	0	0	0	0	0	0	0
"KLHL11"	2328	11832	44	0	13	31	0	0	48	8	0	0	12	36	143	0	148	0
"KLHL12"	3350	36143	1000	134	541	459	95	39	544	64	27	26	965	922	1530	1087	788	1096
"KLHL13"	5337	50130	0	0	0	0	0	0	0	0	0	0	0	0	0	0	0	0
"KLHL14"	4270	100342	0	0	0	0	0	0	0	0	0	0	0	0	0	0	0	0
"KLHL15"	6277	43469	304	0	181	123	0	0	143	0	0	0	611	377	593	194	539	190
"KLHL17"	2572	5130	86	0	39	47	0	0	142	38	0	30	139	109	186	107	245	95
"KLHL18"	4735	63977	2125	217	1220	905	70	147	1203	218	270	314	1141	849	1124	676	1564	876
"KLHL2"	3151	115539	6135	4960	3495	2640	2699	2261	2975	2514	1213	2109	901	1088	1023	888	1277	852
"KLHL20"	3474	71760	759	12	434	325	12	0	425	21	22	0	358	434	524	410	570	444
"KLHL21"	6321	12152	858	35	505	353	9	26	526	46	661	15	1632	528	2544	512	2731	855
"KLHL22"	2575	54318	3768	1647	2055	1713	947	700	1599	797	2325	1740	1173	1103	954	690	1304	708
"KLHL23"	2243	55465	0	0	0	0	0	0	0	0	0	0	0	0	13	0	0	0
"KLHL24"	7426	48893	1498	193	816	682	115	78	1082	55	682	156	1763	1283	2123	964	2070	935
"KLHL25"	3682	35630	1296	21	764	532	21	0	676	102	3	0	385	74	239	44	552	202
"KLHL26"	3125	33466	216	0	117	99	0	0	551	159	342	0	303	120	262	62	447	149
"KLHL28"	6670	36809	620	458	393	227	258	200	480	560	0	777	871	1489	974	1103	948	651
"KLHL29"	6393	19828	2499	2141	1331	1168	1166	975	1614	947	827	994	0	23	0	0	9	0
"KLHL3"	6820	118591	806	1240	498	308	681	559	843	1075	436	1494	575	779	412	383	807	409
"KLHL30"	3564	12132	8	2	4	4	2	0	98	55	0	0	0	0	0	0	0	0
"KLHL31"	5745	17808	0	0	0	0	0	0	0	0	0	0	0	0	0	0	0	0
"KLHL32"	3818	216136	0	0	0	0	0	0	12	0	0	0	0	0	0	0	0	0
"KLHL33"	1364	1587	0	0	0	0	0	0	0	0	0	0	0	0	0	0	0	0
"KLHL34"	2841	2841	0	0	0	0	0	0	0	0	0	0	0	0	0	0	0	0
"KLHL35"	1503	7797	6	0	3	3	0	0	0	11	0	0	0	2	0	3	0	0
"KLHL36"	2173	13786	874	305	435	439	200	105	461	196	825	955	2378	1946	1859	1405	2420	1140
"KLHL38"	1837	7277	0	0	0	0	0	0	0	0	0	0	0	0	0	0	0	0
"KLHL4"	5866	152337	0	0	0	0	0	0	0	0	0	0	0	0	0	0	0	0
"KLHL5"	3496	59770	2077	2005	1144	933	1171	834	1090	1100	0	1483	1112	1315	764	878	974	654
"KLHL6"	6325	68180	2600	6576	1511	1089	3564	3012	782	1906	410	1900	1402	1464	1291	1212	1950	1254
"KLHL7"	3316	69685	149	0	70	79	0	0	233	25	23	0	393	411	451	344	629	342
"KLHL8"	4715	59208	1271	44	672	599	16	28	931	23	142	0	205	267	937	788	911	641
"KLHL9"	4412	4412	476	374	252	224	211	163	413	234	41	191	1546	1846	1636	1446	1518	877
"KLHLX"	2899	71760	759	12	434	325	12	0	425	21	22	0	358	434	524	410	570	444
"KLIP1"	2381	36904	22	57	22	0	21	36	21	35	0	59	180	216	103	102	184	159
"KLK1"	1860	4641	0	0	0	0	0	0	0	30	0	0	1	0	0	0	3	0
"KLK10"	3111	7283	0	0	0	0	0	0	19	11	0	0	0	0	0	0	0	0
"KLK11"	1536	3524	0	0	0	0	0	0	26	17	0	0	0	0	0	0	0	0
"KLK12"	1082	5651	0	0	0	0	0	0	18	10	0	0	0	0	0	0	0	0
"KLK13"	1619	8905	0	0	0	0	0	0	24	0	0	0	0	0	0	0	0	0
"KLK14"	1140	6350	0	0	0	0	0	0	85	23	0	0	0	0	0	0	0	0
"KLK15"	1313	6235	0	0	0	0	0	0	18	0	0	0	0	0	0	0	0	0
"KLK2"	3031	4537	0	0	0	0	0	0	57	48	0	0	0	0	0	0	0	0
"KLK3"	1911	5851	0	0	0	0	0	0	0	0	0	0	0	0	0	0	0	0
"KLK4"	1364	4388	0	0	0	0	0	0	16	9	0	0	0	0	0	0	5	0
"KLK5"	1567	9785	0	0	0	0	0	0	21	10	0	0	0	0	0	0	0	0
"KLK6"	1532	10161	0	0	0	0	0	0	29	0	0	0	0	0	0	0	0	0
"KLK7"	1932	7343	0	0	0	0	0	0	43	0	0	0	0	0	0	0	0	0
"KLK8"	1880	7254	0	0	0	0	0	0	106	49	0	0	0	0	0	0	0	0
"KLK9"	1788	9212	0	0	0	0	0	0	69	57	0	0	0	0	0	0	0	0
"KLKB1"	2292	30954	0	0	0	0	0	0	0	0	0	0	0	0	0	0	0	0
"KLKBL4"	1816	15051	0	0	0	0	0	0	0	0	0	0	0	0	0	0	0	0
"KLRAQ1"	3230	74618	2301	260	1229	1072	152	108	1187	75	840	139	677	792	894	743	992	690
"KLRB1"	745	12628	0	0	0	0	0	0	10	0	0	0	68	78	41	39	59	36
"KLRC1"	1384	7292	0	0	0	0	0	0	0	0	0	0	0	35	0	0	0	0
"KLRC2"	1219	5388	0	0	0	0	0	0	0	0	9	0	0	0	0	0	10	0
"KLRC3"	1028	8278	58	27	30	28	18	9	0	0	9	13	14	15	2	0	19	8
"KLRC4"	930	2373	68	1	36	32	0	1	12	0	0	0	0	16	10	0	17	16
"KLRD1"	3263	9434	15	10	9	6	10	0	18	0	0	0	50	64	21	22	56	47
"KLRF1"	1243	17526	61	0	36	25	0	0	41	22	0	0	48	102	25	38	60	42
"KLRG1"	1791	21119	39	66	20	19	41	25	19	3	38	22	29	46	33	26	113	48
"KLRG2"	1548	30370	0	0	0	0	0	0	24	8	0	0	0	0	0	0	0	0
"KLRK1"	2280	37405	374	250	245	129	166	84	66	0	0	217	87	186	55	35	124	94
"KMO"	5029	63265	7593	36868	4283	3310	19883	16985	1951	16689	1184	30287	3256	11284	1781	8968	2866	3948
"KNCN"	2395	5573	2	22	0	2	16	6	25	30	0	0	1	0	0	0	0	0
"KNDC1"	6803	65947	0	0	0	0	0	0	299	206	0	0	1	1	0	0	3	0
"KNG1"	2155	25000	0	0	0	0	0	0	17	0	0	0	0	8	0	0	0	0
"KNTC1"	7028	99139	434	158	247	187	94	64	460	176	208	78	588	652	447	424	535	312
"KPNA1"	7531	38758	3837	3406	2112	1725	1921	1485	1934	2372	1023	2628	2134	2689	2415	2003	2698	1742
"KPNA2"	2219	10636	11	131	0	11	74	57	10	43	0	59	895	1102	844	1579	1083	1040
"KPNA3"	4491	93616	3020	1331	1730	1290	801	530	1547	863	454	1316	749	2444	2218	1868	2364	1780
"KPNA4"	3818	65415	7702	12936	4280	3422	6992	5944	2626	4984	1078	6791	2796	385	1417	1588	1592	1118
"KPNA5"	7362	68524	1773	1086	947	826	549	537	1023	1039	560	1855	2368	2475	2093	1530	2748	1585
"KPNA6"	7499	68279	1672	1086	885	787	549	537	727	1030	546	1855	2140	2257	1912	1447	2529	1455
"KPNA7"	1695	33894	0	0	0	0	0	0	0	0	0	0	0	0	0	0	0	0
"KPNB1"	4223	33731	3040	3623	1760	1280	1960	1663	1355	1906	557	4155	6358	8559	6752	6606	7850	5877
"KPRP"	2525	4025	0	0	0	0	0	0	0	0	0	0	0	0	0	0	0	0
"KPTN"	1699	9122	0	0	0	0	0	0	94	73	0	0	101	107	145	85	153	92
"KRAS"	5427	45676	730	220	450	280	143	77	512	317	85	300	1230	1408	1173	916	1305	827
"KRBA1"	4033	19516	51	0	31	20	0	0	204	86	69	0	112	97	146	89	232	110
"KRBA2"	2546	8058	54	0	38	16	0	0	76	0	52	0	55	14	90	0	96	0
"KRC"	1709	188736	30	0	17	13	0	0	68	0	0	0	0	0	0	0	0	0
"KRCC1"	1757	28526	1647	707	859	788	397	310	998	479	944	600	1038	1191	1194	924	1342	825
"KREMEN1"	6142	73739	0	0	0	0	0	0	25	0	0	0	74	70	0	4	3	0
"KREMEN2"	2345	4165	191	16	70	121	0	16	108	78	275	55	20	50	44	11	100	0
"KRI1"	3132	12937	333	73	186	147	56	17	93	149	55	126	596	683	719	634	882	614
"KRIT1"	5016	47133	2366	939	1370	996	474	465	1401	425	362	657	714	828	787	608	869	473
"KRMP1"	206	206	0	0	0	0	0	0	0	0	0	0	7	0	7	0	7	5
"KRR1"	3365	13999	2208	1462	1214	994	762	700	1083	870	606	907	5289	6390	5678	5431	5535	3948
"KRSP1"	2056	7089	0	0	0	0	0	0	13	0	0	0	0	0	0	0	0	0
"KRT1"	2460	5673	0	0	0	0	0	0	0	0	0	0	0	3	0	0	0	0
"KRT10"	2147	4495	0	0	0	0	0	0	0	0	0	0	21	18	50	158	53	164
"KRT12"	2000	6034	0	0	0	0	0	0	0	0	0	0	0	0	0	0	0	0
"KRT13"	1858	4624	0	0	0	0	0	0	37	11	0	0	0	0	0	0	0	0
"KRT14"	1642	4616	0	0	0	0	0	0	21	0	0	0	0	1	0	0	0	0
"KRT15"	2620	8030	0	0	0	0	0	0	0	12	0	0	0	0	0	0	0	0
"KRT16"	1723	3048	0	0	0	0	0	0	22	17	0	0	0	0	0	0	0	0
"KRT17"	1582	5192	0	0	0	0	0	0	28	35	0	0	118	284	244	386	157	122
"KRT18"	2161	3815	0	0	0	0	0	0	0	0	0	0	0	0	3	3	0	4
"KRT19"	1476	4773	0	0	0	0	0	0	11	0	0	0	0	0	0	0	0	0
"KRT1B"	3398	13837	0	0	0	0	0	0	21	0	0	0	0	0	0	0	0	0
"KRT2"	2422	7618	0	0	0	0	0	0	9	0	0	0	0	0	0	0	0	0
"KRT20"	1743	9286	0	0	0	0	0	0	0	0	0	0	0	0	0	0	0	0
"KRT222"	1741	9546	0	0	0	0	0	0	0	0	0	0	128	54	114	40	141	61
"KRT222P"	1804	9527	0	0	0	0	0	0	0	0	0	0	0	0	0	0	0	0
"KRT23"	2156	14886	0	0	0	0	0	0	0	0	0	0	0	0	0	7	0	0
"KRT24"	1888	5760	0	0	0	0	0	0	0	0	0	0	0	0	0	0	0	0
"KRT25"	1677	7312	0	0	0	0	0	0	0	0	0	0	0	0	0	0	0	0
"KRT26"	1736	5921	0	0	0	0	0	0	0	0	0	0	0	0	0	0	0	0
"KRT27"	1619	5727	0	0	0	0	0	0	0	0	0	0	0	0	0	0	0	0
"KRT28"	1700	7765	0	0	0	0	0	0	8	0	0	0	0	0	0	0	0	0
"KRT3"	2318	6424	0	0	0	0	0	0	0	34	0	0	0	0	0	0	0	0
"KRT31"	1600	3867	0	0	0	0	0	0	0	0	0	0	0	0	0	0	0	0
"KRT32"	2011	7874	0	0	0	0	0	0	11	9	0	0	0	0	0	0	0	0
"KRT33A"	1259	4687	0	0	0	0	0	0	0	0	0	0	0	0	0	0	0	0
"KRT33B"	1608	6302	0	0	0	0	0	0	0	0	0	0	0	0	0	0	0	0
"KRT34"	1718	4715	0	0	0	0	0	0	0	0	0	0	0	0	0	0	0	0
"KRT35"	1678	4452	0	0	0	0	0	0	0	0	0	0	0	0	0	0	0	0
"KRT36"	1649	3728	0	0	0	0	0	0	20	30	0	0	0	0	0	0	0	0
"KRT37"	1725	4015	0	0	0	0	0	0	9	0	0	0	0	0	0	0	0	0
"KRT38"	2844	4977	0	0	0	0	0	0	17	0	0	0	0	0	0	0	0	0
"KRT39"	1703	8477	0	0	0	0	0	0	0	0	0	0	0	0	0	0	0	0
"KRT4"	2584	8003	0	0	0	0	0	0	0	0	0	0	0	0	0	0	0	0
"KRT40"	1947	9421	0	0	0	0	0	0	0	0	0	0	0	0	0	0	0	0
"KRT5"	2310	5884	0	0	0	0	0	0	0	12	0	0	0	0	0	0	0	0
"KRT6"	1790	15577	0	0	0	0	0	0	0	0	0	0	0	0	0	0	0	0
"KRT6A"	2458	6224	0	0	0	0	0	0	11	0	0	0	0	0	0	0	0	0
"KRT6B"	2289	5475	0	0	0	0	0	0	11	0	0	0	0	0	0	0	0	0
"KRT6C"	2297	5270	0	0	0	0	0	0	0	0	0	0	0	0	0	0	0	0
"KRT7"	1711	15757	0	0	0	0	0	0	22	0	0	0	0	0	0	0	0	0
"KRT71"	2273	9239	0	0	0	0	0	0	19	15	0	0	0	0	0	0	0	0
"KRT72"	2024	15951	0	0	0	0	0	0	14	0	0	0	0	0	0	0	0	0
"KRT73"	2292	10990	0	0	0	0	0	0	52	0	0	0	0	0	0	0	0	0
"KRT74"	2797	8008	0	0	0	0	0	0	11	17	0	0	0	0	0	0	0	0
"KRT75"	2134	10258	0	0	0	0	0	0	35	52	0	0	0	0	0	0	0	0
"KRT76"	2537	9191	0	0	0	0	0	0	11	0	0	0	0	0	0	0	0	0
"KRT77"	3312	13837	0	0	0	0	0	0	21	0	0	0	0	0	0	0	0	0
"KRT78"	1787	10034	0	0	0	0	0	0	48	0	0	0	0	0	0	0	0	0
"KRT79"	2074	12847	0	0	0	0	0	0	26	24	0	0	0	5	5	0	8	5
"KRT8"	2135	52657	0	0	0	0	0	0	65	44	0	0	0	0	1	0	0	1
"KRT80"	3923	16754	0	0	0	0	0	0	138	92	0	0	0	0	0	0	0	0
"KRT81"	1917	5602	0	0	0	0	0	0	49	16	0	0	0	0	0	0	0	0
"KRT82"	2690	12443	0	0	0	0	0	0	54	15	0	0	0	0	0	0	0	0
"KRT83"	1884	7099	0	0	0	0	0	0	0	0	0	0	0	0	0	0	0	0
"KRT84"	2082	7823	0	0	0	0	0	0	22	11	0	0	0	0	0	0	0	0
"KRT85"	2498	7519	0	0	0	0	0	0	13	17	0	0	0	0	0	0	0	0
"KRT86"	2226	34488	0	0	0	0	0	0	74	36	0	0	0	0	0	0	0	0
"KRT9"	2295	6216	0	0	0	0	0	0	23	0	0	0	0	0	0	0	0	0
"KRTAP1-1"	904	904	0	0	0	0	0	0	0	0	0	0	0	0	0	0	0	0
"KRTAP1-3"	970	970	0	0	0	0	0	0	0	0	0	0	0	0	0	0	0	0
"KRTAP1-5"	1175	1175	0	0	0	0	0	0	0	0	0	0	0	0	0	0	0	0
"KRTAP10-1"	1012	1012	0	0	0	0	0	0	43	0	0	0	0	0	0	0	0	0
"KRTAP10-10"	1099	1099	0	0	0	0	0	0	27	0	0	0	0	0	0	0	0	0
"KRTAP10-11"	1235	1235	0	0	0	0	0	0	0	0	0	0	0	0	0	0	0	0
"KRTAP10-12"	874	874	0	0	0	0	0	0	0	0	0	0	0	0	0	0	0	0
"KRTAP10-2"	1072	1072	0	0	0	0	0	0	19	0	0	0	0	0	0	0	0	0
"KRTAP10-3"	739	739	0	0	0	0	0	0	0	0	0	0	0	0	0	0	0	0
"KRTAP10-4"	1383	1383	0	0	0	0	0	0	0	0	0	0	0	0	0	0	0	0
"KRTAP10-5"	919	919	0	0	0	0	0	0	0	0	0	0	0	0	0	0	0	0
"KRTAP10-6"	1238	1238	0	0	0	0	0	0	0	13	0	0	0	0	0	0	0	0
"KRTAP10-7"	1574	1588	0	0	0	0	0	0	0	0	0	0	0	0	0	0	0	0
"KRTAP10-8"	877	877	0	0	0	0	0	0	0	10	0	0	0	0	0	0	0	0
"KRTAP10-9"	1256	1256	0	0	0	0	0	0	0	0	0	0	0	0	0	0	0	0
"KRTAP11-1"	910	910	0	0	0	0	0	0	0	0	0	0	0	0	0	0	0	0
"KRTAP12-1"	587	587	0	0	0	0	0	0	0	0	0	0	0	0	0	0	0	0
"KRTAP12-2"	739	739	0	0	0	0	0	0	0	0	0	0	0	0	0	0	0	0
"KRTAP12-3"	410	410	0	0	0	0	0	0	11	12	0	0	0	0	0	0	0	0
"KRTAP12-4"	448	448	0	0	0	0	0	0	30	12	0	0	0	0	0	0	0	0
"KRTAP13-1"	746	746	0	0	0	0	0	0	0	0	0	0	0	0	0	0	0	0
"KRTAP13-2"	849	849	0	0	0	0	0	0	0	0	0	0	0	0	0	0	0	0
"KRTAP13-3"	521	521	0	0	0	0	0	0	0	0	0	0	0	0	0	0	0	0
"KRTAP13-4"	482	482	0	0	0	0	0	0	0	0	0	0	0	0	0	0	0	0
"KRTAP15-1"	453	453	0	0	0	0	0	0	0	0	0	0	0	0	0	0	0	0
"KRTAP17-1"	778	778	0	0	0	0	0	0	0	0	0	0	0	0	0	0	0	0
"KRTAP19-1"	272	272	0	0	0	0	0	0	0	0	0	0	0	0	0	0	0	0
"KRTAP19-2"	158	158	0	0	0	0	0	0	0	0	0	0	0	0	0	0	0	0
"KRTAP19-3"	495	495	0	0	0	0	0	0	0	0	0	0	0	0	0	0	0	0
"KRTAP19-4"	255	255	0	0	0	0	0	0	0	0	0	0	0	0	0	0	0	0
"KRTAP19-5"	219	219	0	0	0	0	0	0	0	0	0	0	0	0	0	0	0	0
"KRTAP19-6"	329	329	0	0	0	0	0	0	0	0	0	0	0	0	0	0	0	0
"KRTAP19-7"	192	192	0	0	0	0	0	0	0	0	0	0	0	0	0	0	0	0
"KRTAP19-8"	318	318	0	0	0	0	0	0	0	0	0	0	0	0	0	0	0	0
"KRTAP2-1"	772	772	0	0	0	0	0	0	0	0	0	0	0	0	0	0	0	0
"KRTAP2-2"	712	712	0	0	0	0	0	0	0	0	0	0	0	0	0	0	0	0
"KRTAP2-4"	858	858	0	0	0	0	0	0	0	0	0	0	0	0	0	0	0	0
"KRTAP20-1"	171	171	0	0	0	0	0	0	0	0	0	0	0	0	0	0	0	0
"KRTAP20-2"	198	198	0	0	0	0	0	0	0	0	0	0	0	0	0	0	0	0
"KRTAP20-3"	274	274	0	0	0	0	0	0	0	0	0	0	0	0	0	0	0	0
"KRTAP20-4"	225	225	0	0	0	0	0	0	0	0	0	0	0	0	0	0	0	0
"KRTAP21-1"	239	239	0	0	0	0	0	0	0	0	0	0	0	0	0	0	0	0
"KRTAP21-2"	251	251	0	0	0	0	0	0	0	0	0	0	0	0	0	0	0	0
"KRTAP22-1"	147	147	0	0	0	0	0	0	0	0	0	0	0	0	0	0	0	0
"KRTAP23-1"	209	209	0	0	0	0	0	0	0	0	0	0	0	0	0	0	0	0
"KRTAP24-1"	1649	1649	0	0	0	0	0	0	0	0	0	0	0	0	0	0	0	0
"KRTAP25-1"	371	371	0	0	0	0	0	0	0	0	0	0	0	0	0	0	0	0
"KRTAP26-1"	1157	1157	0	0	0	0	0	0	0	0	0	0	0	0	0	0	0	0
"KRTAP27-1"	683	683	0	0	0	0	0	0	0	0	0	0	0	0	0	0	0	0
"KRTAP3-1"	594	594	0	0	0	0	0	0	0	0	0	0	0	0	0	0	0	0
"KRTAP3-2"	694	694	0	0	0	0	0	0	0	0	0	0	0	0	0	0	0	0
"KRTAP3-3"	705	705	0	0	0	0	0	0	0	0	0	0	0	0	0	0	0	0
"KRTAP4-1"	785	22266	0	0	0	0	0	0	0	0	0	0	0	0	0	0	0	0
"KRTAP4-11"	1172	1172	0	0	0	0	0	0	0	0	0	0	0	0	0	0	0	0
"KRTAP4-12"	1074	1074	0	0	0	0	0	0	0	0	0	0	0	0	0	0	0	0
"KRTAP4-2"	762	762	0	0	0	0	0	0	0	0	0	0	0	0	0	0	0	0
"KRTAP4-3"	941	941	0	0	0	0	0	0	0	0	0	0	0	0	0	0	0	0
"KRTAP4-4"	1077	1077	0	0	0	0	0	0	0	0	0	0	0	0	0	0	0	0
"KRTAP4-5"	878	878	0	0	0	0	0	0	0	0	0	0	0	0	0	0	0	0
"KRTAP4-7"	937	937	0	0	0	0	0	0	0	0	0	0	0	0	0	0	0	0
"KRTAP4-8"	1141	1141	0	0	0	0	0	0	0	0	0	0	0	0	0	0	0	0
"KRTAP4-9"	1099	1099	0	0	0	0	0	0	0	0	0	0	0	0	0	0	0	0
"KRTAP4.6"	1015	1015	0	0	0	0	0	0	0	0	0	0	0	0	0	0	0	0
"KRTAP5-1"	943	943	0	0	0	0	0	0	69	0	0	0	0	0	0	0	0	0
"KRTAP5-10"	1059	1059	0	0	0	0	0	0	10	18	0	0	0	0	0	0	0	0
"KRTAP5-11"	1020	1020	0	0	0	0	0	0	0	0	0	0	0	0	0	0	0	0
"KRTAP5-2"	1117	1117	0	0	0	0	0	0	29	0	0	0	0	0	0	0	0	0
"KRTAP5-3"	900	900	0	0	0	0	0	0	18	9	0	0	0	0	0	0	0	0
"KRTAP5-4"	1121	1182	0	0	0	0	0	0	14	17	0	0	0	0	0	0	0	0
"KRTAP5-5"	1126	1126	0	0	0	0	0	0	0	0	0	0	0	0	0	0	0	0
"KRTAP5-6"	561	561	0	0	0	0	0	0	0	0	0	0	0	0	0	0	0	0
"KRTAP5-7"	899	899	0	0	0	0	0	0	14	0	0	0	0	0	0	0	0	0
"KRTAP5-8"	1184	1184	0	0	0	0	0	0	0	0	0	0	0	0	0	0	0	0
"KRTAP5-9"	1189	1189	0	0	0	0	0	0	22	0	0	0	0	0	0	0	0	0
"KRTAP6-1"	219	219	0	0	0	0	0	0	0	0	0	0	0	0	0	0	0	0
"KRTAP6-2"	189	189	0	0	0	0	0	0	0	0	0	0	0	0	0	0	0	0
"KRTAP6-3"	616	616	0	0	0	0	0	0	0	0	0	0	0	0	0	0	0	0
"KRTAP7-1"	693	693	0	0	0	0	0	0	0	0	0	0	0	0	0	0	0	0
"KRTAP8-1"	556	556	0	0	0	0	0	0	0	0	0	0	0	0	0	0	0	0
"KRTAP9-2"	1005	1005	0	0	0	0	0	0	0	0	0	0	0	0	0	0	0	0
"KRTAP9-4"	967	967	0	0	0	0	0	0	0	0	0	0	0	0	0	0	0	0
"KRTAP9-8"	987	987	0	0	0	0	0	0	0	0	0	0	0	0	0	0	0	0
"KRTAP9-9"	975	23902	0	0	0	0	0	0	0	0	0	0	0	0	0	0	0	0
"KRTCAP2"	1494	1929	83	31	45	38	31	0	146	36	279	87	621	551	1162	1031	1027	864
"KRTCAP3"	947	1852	0	0	0	0	0	0	16	0	0	0	3	0	10	0	0	8
"KRTDAP"	418	3128	4	0	4	0	0	0	0	1	0	0	0	0	0	0	0	0
"KSR1"	4508	151683	584	79	318	266	44	35	1450	154	256	113	373	470	461	335	551	344
"KSR2"	17028	515213	0	0	0	0	0	0	85	14	0	0	1	0	0	0	0	0
"KTELC1"	3541	25769	1244	5741	690	554	2781	2960	371	2530	92	3065	654	4967	624	1445	1033	1088
"KTI12"	1697	1697	30	0	30	0	0	0	29	22	0	0	325	239	370	282	436	253
"KTN1"	4958	104378	11838	2926	6656	5182	1670	1256	5106	1065	2619	2025	13484	13831	9357	7600	13171	8502
"KU-MEL-3"	1144	1308	0	0	0	0	0	0	0	0	0	0	0	0	0	0	0	0
"KY"	5713	51099	0	0	0	0	0	0	101	23	0	0	2	2	3	2	4	4
"KYNU"	1772	164691	50198	372564	28026	22172	201665	170899	8749	193704	5615	273715	1377	18398	1529	15924	2199	4649
"Kid"	413	587	49	0	49	0	0	0	64	0	0	0	227	126	304	105	369	51
"Kin17"	1816	32578	233	48	144	89	36	12	288	83	57	68	202	160	252	174	240	153
"Kox-1"	3946	167131	0	0	0	0	0	0	0	0	0	0	0	0	0	0	0	0
"L-SOX5"	2018	414581	0	0	0	0	0	0	0	0	0	0	0	0	0	0	0	0
"L01117"	1655	1655	1005	256	585	420	114	142	460	197	661	123	27995	8633	17194	8506	29128	9598
"L07266"	102	102	0	0	0	0	0	0	0	0	0	0	0	0	0	0	0	0
"L12234"	115	115	0	0	0	0	0	0	0	13	0	0	0	0	0	0	0	0
"L13779"	727	33773	0	0	0	0	0	0	0	0	0	0	0	0	0	0	0	0
"L1CAM"	5054	14427	0	0	0	0	0	0	264	46	0	0	22	16	0	0	0	0
"L1TD1"	3858	17504	0	0	0	0	0	0	0	0	0	0	0	0	0	0	0	0
"L25629"	199	509	0	0	0	0	0	0	0	0	0	0	0	0	0	0	0	0
"L2HGDH"	6103	69795	5	0	5	0	0	0	0	0	0	0	78	58	37	20	47	18
"L37717"	160	160	0	0	0	0	0	0	0	0	0	0	0	0	0	0	0	0
"L3MBTL"	4390	22298	130	0	83	47	0	0	477	59	15	14	51	5	40	26	150	3
"L3MBTL2"	3314	25963	528	92	285	243	60	32	526	258	303	160	854	735	1048	845	1408	925
"L3MBTL3"	4222	122852	31	0	25	6	0	0	58	3	0	17	134	140	130	137	163	124
"L3MBTL4"	3606	460206	32	1027	12	20	588	439	72	2480	0	1956	13	0	10	15	19	12
"L40518"	299	16040	0	0	0	0	0	0	0	0	0	0	0	0	1516	862	0	0
"LA16c-360B4.1"	2143	117351	434	197	258	176	99	98	1351	537	348	271	65	188	105	126	225	156
"LACE1"	2266	228153	684	148	410	274	62	86	795	237	45	170	143	174	181	142	187	106
"LACRT"	513	4042	0	0	0	0	0	0	0	0	0	0	0	0	0	0	0	0
"LACTB"	1939	20224	2249	2965	1297	952	1608	1357	717	1094	292	2373	2588	4110	1668	2785	3600	1997
"LACTB2"	1559	31947	15	11	15	0	11	0	73	8	0	0	340	426	468	365	424	310
"LAD1"	2847	18703	0	0	0	0	0	0	140	21	0	0	10	82	17	33	4	3
"LAG3"	2588	5940	0	0	0	0	0	0	66	0	0	0	1	0	10	0	0	0
"LAGE3"	1819	2357	78	47	42	36	23	24	26	23	0	0	134	153	175	217	224	156
"LAIR-2"	712	10301	0	0	0	0	0	0	0	0	0	0	0	0	0	0	0	0
"LAIR1"	2826	11488	96	30	66	30	16	14	273	205	201	318	407	1058	2971	4144	1671	1474
"LAIR2"	702	7884	0	0	0	0	0	0	0	0	0	0	2	0	14	67	9	6
"LALBA"	731	2363	0	0	0	0	0	0	0	0	0	0	0	0	0	0	0	0
"LAMA1"	10550	175927	0	0	0	0	0	0	23	0	0	0	0	0	0	0	0	0
"LAMA2"	9748	633424	12968	13095	6439	6529	6992	6103	5583	3124	1968	1835	262	583	131	83	203	3
"LAMA3"	10578	265467	0	0	0	0	0	0	10	0	0	0	0	0	0	0	0	0
"LAMA4"	7326	146696	0	0	0	0	0	0	0	0	0	0	0	0	0	0	0	0
"LAMA5"	11504	58247	9	2	6	3	2	0	341	221	0	0	10	16	4	5	8	4
"LAMB1"	5880	79560	1131	461	693	438	273	188	728	206	205	260	5	0	8	0	59	6
"LAMB2"	5839	12053	159	17	59	100	0	17	420	202	43	13	822	820	527	560	1509	880
"LAMB2L"	1543	1543	0	0	0	0	0	0	0	0	0	0	0	0	0	0	0	0
"LAMB3"	4327	36461	49	1125	30	19	703	422	117	940	14	3206	370	1217	331	852	280	384
"LAMB4"	5892	106807	0	0	0	0	0	0	0	0	0	0	0	0	0	0	0	0
"LAMC1"	7916	122133	108	0	65	43	0	0	214	33	10	0	839	780	1142	951	1601	1077
"LAMC2"	5646	59090	0	0	0	0	0	0	0	0	0	0	0	0	0	0	0	0
"LAMC3"	6126	83944	0	0	0	0	0	0	214	57	0	0	0	0	0	0	0	0
"LAMP1"	2549	26274	192	63	127	65	35	28	311	406	16	168	2981	3148	10560	12173	8525	8654
"LAMP2"	6596	43202	1863	1580	1014	849	852	728	778	685	468	1367	6236	7065	7676	7411	7921	6256
"LAMP3"	3346	40665	1199	10972	658	541	3162	7810	27	7978	0	9721	807	9992	1341	6924	1062	2641
"LAMR1P15"	1441	1441	0	0	0	0	0	0	0	0	0	0	0	0	0	0	0	0
"LANCL1"	4611	45519	59	7	33	26	0	7	199	0	32	0	642	739	656	426	731	386
"LANCL2"	4360	68294	448	1152	235	213	661	491	228	561	0	436	411	637	581	610	686	489
"LANCL3"	3337	105929	0	0	0	0	0	0	20	0	0	0	0	0	0	0	0	0
"LAP3"	2113	30665	3877	5972	2175	1702	3227	2745	1408	2446	2909	5254	2932	5148	8106	6567	7393	6064
"LAPTM4A"	1771	19379	1372	103	772	600	58	45	715	51	265	10	6111	4964	4631	3717	5064	3719
"LAPTM4B"	2244	77022	2	0	0	2	0	0	0	0	0	0	146	164	228	197	139	125
"LAPTM5"	2248	25370	3706	363	2004	1702	211	152	1319	385	1444	373	19056	17998	9692	8744	8620	18573
"LARGE"	4216	647355	11	0	0	11	0	0	82	0	0	24	7	6	0	0	0	0
"LARP1"	7244	62274	6523	865	3761	2762	460	405	2527	671	3740	818	5296	4517	6407	3931	7458	4110
"LARP1B"	3975	149786	631	90	339	292	61	29	514	82	0	107	477	796	467	544	514	411
"LARP2"	1811	101101	558	82	289	269	61	21	478	69	0	107	335	567	328	327	351	304
"LARP4"	6494	79140	2694	451	1560	1134	305	146	1263	195	718	594	1698	2131	2168	1771	2246	1482
"LARP4B"	5657	76220	10697	8910	6054	4643	4910	4000	4095	4437	5447	7004	3086	3151	1456	2505	4433	2577
"LARP6"	2050	22609	0	0	0	0	0	0	8	0	0	0	0	0	0	0	0	0
"LARP7"	2508	20623	355	386	219	136	224	162	242	142	54	302	1226	1545	1248	1053	1362	814
"LARS"	4881	69707	999	359	567	432	251	108	621	344	455	243	2262	2208	2653	2371	2962	1980
"LARS2"	4225	160255	295	163	200	95	72	91	470	126	99	131	502	530	716	669	889	627
"LAS1"	1673	80506	0	0	0	0	0	0	20	0	0	0	0	0	0	0	0	0
"LAS1L"	2478	22201	272	0	137	135	0	0	114	29	0	29	448	442	613	559	773	464
"LASP1"	4286	51912	7874	680	4297	3577	351	329	2779	486	7781	1412	15144	13398	17436	13528	20539	14350
"LASS1"	2566	27594	0	0	0	0	0	0	254	36	0	0	0	0	0	0	0	0
"LASS2"	2515	9792	258	105	149	109	43	62	311	68	312	212	4125	4258	4141	3903	5745	3666
"LASS3"	4087	143932	0	0	0	0	0	0	13	0	0	0	0	0	0	0	0	0
"LASS4"	1886	53087	6	0	4	2	0	0	242	69	0	0	15	18	19	15	12	16
"LASS5"	3001	37517	4484	3410	2559	1925	1849	1561	1470	1492	2793	3974	1244	791	658	373	667	368
"LASS6"	6294	318319	24180	16112	13717	10463	8832	7280	11935	8641	3942	7706	3927	5254	4289	4185	4296	3275
"LAT"	2607	6572	186	0	135	51	0	0	110	95	6	67	107	245	407	98	339	164
"LAT2"	2204	20078	1230	297	608	622	154	143	425	525	1632	385	3075	3005	1904	1711	3454	2153
"LATHEO"	2499	77325	141	17	101	40	17	0	247	52	0	52	129	217	359	329	452	248
"LATS1"	4763	57343	1473	644	900	573	345	299	998	676	417	1012	466	468	646	448	1104	243
"LATS2"	5548	88546	3081	8202	1680	1401	4312	3890	1577	4613	156	4127	1093	706	1162	1232	1225	904
"LAX1"	3281	11196	2	0	0	2	0	0	0	0	0	0	19	14	0	0	0	0
"LAYN"	2102	20557	0	0	0	0	0	0	0	0	0	0	48	58	12	0	33	0
"LBH"	2941	28504	0	12	0	0	0	12	69	18	0	37	140	166	94	65	152	113
"LBP"	1838	30770	0	0	0	0	0	0	0	0	0	0	0	0	0	0	0	0
"LBP-32"	3646	50621	0	0	0	0	0	0	14	79	0	0	2	560	7	177	0	87
"LBP-9"	7957	17606	0	0	0	0	0	0	42	11	0	0	0	0	0	0	0	0
"LBR"	3805	26581	890	61	495	395	31	30	622	48	282	13	2106	1889	2522	1715	2065	1311
"LBX1"	1286	1985	0	0	0	0	0	0	0	0	0	0	0	0	0	0	0	0
"LBX2"	1453	5800	27	0	15	12	0	0	110	49	0	0	94	122	0	0	21	5
"LBXCOR1"	2776	8235	0	0	0	0	0	0	13	26	0	0	1	32	0	0	0	0
"LCA5"	4727	52440	0	0	0	0	0	0	0	0	0	0	0	0	0	0	0	0
"LCA5L"	3260	16865	0	0	0	0	0	0	13	0	0	0	0	18	0	0	0	3
"LCAT"	1360	4230	63	11	43	20	0	11	87	81	106	25	0	5	64	8	131	26
"LCE1A"	333	333	0	0	0	0	0	0	0	0	0	0	0	0	0	0	0	0
"LCE1B"	1141	1141	0	0	0	0	0	0	0	0	0	0	0	0	0	0	0	0
"LCE1C"	697	1798	0	0	0	0	0	0	0	0	0	0	0	0	0	0	0	0
"LCE1D"	431	1431	0	0	0	0	0	0	0	0	0	0	0	0	0	0	0	0
"LCE1E"	1178	2147	0	0	0	0	0	0	0	0	0	0	0	0	0	0	0	0
"LCE1F"	357	357	0	0	0	0	0	0	0	0	0	0	0	0	0	0	0	0
"LCE2A"	592	1078	0	0	0	0	0	0	0	0	0	0	0	0	0	0	0	0
"LCE2B"	611	1277	0	0	0	0	0	0	0	0	0	0	0	0	0	0	0	0
"LCE2C"	613	1278	0	0	0	0	0	0	0	0	0	0	0	0	0	0	0	0
"LCE2D"	610	1264	0	0	0	0	0	0	10	0	0	0	0	0	0	0	0	0
"LCE3A"	270	270	0	0	0	0	0	0	0	0	0	0	0	0	0	0	0	0
"LCE3B"	288	288	0	0	0	0	0	0	0	0	0	0	0	0	0	0	0	0
"LCE3C"	426	426	0	0	0	0	0	0	0	0	0	0	0	0	0	0	0	0
"LCE3D"	611	1121	0	0	0	0	0	0	0	0	0	0	0	0	0	0	0	0
"LCE3E"	612	1119	0	0	0	0	0	0	0	0	0	0	0	0	0	0	0	0
"LCE4A"	389	389	0	0	0	0	0	0	0	0	0	0	0	0	0	0	0	0
"LCE5A"	820	1334	0	0	0	0	0	0	0	0	0	0	0	0	0	0	0	0
"LCE6A"	643	1130	0	0	0	0	0	0	0	0	0	0	0	0	0	0	0	0
"LCK"	2202	12055	22	0	12	10	0	0	184	76	0	0	61	96	42	40	113	78
"LCLAT1"	5266	196955	0	0	0	0	0	0	0	9	0	9	13	23	0	5	5	3
"LCMT"	1385	66506	1901	40	1038	863	22	18	1169	68	664	45	299	465	528	464	471	480
"LCMT1"	1381	66506	1901	40	1038	863	22	18	1169	68	664	45	299	465	528	464	471	480
"LCMT2"	2917	2917	0	0	0	0	0	0	14	0	0	0	219	147	245	88	314	118
"LCN1"	786	5094	0	0	0	0	0	0	62	48	0	0	0	0	0	0	0	0
"LCN10"	2017	4788	0	0	0	0	0	0	75	26	0	0	0	0	0	0	0	0
"LCN12"	1804	3178	1	0	1	0	0	0	50	29	0	0	0	0	3	0	0	0
"LCN15"	768	4880	2	0	2	0	0	0	12	0	0	0	1	0	0	0	0	0
"LCN2"	1206	1916	1	0	0	1	0	0	105	58	0	0	0	0	0	0	0	0
"LCN6"	2497	10354	0	0	0	0	0	0	171	64	0	0	0	0	0	0	0	0
"LCN8"	1392	2573	0	0	0	0	0	0	47	9	0	0	0	0	0	0	0	0
"LCN9"	530	2589	0	0	0	0	0	0	16	16	0	0	0	0	0	0	0	0
"LCNL1"	1839	2767	1	0	1	0	0	0	68	36	0	0	1	4	0	0	0	0
"LCOR"	4842	125930	11528	11588	6510	5018	6282	5306	4836	4571	3766	9978	424	799	470	893	355	202
"LCORL"	3475	178543	7498	1706	4281	3217	1029	677	4393	1098	149	720	378	499	638	408	555	326
"LCP1"	3805	56402	22929	105414	12812	10117	56817	48597	5368	39928	7496	71233	62125	112362	24783	43386	30663	28559
"LCP2"	2525	49736	23316	112463	12963	10353	60525	51938	5217	44289	4982	35243	5160	5154	3458	11234	3944	5073
"LCT"	6291	49337	0	0	0	0	0	0	21	0	0	0	20	9	0	0	16	0
"LCTL"	2138	17298	0	0	0	0	0	0	22	36	0	0	99	220	110	116	117	89
"LDB1"	2306	7398	1177	260	656	521	67	193	666	280	1193	276	1237	1040	1283	715	1286	726
"LDB2"	2800	397256	0	0	0	0	0	0	19	16	0	0	0	0	0	0	0	0
"LDB3"	5389	67560	0	0	0	0	0	0	282	162	0	0	0	0	0	0	0	0
"LDHA"	2216	13831	697	315	399	298	204	111	342	239	20	238	7449	8444	7874	7033	8861	7750
"LDHAL6A"	2590	23775	273	48	191	82	17	31	116	35	0	0	17	31	0	5	4	3
"LDHAL6B"	1667	1667	124	308	83	41	174	134	104	289	0	110	0	10	0	0	0	0
"LDHB"	1546	22454	20	0	15	5	0	0	50	0	0	0	672	1030	3555	2584	2623	2278
"LDHC"	1291	38941	1	0	0	1	0	0	0	0	0	0	2	0	4	0	5	4
"LDHD"	2077	4908	87	7	37	50	0	7	128	58	61	10	726	550	319	330	545	413
"LDLR"	5280	44448	1467	3547	799	668	1925	1622	623	2304	70	4590	1691	4918	1175	2753	1436	2331
"LDLRAD1"	791	9299	0	0	0	0	0	0	46	0	0	0	0	0	0	0	0	0
"LDLRAD2"	4017	12958	56	22	24	32	9	13	10	37	0	0	313	343	278	240	512	384
"LDLRAD3"	2975	287231	8	165	8	0	97	68	76	497	0	0	28	18	58	79	47	64
"LDLRAP1"	2942	25301	1132	116	672	460	82	34	758	96	678	0	671	554	693	467	871	621
"LDOC1"	1372	1372	0	0	0	0	0	0	0	0	0	0	0	0	0	0	0	0
"LDOC1L"	5326	5557	11	0	11	0	0	0	60	18	0	0	6	542	826	430	987	455
"LEAP2"	709	1225	132	324	65	67	170	154	86	1	0	115	14	8	8	7	0	4
"LECT1"	1453	36549	0	0	0	0	0	0	21	0	0	0	0	0	0	0	0	0
"LECT2"	1081	8125	0	0	0	0	0	0	0	0	0	0	0	0	0	0	0	0
"LEF1"	3080	120879	0	0	0	0	0	0	0	0	0	0	3	5	0	0	0	0
"LEFTY1"	1619	2855	0	0	0	0	0	0	0	10	0	0	0	0	0	0	0	0
"LEFTY2"	2023	4619	0	0	0	0	0	0	0	0	0	0	0	0	0	0	0	0
"LEKR1"	2895	219824	0	0	0	0	0	0	0	0	0	0	0	0	0	0	0	0
"LELP1"	523	1677	0	0	0	0	0	0	0	0	0	0	0	0	0	0	0	0
"LEMD1"	927	40670	0	0	0	0	0	0	0	7	0	0	0	0	0	0	0	0
"LEMD2"	2948	17917	1852	587	1033	819	322	265	1121	406	1318	865	1284	544	2041	1258	1335	1231
"LEMD3"	4757	78738	3076	983	1862	1214	527	456	1539	791	246	793	1225	1002	1091	647	1143	590
"LEMP-1(a)"	861	40670	0	0	0	0	0	0	0	7	0	0	0	0	0	0	0	0
"LENEP"	650	730	11	0	11	0	0	0	14	25	0	0	0	0	0	0	0	0
"LENG1"	889	4066	12	0	9	3	0	0	138	32	0	14	106	222	105	122	192	143
"LENG4"	1487	14064	666	37	295	371	17	20	256	62	876	103	2516	2200	2044	1710	2900	2036
"LENG6"	526	526	0	0	0	0	0	0	0	0	0	0	0	0	0	0	0	0
"LENG7"	548	3515	2000	8747	1125	875	4796	3951	548	4905	291	5785	3	5	22466	27445	32519	16182
"LENG8"	5167	12186	7104	4494	3772	3332	2343	2151	2360	2397	7433	5418	3097	3301	7609	6282	10963	5026
"LENG9"	1915	1915	4390	3022	2373	2017	1592	1430	1464	151	5282	3254	2366	2669	5439	2916	5267	3710
"LEO1"	2157	33735	528	288	336	192	147	141	371	118	0	178	557	399	729	375	748	436
"LEP"	3430	16353	0	0	0	0	0	0	0	0	0	0	0	0	0	0	0	0
"LEPR"	5171	214794	2064	485	1112	952	248	237	1336	374	415	287	3748	4181	2776	2815	3414	1830
"LEPRE1"	3079	20711	477	42	205	272	25	17	314	90	196	33	1014	625	1423	977	1984	1081
"LEPREL1"	3712	164391	27	3696	0	27	2025	1671	10	660	0	0	99	119	15	14	15	0
"LEPREL2"	2955	10832	0	0	0	0	0	0	51	38	0	0	7	0	11	9	30	12
"LEPROT"	1649	216504	2064	485	1112	952	248	237	1336	374	415	287	3748	4181	2776	2815	3414	1830
"LEPROTL1"	2715	12666	573	0	321	252	0	0	443	0	210	0	3117	2464	1797	1304	2322	1455
"LETM1"	5474	44768	650	75	393	257	45	30	446	290	24	219	1033	1020	1149	882	1574	892
"LETM2"	2041	7931	73	0	42	31	0	0	96	12	0	17	4	14	0	0	10	0
"LETMD1"	2179	12124	890	279	511	379	131	148	410	157	477	253	964	587	911	500	1126	421
"LEUTX"	673	9541	0	0	0	0	0	0	0	0	0	0	0	0	0	0	0	0
"LFIRE1"	1767	45974	49	0	18	31	0	0	66	0	0	0	141	67	235	83	141	61
"LFNG"	2380	8584	1390	223	752	638	149	74	440	200	1970	380	922	478	1369	637	1344	658
"LGALS1"	560	4196	336	366	188	148	204	162	61	253	160	549	11171	9019	8882	9698	13348	9936
"LGALS12"	1831	8789	0	0	0	0	0	0	0	0	0	0	0	0	0	0	0	0
"LGALS13"	598	4946	0	0	0	0	0	0	0	0	0	0	0	0	0	0	0	0
"LGALS14"	1087	5143	0	0	0	0	0	0	0	0	0	0	0	0	0	0	0	0
"LGALS16"	500	4627	0	0	0	0	0	0	0	0	0	0	0	0	0	0	0	0
"LGALS2"	531	9772	122	0	17	105	0	0	119	41	154	35	3	10	305	455	964	477
"LGALS3"	1068	16277	3368	3708	1851	1517	2078	1630	1413	1794	2577	3238	8446	6531	7905	11687	9504	10028
"LGALS3BP"	2265	8727	8	21	8	0	11	10	65	36	0	0	450	481	1240	486	1250	1050
"LGALS4"	1555	10068	0	0	0	0	0	0	59	0	0	0	0	0	0	0	0	0
"LGALS7"	498	2551	0	0	0	0	0	0	0	0	0	0	0	0	0	0	0	0
"LGALS7B"	492	2545	0	0	0	0	0	0	0	0	0	0	0	0	0	0	0	0
"LGALS8"	3014	26259	1629	130	980	649	68	62	937	44	506	80	3667	3129	4003	2634	817	2157
"LGALS9"	1774	18413	1956	509	987	969	286	223	848	257	1311	531	4047	2980	7506	6132	6699	5202
"LGALS9B"	1513	18413	1956	509	987	969	286	223	860	257	1311	531	4047	2980	7823	6395	6930	5439
"LGALS9C"	1729	18161	0	0	0	0	0	0	12	0	0	0	0	0	356	281	275	263
"LGI1"	2373	40351	0	0	0	0	0	0	0	0	0	0	0	0	0	0	0	0
"LGI2"	6347	31945	0	0	0	0	0	0	0	0	0	0	0	0	0	0	0	0
"LGI3"	3272	10001	0	0	0	0	0	0	121	56	0	0	0	0	0	0	0	0
"LGI4"	2897	10763	0	0	0	0	0	0	54	53	0	0	0	0	0	0	0	0
"LGICZ"	2176	3624	181	231	162	19	72	159	70	0	0	0	0	1735	0	0	0	0
"LGMD2B"	7090	233141	2486	1241	1557	929	634	607	5368	2984	877	818	1992	1942	9108	9587	6449	4465
"LGMN"	2150	44857	15	4	15	0	4	0	194	42	0	0	414	384	1170	1936	1031	879
"LGR4"	5263	106826	71	0	50	21	0	0	123	0	0	0	262	245	337	206	470	250
"LGR5"	4066	146275	0	0	0	0	0	0	0	0	0	0	0	0	0	0	0	0
"LGR6"	3475	125772	0	0	0	0	0	0	318	150	0	0	0	0	0	0	0	0
"LGR7"	3046	130217	0	0	0	0	0	0	0	0	0	0	0	1	0	0	0	0
"LGSN"	5637	44027	0	0	0	0	0	0	0	0	0	0	0	0	0	0	0	0
"LGTN"	2112	20932	595	129909	301	294	67482	62427	225	71182	22	137358	589	612	690	637	1193	775
"LHB"	525	1111	0	0	0	0	0	0	26	10	0	0	1	0	0	0	42	0
"LHCGR"	3096	68961	0	0	0	0	0	0	0	0	0	0	0	0	0	0	0	0
"LHFP"	2161	260328	761	17961	413	348	9793	8168	11	2301	0	11779	163	178	69	37	0	10
"LHFPL1"	1768	49497	0	0	0	0	0	0	8	0	0	0	0	0	0	0	0	0
"LHFPL2"	5048	163610	12480	10599	6828	5652	5669	4930	4841	4630	5063	10958	5101	728	5030	3738	593	375
"LHFPL3"	3226	579899	16	0	3	13	0	0	14	13	0	0	809	917	1771	794	2995	1526
"LHFPL4"	4883	55442	14	0	14	0	0	0	12	39	0	47	0	1	0	0	0	0
"LHFPL5"	2151	18783	0	0	0	0	0	0	38	0	0	0	0	0	0	0	0	0
"LHPP"	1620	152299	677	31	385	292	31	0	1774	420	276	59	280	401	334	340	447	342
"LHX1"	2288	5997	0	0	0	0	0	0	31	0	0	0	0	0	0	0	0	0
"LHX2"	2445	21555	0	0	0	0	0	0	92	97	0	0	0	27	0	29	0	0
"LHX3"	2407	6908	0	0	0	0	0	0	0	0	0	0	0	0	0	0	0	0
"LHX4"	1876	44748	221	97	130	91	64	33	223	155	0	29	50	118	140	59	155	0
"LHX5"	2089	9185	0	0	0	0	0	0	47	12	0	0	0	0	0	0	0	0
"LHX6"	3389	25007	0	0	0	0	0	0	53	17	0	0	0	0	0	0	0	0
"LHX8"	2381	33099	0	0	0	0	0	0	0	0	0	0	0	0	0	0	0	0
"LHX9"	2520	12758	0	0	0	0	0	0	0	16	0	0	0	0	0	0	0	0
"LIAS"	1737	18606	98	0	32	66	0	0	175	36	67	0	217	163	171	115	195	105
"LIF"	3922	6356	0	0	0	0	0	0	59	11	0	0	1	3	0	11	0	0
"LIFR"	10278	81685	0	0	0	0	0	0	15	0	0	0	0	0	0	0	0	0
"LIG"	5153	84746	10294	3061	5764	4530	1664	1397	4247	1406	6954	5192	2479	2736	2357	1951	2694	1763
"LIG1"	4111	54859	354	34	190	164	15	19	424	140	152	16	337	316	468	402	503	382
"LIG3"	3721	24552	840	616	431	409	345	271	510	328	15	289	1978	362	533	503	630	472
"LIG4"	4098	7338	243	145	148	95	93	52	141	70	0	0	695	1048	838	648	929	578
"LILRA1"	1920	7429	32	0	4	28	0	0	29	0	14	12	596	540	231	250	139	268
"LILRA2"	2350	14545	446	0	271	175	0	0	167	10	316	31	1124	869	726	943	718	915
"LILRA3"	1581	4383	0	3	0	0	2	1	0	2	0	0	0	2	87	253	95	14
"LILRA4"	1837	5695	36	2	24	12	1	1	54	14	103	0	0	0	16	0	0	0
"LILRA5"	1371	6057	0	0	0	0	0	0	0	49	0	0	81	270	61	250	73	124
"LILRA6"	3938	6257	1270	548	687	583	286	262	494	555	597	434	2674	2822	4145	5386	5693	3789
"LILRB1"	2982	20375	2820	1072	1456	1364	546	526	801	750	2369	1598	4266	4671	4163	3700	2995	2833
"LILRB2"	2938	7359	388	155	228	160	62	93	209	263	273	167	668	1170	1025	2226	1536	1491
"LILRB3"	2900	26579	885	393	462	423	224	169	181	210	324	267	1424	570	2823	2673	3650	2250
"LILRB4"	2095	5722	1049	1982	554	495	1010	972	157	720	653	1199	4118	4403	5041	6934	3160	4018
"LILRB5"	2490	6900	0	0	0	0	0	0	19	0	0	1	27	10	289	361	484	43
"LILRP2"	5288	5288	1	0	1	0	0	0	0	0	0	0	14	5	17	12	22	19
"LIM"	5693	216340	6454	25878	3758	2696	13900	11978	2747	14403	175	22307	2228	2741	2101	2017	1921	1294
"LIM2"	989	8049	0	0	0	0	0	0	36	0	0	0	0	0	0	0	0	0
"LIMA1"	3931	26332	119	58	47	72	15	43	196	105	0	254	2270	2430	1360	1189	3308	2008
"LIMCH1"	7710	161870	0	0	0	0	0	0	29	7	0	17	41	73	111	43	57	6
"LIMD1"	6291	86433	3801	1326	2115	1686	704	622	2033	671	1736	737	2308	1762	1927	1059	2679	1330
"LIMD2"	3465	4797	2379	1007	1275	1104	518	489	686	277	1541	1052	596	361	6568	5338	9481	6207
"LIME1"	2049	3328	348	3	246	102	2	1	182	546	62	231	204	167	241	205	445	342
"LIMK1"	3404	14362	2985	316	1719	1266	177	139	1285	245	4733	475	6060	3582	6610	4706	8095	4783
"LIMK2"	3861	31718	197	0	81	116	0	0	331	55	19	38	237	180	298	207	411	283
"LIMS1"	1869	29621	52150	24933	29037	23113	13427	11506	19232	7484	26376	19420	19398	20987	12477	10543	12619	8312
"LIMS2"	2516	35888	299	3368	189	110	1849	1519	592	2510	6	2535	33	50	14	37	438	365
"LIMS3"	3216	70140	0	0	0	0	0	0	0	0	0	0	0	0	1862	1554	2068	857
"LIN28"	4017	18951	0	0	0	0	0	0	26	20	0	0	0	0	0	0	0	0
"LIN28B"	5508	126285	0	0	0	0	0	0	0	0	0	0	0	0	0	0	0	0
"LIN37"	909	5909	3	0	0	3	0	0	278	199	0	9	522	480	645	473	928	597
"LIN52"	2320	115456	278	54	188	90	21	33	436	51	0	22	167	194	137	107	148	96
"LIN54"	6140	86228	258	61	152	106	51	10	348	14	0	0	438	316	461	165	428	221
"LIN7A"	1236	140525	1853	385	1059	794	230	155	746	88	0	0	606	859	91	106	117	72
"LIN7B"	760	4100	13	0	0	13	0	0	47	20	0	0	67	28	104	60	147	62
"LIN7C"	4851	12357	235	107	136	99	79	28	167	164	0	113	976	1354	802	851	881	609
"LIN9"	3343	78339	0	0	0	0	0	0	3	0	0	0	84	30	65	17	70	38
"LINCR"	587	4920	0	78	0	0	33	45	15	44	0	0	0	93	0	20	0	0
"LINGO1"	3309	83108	0	0	0	0	0	0	513	324	0	0	0	0	0	0	0	0
"LINGO2"	2799	770777	18	0	9	9	0	0	0	0	0	0	0	0	0	0	0	0
"LINGO3"	2132	18384	707	3	371	336	3	0	227	27	250	0	663	300	155	23	194	46
"LINGO4"	2608	5119	0	0	0	0	0	0	47	8	0	0	0	0	0	0	0	0
"LINS1"	2584	32970	240	334	95	145	177	157	194	385	0	289	280	484	359	301	356	165
"LIP1"	953	4175	129	102	60	69	59	43	141	71	158	45	76	172	184	53	268	117
"LIPA"	2762	201056	53893	109997	29911	23982	59138	50859	19552	46016	35880	15751	78021	502935	113679	196341	127270	118211
"LIPC"	2165	158299	0	0	0	0	0	0	84	7	0	0	0	0	0	0	0	0
"LIPE"	3815	25913	151	0	107	44	0	0	277	119	89	0	0	11	7	14	10	7
"LIPF"	1589	14480	0	0	0	0	0	0	0	0	0	0	0	0	0	0	0	0
"LIPG"	4149	30851	0	0	0	0	0	0	0	0	0	0	0	0	0	0	0	0
"LIPH"	2483	44800	0	0	0	0	0	0	0	0	0	0	0	0	0	0	0	0
"LIPI"	1643	98119	0	0	0	0	0	0	0	0	0	0	0	0	0	0	0	0
"LIPJ"	1494	20215	0	0	0	0	0	0	0	0	0	0	0	0	0	0	0	0
"LIPK"	1207	28212	0	0	0	0	0	0	0	0	0	0	0	0	0	0	0	0
"LIPM"	1680	17818	0	0	0	0	0	0	0	0	0	0	0	0	0	0	0	0
"LIPN"	1204	16836	0	0	0	0	0	0	0	0	0	0	0	0	0	0	0	0
"LIPT1"	1547	8195	0	0	0	0	0	0	11	0	0	0	117	68	73	29	131	47
"LIPT2"	961	1833	0	0	0	0	0	0	0	0	0	0	42	12	31	0	51	0
"LIR-5"	1613	2804	905	1752	413	492	1010	742	129	730	429	1211	2283	4334	2084	5930	793	1555
"LIR-8"	1128	2571	0	0	0	0	0	0	19	0	0	1	18	0	14	9	57	27
"LITAF"	2634	38649	25673	117904	14362	11311	63003	54901	3883	156	10810	187	1551	1481	11880	35394	12575	36863
"LIX1"	3972	50947	0	0	0	0	0	0	0	0	0	0	0	0	0	0	0	0
"LIX1L"	1406	22007	36	0	12	24	0	0	61	0	0	0	901	730	428	262	553	274
"LKAP"	1926	8397	147	6	63	84	4	2	40	49	142	66	298	312	456	278	544	254
"LKP"	1406	6485	474	147	285	189	87	60	165	77	0	26	1011	1323	1758	1547	1819	1468
"LKR/SDH"	5948	60278	0	0	0	0	0	0	0	0	0	0	0	0	0	0	0	0
"LL0XNC01-19D8.1"	1757	11507	0	0	0	0	0	0	0	0	0	0	0	0	0	0	0	0
"LLGL1"	4245	19252	124	22	120	4	22	0	381	102	41	0	4138	4137	324	286	577	1148
"LLGL2"	3573	49508	98	39	29	69	26	13	289	228	34	0	290	258	144	124	256	113
"LLPH"	1219	7685	21	0	21	0	0	0	10	16	0	0	373	438	492	386	560	378
"LLT1"	5864	29732	6640	8541	4288	2352	4533	4008	2445	2738	1775	4525	1131	1901	799	889	809	774
"LM25"	318	318	0	0	0	0	0	0	0	0	0	0	0	0	0	0	0	0
"LMAN1"	4845	31452	148	36	86	62	27	9	235	29	0	0	1919	2092	3143	2902	2514	530
"LMAN1L"	2859	14016	0	0	0	0	0	0	183	25	0	0	1	3	0	0	0	0
"LMAN2"	1839	20323	1147	183	485	662	122	61	572	212	776	342	2347	2508	3410	2598	3008	2208
"LMAN2/AP3S1 fusion"	939	939	0	0	0	0	0	0	0	0	0	0	264	298	0	0	0	0
"LMAN2L"	2497	34146	15	12	0	15	12	0	123	66	36	19	277	207	363	270	397	270
"LMBR1"	5030	212333	1656	735	970	686	472	263	1475	744	85	620	837	869	813	605	880	588
"LMBR1L"	2562	13757	1158	51	712	446	32	19	598	134	1444	177	864	662	1833	858	1594	884
"LMBRD1"	2093	120785	648	32	344	304	23	9	983	19	0	0	963	1430	1772	1495	1672	1288
"LMBRD2"	3255	48603	375	15	216	159	9	6	285	27	57	0	888	1090	396	344	304	178
"LMCD1"	1739	66296	0	0	0	0	0	0	158	0	25	0	52	37	11	0	294	154
"LMF1"	2746	127685	500	209	285	215	111	98	1563	659	348	271	119	251	191	126	533	355
"LMF2"	2698	4761	247	66	135	112	44	22	98	108	223	56	1056	548	985	1023	1607	988
"LMLN"	7654	83520	10	0	0	10	0	0	43	0	0	0	242	390	253	277	386	249
"LMNA"	3366	56181	2038	1457	1135	903	824	633	1204	1479	156	2030	4734	5684	3331	3150	6168	4411
"LMNB1"	2972	59878	93	2	35	58	2	0	119	5	0	0	487	484	608	403	624	386
"LMNB2"	4646	28795	159	26	72	87	12	14	237	371	27	415	825	911	961	1123	1196	995
"LMO1"	1399	39551	0	0	0	0	0	0	85	63	0	0	0	0	0	0	0	0
"LMO2"	2297	33713	2020	70	1116	904	42	28	1278	53	1769	0	674	1859	2912	1509	3928	1780
"LMO3"	3731	58126	0	20	0	0	12	8	12	21	0	0	0	0	0	0	0	0
"LMO4"	5407	20454	351	47	171	180	25	22	443	76	87	87	705	190	403	514	1116	843
"LMO7"	7265	239436	6	0	6	0	0	0	17	0	0	0	32	40	21	33	24	7
"LMOD1"	3966	50133	0	0	0	0	0	0	11	0	0	0	0	0	0	0	0	0
"LMOD2"	2152	8288	0	0	0	0	0	0	0	0	0	0	0	0	0	0	0	0
"LMOD3"	4102	15709	38	0	15	23	0	0	53	0	108	0	0	13	0	0	0	0
"LMTK2"	5616	99406	295	104	168	127	57	47	315	43	0	36	758	710	283	190	594	299
"LMTK3"	4986	27918	1	0	0	1	0	0	244	112	0	1	0	1	0	0	3	0
"LMX1A"	3390	153914	0	0	0	0	0	0	0	0	0	0	0	0	0	0	0	0
"LMX1B"	5791	86565	0	0	0	0	0	0	409	222	0	0	0	0	0	0	0	0
"LNP"	5783	76610	446	9	250	196	0	9	438	14	36	44	310	350	1043	812	1224	705
"LNP1"	2259	55134	0	0	0	0	0	0	9	0	0	0	3	0	0	4	0	0
"LNPEP"	4488	93771	3983	819	2195	1788	491	328	2292	360	564	502	3744	4129	1384	1149	1687	628
"LNX1"	3089	131287	37	21	26	11	0	21	77	0	0	0	306	246	274	65	313	202
"LNX2"	4812	74670	189	36	94	95	32	4	266	15	17	17	253	128	286	48	323	116
"LOC100008587"	314	44129	0	0	0	0	0	0	0	0	0	0	0	0	0	0	0	0
"LOC100009676"	2783	2783	188	128	95	93	45	83	71	70	0	175	214	196	234	243	255	204
"LOC100049716"	2659	2899	0	0	0	0	0	0	15	8	0	0	225	184	140	41	127	27
"LOC100101266"	1256	1256	0	0	0	0	0	0	10	0	0	0	0	0	0	0	0	0
"LOC100101938"	3746	82174	0	0	0	0	0	0	14	0	0	0	420	440	0	0	0	0
"LOC100124692"	3562	50120	0	0	0	0	0	0	0	0	0	0	0	0	0	0	0	0
"LOC100125556"	2044	13423	0	0	0	0	0	0	31	22	0	0	0	0	0	0	0	0
"LOC100126784"	3667	3667	0	0	0	0	0	0	0	0	0	0	0	0	0	0	0	0
"LOC100128023"	1145	1145	0	0	0	0	0	0	0	0	0	0	0	0	0	0	0	0
"LOC100128164"	6031	22750	0	0	0	0	0	0	0	0	0	0	0	1	0	0	0	0
"LOC100128191"	3161	3253	24	0	0	24	0	0	36	0	0	0	251	191	262	234	244	149
"LOC100128239"	2302	9071	0	0	0	0	0	0	79	11	0	0	0	0	0	0	0	0
"LOC100128288"	2130	2130	0	0	0	0	0	0	14	0	0	0	26	0	0	0	0	0
"LOC100128292"	3014	3014	0	0	0	0	0	0	0	0	0	0	0	0	0	0	0	0
"LOC100128542"	486	41013	10	219	10	0	132	87	0	8	0	726	0	30	38	91	5	9
"LOC100128573"	524	524	0	0	0	0	0	0	0	0	0	0	0	0	0	0	0	0
"LOC100128675"	3718	33505	0	0	0	0	0	0	235	147	0	0	4	0	0	5	0	0
"LOC100128731"	486	1225	50	28	28	22	16	12	17	40	0	0	815	914	704	1359	905	600
"LOC100128788"	1782	13736	42	23	28	14	2	21	246	145	0	0	12	87	109	101	136	98
"LOC100128811"	2435	18206	0	0	0	0	0	0	0	0	0	0	0	0	0	0	0	0
"LOC100128822"	1421	1421	0	0	0	0	0	0	0	0	0	0	47	49	92	96	157	121
"LOC100128842"	3518	3518	425	342	237	188	176	166	130	64	301	798	40	215	58	228	141	101
"LOC100128977"	841	52158	0	0	0	0	0	0	43	26	0	0	0	0	0	0	0	0
"LOC100129034"	5711	5711	4937	3574	2695	2242	2129	1445	1	2726	3179	4993	10705	10661	18612	15581	17933	11911
"LOC100129055"	2781	38675	0	0	0	0	0	0	0	0	0	0	0	0	0	0	0	0
"LOC100129354"	1016	1927	0	0	0	0	0	0	34	0	0	0	0	0	0	0	0	0
"LOC100129387"	4132	4132	662	163	382	280	91	72	1265	572	424	347	463	1156	376	185	201	154
"LOC100129534"	2249	2249	1	0	0	1	0	0	21	0	0	0	0	0	0	0	0	0
"LOC100129550"	5904	5904	5845	1475	3332	2513	1002	473	2050	296	1699	777	4168	3455	1739	670	2890	1202
"LOC100129637"	6940	7543	322	16	167	155	16	0	194	91	0	65	218	227	179	107	378	163
"LOC100129716"	2504	40369	684	1182	408	276	618	564	487	957	108	780	72	407	103	447	53	209
"LOC100129827"	589	58661	0	0	0	0	0	0	0	0	0	0	0	0	0	0	0	0
"LOC100129935"	1835	3718	0	0	0	0	0	0	0	0	0	0	0	0	0	0	0	0
"LOC100130015"	1385	4873	0	0	0	0	0	0	31	9	0	0	4	0	4	0	26	14
"LOC100130148"	3016	3016	0	0	0	0	0	0	15	10	0	0	0	0	0	0	0	0
"LOC100130238"	3881	5511	0	0	0	0	0	0	33	0	0	0	0	0	0	0	0	0
"LOC100130264"	1797	42296	0	0	0	0	0	0	11	7	0	0	0	0	0	0	0	0
"LOC100130274"	1321	1416	0	0	0	0	0	0	0	12	0	0	0	0	0	0	0	0
"LOC100130331"	3135	66144	0	0	0	0	0	0	0	0	0	0	0	0	0	0	0	0
"LOC100130354"	1896	1896	0	0	0	0	0	0	0	0	0	0	0	0	0	0	0	0
"LOC100130386"	2580	2580	0	0	0	0	0	0	29	0	0	0	0	0	0	0	0	0
"LOC100130426"	410	1129	0	2	0	0	2	0	9	0	0	0	3	8	3	6	0	0
"LOC100130522"	3337	23811	92	67	79	13	39	28	279	188	40	46	0	36	0	0	0	0
"LOC100130557"	3183	3183	1589	950	695	894	950	0	1029	884	0	1848	14	76	118	70	138	76
"LOC100130581"	3027	12971	0	423	0	0	212	211	371	398	0	242	87	95	17	18	44	10
"LOC100130872"	4984	13180	0	0	0	0	0	0	110	14	0	0	0	0	0	0	0	0
"LOC100130932"	932	932	0	0	0	0	0	0	17	0	0	0	13	0	0	0	0	0
"LOC100130933"	828	1411	21	0	9	12	0	0	44	15	0	0	2	0	0	0	0	0
"LOC100130958"	888	13629	622	151	313	309	93	58	56	27	0	185	1662	1485	1679	1161	1863	1075
"LOC100130987"	854	73850	240	954	173	67	519	435	617	775	103	751	1596	2301	2120	4414	2649	2756
"LOC100130988"	1919	63678	0	0	0	0	0	0	0	0	0	0	0	0	0	0	0	0
"LOC100131193"	2391	4923	420	89	242	178	52	37	283	155	333	312	104	124	289	290	463	464
"LOC100131434"	1335	7341	49	18	35	14	18	0	53	55	0	29	5	4	84	13	77	5
"LOC100131551"	3014	11604	0	0	0	0	0	0	13	19	0	0	0	0	0	0	0	0
"LOC100131691"	2572	15573	2742	1507	1469	1273	801	706	1105	713	2596	1599	892	851	1078	757	1802	859
"LOC100131998"	2499	18171	2468	2293	1352	1116	1262	1031	750	992	2422	2194	229	280	330	553	481	394
"LOC100132111"	764	5697	0	0	0	0	0	0	0	0	0	0	0	0	0	0	0	0
"LOC100132167"	1012	121626	218	16	89	129	7	9	319	58	71	13	0	4	30	30	38	28
"LOC100132215"	2030	3748	0	0	0	0	0	0	22	0	0	0	61	88	52	63	75	61
"LOC100132247"	3810	22986	122	298	108	14	158	140	109	95	0	289	227	281	12830	13503	17483	10915
"LOC100132287"	4372	4690	0	0	0	0	0	0	0	0	0	0	0	0	892	865	1009	691
"LOC100132288"	2072	47868	1712	352	846	866	179	173	2043	1338	354	1217	900	736	525	343	807	405
"LOC100132354"	2283	47180	0	0	0	0	0	0	159	33	0	0	0	0	0	0	0	0
"LOC100132707"	1716	20969	186	0	106	80	0	0	207	5	66	0	625	699	345	267	382	190
"LOC100132724"	2436	2436	77	12	39	38	12	0	72	16	0	0	72	45	0	0	0	0
"LOC100132831"	1981	1981	0	0	0	0	0	0	0	0	0	0	0	0	0	0	0	0
"LOC100132832"	2337	13560	961	678	540	421	391	287	377	233	973	545	17	29	110	64	60	34
"LOC100133050"	705	8751	0	0	0	0	0	0	9	0	0	0	0	0	0	0	0	0
"LOC100133161"	4638	6792	0	0	0	0	0	0	0	0	0	0	0	0	638	597	728	461
"LOC100133308"	2390	8505	0	0	0	0	0	0	0	0	0	0	0	0	0	0	0	0
"LOC100133469"	1746	13076	0	0	0	0	0	0	9	0	0	0	0	0	0	0	0	0
"LOC100133545"	1907	6712	0	0	0	0	0	0	30	31	0	0	0	0	0	0	0	0
"LOC100133612"	1954	15043	451	32	264	187	16	16	321	132	61	94	31	0	11	10	57	19
"LOC100133669"	1763	10625	0	0	0	0	0	0	147	72	0	0	0	0	0	0	0	0
"LOC100133893"	1098	8612	0	0	0	0	0	0	0	0	0	0	0	0	0	0	0	0
"LOC100133920"	2033	13590	0	0	0	0	0	0	0	0	0	0	0	0	0	0	0	0
"LOC100133957"	1526	1526	0	0	0	0	0	0	0	11	0	0	24	17	8	12	21	15
"LOC100133985"	662	1281	0	0	0	0	0	0	0	0	0	0	0	0	0	0	0	0
"LOC100133991"	1263	6440	1072	410	565	507	226	184	654	405	615	358	866	789	1343	685	1936	1126
"LOC100134229"	2380	2380	125	234	64	61	133	101	86	72	0	247	381	573	219	235	342	296
"LOC100134259"	2160	13132	0	0	0	0	0	0	46	12	0	0	0	0	0	0	0	0
"LOC100134368"	1574	10721	20	0	20	0	0	0	57	19	0	0	48	60	2	0	9	0
"LOC100134713"	1650	1743	13	0	3	10	0	0	3	8	0	0	456	410	551	302	613	397
"LOC100134868"	1672	11991	90	0	46	44	0	0	32	0	0	0	0	0	14	9	39	24
"LOC100135777"	1426	3595	0	0	0	0	0	0	20	31	0	0	14	1	18	45	9	30
"LOC100144602"	1180	23426	0	0	0	0	0	0	0	0	0	0	0	0	0	0	0	0
"LOC100144604"	1766	4447	0	0	0	0	0	0	0	0	0	0	0	0	0	0	0	0
"LOC100169752"	752	4074	0	0	0	0	0	0	0	0	0	0	0	0	0	0	0	0
"LOC100170939"	165	897	0	0	0	0	0	0	0	0	0	0	0	0	534	420	635	454
"LOC100188947"	1027	304499	0	49	0	0	35	14	108	47	0	31	95	129	142	174	97	67
"LOC100188949"	1592	33629	0	0	0	0	0	0	0	0	0	15	0	0	0	0	6	0
"LOC100189589"	2148	8165	144	5	91	53	5	0	56	39	0	13	44	40	54	38	78	36
"LOC100190938"	3259	7328	0	0	0	0	0	0	0	11	0	0	0	2	0	0	0	0
"LOC100190940"	3532	8890	0	0	0	0	0	0	0	0	0	0	0	0	0	0	0	0
"LOC100190986"	2431	2431	0	0	0	0	0	0	0	0	0	0	0	0	281	307	375	171
"LOC100192378"	1713	72397	0	0	0	0	0	0	19	0	0	0	0	0	0	0	0	0
"LOC100192426"	620	6216	0	0	0	0	0	0	0	0	0	0	0	0	0	0	0	0
"LOC100216001"	2557	98820	0	0	0	0	0	0	0	0	0	0	0	0	0	0	0	0
"LOC100216545"	3601	3601	1677	2533	942	735	1350	1183	456	1714	498	3950	0	31	28	85	0	59
"LOC100233209"	2505	8025	0	0	0	0	0	0	11	0	0	0	19	23	10	7	24	14
"LOC100240726"	1632	1632	0	0	0	0	0	0	0	0	0	0	0	0	0	0	0	0
"LOC100240734"	490	490	0	0	0	0	0	0	0	0	0	0	0	0	0	0	0	0
"LOC100240735"	907	2985	0	0	0	0	0	0	0	0	0	0	0	0	0	0	0	0
"LOC100268168"	1595	4585	0	0	0	0	0	0	20	0	0	0	1	0	2	1	0	0
"LOC100270710"	687	687	81	0	42	39	0	0	34	0	0	0	627	495	782	548	929	547
"LOC100270746"	941	941	0	0	0	0	0	0	0	0	0	0	0	0	0	0	0	0
"LOC100270804"	2017	2017	0	0	0	0	0	0	0	0	0	0	9	0	0	0	0	0
"LOC100271715"	5013	56001	18	0	10	8	0	0	26	0	0	0	0	0	0	0	0	0
"LOC100271722"	1612	4961	0	0	0	0	0	0	0	0	0	0	45	5	21	14	49	0
"LOC100271831"	395	395	0	0	0	0	0	0	0	0	0	0	120	0	0	0	0	0
"LOC100271832"	1393	19008	0	0	0	0	0	0	0	0	0	0	0	0	0	0	0	0
"LOC100272146"	3215	3215	64	0	39	25	0	0	47	0	0	0	0	0	77	0	50	0
"LOC100272216"	2050	2050	432	111	277	155	79	32	312	80	410	110	404	331	4326	2425	5758	2674
"LOC100272217"	2144	2144	0	0	0	0	0	0	16	0	0	0	0	0	0	0	0	0
"LOC100272228"	3362	286051	3891	673	2024	1867	353	320	2306	718	1259	865	277	240	94	78	350	0
"LOC100286844"	3090	12612	29	0	18	11	0	0	54	10	0	0	244	72	226	67	195	68
"LOC100287227"	2540	2540	796	12	115	681	0	12	903	68	177	0	44	16	5	32	34	20
"LOC100287704"	656	2705	0	0	0	0	0	0	0	0	0	0	0	0	0	0	0	0
"LOC100287718"	1004	12244	0	0	0	0	0	0	0	0	0	0	0	0	0	0	0	0
"LOC100289341"	1873	1873	19	0	19	0	0	0	15	17	0	0	135	29	0	26	66	23
"LOC100302401"	2340	2487	230	61	108	122	61	0	3925	123	490	152	204	171	313	296	332	175
"LOC100302640"	2730	403827	0	0	0	0	0	0	0	0	0	0	0	19	0	0	0	0
"LOC100302650"	1658	1658	9	15	0	9	7	8	11	9	26	17	42	51	31	106	38	42
"LOC100302652"	2308	190054	3960	1330	2235	1725	808	522	2726	750	1615	995	1710	1838	1281	1103	1606	1127
"LOC113230"	1302	2054	104	0	67	37	0	0	14	15	0	39	107	67	99	65	212	87
"LOC113386"	1400	10273	1015	756	561	454	365	391	503	394	175	556	1039	1219	3	1	7	2
"LOC115110"	2371	2927	15	3	15	0	0	3	75	52	0	0	110	145	98	132	213	289
"LOC121838"	2566	8129	0	0	0	0	0	0	0	0	0	0	0	0	0	0	0	0
"LOC121952"	2316	15936	86	0	45	41	0	0	129	0	0	0	0	0	0	0	0	0
"LOC124491"	4346	21440	741	425	376	365	255	170	454	200	111	366	129	1119	669	439	845	521
"LOC126536"	3351	11830	0	0	0	0	0	0	30	77	0	0	0	0	0	0	0	0
"LOC127841"	1291	1291	0	0	0	0	0	0	0	11	0	0	0	0	0	0	0	0
"LOC129293"	3062	8065	848	33	435	413	18	15	359	50	153	7	270	161	153	111	174	183
"LOC134466"	2423	16148	0	0	0	0	0	0	0	4	0	0	0	0	0	0	0	0
"LOC136242"	1162	5137	0	0	0	0	0	0	0	0	0	0	0	0	0	0	0	0
"LOC143188"	3208	4456	55	0	30	25	0	0	25	9	0	0	26	12	0	0	21	0
"LOC143666"	2078	2078	0	0	0	0	0	0	12	0	0	0	0	0	0	0	0	0
"LOC144438"	3981	3981	378	514	200	178	258	256	183	260	93	432	871	0	0	0	0	0
"LOC144486"	2565	2565	0	0	0	0	0	0	0	0	0	0	0	0	0	0	1	0
"LOC144571"	2190	2880	125	105	74	51	53	52	0	7	0	102	529	542	458	762	527	871
"LOC144678"	2641	30305	0	0	0	0	0	0	0	0	0	0	0	0	0	0	0	0
"LOC144742"	2295	19557	0	0	0	0	0	0	0	0	0	0	0	0	0	0	0	0
"LOC144776"	2024	35645	0	0	0	0	0	0	0	0	0	0	0	0	0	0	0	0
"LOC145474"	1842	1842	55	261	21	34	157	104	119	394	59	433	0	0	0	0	0	0
"LOC145783"	3021	32331	8	1	3	5	0	1	9	4	0	0	76	57	104	65	94	51
"LOC145814"	1437	39516	0	0	0	0	0	0	0	0	0	0	0	0	0	0	0	0
"LOC145820"	2689	74754	0	0	0	0	0	0	0	0	0	0	0	0	0	0	0	0
"LOC145837"	1710	9722	0	0	0	0	0	0	27	23	0	0	0	0	0	0	0	0
"LOC145845"	2994	22092	0	0	0	0	0	0	0	0	0	0	0	0	0	0	0	0
"LOC146336"	2935	14649	0	0	0	0	0	0	68	14	0	0	0	0	0	0	0	0
"LOC146481"	1823	3184	0	0	0	0	0	0	0	0	0	0	0	0	0	0	0	0
"LOC146880"	2876	3366	6225	2910	2889	3336	1574	1336	2604	2282	6172	2963	2089	2341	2141	1548	2481	1076
"LOC147645"	2298	8215	25	0	11	14	0	0	82	26	0	0	199	127	109	52	199	78
"LOC147710"	473	11748	0	0	0	0	0	0	0	0	0	0	0	0	0	0	0	0
"LOC147727"	2011	2011	51	0	51	0	0	0	23	20	0	32	216	173	106	69	143	88
"LOC148145"	3444	4017	0	0	0	0	0	0	0	0	0	0	0	0	0	0	0	0
"LOC148189"	2053	3448	65	0	48	17	0	0	87	0	0	14	56	45	55	35	52	17
"LOC148413"	1744	2515	451	140	267	184	79	61	131	167	253	219	1659	1515	32	1019	1502	961
"LOC148696"	4218	4218	327	40	197	130	26	14	206	135	209	154	0	0	0	0	0	0
"LOC148709"	2324	13489	0	0	0	0	0	0	17	1	0	0	1	0	0	0	0	0
"LOC149134"	2604	16372	0	0	0	0	0	0	11	14	0	0	0	1	0	0	0	0
"LOC149620"	2810	5585	0	0	0	0	0	0	0	0	0	0	0	0	0	0	0	0
"LOC149837"	3593	6026	0	0	0	0	0	0	67	0	0	0	26	33	0	0	85	0
"LOC149950"	846	21413	0	0	0	0	0	0	163	74	0	0	0	0	0	0	0	0
"LOC150185"	711	711	0	0	0	0	0	0	0	0	0	0	0	0	0	0	0	0
"LOC150381"	1636	4676	562	0	324	238	0	0	345	35	149	28	43	40	48	42	57	46
"LOC150568"	1508	78411	0	0	0	0	0	0	0	0	0	0	0	0	0	0	0	0
"LOC150776"	3806	28765	917	258	511	406	125	133	722	461	807	565	288	239	933	736	1308	640
"LOC150786"	3667	3667	0	0	0	0	0	0	0	0	0	0	0	151	0	0	0	0
"LOC151121"	2218	31677	0	0	0	0	0	0	0	0	0	0	0	0	0	0	0	0
"LOC151162"	5233	5233	808	444	448	360	226	218	235	237	211	203	3239	4212	4449	4628	4563	3631
"LOC151174"	1962	6566	20	0	1	19	0	0	82	0	131	0	0	0	10	0	77	24
"LOC151300"	1557	1639	0	0	0	0	0	0	0	0	0	0	0	0	0	0	0	0
"LOC151534"	2450	2450	55	0	32	23	0	0	40	20	53	0	177	122	0	0	0	107
"LOC151658"	1769	36406	0	0	0	0	0	0	0	0	0	0	0	0	0	0	0	0
"LOC151760"	805	1338	0	0	0	0	0	0	0	0	0	0	0	0	0	0	0	0
"LOC152024"	2972	6960	0	0	0	0	0	0	0	0	0	0	0	0	0	0	0	0
"LOC152225"	2055	57069	0	0	0	0	0	0	0	0	0	0	0	2	0	0	0	0
"LOC153328"	1885	38073	11497	11168	6353	5144	5970	5198	7148	6486	6196	9356	8568	9880	8354	8503	7444	6786
"LOC153684"	2262	3136	201	9	127	74	0	9	229	62	0	0	84	33	112	75	87	0
"LOC153910"	2346	111436	0	0	0	0	0	0	0	0	0	0	0	0	0	0	0	0
"LOC154449"	1333	8237	0	0	0	0	0	0	23	0	0	0	0	0	0	0	0	0
"LOC154761"	2411	115061	0	0	0	0	0	0	0	0	0	0	11	0	190	44	197	26
"LOC154822"	5630	13731	0	0	0	0	0	0	80	0	0	0	0	0	0	0	0	0
"LOC157381"	3583	9089	0	0	0	0	0	0	0	0	0	0	11	0	0	0	0	0
"LOC157627"	2925	3267	0	0	0	0	0	0	0	0	0	0	0	0	0	0	0	0
"LOC158376"	1548	2139	0	0	0	0	0	0	0	0	0	0	0	0	0	0	0	0
"LOC158381"	3958	44348	0	0	0	0	0	0	0	0	0	0	0	0	0	0	0	0
"LOC158696"	2909	2909	0	0	0	0	0	0	0	0	0	0	0	0	0	0	0	0
"LOC161527"	672	936	0	0	0	0	0	0	0	0	0	0	0	0	0	0	53	0
"LOC162427"	3787	29921	846	238	472	374	122	116	702	160	226	312	1813	1149	1637	726	2061	1005
"LOC169834"	2382	15072	0	0	0	0	0	0	0	0	0	0	0	0	0	0	0	0
"LOC196394"	2518	58037	11	0	11	0	0	0	10	8	53	0	23	23	15	18	10	5
"LOC200030"	4536	25081	0	0	0	0	0	0	0	0	0	0	0	0	2091	3082	2760	1690
"LOC200726"	1379	7033	0	0	0	0	0	0	0	0	0	0	0	0	0	0	0	0
"LOC201651"	1292	14440	0	0	0	0	0	0	0	0	0	0	0	0	0	0	0	0
"LOC202051"	911	7523	0	0	0	0	0	0	33	10	0	0	0	6	6	5	0	0
"LOC202181"	2863	53779	1639	140	970	669	36	104	926	68	398	172	195	48	176	66	224	20
"LOC202781"	2271	2271	0	0	0	0	0	0	0	0	0	0	64	41	38	35	47	24
"LOC219347"	4050	32960	0	0	0	0	0	0	0	0	0	0	31	32	19	36	38	12
"LOC220115"	2636	98098	0	0	0	0	0	0	0	0	0	0	6	10	0	0	0	0
"LOC220429"	2973	2973	0	0	0	0	0	0	0	0	0	0	0	0	0	0	0	0
"LOC220729"	1534	13855	4448	1613	2541	1907	868	745	1942	952	2562	1349	1183	554	472	215	501	183
"LOC220930"	2214	2568	0	0	0	0	0	0	0	0	0	0	0	0	0	0	0	0
"LOC221122"	1240	4125	1	0	1	0	0	0	0	19	0	0	0	0	0	0	0	0
"LOC221442"	4586	39796	354	65	185	169	38	27	206	17	21	34	729	34	92	54	118	29
"LOC221710"	4688	44700	714	20	397	317	20	0	689	91	108	183	586	637	578	406	577	432
"LOC221955"	2367	38897	2751	952	1488	1263	550	402	1146	1422	2560	1584	404	267	570	484	1264	472
"LOC222901"	2824	3703	333	364	173	160	162	202	69	191	0	374	3785	4461	6462	6697	9563	6321
"LOC23117"	4294	56060	14471	7384	8169	6302	4076	3308	6162	4048	11351	10325	18679	19103	31518	31623	36507	26586
"LOC253039"	3795	11326	249	616	145	104	348	268	328	548	0	255	359	382	306	203	818	429
"LOC253724"	4531	86463	76	3	24	52	3	0	47	11	0	0	7	0	14	10	25	0
"LOC254312"	1117	17224	0	0	0	0	0	0	0	0	0	0	0	0	0	0	0	0
"LOC254559"	4785	36910	0	0	0	0	0	0	116	88	0	4	0	0	0	0	0	0
"LOC255025"	2020	237974	0	0	0	0	0	0	0	0	0	0	0	0	0	0	0	0
"LOC255167"	3034	5204	0	0	0	0	0	0	18	0	0	0	0	0	0	0	0	0
"LOC256880"	1986	1986	0	0	0	0	0	0	0	13	0	0	0	0	0	0	0	0
"LOC257358"	2207	3671	0	0	0	0	0	0	0	15	0	0	0	0	0	0	0	0
"LOC25845"	1744	2456	387	198	188	199	101	97	73	73	92	0	131	150	245	128	249	164
"LOC26080"	1970	36721	0	0	0	0	0	0	0	0	0	0	0	0	0	0	0	0
"LOC282997"	2016	2016	0	0	0	0	0	0	0	0	0	0	44	51	0	3	34	2
"LOC283050"	3830	51324	323	3219	161	162	1728	1491	1084	2310	205	4469	286	720	863	2521	306	912
"LOC283070"	2413	2413	969	490	700	269	164	326	439	148	164	183	3970	4016	1590	1138	2319	1414
"LOC283267"	3305	3305	315	18	205	110	0	18	136	0	0	0	1019	1130	455	294	508	261
"LOC283332"	2341	2980	0	0	0	0	0	0	17	0	0	0	0	0	0	0	0	0
"LOC283392"	3162	10963	0	0	0	0	0	0	0	0	0	0	0	0	0	0	0	0
"LOC283404"	1056	12883	0	0	0	0	0	0	49	44	0	0	0	0	0	0	0	0
"LOC283663"	2539	7404	206	135	149	57	78	57	89	94	0	20	179	362	81	108	93	29
"LOC283685"	1673	6373	0	0	0	0	0	0	33	16	0	0	0	0	0	0	0	0
"LOC283731"	2568	2907	0	0	0	0	0	0	0	0	0	0	1	0	0	0	0	0
"LOC283761"	2354	19105	0	0	0	0	0	0	0	0	0	0	0	0	0	0	0	0
"LOC283767"	1053	1708	0	0	0	0	0	0	0	0	0	0	0	0	0	0	0	0
"LOC283788"	3668	43294	0	0	0	0	0	0	0	0	0	0	0	0	0	0	0	0
"LOC283856"	2683	98109	0	0	0	0	0	0	0	0	0	0	0	0	0	0	0	0
"LOC283867"	1769	291803	0	0	0	0	0	0	0	0	0	0	0	0	0	0	0	0
"LOC283914"	2808	27053	0	0	0	0	0	0	0	9	0	0	0	0	0	0	0	0
"LOC283922"	2424	35851	1358	513	749	609	289	224	589	307	673	910	345	398	442	384	893	454
"LOC283999"	2381	9556	0	0	0	0	0	0	81	52	0	0	0	1	0	0	0	0
"LOC284009"	578	8456	151	16	95	56	16	0	107	75	245	38	0	0	0	0	3	2
"LOC284023"	2526	2626	0	0	0	0	0	0	15	20	0	0	225	145	108	59	158	58
"LOC284100"	2462	41792	0	0	0	0	0	0	9	0	0	0	0	0	0	0	0	0
"LOC284232"	37568	37568	0	0	0	0	0	0	0	0	0	0	0	0	0	0	0	0
"LOC284233"	2879	5102	0	0	0	0	0	0	0	0	0	0	1	8	5	0	0	0
"LOC284260"	1840	504739	0	0	0	0	0	0	43	0	0	0	0	0	0	0	0	0
"LOC284276"	2245	31173	0	0	0	0	0	0	0	0	0	0	0	0	0	0	0	0
"LOC284379"	1219	3866	0	0	0	0	0	0	0	0	0	0	0	0	0	0	0	0
"LOC284440"	2538	20041	0	0	0	0	0	0	0	0	0	0	0	0	0	0	0	0
"LOC284441"	2048	2048	77	88	46	31	47	41	22	9	0	0	1406	1820	0	0	0	0
"LOC284551"	2744	5812	0	0	0	0	0	0	0	0	0	0	0	0	0	0	0	0
"LOC284578"	2364	2364	0	0	0	0	0	0	0	0	0	0	0	0	0	0	0	0
"LOC284632"	1849	11452	0	0	0	0	0	0	12	0	0	0	0	0	0	0	0	0
"LOC284661"	2080	12635	0	0	0	0	0	0	0	0	0	0	0	0	0	0	0	0
"LOC284688"	1728	12804	0	0	0	0	0	0	0	0	0	0	0	0	0	0	0	0
"LOC284749"	3597	10729	0	0	0	0	0	0	54	0	0	0	0	0	0	0	0	0
"LOC284751"	2283	22201	0	0	0	0	0	0	122	31	0	0	0	1	0	0	0	0
"LOC284788"	1688	20312	0	0	0	0	0	0	0	0	0	0	0	0	0	0	0	0
"LOC284798"	3163	7994	0	0	0	0	0	0	0	0	0	0	0	0	0	0	0	0
"LOC284804"	885	36567	1449	756	785	664	387	369	793	1424	674	3234	12	10	18	19	19	17
"LOC284805"	3874	41083	0	0	0	0	0	0	144	59	0	0	0	0	0	0	0	0
"LOC284837"	4598	6809	106	2	40	66	2	0	222	82	0	43	13	0	0	0	0	0
"LOC284900"	950	5588	0	0	0	0	0	0	23	0	0	1	89	27	3	0	44	4
"LOC284912"	849	8143	0	0	0	0	0	0	32	0	0	0	0	0	0	0	0	0
"LOC285033"	1839	33562	944	28	568	376	28	0	361	23	217	84	1377	117	175	2	1741	61
"LOC285045"	1997	103698	0	0	0	0	0	0	0	0	0	0	0	0	0	0	0	0
"LOC285074"	3060	19891	228	21	125	103	21	0	278	19	133	47	74	38	420	178	439	430
"LOC285141"	602	15183	0	0	0	0	0	0	0	0	0	0	0	0	0	0	0	0
"LOC285194"	2104	7252	0	0	0	0	0	0	0	0	0	0	0	0	0	0	0	0
"LOC285205"	1307	45701	0	0	0	0	0	0	0	0	0	0	0	0	0	0	0	0
"LOC285359"	983	983	56	0	34	22	0	0	0	10	0	28	71	103	75	0	88	0
"LOC285370"	2872	4710	0	0	0	0	0	0	0	0	0	0	0	0	0	0	0	0
"LOC285375"	1000	95913	0	0	0	0	0	0	406	77	0	0	0	0	0	0	0	0
"LOC285401"	1976	174604	0	0	0	0	0	0	17	0	0	0	0	0	0	0	0	0
"LOC285419"	6501	17803	0	0	0	0	0	0	0	15	0	0	0	0	0	0	0	0
"LOC285456"	3777	82269	0	0	0	0	0	0	0	0	0	0	0	0	0	0	0	0
"LOC285501"	1043	261998	0	0	0	0	0	0	0	0	0	0	0	0	0	0	0	0
"LOC285548"	1750	1750	0	0	0	0	0	0	0	0	0	0	0	0	0	0	0	0
"LOC285550"	4379	8712	223	0	104	119	0	0	166	0	56	0	502	352	181	157	221	23
"LOC285593"	1784	5430	0	0	0	0	0	0	15	0	0	0	0	1	0	0	0	0
"LOC285627"	2019	17722	0	35	0	0	19	16	12	0	0	0	0	0	0	0	0	0
"LOC285629"	2323	6847	0	0	0	0	0	0	0	0	0	0	0	0	0	0	0	0
"LOC285692"	1857	262510	0	0	0	0	0	0	0	0	0	0	0	0	0	0	0	0
"LOC285696"	3319	87396	0	0	0	0	0	0	20	0	0	0	0	0	0	0	0	0
"LOC285733"	891	8108	34	0	22	12	0	0	66	14	0	0	0	0	0	0	1	0
"LOC285735"	2514	18493	0	0	0	0	0	0	0	0	0	0	0	0	0	0	0	0
"LOC285740"	1919	7720	4469	739	2722	1747	422	317	1453	487	1951	621	0	0	0	0	0	0
"LOC285768"	2344	140327	0	0	0	0	0	0	23	0	0	0	0	0	0	0	0	0
"LOC285780"	2957	262237	3460	978	1944	1516	502	476	3934	1603	1169	724	150	174	104	105	149	120
"LOC285941"	1923	8811	673	132	387	286	75	57	270	35	250	106	0	0	0	0	0	0
"LOC285954"	2997	85462	804	27519	485	319	14824	12695	48	10235	0	18629	0	953	50	4397	55	816
"LOC286002"	3890	5284	0	0	0	0	0	0	2	0	0	0	1	1	1	0	0	0
"LOC286016"	2015	2015	0	0	0	0	0	0	0	10	0	0	10	0	166	0	0	0
"LOC286094"	1225	65587	0	0	0	0	0	0	0	0	0	0	0	0	0	0	0	0
"LOC286135"	2841	32094	0	0	0	0	0	0	0	0	0	0	0	0	0	0	0	0
"LOC286238"	942	5241	0	0	0	0	0	0	0	0	0	0	0	0	0	0	0	0
"LOC286359"	2021	5854	0	0	0	0	0	0	0	0	0	0	0	0	0	0	0	0
"LOC286367"	3413	3413	0	0	0	0	0	0	0	10	0	0	0	0	0	0	0	0
"LOC286467"	2940	127994	0	0	0	0	0	0	0	12	0	0	0	3	3	0	0	0
"LOC29034"	2304	2304	0	0	0	0	0	0	0	0	0	0	0	0	0	0	0	0
"LOC338579"	3648	23997	0	0	0	0	0	0	0	0	0	0	0	0	0	0	0	0
"LOC338588"	1012	6258	0	0	0	0	0	0	0	0	0	0	0	0	0	0	0	0
"LOC338651"	2556	25939	0	0	0	0	0	0	143	19	0	0	0	0	0	0	0	0
"LOC338758"	2998	2998	41	211	21	20	123	88	48	25432	0	6086	89	231	121	349	62	175
"LOC338797"	1799	20087	0	0	0	0	0	0	18	0	0	0	0	0	0	0	0	0
"LOC338799"	1527	8218	2716	1475	1456	1260	799	676	1194	884	4030	2642	911	419	1815	760	2986	995
"LOC339047"	1787	11850	88	61	58	30	24	37	0	26	0	0	0	72	847	1323	1024	1009
"LOC339240"	3153	3153	0	0	0	0	0	0	0	0	0	0	0	0	0	0	0	0
"LOC339290"	5490	8406	232	0	127	105	0	0	66	0	0	0	646	617	540	313	567	290
"LOC339524"	3447	4743	0	0	0	0	0	0	32	0	0	0	5	0	6	0	0	0
"LOC339535"	1531	5633	0	0	0	0	0	0	0	0	0	0	0	0	0	0	0	0
"LOC339568"	1518	10969	0	0	0	0	0	0	0	0	0	0	0	0	0	0	0	0
"LOC339674"	1507	6756	0	0	0	0	0	0	15	11	0	0	0	0	0	0	0	0
"LOC339788"	2317	54421	0	0	0	0	0	0	0	0	0	0	0	0	0	0	0	0
"LOC340017"	1387	3655	0	0	0	0	0	0	0	0	0	0	0	0	0	0	0	0
"LOC340074"	2043	5252	0	0	0	0	0	0	0	0	0	0	0	0	0	0	0	0
"LOC340094"	1800	35639	0	0	0	0	0	0	0	0	0	0	0	0	0	0	0	0
"LOC340357"	961	45340	0	0	0	0	0	0	0	0	0	0	0	0	0	0	0	0
"LOC340508"	2263	6274	0	0	0	0	0	0	0	0	0	0	0	0	0	0	0	0
"LOC341056"	2046	2046	0	0	0	0	0	0	0	0	0	0	140	142	0	0	0	0
"LOC342346"	3441	43828	2	10	0	2	6	4	81	101	3	0	223	279	0	0	1	0
"LOC344595"	3262	8181	0	0	0	0	0	0	0	0	0	0	0	0	0	0	0	0
"LOC347376"	450	450	0	0	0	0	0	0	0	0	0	0	0	0	0	0	0	0
"LOC348021"	2142	4377	0	0	0	0	0	0	0	0	0	0	0	0	0	0	0	0
"LOC348840"	2905	23140	0	0	0	0	0	0	0	0	0	0	0	0	0	0	0	0
"LOC348926"	3418	13480	0	0	0	0	0	0	24	0	0	0	0	0	25	0	0	20
"LOC349114"	4655	61056	74	29	47	27	15	14	55	59	44	80	98	88	46	24	165	108
"LOC360030"	911	8907	0	0	0	0	0	0	0	0	0	0	0	0	0	0	0	0
"LOC374491"	2721	17466	10	0	7	3	0	0	0	8	0	0	0	0	0	0	0	0
"LOC375133"	3887	13069	233	41	140	93	24	17	370	93	92	53	263	275	2402	1973	2715	1897
"LOC375190"	1602	50321	140	0	56	84	0	0	335	0	128	23	78	70	47	42	89	66
"LOC375295"	1159	8093	0	0	0	0	0	0	0	0	0	0	0	0	0	0	0	0
"LOC387646"	6455	6455	0	0	0	0	0	0	0	0	0	0	0	0	0	0	0	0
"LOC387647"	3020	76136	8047	1744	4510	3537	913	831	4340	1176	4347	1340	2750	2321	2120	1458	2869	1475
"LOC387763"	1328	1328	0	0	0	0	0	0	20	0	0	0	0	0	0	0	0	0
"LOC387890"	1576	48101	0	3	0	0	2	1	0	0	0	0	0	0	0	0	0	0
"LOC388152"	3741	30196	0	0	0	0	0	0	18	0	0	0	0	0	0	3	0	0
"LOC388242"	1483	2612	0	0	0	0	0	0	0	0	0	0	0	0	24	21	41	7
"LOC388312"	4819	18598	110	25	68	42	25	0	22	29	0	69	34	48	922	884	1116	761
"LOC388387"	1990	24062	0	0	0	0	0	0	10	0	0	0	0	0	0	0	0	0
"LOC388428"	1583	17659	1	0	1	0	0	0	79	38	0	0	1	0	0	0	0	0
"LOC388503"	3791	32781	0	0	0	0	0	0	78	27	0	0	0	2	0	0	0	0
"LOC388588"	549	3195	0	0	0	0	0	0	60	17	0	0	20	18	0	4	5	15
"LOC388692"	12268	12268	212	34	102	110	13	21	176	21	0	34	59	55	39	33	272	26
"LOC388789"	492	2130	30	0	20	10	0	0	16	9	0	0	169	375	393	279	583	411
"LOC388796"	2157	14725	1715	1224	941	774	623	601	600	1173	684	1404	376	498	295	339	245	135
"LOC388882"	1431	24737	0	0	0	0	0	0	0	0	0	0	0	0	0	0	0	0
"LOC388906"	1243	5110	0	0	0	0	0	0	14	0	0	0	0	4	2	3	8	2
"LOC388946"	682	4861	0	0	0	0	0	0	0	0	0	0	0	0	0	0	0	0
"LOC389033"	404	11457	0	0	0	0	0	0	12	0	0	0	0	0	0	0	0	0
"LOC389332"	1696	1696	0	0	0	0	0	0	0	0	0	0	0	0	0	0	0	0
"LOC389333"	3252	3252	0	0	0	0	0	0	11	0	0	0	0	0	0	0	0	0
"LOC389458"	534	1117	0	0	0	0	0	0	0	0	0	0	0	0	0	0	0	0
"LOC389493"	601	1717	0	0	0	0	0	0	0	0	0	0	3	2	0	0	0	0
"LOC389527"	1184	38887	0	0	0	0	0	0	0	0	0	0	0	0	714	678	397	235
"LOC389634"	878	34005	19	75	19	0	27	48	0	7	0	544	20	29	14	11	12	9
"LOC389705"	928	26399	0	0	0	0	0	0	0	0	0	0	0	0	0	0	0	0
"LOC389791"	2105	2105	0	0	0	0	0	0	18	17	0	0	0	0	0	0	0	0
"LOC389833"	1300	35028	0	0	0	0	0	0	0	0	0	0	0	0	0	0	0	0
"LOC389834"	8204	8204	0	0	0	0	0	0	0	0	0	0	0	0	0	0	0	0
"LOC389906"	1501	17223	93	0	61	32	0	0	78	16	27	10	67	92	172	159	152	83
"LOC390594"	1377	1377	0	0	0	0	0	0	0	0	0	0	0	0	0	0	0	0
"LOC390595"	1464	22193	696	59	430	266	33	26	360	74	0	0	8	0	12	3	0	5
"LOC390748"	1262	3270	2	0	2	0	0	0	111	40	0	0	259	27	272	139	82	0
"LOC390858"	536	17477	0	0	0	0	0	0	0	0	0	0	0	0	0	0	0	0
"LOC391322"	565	928	29	0	29	0	0	0	28	15	0	0	31	0	57	1	62	0
"LOC392196"	1439	1439	0	0	0	0	0	0	0	0	0	0	0	0	0	0	0	0
"LOC399744"	5260	24008	0	0	0	0	0	0	0	0	0	0	14	0	114	112	144	73
"LOC399815"	2118	19083	21	0	21	0	0	0	175	12	0	0	24	21	16	0	50	0
"LOC399959"	3086	113961	0	0	0	0	0	0	0	0	0	0	0	0	0	0	0	0
"LOC400043"	1390	6766	0	0	0	0	0	0	95	61	0	0	17	20	0	0	39	0
"LOC400657"	3474	6061	11	0	11	0	0	0	56	15	0	0	268	168	79	51	114	0
"LOC400696"	2588	6349	0	0	0	0	0	0	0	0	0	0	0	0	0	0	0	0
"LOC400713"	521	4801	0	0	0	0	0	0	17	0	0	0	20	44	84	75	98	71
"LOC400752"	1710	1710	0	0	0	0	0	0	0	13	0	0	0	0	0	0	0	0
"LOC400759"	1239	17257	0	0	0	0	0	0	0	0	0	0	0	0	74	362	64	166
"LOC400794"	1759	105264	0	0	0	0	0	0	7	0	0	0	0	0	0	0	0	0
"LOC400891"	5148	18208	0	0	0	0	0	0	39	36	0	0	1	0	0	0	0	0
"LOC400927"	1924	38028	1892	229	1010	882	129	100	1443	240	246	177	90	58	12	20	105	0
"LOC400931"	4721	27931	4642	383	2495	2147	206	177	1658	687	3674	1130	0	13	0	33	0	0
"LOC400940"	3466	6256	0	0	0	0	0	0	0	0	0	0	0	0	0	0	0	0
"LOC401010"	2735	2735	0	0	0	0	0	0	0	0	0	0	67	51	0	0	0	0
"LOC401052"	1901	4679	37	0	37	0	0	0	44	11	0	0	43	0	30	2	107	44
"LOC401093"	6650	7004	26506	49044	14776	11730	26527	22517	10402	26441	5298	17400	171	246	103	301	193	80
"LOC401127"	1648	1648	0	0	0	0	0	0	0	0	0	0	42	67	0	0	0	0
"LOC401296"	1425	1517	0	0	0	0	0	0	0	11	0	0	0	0	0	0	0	0
"LOC401307"	2160	205911	5787	2591	3212	2575	1421	1170	3855	1947	764	1407	648	950	639	559	698	477
"LOC401308"	1443	2905	3409	5318	1624	1785	2803	2515	740	3426	244	1045	52605	109	5983	60112	45173	52874
"LOC401327"	1654	1733	0	0	0	0	0	0	0	0	0	0	421	336	0	0	0	0
"LOC401379"	1330	15438	0	0	0	0	0	0	13	0	0	0	19	7	3	0	0	3
"LOC401387"	2666	20394	0	0	0	0	0	0	0	0	0	0	0	0	0	0	0	0
"LOC401397"	1129	1865	0	0	0	0	0	0	0	0	0	0	411	493	546	554	596	418
"LOC401431"	3071	6168	0	0	0	0	0	0	19	0	0	0	0	0	0	0	0	0
"LOC401463"	2701	2954	0	0	0	0	0	0	0	0	0	0	0	0	0	0	0	0
"LOC401588"	1849	2686	0	0	0	0	0	0	0	0	0	0	15	30	9	41	36	24
"LOC401629"	485	4313	0	0	0	0	0	0	0	0	0	0	0	0	0	0	0	0
"LOC402176"	1783	1783	134	0	77	57	0	0	38	11	0	39	0	0	0	0	0	0
"LOC402377"	585	5236	0	2	0	0	0	2	10	0	0	1	32	0	0	0	0	0
"LOC402468"	2063	10623	755	433	412	343	219	214	369	303	413	306	578	382	1218	763	1583	625
"LOC402538"	978	11738	2193	675	1450	743	409	266	659	552	1145	1093	116	66	3	7	0	5
"LOC402644"	478	478	0	0	0	0	0	0	0	0	0	0	0	0	0	0	0	0
"LOC404266"	430	3921	0	0	0	0	0	0	19	0	0	0	0	0	0	0	0	0
"LOC415056"	1323	15062	0	0	0	0	0	0	149	28	0	0	0	0	0	0	0	0
"LOC440040"	2186	251889	0	0	0	0	0	0	0	0	0	0	0	0	0	0	0	0
"LOC440173"	2017	33676	0	0	0	0	0	0	0	0	0	0	0	0	0	0	0	0
"LOC440248"	3127	30990	306	66	160	146	36	30	182	51	31	30	165	161	1453	1105	2281	1070
"LOC440295"	4248	8598	0	0	0	0	0	0	0	0	0	0	0	0	1	3	11	35
"LOC440356"	768	4221	0	0	0	0	0	0	45	9	0	0	0	0	0	0	0	1
"LOC440419"	3095	13619	0	0	0	0	0	0	0	0	0	0	0	0	0	0	0	0
"LOC440461"	1637	1637	0	0	0	0	0	0	0	0	0	0	0	0	0	0	0	0
"LOC440563"	1008	1008	0	0	0	0	0	0	0	0	0	0	0	0	0	0	0	0
"LOC440570"	2484	3099	0	0	0	0	0	0	0	0	0	0	0	0	0	0	0	0
"LOC440895"	3025	48757	0	0	0	0	0	0	0	0	0	0	0	0	345	262	597	0
"LOC440896"	3256	6829	0	0	0	0	0	0	0	37	0	0	0	119	0	324	0	66
"LOC440905"	4537	25134	0	0	0	0	0	0	0	0	0	0	0	0	0	0	0	0
"LOC440925"	2130	2130	0	0	0	0	0	0	0	0	0	0	0	0	0	0	0	0
"LOC440934"	828	1029	0	0	0	0	0	0	0	10	0	0	0	56	0	53	0	65
"LOC440944"	1989	7585	1195	1803	695	500	952	851	495	729	366	1650	520	858	189	235	225	106
"LOC440957"	451	3967	635	220	318	317	110	110	337	87	511	0	436	62	554	249	757	263
"LOC441046"	1989	1989	0	0	0	0	0	0	0	0	0	0	0	0	0	0	0	0
"LOC441089"	1363	1363	0	0	0	0	0	0	0	0	0	0	85	121	73	84	112	84
"LOC441108"	889	75878	3854	4270	2175	1679	1288	2982	1204	6012	1027	6346	768	10353	945	11924	1458	8302
"LOC441177"	2066	2066	0	0	0	0	0	0	0	0	0	0	0	0	0	0	0	0
"LOC441178"	2561	4163	0	0	0	0	0	0	34	0	0	0	0	0	0	0	0	0
"LOC441204"	3221	100257	73	0	24	49	0	0	240	0	0	25	36	30	50	44	45	10
"LOC441208"	2035	2035	14	0	0	14	0	0	0	0	0	0	0	5	9	0	5	0
"LOC441242"	2005	28292	523	24	357	166	17	7	412	41	450	73	219	309	378	305	579	226
"LOC441294"	2355	2355	0	0	0	0	0	0	0	0	0	0	0	0	0	0	0	0
"LOC441309"	1261	71627	390	70	247	143	38	32	476	41	36	131	43	85	63	52	63	46
"LOC441426"	1424	1424	0	0	0	0	0	0	0	0	0	0	0	0	0	0	0	0
"LOC441454"	1381	1381	121	85	71	50	36	49	64	43	0	0	0	0	47	0	0	0
"LOC441455"	1648	1648	0	0	0	0	0	0	0	0	0	0	0	0	0	0	0	0
"LOC441476"	1195	2206	0	0	0	0	0	0	36	28	0	0	0	0	0	0	0	0
"LOC441493"	2376	2376	0	0	0	0	0	0	0	0	0	0	0	0	0	0	0	0
"LOC441601"	1010	18625	0	0	0	0	0	0	0	0	0	0	0	2	4	0	0	0
"LOC441666"	6663	36180	0	0	0	0	0	0	0	0	0	0	0	0	0	0	0	0
"LOC441743"	662	662	0	0	0	0	0	0	0	0	0	0	10	0	0	0	0	0
"LOC441869"	2020	2850	0	0	0	0	0	0	0	0	0	0	0	0	0	0	0	0
"LOC442028"	3340	78659	0	0	0	0	0	0	0	0	0	0	0	0	0	0	0	0
"LOC442245"	1136	1136	0	0	0	0	0	0	0	0	0	0	0	0	0	0	0	0
"LOC442308"	1332	1332	0	0	0	0	0	0	0	0	0	0	0	0	0	0	0	0
"LOC442454"	798	798	233	67	95	138	48	19	30	12	0	25	0	385	0	0	0	0
"LOC442459"	2185	478243	0	0	0	0	0	0	8	0	0	0	0	0	0	0	0	0
"LOC492303"	1701	1701	0	0	0	0	0	0	13	0	0	0	10	0	0	1	0	0
"LOC493754"	4271	63919	5979	1770	3304	2675	944	826	2216	1453	4490	3962	776	933	487	266	827	443
"LOC494141"	2080	2371	0	0	0	0	0	0	0	0	0	0	0	0	0	0	0	0
"LOC494150"	1533	1533	183	80	180	3	43	37	181	33	204	123	0	0	3	0	0	0
"LOC51326"	983	53279	375	36	220	155	23	13	320	48	0	0	53	0	1703	1289	2368	1210
"LOC541467"	1857	1857	0	0	0	0	0	0	0	0	0	0	0	5	11	21	14	7
"LOC541471"	1589	287335	2316	8034	1266	1050	4402	3632	1608	3720	471	5701	296	447	579	902	517	435
"LOC541472"	1360	2221	461	2830	270	191	1485	1345	0	1517	0	2136	0	9069	0	5187	0	1560
"LOC541473"	977	3470	0	0	0	0	0	0	0	0	0	0	0	0	0	15	0	39
"LOC550112"	3440	379673	533	54	308	225	41	13	2219	294	0	0	85	76	157	114	578	195
"LOC552889"	3674	3674	437	189	238	199	70	119	147	83	0	152	2737	2404	2894	1986	3366	2005
"LOC553137"	2458	4872	0	0	0	0	0	0	0	0	0	0	0	0	0	0	0	0
"LOC553158"	1880	160292	100	0	63	37	0	0	535	249	0	31	56	42	85	82	102	113
"LOC554174"	1181	2420	500	0	262	238	0	0	345	34	77	28	40	37	47	40	48	41
"LOC554202"	2152	105432	0	0	0	0	0	0	0	0	0	0	0	0	0	0	0	0
"LOC554203"	2217	56169	8127	2972	4528	3599	1742	1230	3330	1124	3940	3490	607	551	25	0	83	35
"LOC554223"	1286	5901	0	0	0	0	0	0	21	20	0	0	2	1	1	0	165	141
"LOC554248"	1499	77453	10445	5810	5776	4669	3194	2616	4490	2101	2584	2421	197	190	199	274	299	191
"LOC554249"	1355	1469	0	0	0	0	0	0	0	0	0	0	0	0	15	7	30	15
"LOC55908"	1018	3803	0	0	0	0	0	0	16	5	0	0	14	6	10	20	25	17
"LOC57228"	1211	25071	22	0	22	0	0	0	16	0	0	0	116	132	98	58	99	46
"LOC572558"	532	2648	0	0	0	0	0	0	0	0	0	0	0	0	0	0	2	0
"LOC595101"	4328	67783	903	551	486	417	266	285	574	327	326	987	29	37	276	267	340	377
"LOC606724"	572	572	8	1	4	4	0	1	0	0	0	0	0	40	239	0	422	124
"LOC641298"	2551	9428	6	0	0	6	0	0	0	0	3	6	0	0	629	923	824	451
"LOC641367"	2695	2695	347	198	203	144	125	73	182	153	152	274	0	0	0	0	0	0
"LOC641515"	2799	6947	0	0	0	0	0	0	0	0	0	0	0	0	0	0	0	0
"LOC641518"	1681	4311	0	0	0	0	0	0	0	0	0	0	0	0	0	0	0	0
"LOC642204"	2218	26014	0	0	0	0	0	0	0	0	0	0	0	0	0	0	0	0
"LOC642502"	2753	50369	710	23	315	395	23	0	287	130	110	248	1446	1403	3516	3251	3834	2800
"LOC642587"	892	3724	0	0	0	0	0	0	8	0	0	0	0	0	0	0	0	0
"LOC642597"	2304	53585	0	0	0	0	0	0	0	0	0	0	0	0	0	0	0	0
"LOC642776"	2082	51820	371	75	217	154	46	29	358	90	43	156	0	0	0	0	0	1
"LOC642826"	809	809	0	0	0	0	0	0	0	0	0	0	0	0	13	12	19	0
"LOC642846"	3521	30433	72	14	40	32	7	7	82	11	0	0	18	52	189	107	649	282
"LOC642852"	7167	9303	163	0	101	62	0	0	167	58	29	23	216	180	183	112	260	140
"LOC642929"	988	4947	0	0	0	0	0	0	0	0	0	0	0	0	0	0	0	0
"LOC643008"	1551	7974	81	0	24	57	0	0	233	108	1	0	0	0	0	0	1	0
"LOC643387"	2658	2658	0	0	0	0	0	0	0	0	0	0	0	0	0	0	0	0
"LOC643406"	3791	5930	0	0	0	0	0	0	9	0	0	0	0	0	0	0	0	0
"LOC643486"	817	817	0	0	0	0	0	0	0	0	0	0	0	0	0	0	0	0
"LOC643648"	1173	69529	0	0	0	0	0	0	0	0	0	0	0	0	0	0	0	0
"LOC643650"	2880	54947	0	0	0	0	0	0	169	41	0	0	0	0	0	0	0	0
"LOC643677"	21473	29706	0	0	0	0	0	0	0	0	0	0	0	0	0	0	0	0
"LOC643699"	566	820	0	0	0	0	0	0	0	0	0	0	0	0	1	0	0	0
"LOC643719"	604	959	0	0	0	0	0	0	0	0	0	0	0	0	0	0	0	0
"LOC643733"	3531	7156	0	0	0	0	0	0	0	0	0	0	1	0	1	2	5	0
"LOC643763"	7041	7041	0	0	0	0	0	0	0	0	0	0	0	0	0	0	0	0
"LOC643837"	1550	26678	33	25	23	10	0	25	66	162	0	98	55	147	188	131	80	66
"LOC643854"	2576	2576	0	0	0	0	0	0	0	0	0	0	0	0	0	0	0	0
"LOC643955"	1767	12764	0	0	0	0	0	0	0	0	0	0	0	0	0	0	0	0
"LOC644145"	391	17195	0	0	0	0	0	0	0	0	0	0	0	0	0	0	0	0
"LOC644172"	2259	2259	34	0	23	11	0	0	18	0	0	0	0	11	0	0	0	0
"LOC644215"	898	7263	0	0	0	0	0	0	8	0	0	18	0	0	0	0	0	0
"LOC644246"	519	3147	2	0	2	0	0	0	50	0	0	0	208	0	9	26	28	12
"LOC644538"	1534	1534	0	0	0	0	0	0	0	0	0	0	0	0	0	0	0	0
"LOC644617"	1844	1844	110	0	49	61	0	0	66	0	0	0	0	534	98	344	100	414
"LOC644669"	2103	12365	0	0	0	0	0	0	0	0	0	0	0	0	0	0	0	0
"LOC644844"	436	5400	4	0	2	2	0	0	0	31	0	0	1	0	0	0	0	0
"LOC644936"	1380	1380	0	0	0	0	0	0	0	0	0	0	0	0	0	0	0	0
"LOC645166"	1108	22651	0	0	0	0	0	0	20	17	0	0	0	0	764	526	950	812
"LOC645212"	1792	2359	0	0	0	0	0	0	24	0	0	0	124	47	27	28	76	19
"LOC645249"	939	5519	0	0	0	0	0	0	0	0	0	0	0	0	0	0	0	0
"LOC645323"	4178	11854	0	0	0	0	0	0	0	0	0	0	0	0	0	0	0	0
"LOC645332"	1861	13569	0	0	0	0	0	0	0	9	0	0	0	0	0	0	0	0
"LOC645676"	1962	1962	103	34	63	40	0	34	33	93	166	138	41	36	27	70	16	34
"LOC645752"	1414	1586	0	0	0	0	0	0	26	0	0	0	0	0	0	0	0	0
"LOC645851"	869	1449	6414	1308	3	6411	0	1308	7093	0	13299	3485	3	2	13	7	23	8
"LOC646214"	8227	8227	179	55	92	87	35	20	81	63	0	71	1079	1343	227	104	234	0
"LOC646405"	6699	39714	0	0	0	0	0	0	0	0	0	0	0	0	0	0	0	0
"LOC646471"	3654	3654	112	20	69	43	10	10	112	45	0	22	226	141	228	154	367	87
"LOC646498"	618	12354	0	6	0	0	6	0	10	0	0	0	0	0	0	0	0	0
"LOC646627"	435	435	0	0	0	0	0	0	0	0	0	0	0	0	0	0	0	0
"LOC646762"	5785	39217	403	38	246	157	26	12	200	8	0	22	208	137	44	14	54	0
"LOC646813"	1291	11486	0	0	0	0	0	0	0	0	0	0	0	0	0	0	0	0
"LOC646851"	10339	78511	0	0	0	0	0	0	8	8	0	0	0	1	0	0	0	0
"LOC646938"	393	1267	0	0	0	0	0	0	0	0	0	0	0	0	0	0	0	0
"LOC646999"	2603	2603	0	0	0	0	0	0	0	0	0	0	0	0	0	0	0	0
"LOC647107"	1525	126059	0	0	0	0	0	0	0	0	0	0	0	0	0	0	0	0
"LOC647121"	4239	52778	84	0	34	50	0	0	47	0	0	0	19	49	1278	771	1648	762
"LOC647264"	408	408	0	0	0	0	0	0	0	0	0	0	0	0	0	0	0	0
"LOC647288"	2629	2629	0	0	0	0	0	0	0	0	0	0	0	0	0	0	0	0
"LOC647309"	3629	9941	0	0	0	0	0	0	0	0	0	0	0	0	0	0	0	0
"LOC647946"	2346	133716	0	0	0	0	0	0	18	0	0	0	0	0	0	0	0	0
"LOC647979"	5342	5342	1120	854	641	479	456	398	621	454	465	675	7262	8035	3166	2643	3026	2144
"LOC648232"	2571	8172	0	0	0	0	0	0	0	0	0	0	0	0	0	0	0	0
"LOC648691"	3107	7252	0	0	0	0	0	0	0	0	0	0	0	0	0	0	0	0
"LOC648740"	1982	1982	0	0	0	0	0	0	0	0	0	0	0	0	0	0	0	0
"LOC649305"	3894	128437	4106	1735	2323	1783	960	775	2437	1417	1757	2254	0	54	15	29	0	13
"LOC649330"	1003	1003	0	0	0	0	0	0	0	0	0	0	0	0	0	0	0	0
"LOC650293"	651	651	0	0	0	0	0	0	0	0	0	0	0	0	0	0	0	0
"LOC650368"	2516	28189	0	0	0	0	0	0	13	0	0	0	0	0	0	0	0	0
"LOC650623"	5919	5919	681	353	424	257	188	165	289	127	82	184	109	213	39	38	78	20
"LOC651250"	11197	34374	1648	807	875	773	441	366	827	336	301	277	1552	1495	1716	1374	1986	1221
"LOC651900"	899	1713	0	0	0	0	0	0	0	0	0	0	0	0	0	0	0	0
"LOC652203"	2382	13839	451	78	248	203	43	35	273	81	38	88	0	0	1683	436	2509	421
"LOC652276"	4108	13747	348	163	202	146	103	60	202	75	77	235	42	45	653	322	697	197
"LOC652968"	1241	3353	0	136	0	0	80	56	27	124	0	196	19	34	25	51	67	46
"LOC653113"	2147	11898	105	0	48	57	0	0	174	20	0	0	19	41	21	24	139	36
"LOC653390"	2411	41875	1698	334	957	741	179	155	778	333	1859	972	49	39	446	613	458	356
"LOC653545"	3205	8207	0	0	0	0	0	0	0	0	0	0	0	0	0	0	0	0
"LOC653739"	2402	55795	36	11	15	21	0	11	72	44	0	28	52	47	1	0	0	0
"LOC654342"	1695	40182	54	0	38	16	0	0	561	143	0	0	0	0	189	142	43	147
"LOC678655"	2370	12518	67	19	39	28	19	0	133	57	0	0	268	335	138	93	201	89
"LOC723809"	1836	32019	4	0	4	0	0	0	0	13	0	0	0	0	0	0	0	0
"LOC723972"	737	737	0	0	0	0	0	0	0	0	0	0	131	157	0	0	0	0
"LOC727677"	1426	192324	0	0	0	0	0	0	12	0	0	0	0	0	0	0	0	0
"LOC727761"	986	11072	322	0	200	122	0	0	121	20	121	0	205	218	236	209	236	209
"LOC727896"	3408	3408	46	341	27	19	192	149	13	184	0	0	160	232	0	166	0	70
"LOC727924"	1609	93056	0	0	0	0	0	0	0	0	0	0	0	0	0	0	0	0
"LOC728138"	2164	2273	129	76	68	61	48	28	173	56	55	196	21	0	498	395	725	246
"LOC728190"	2346	98428	1348	350	749	599	200	150	2029	1086	510	868	634	900	144	278	248	119
"LOC728264"	9596	25961	0	0	0	0	0	0	64	19	0	0	0	0	0	0	0	0
"LOC728377"	1383	18664	0	0	0	0	0	0	0	0	0	0	0	0	0	0	0	0
"LOC728392"	1717	1796	2	0	2	0	0	0	0	50	0	0	151	101	74	117	124	80
"LOC728395"	1177	2795	0	0	0	0	0	0	0	0	0	0	0	0	0	0	0	0
"LOC728402"	1214	1214	0	0	0	0	0	0	0	0	0	0	0	0	0	0	0	0
"LOC728411"	4236	129892	506	115	279	227	56	59	716	213	48	129	14	28	147	128	332	85
"LOC728448"	2645	37419	431	303	240	191	161	142	340	151	163	223	72	163	251	195	212	57
"LOC728606"	2600	16019	0	0	0	0	0	0	10	0	0	0	0	0	0	0	0	0
"LOC728613"	3706	36448	15	0	0	15	0	0	141	15	0	0	59	71	64	47	116	51
"LOC728640"	2518	2518	0	0	0	0	0	0	0	0	0	0	0	0	0	0	0	0
"LOC728643"	541	541	0	0	0	0	0	0	0	0	0	0	0	0	0	0	0	0
"LOC728661"	6430	31305	1654	672	966	688	370	302	1290	750	1355	645	2873	2449	6071	4412	7494	4440
"LOC728723"	1569	60293	53	2	28	25	2	0	562	36	0	0	13	10	35	21	39	29
"LOC728741"	1331	14096	0	0	0	0	0	0	0	0	0	0	0	0	12	9	0	0
"LOC728743"	3371	6719	0	0	0	0	0	0	29	13	0	0	52	6	72	21	121	16
"LOC728758"	2347	2347	0	0	0	0	0	0	15	0	0	0	0	0	0	0	0	0
"LOC728819"	1171	1171	0	0	0	0	0	0	0	0	0	0	0	0	0	0	0	0
"LOC728855"	1273	40261	119	9	72	47	9	0	144	0	0	49	0	42	96	139	340	167
"LOC728875"	807	40247	0	0	0	0	0	0	56	13	0	0	0	0	51	36	110	82
"LOC728989"	1082	23706	0	0	0	0	0	0	0	0	0	0	0	0	16	15	15	8
"LOC729020"	2294	11910	7237	280	4026	3211	157	123	3168	97	905	120	366	1216	1763	1002	1948	1118
"LOC729082"	1897	15595	2212	363	1183	1029	221	142	1089	218	1440	545	7508	7961	5958	3957	5923	3153
"LOC729085"	3436	78448	6120	318	3542	2578	168	150	2945	254	1097	416	628	697	738	689	933	676
"LOC729121"	1732	3767	0	0	0	0	0	0	0	0	0	0	0	0	0	0	0	0
"LOC729156"	2437	34835	36	15	24	12	0	15	43	41	0	19	616	698	546	636	654	466
"LOC729176"	2156	2156	0	0	0	0	0	0	0	0	0	0	166	183	0	0	54	0
"LOC729234"	854	12585	12	0	5	7	0	0	59	23	49	0	125	148	160	199	234	242
"LOC729338"	632	2271	0	0	0	0	0	0	0	0	0	0	0	0	0	0	0	0
"LOC729375"	2121	13653	0	0	0	0	0	0	11	28	0	0	0	0	6	0	0	0
"LOC729384"	1654	8997	0	0	0	0	0	0	0	0	0	0	0	0	27	0	0	0
"LOC729467"	1044	14871	0	0	0	0	0	0	0	0	0	0	0	0	0	0	0	0
"LOC729603"	3132	3132	707	551	442	265	283	268	400	252	336	428	485	545	93	98	120	106
"LOC729678"	2894	5768	387	1030	221	166	563	467	284	502	423	1033	1415	1299	1458	1420	142	1225
"LOC729799"	2571	2571	110	38	53	57	20	18	85	14	0	0	164	177	0	0	0	0
"LOC729862"	445	445	0	0	0	0	0	0	0	0	0	0	0	0	0	0	0	0
"LOC729991"	1500	10716	863	293	482	381	169	124	415	284	769	362	134	115	322	219	485	330
"LOC729991-MEF2B"	2142	47026	1471	375	858	613	206	169	1056	498	1852	619	647	496	398	265	613	401
"LOC730092"	1621	22546	272	57	178	94	36	21	186	17	16	42	167	109	217	84	215	49
"LOC730101"	3786	4754	205	1001	108	97	514	487	75	375	0	517	120	851	103	783	214	649
"LOC730441"	2057	3968	0	0	0	0	0	0	0	0	0	0	0	0	0	0	0	0
"LOC730668"	4163	4163	0	0	0	0	0	0	38	0	0	36	0	0	0	0	0	0
"LOC730811"	3244	7878	0	0	0	0	0	0	0	0	0	0	0	0	0	0	0	0
"LOC731779"	799	4073	0	0	0	0	0	0	81	51	0	0	0	0	0	0	0	0
"LOC80054"	2201	2201	0	0	0	0	0	0	25	0	0	0	184	79	243	74	305	121
"LOC80154"	3640	34246	0	0	0	0	0	0	0	0	0	0	0	0	0	5	4	0
"LOC81691"	2795	43224	195	1546	149	46	601	945	60	1914	0	1772	90	6342	151	197	75	62
"LOC84740"	6794	24837	0	0	0	0	0	0	71	195	0	0	0	0	0	0	28	4
"LOC84856"	2310	19847	0	0	0	0	0	0	0	9	0	0	0	0	0	0	0	0
"LOC90110"	2253	2253	123	86	43	80	49	37	97	84	204	162	0	0	279	169	378	253
"LOC90246"	2751	2751	0	0	0	0	0	0	0	0	0	0	0	0	0	0	0	0
"LOC90379"	962	1695	250	12	150	100	0	12	71	51	0	0	414	338	351	338	614	235
"LOC90586"	2074	2074	0	0	0	0	0	0	0	0	0	0	0	0	0	0	0	0
"LOC90784"	3654	3654	23	54	0	23	43	11	0	0	0	0	1050	972	271	179	313	236
"LOC90826"	2689	45746	378	30	196	182	13	17	289	7	0	13	190	168	288	135	326	174
"LOC90834"	2422	2422	609	277	270	339	145	132	397	100	668	330	20	22	56	62	136	1
"LOC90835"	1049	2042	0	0	0	0	0	0	36	9	0	0	20	12	27	25	30	9
"LOC90925"	1007	1089	0	0	0	0	0	0	0	0	0	0	0	0	0	0	0	0
"LOC91149"	4623	13016	0	0	0	0	0	0	15	0	0	0	0	0	0	0	0	0
"LOC91316"	3818	54663	3252	1125	1692	1560	658	467	2177	964	3387	1912	619	845	880	1019	1025	695
"LOC91450"	993	993	226	87	117	109	42	45	807	57	94	59	0	0	0	0	0	0
"LOC91948"	1520	131815	0	0	0	0	0	0	15	0	0	0	0	0	0	0	0	0
"LOC92249"	2890	134436	189	0	102	87	0	0	263	43	0	65	117	135	2	1	2	2
"LOC92659"	1896	2925	0	0	0	0	0	0	39	58	0	0	0	0	0	0	0	0
"LOC92973"	5244	5244	0	0	0	0	0	0	18	0	0	0	0	0	0	0	0	0
"LOC93432"	1596	32228	0	0	0	0	0	0	0	0	0	0	0	0	0	0	0	0
"LOC93622"	1670	1955	59	0	35	24	0	0	39	7	0	0	324	165	287	92	323	111
"LOC96610"	3184	11596	600	206	327	273	87	119	301	111	202	81	820	820	910	845	818	557
"LOH11CR1A"	4982	4982	0	0	0	0	0	0	0	0	0	0	0	0	0	0	0	0
"LOH11CR1F"	5441	11601	0	0	0	0	0	0	0	0	0	0	0	0	0	0	0	0
"LOH11CR1L"	2316	8185	69	0	34	35	0	0	6	22	12	0	92	120	89	1053	1487	85
"LOH12CR1"	2089	109820	3831	1560	2087	1744	864	696	1946	783	796	1905	268	489	283	257	380	259
"LOH12CR2"	1538	1659	0	0	0	0	0	0	0	0	0	0	16	0	46	3	5	6
"LONP"	2222	103416	4028	1059	2238	1790	617	442	2408	509	1010	743	742	685	800	664	824	492
"LONP1"	3196	28332	1839	1509	987	852	814	695	633	830	997	2450	2773	1884	3158	2066	3430	2911
"LONP2"	4357	109198	4680	1665	2628	2052	949	716	2685	738	1389	1158	1651	1731	1586	1243	1637	973
"LONRF1"	3596	33588	761	2391	412	349	1358	1033	531	1628	22	2048	843	2824	750	1911	921	925
"LONRF2"	13923	49443	0	0	0	0	0	0	0	0	0	0	0	0	0	0	0	0
"LONRF3"	2775	43236	27	113	19	8	62	51	29	121	0	69	52	90	251	276	90	151
"LOR"	1229	2421	0	0	0	0	0	0	0	0	0	0	0	0	0	0	0	0
"LOX"	3911	13894	0	0	0	0	0	0	0	0	0	0	0	0	0	0	0	0
"LOXHD1"	6894	179781	0	0	0	0	0	0	55	33	0	0	0	0	0	0	0	0
"LOXL1"	2368	25691	0	0	0	0	0	0	152	64	0	0	0	0	0	0	0	0
"LOXL2"	3824	107314	0	0	0	0	0	0	273	97	0	20	16	3	0	0	4	0
"LOXL3"	3343	20267	2734	440	1755	979	283	157	953	465	2274	938	499	591	830	699	1506	730
"LOXL4"	3672	20566	810	121	522	288	44	77	540	210	107	144	2	0	0	0	0	0
"LP9056"	3640	8776	0	0	0	0	0	0	0	0	0	0	0	0	0	0	0	0
"LPA"	6528	134893	0	0	0	0	0	0	19	0	0	0	0	0	0	0	0	0
"LPAAT-delta"	7399	144052	8036	31925	4480	3556	17243	14682	2327	19753	1383	26950	443	975	1412	2975	1232	895
"LPAAT-e"	4994	53143	153	11	69	84	11	0	155	59	0	0	618	656	592	439	866	578
"LPAL2"	2048	43939	0	0	0	0	0	0	0	0	0	0	0	4	0	0	0	0
"LPAR1"	3447	165472	188	213	85	103	148	65	723	650	24	1981	64	168	226	213	348	271
"LPAR2"	2562	5273	464	72	265	199	33	39	91	103	307	132	1819	277	774	515	820	476
"LPAR3"	1724	79812	0	0	0	0	0	0	0	0	0	0	0	0	0	0	0	0
"LPAR4"	2617	9372	0	0	0	0	0	0	0	0	0	0	0	0	0	0	0	0
"LPAR5"	2857	17298	0	0	0	0	0	0	112	0	0	0	25	8	2	0	7	0
"LPAR6"	3008	33658	2227	2155	1280	947	1217	938	1098	1234	63	1296	3010	1104	2120	369	2806	707
"LPCAT1"	3958	62534	3183	4323	1672	1511	2177	2146	1392	4347	784	7718	1601	2655	1564	3538	2000	768
"LPCAT2"	5401	77670	8524	1741	4759	3765	1117	624	4002	1102	1307	1018	8810	9027	6635	5232	6718	4343
"LPCAT3"	2309	40496	2075	294	1249	826	182	112	1329	449	459	318	784	2504	2304	1854	2791	1915
"LPCAT4"	1921	8307	1215	93	690	525	46	47	488	68	1134	34	1414	1134	3029	1366	3599	1574
"LPGAT1"	8375	86779	6034	7509	3339	2695	4113	3396	2353	4163	2627	8826	3305	4330	2819	2875	3557	2498
"LPHN1"	7879	58448	2215	1490	1220	995	808	682	1050	1227	1817	1957	901	1064	1467	1612	1153	714
"LPHN2"	5833	192026	0	0	0	0	0	0	0	0	0	0	0	0	0	0	0	0
"LPHN3"	6778	871195	0	0	0	0	0	0	0	0	0	0	0	0	0	0	0	0
"LPIN1"	5617	149812	4277	1103	2429	1848	681	422	2294	1049	877	534	1949	1974	2278	1614	3173	1767
"LPIN2"	6248	94954	4044	4415	2449	1595	2463	1952	2311	3329	837	1413	728	6214	2477	2789	2509	1815
"LPIN3"	4385	19663	10	0	0	10	0	0	75	16	6	6	10	38	14	0	43	20
"LPL"	3756	28189	29	187	17	12	137	50	153	432	0	794	4140	4447	9278	12069	5523	6051
"LPL1"	2479	55640	2364	275	1408	956	149	126	1342	188	699	186	2275	2347	550	1813	581	304
"LPO"	2991	30093	0	0	0	0	0	0	35	0	0	0	1	0	0	0	0	0
"LPP"	7270	666722	168238	159151	94043	74195	86307	72844	72737	71097	88119	111651	2369	3434	2777	2330	2817	1395
"LPPR2"	3139	5877	56	0	34	22	0	0	136	45	0	76	333	301	399	416	453	345
"LPPR3"	2628	9451	50	21	29	21	21	0	39	283	0	33	0	0	0	0	0	0
"LPPR4"	4975	45238	0	0	0	0	0	0	0	0	0	0	0	0	0	0	0	0
"LPXN"	2188	49046	7503	11638	4247	3256	6357	5281	3670	3820	4289	7352	1782	1636	2298	2266	1812	1580
"LQFBS-1"	2714	2714	666	238	385	281	76	162	230	212	0	89	1236	1237	1522	1245	1959	1298
"LQK1"	943	1535	0	0	0	0	0	0	0	10	0	0	0	0	8	26	13	29
"LRAT"	5004	9120	0	0	0	0	0	0	0	0	0	0	0	0	0	0	0	0
"LRBA"	10400	751283	1183	780	697	486	428	352	1451	840	205	551	858	1148	1106	961	1226	797
"LRCH1"	5599	191740	11678	28367	6504	5174	15381	12986	5262	14909	2229	25633	1217	1574	1057	1000	1114	853
"LRCH2"	4945	123453	0	0	0	0	0	0	0	0	0	0	0	0	0	0	0	0
"LRCH3"	3113	92900	3568	4191	2134	1434	2290	1901	1749	2572	1080	4009	1161	2219	602	604	1813	426
"LRCH4"	3217	12142	2571	3339	1452	1119	1829	1510	876	2496	2603	5625	1354	1703	1772	2215	2146	1947
"LRDD"	4521	6062	301	70	155	146	46	24	166	162	389	114	250	178	415	382	191	392
"LRFN1"	3134	8521	1	0	0	1	0	0	0	0	0	0	0	72	128	24	0	90
"LRFN2"	3147	195755	0	0	0	0	0	0	165	57	0	0	0	0	0	0	0	0
"LRFN3"	2516	8075	0	3	0	0	0	3	0	9	0	0	19	1	12	4	22	6
"LRFN4"	2529	3071	322	24	176	146	24	0	129	50	336	56	814	592	1272	752	1911	1134
"LRFN5"	4258	205122	0	0	0	0	0	0	0	0	0	0	0	0	0	0	0	0
"LRG1"	1781	2810	0	0	0	0	0	0	0	28	0	0	11	0	5	0	39	0
"LRGUK"	2720	136830	0	22	0	0	15	7	38	7	0	40	3	2	0	0	20	4
"LRIG1"	4780	121625	224	88	68	156	70	18	258	100	0	50	560	610	513	442	501	332
"LRIG2"	4146	51513	1441	110	770	671	59	51	928	39	408	94	556	235	428	117	447	224
"LRIG3"	4041	48326	0	0	0	0	0	0	0	0	0	0	0	0	0	0	0	0
"LRIT1"	2305	9943	0	0	0	0	0	0	14	12	0	0	0	0	0	0	0	0
"LRIT2"	3120	5035	0	0	0	0	0	0	0	0	0	0	0	0	0	0	0	0
"LRIT3"	3784	20986	0	0	0	0	0	0	0	0	0	0	0	0	0	0	0	0
"LRMP"	3084	56029	3618	116	2011	1607	83	33	2371	49	588	12	1985	1580	1811	1179	2139	1397
"LRP1"	14975	84843	3829	1581	2089	1740	841	740	3900	1912	3225	1361	7808	6597	23512	27284	19082	18040
"LRP10"	3255	6331	807	126	437	370	60	66	262	161	571	231	5286	4502	5690	4678	8137	5893
"LRP11"	3625	45588	69	409	30	39	269	140	90	146	0	35	190	409	194	157	152	123
"LRP12"	4116	99755	7052	25630	3956	3096	13751	11879	2296	12444	372	18452	1187	2563	765	2019	1439	649
"LRP1B"	16622	1900276	0	0	0	0	0	0	9	0	0	0	0	0	0	0	0	0
"LRP2"	15813	235504	0	0	0	0	0	0	0	0	0	0	0	0	0	0	0	0
"LRP2BP"	6246	15141	34	0	34	0	0	0	47	12	0	0	0	0	0	0	28	0
"LRP3"	4503	4993	1	0	0	1	0	0	89	18	0	0	512	402	706	536	778	596
"LRP4"	8017	61659	0	0	0	0	0	0	13	0	0	0	0	0	0	0	0	0
"LRP5"	5169	136633	0	0	0	0	0	0	527	140	0	0	7	6	56	42	36	44
"LRP5L"	3608	11140	2840	1824	1572	1268	995	829	1068	1849	1801	2667	328	653	839	1009	621	247
"LRP6"	10104	150850	3	4	3	0	4	0	0	0	0	0	5	5	12	15	0	4
"LRP8"	4626	82611	3181	380	1783	1398	193	187	2198	456	200	172	966	662	562	543	755	462
"LRPAP1"	1578	19936	2284	869	1295	989	399	470	1184	788	2190	1222	2105	1719	3561	4117	4028	2986
"LRPDIT"	3360	1281601	0	0	0	0	0	0	0	0	0	0	0	0	0	0	0	0
"LRPPRC"	6657	109783	2389	1066	1350	1039	575	491	1753	1124	459	899	3678	4132	4245	3389	4958	3327
"LRRC1"	3438	129387	126	26	86	40	13	13	172	61	0	199	132	118	96	81	165	73
"LRRC10"	2597	2597	0	0	0	0	0	0	0	0	0	0	0	0	0	0	0	0
"LRRC10B"	2214	2214	0	0	0	0	0	0	0	0	0	0	0	0	0	0	0	0
"LRRC14"	5395	7168	784	97	444	340	59	38	284	132	999	363	663	490	918	460	1343	565
"LRRC14B"	1575	3844	0	0	0	0	0	0	45	41	0	0	0	2	0	0	0	0
"LRRC15"	5942	14497	0	0	0	0	0	0	17	9	0	0	0	0	0	0	0	0
"LRRC16A"	5474	341110	20069	8329	11315	8754	4849	3480	17620	7718	15587	8934	185	126	186	192	132	84
"LRRC16B"	4640	17733	5	0	5	0	0	0	94	140	15	0	10	6	0	0	0	0
"LRRC17"	2273	32212	0	0	0	0	0	0	0	3	0	0	0	0	0	0	6	0
"LRRC18"	1619	4751	95857	43533	57684	38173	21977	21556	40402	33339	45719	77039	274	686	378	324	862	216
"LRRC19"	3605	12550	0	0	0	0	0	0	22	0	0	0	0	0	0	0	0	0
"LRRC2"	5113	51133	0	0	0	0	0	0	0	0	0	0	0	0	0	0	0	0
"LRRC20"	3163	82687	0	0	0	0	0	0	170	35	0	0	69	53	9	0	45	10
"LRRC21"	176	176	0	0	0	0	0	0	0	0	0	0	0	0	0	0	0	0
"LRRC23"	1807	9510	150	24	93	57	14	10	186	72	0	0	318	268	297	293	295	201
"LRRC24"	2531	5411	589	109	310	279	71	38	331	60	731	302	974	709	33	793	1700	880
"LRRC25"	2404	6462	33	0	15	18	0	0	116	37	0	0	1066	223	504	207	676	291
"LRRC26"	1197	1281	0	0	0	0	0	0	0	0	0	0	0	0	0	0	0	0
"LRRC27"	8216	49271	709	0	426	283	0	0	559	71	132	0	352	119	259	101	447	163
"LRRC28"	2242	135630	2747	8869	1518	1229	4753	4116	1411	2506	708	1444	3764	6410	790	1598	680	830
"LRRC29"	1945	3947	383	4	167	216	4	0	348	387	45	97	67	60	91	65	98	69
"LRRC3"	2498	3339	0	0	0	0	0	0	35	14	0	0	272	138	150	75	260	70
"LRRC30"	906	906	0	0	0	0	0	0	0	0	0	0	0	0	0	0	0	0
"LRRC31"	2474	30633	0	0	0	0	0	0	0	0	0	0	0	0	0	0	0	0
"LRRC32"	4314	12477	14	1061	14	0	621	440	82	1072	0	2959	0	293	0	4160	3	1645
"LRRC33"	2465	22218	7330	1743	4048	3282	875	868	3234	1101	8171	4951	6135	3867	7258	4349	8632	5820
"LRRC34"	4033	19456	0	0	0	0	0	0	0	0	0	0	0	1	4	0	0	0
"LRRC36"	2414	58363	0	0	0	0	0	0	0	0	0	0	0	0	0	0	0	0
"LRRC37A"	5189	42663	46	25	37	9	12	13	89	11	0	0	20	0	1306	1261	1715	1200
"LRRC37A2"	5189	42940	1123	441	606	517	257	184	1134	382	276	335	269	239	3246	614	4003	925
"LRRC37A3"	5764	64502	640	309	379	261	165	144	408	158	296	479	346	549	1083	729	1328	741
"LRRC37B"	3088	45482	1001	289	559	442	190	99	708	63	620	210	377	138	290	96	331	145
"LRRC37B2"	4183	29038	529	95	290	239	74	21	315	75	150	84	622	564	592	373	688	324
"LRRC38"	1908	38797	0	0	0	0	0	0	22	11	0	0	0	0	0	0	0	0
"LRRC39"	1519	29389	68	0	35	33	0	0	35	0	0	0	316	259	263	95	249	61
"LRRC3B"	1694	86107	0	0	0	0	0	0	0	0	0	0	0	0	0	0	0	0
"LRRC4"	3707	3878	1066	502	434	632	276	226	457	951	184	352	13	29	35	6	22	0
"LRRC40"	2862	60780	402	222	248	154	140	82	258	379	17	115	603	589	452	396	548	273
"LRRC41"	2957	24967	894	378	463	431	176	202	493	350	343	506	1044	1437	1700	1337	1885	1345
"LRRC42"	1757	21804	15	0	8	7	0	0	0	14	11	0	16	240	346	186	339	234
"LRRC43"	2036	20352	0	0	0	0	0	0	23	15	0	0	0	0	0	0	0	0
"LRRC45"	2615	7748	60	3	25	35	0	3	133	34	27	10	257	192	328	231	467	322
"LRRC46"	2332	5592	0	0	0	0	0	0	107	84	0	0	7	6	0	6	15	11
"LRRC47"	2655	16286	290	78	179	111	46	32	343	61	154	46	552	310	544	438	640	475
"LRRC48"	2168	44062	933	12	577	356	12	0	514	22	612	0	243	114	250	1	367	46
"LRRC49"	3020	196818	0	0	0	0	0	0	8	0	0	0	0	0	0	0	0	0
"LRRC4B"	2958	51152	0	0	0	0	0	0	276	68	0	27	18	0	0	0	0	0
"LRRC4C"	4110	179913	0	0	0	0	0	0	16	0	0	0	0	0	0	0	0	0
"LRRC50"	2447	32660	338	3353	301	37	1243	2110	61	2109	0	790	0	0	0	274	0	618
"LRRC52"	1124	19709	0	0	0	0	0	0	7	0	0	0	0	0	0	0	0	0
"LRRC55"	3799	8359	0	0	0	0	0	0	0	0	0	0	0	0	0	0	0	0
"LRRC56"	2787	17395	105	26	56	49	21	5	196	214	8	35	62	40	58	100	149	63
"LRRC57"	2652	6280	106	48	53	53	14	34	36	56	7	65	475	547	376	260	411	278
"LRRC58"	7687	24612	928	181	530	398	99	82	489	121	0	0	2954	126	2491	1740	2505	1284
"LRRC59"	2834	16234	226	678	125	101	414	264	192	652	6	787	2803	1226	3300	1009	1500	632
"LRRC6"	1694	103367	0	13	0	0	5	8	8	8	0	12	5	1	7	0	3	4
"LRRC61"	2513	2513	9	0	5	4	0	0	30	9	0	0	99	64	129	22	297	80
"LRRC63"	1872	54994	0	0	0	0	0	0	20	25	0	5	0	1	0	7	0	4
"LRRC66"	3332	23921	0	0	0	0	0	0	0	0	0	0	8	0	0	0	0	0
"LRRC67"	1088	40420	0	0	0	0	0	0	0	0	0	0	0	0	0	0	0	0
"LRRC68"	1721	2149	1949	90	1081	868	60	30	1522	537	1364	60	342	213	558	336	613	379
"LRRC69"	1493	100862	2534	887	1429	1105	523	364	1003	134	241	287	288	151	158	14	93	10
"LRRC7"	6268	363313	0	0	0	0	0	0	0	0	0	0	0	0	4	0	0	0
"LRRC70"	2251	2715	0	0	0	0	0	0	19	14	0	0	0	0	0	2	0	0
"LRRC8A"	4625	35536	636	65	379	257	32	33	680	618	173	1199	1478	1271	1822	1560	2362	1693
"LRRC8B"	8044	73023	8501	6299	4593	3908	3446	2853	3943	3207	773	3719	1639	2750	1507	1495	1848	1497
"LRRC8C"	7209	86451	23855	3618	13258	10597	1921	1697	11635	1016	10912	1226	5316	5384	5090	2764	5722	3252
"LRRC8D"	3788	115416	15983	3887	8992	6991	2267	1620	8071	2371	7836	3485	1684	1419	1685	1137	1901	1251
"LRRC8E"	3607	13522	0	0	0	0	0	0	82	30	0	0	0	0	0	0	0	0
"LRRCC1"	4512	37417	0	0	0	0	0	0	0	0	0	0	67	73	37	20	82	55
"LRRFIP1"	4503	73751	36559	16302	20165	16394	8691	7611	15516	7526	27207	16012	12302	14183	13823	10922	14912	8631
"LRRFIP2"	3843	123736	8795	18503	4914	3881	9982	8521	3098	8703	1397	17739	867	3350	1008	1674	806	1214
"LRRIQ1"	5468	208783	0	0	0	0	0	0	0	0	0	0	0	0	0	0	0	0
"LRRIQ3"	4755	172169	0	0	0	0	0	0	0	0	0	0	0	0	0	0	0	0
"LRRIQ4"	1827	15850	0	0	0	0	0	0	0	0	0	0	0	0	0	0	0	0
"LRRK1"	7663	150857	23414	10236	13074	10340	5437	4799	8806	5955	10130	9285	2276	3267	3113	2610	4884	2769
"LRRK2"	9273	144273	2625	515	1421	1204	327	188	3054	829	456	305	974	1003	1041	1038	1976	1568
"LRRN1"	3824	48267	101	0	71	30	0	0	88	42	0	0	0	0	7	0	0	0
"LRRN2"	3325	68296	41	0	14	27	0	0	87	25	0	0	0	11	9	0	9	0
"LRRN3"	3729	34447	191	39	134	57	39	0	140	63	0	32	0	0	0	0	0	0
"LRRN4"	2695	13271	0	0	0	0	0	0	10	9	0	0	0	0	0	0	0	0
"LRRN4CL"	2414	3326	0	0	0	0	0	0	0	0	0	0	0	0	0	0	0	0
"LRRTM1"	2988	16008	0	0	0	0	0	0	0	0	0	0	0	0	0	0	0	0
"LRRTM2"	5630	5980	667	501	403	264	270	231	496	647	92	537	0	1	0	0	0	0
"LRRTM3"	5612	175077	0	0	0	0	0	0	0	0	0	0	0	0	0	0	0	0
"LRRTM4"	3626	5717	0	0	0	0	0	0	0	0	0	0	0	0	0	0	0	0
"LRSAM1"	3176	51763	2580	525	1430	1150	280	245	1481	772	1692	1454	627	708	702	538	998	549
"LRTM1"	1276	9689	0	0	0	0	0	0	0	0	0	0	0	0	0	0	0	0
"LRTM2"	3991	16487	0	0	0	0	0	0	110	39	0	0	0	0	0	0	0	0
"LRTOMT"	3833	30447	1678	80	858	820	57	23	976	109	1037	182	3845	2531	4159	3111	5330	3415
"LRWD1"	2211	8222	42	5	30	12	5	0	164	111	0	0	323	132	331	140	631	295
"LSAMP"	1609	635230	0	0	0	0	0	0	0	0	0	0	0	0	0	0	0	0
"LSD"	2118	22501	893	216	565	328	112	104	622	108	71	0	1187	1193	1771	1329	1411	686
"LSDP5"	1764	11599	0	0	0	0	0	0	48	58	0	0	11	0	5	0	39	0
"LSG1"	3585	31690	679	284	419	260	135	149	322	281	54	116	1009	1001	804	568	961	525
"LSM1"	921	13167	104	18	34	70	18	0	116	27	0	53	101	121	228	203	319	462
"LSM10"	852	4464	71	0	37	34	0	0	111	16	0	0	773	28	71	0	2	0
"LSM11"	2565	12993	11	0	6	5	0	0	21	0	0	0	93	128	98	53	133	12
"LSM12"	2489	32985	1150	752	605	545	431	321	586	552	257	1537	226	214	1379	1203	1674	1179
"LSM14A"	3843	21320	4998	2700	2861	2137	1480	1220	2173	1530	1552	2799	2850	2785	2841	2486	3296	1830
"LSM14B"	2633	7121	1219	76	688	531	41	35	720	101	789	224	1522	672	2004	895	2458	761
"LSM2"	862	9572	0	0	0	0	0	0	41	8	0	0	292	7	122	249	375	251
"LSM3"	557	19501	12	0	12	0	0	0	63	0	0	40	238	271	424	372	481	373
"LSM4"	1152	16285	491	36	369	122	4	32	400	112	397	77	326	1102	1385	1135	2261	1155
"LSM5"	3002	5532	0	0	0	0	0	0	22	0	0	0	359	386	361	292	463	289
"LSM6"	790	14379	461	11	260	201	11	0	205	29	63	62	361	377	379	312	580	362
"LSM7"	522	7094	285	0	163	122	0	0	275	116	353	216	360	335	400	60	501	232
"LSM8"	1309	8794	443	112	216	227	50	62	348	57	236	177	1037	1007	775	446	1133	487
"LSMD1"	999	1169	1240	34413	560	680	18114	16299	47	16744	0	42580	21	882	327	85	29	3018
"LSP1"	2027	27099	8543	6197	790	7753	3274	2923	4366	2949	9328	4288	13611	10745	14700	11969	23148	15950
"LSR"	2286	19308	1046	246	584	462	127	119	501	204	1169	189	69	110	73	85	140	82
"LSS"	4411	39702	1565	4347	968	597	2362	1985	818	2671	154	4051	854	1447	1113	2636	1433	1513
"LST-3TM12"	2141	274432	0	0	0	0	0	0	0	0	0	0	0	0	0	0	0	0
"LST002"	4066	33116	110	30	71	39	19	11	229	31	28	28	902	1075	918	689	977	649
"LST005"	2531	5755	103	70	63	40	29	41	70	39	7	24	72	84	823	512	975	511
"LST1"	752	2716	621	83	351	270	47	36	234	159	195	65	3200	2940	3087	3010	4529	3163
"LST3"	2326	274432	0	0	0	0	0	0	0	0	0	0	0	0	0	0	0	0
"LTA"	1463	2224	0	36	0	0	36	0	0	55	0	0	0	610	0	276	4	279
"LTA4H"	2084	42689	285	4	186	99	0	4	286	59	12	0	1451	1941	1486	1153	2696	1951
"LTB"	898	1869	49	123	27	22	30	93	0	7001	0	337	194	229	124	351	243	47
"LTB4R"	4135	4750	1072	424	599	473	205	219	403	280	1091	420	615	381	1382	827	1722	707
"LTB4R2"	2799	2799	2202	339	1214	988	148	191	744	326	1076	339	3056	2453	681	422	912	382
"LTBP1"	6164	452183	0	0	0	0	0	0	0	0	0	0	0	0	0	0	3	0
"LTBP2"	8587	114147	0	0	0	0	0	0	318	128	0	0	34	0	0	0	7	0
"LTBP3"	4729	19670	154	50	58	96	27	23	217	142	2	17	515	330	435	387	574	399
"LTBP4"	5176	32586	68	0	43	25	0	0	391	194	109	13	238	158	179	126	443	273
"LTBR"	2115	7377	566	79	314	252	34	45	359	174	225	163	3722	2806	2220	1751	5604	3178
"LTC4S"	671	2528	269	38	151	118	0	38	95	58	231	89	96	38	227	75	282	88
"LTF"	2871	49229	0	0	0	0	0	0	38	0	0	0	0	0	0	0	0	0
"LTG9/MLLT3"	2115	259789	33	37	22	11	18	19	10	9	0	15	17	4	8	8	5	0
"LTK"	3147	10247	0	0	0	0	0	0	42	0	0	0	0	0	0	0	0	0
"LTRPC6"	3268	37749	0	0	0	0	0	0	11	0	0	0	0	0	0	0	0	0
"LTV1"	2580	7333	1747	1139	933	814	613	526	810	802	541	1527	1587	2218	1211	1122	1911	1128
"LUC7L"	2265	20800	3155	2307	1839	1316	1267	1040	1466	1543	2803	4202	405	743	609	792	542	744
"LUC7L2"	3628	48781	6491	6577	3654	2837	3625	2952	2889	3014	2084	4536	3293	4559	3736	3242	3772	2468
"LUC7L3"	3474	33095	3031	2264	1737	1294	1170	1094	1468	1302	818	1929	1924	1922	2247	1664	2946	1307
"LUM"	2118	8311	0	0	0	0	0	0	0	0	0	0	0	0	0	0	0	0
"LUZP1"	8658	85003	3053	2096	1728	1325	1133	963	1198	2376	398	4751	2221	3173	3047	3044	4151	2303
"LUZP2"	5265	585628	0	0	0	0	0	0	0	0	0	0	0	0	0	0	0	0
"LUZP4"	1730	17829	0	0	0	0	0	0	0	0	0	0	0	0	0	0	0	0
"LVRN"	4640	65149	0	0	0	0	0	0	0	0	0	0	0	0	0	0	0	0
"LW-1"	2333	2794	0	0	0	0	0	0	0	0	0	0	0	0	0	0	0	0
"LXN"	1121	6280	118	21	65	53	9	12	77	20	0	62	55	108	85	52	74	84
"LY49L"	2275	11358	6	0	0	6	0	0	0	10	12	0	30	30	23	0	10	0
"LY6D"	805	1712	0	0	0	0	0	0	24	20	0	0	0	0	0	0	0	0
"LY6E"	1180	3927	82	68	21	61	35	33	86	57	44	0	2914	2493	8705	4336	5488	5451
"LY6G5B"	777	1501	1508	1379	889	619	755	624	617	645	914	1206	2784	3677	2498	2301	3498	2235
"LY6G5C"	954	7358	0	0	0	0	0	0	55	57	0	0	3	5	26	24	9	7
"LY6G6C"	995	3087	0	0	0	0	0	0	19	0	0	0	0	0	0	0	0	0
"LY6G6D"	495	2450	0	0	0	0	0	0	19	0	0	0	0	0	0	0	0	0
"LY6G6E"	756	1726	0	0	0	0	0	0	19	15	0	0	1	1	0	0	0	0
"LY6G6F"	1155	10899	0	1	0	0	1	0	53	32	0	0	3	2	0	0	0	0
"LY6H"	1622	2425	0	0	0	0	0	0	0	16	0	0	0	0	0	0	0	0
"LY6K"	1958	4055	0	0	0	0	0	0	0	0	0	0	0	0	0	0	0	0
"LY75"	8951	136123	12466	7441	7005	5461	4005	3436	6750	3695	3619	4460	12050	13691	10917	8415	16298	9694
"LY86"	884	66284	4869	991	2689	2180	565	426	3201	1029	1504	530	703	353	654	564	431	706
"LY9"	2465	32117	41	0	36	5	0	0	72	0	0	0	331	253	1060	731	837	728
"LY96"	595	37720	2702	190	1588	1114	119	71	1244	57	791	0	717	397	723	643	739	609
"LYAR"	1576	22467	0	49	0	0	28	21	60	155	0	141	229	465	353	492	425	415
"LYG1"	1077	20518	18	0	10	8	0	0	50	0	0	0	37	32	20	8	43	25
"LYG2"	874	12861	0	0	0	0	0	0	0	0	0	0	0	0	0	0	0	0
"LYL1"	1493	3835	115	0	68	47	0	0	58	14	69	0	630	152	644	194	829	152
"LYN"	3101	131552	22601	65594	12667	9934	35034	30560	6789	31369	7490	52162	4341	7022	4449	5206	4697	3920
"LYNX1"	4953	7027	0	0	0	0	0	0	139	71	0	0	148	49	961	1045	183	272
"LYPD1"	2685	26145	0	0	0	0	0	0	15	0	0	0	0	0	5	0	0	0
"LYPD2"	536	2325	0	0	0	0	0	0	18	0	0	0	0	0	0	0	0	0
"LYPD3"	1711	4887	0	0	0	0	0	0	17	0	0	17	80	225	160	244	177	63
"LYPD4"	1797	7360	0	0	0	0	0	0	0	0	0	0	0	0	0	0	0	0
"LYPD5"	2505	6535	0	0	0	0	0	0	19	0	0	0	0	0	0	0	0	0
"LYPD6"	3642	105647	0	0	0	0	0	0	0	0	0	0	0	0	0	0	0	0
"LYPD6B"	1580	176793	0	0	0	0	0	0	0	0	0	0	0	0	0	4	0	0
"LYPLA1"	2582	55640	2364	275	1408	956	149	126	1342	188	699	186	2275	2347	550	1813	581	304
"LYPLA2"	1735	4381	118	50	66	52	0	50	117	90	0	126	214	267	1433	1303	857	1363
"LYPLA3"	3123	6277	131	0	59	72	0	0	187	15	100	0	1442	666	2504	1202	2109	1226
"LYPLAL1"	1896	39016	2312	115	1229	1083	61	54	1329	128	289	77	460	176	616	312	543	294
"LYRIC"	6434	39309	2715	476	1535	1180	269	207	1127	132	1368	99	7065	6626	5719	4330	7058	4098
"LYRM1"	1663	23902	1706	1660	85	1621	873	787	146	1106	18	2831	502	1932	471	785	456	510
"LYRM2"	5515	6273	118	0	79	39	0	0	91	35	0	0	1029	925	667	503	774	548
"LYRM4"	1610	152516	1707	1079	976	731	566	513	1798	2424	89	1838	278	283	220	204	419	334
"LYRM5"	1141	9800	29	0	29	0	0	0	60	8	0	0	214	264	217	195	264	174
"LYRM7"	6218	34480	89	0	42	47	0	0	62	0	0	0	604	636	237	132	270	154
"LYSMD1"	2456	6147	451	0	316	135	0	0	279	25	0	0	2455	1496	2381	1246	2887	0
"LYSMD2"	1694	15060	14	617	14	0	310	307	19	670	0	375	136	798	138	432	141	177
"LYSMD3"	4261	13956	108	12	33	75	12	0	94	11	0	0	477	455	521	445	526	301
"LYSMD4"	2887	6014	1531	843	819	712	238	605	782	275	87	200	2689	3090	2650	2201	2792	2514
"LYST"	13529	205877	41948	20261	23657	18291	11169	9092	19105	8044	22467	13703	5864	8686	7088	5733	8446	3552
"LYVE1"	2506	10954	0	0	0	0	0	0	0	0	0	0	0	0	0	0	0	0
"LYZ"	1520	5881	774	377	440	334	193	184	194	113	158	26	17962	15682	41779	15076	33469	9473
"LYZL1"	816	22169	0	0	0	0	0	0	11	0	0	0	0	0	0	0	0	0
"LYZL2"	778	17940	0	0	0	0	0	0	0	0	0	0	0	0	0	0	0	0
"LYZL4"	875	13490	0	0	0	0	0	0	0	0	0	0	0	0	0	0	0	0
"LYZL6"	916	9148	0	0	0	0	0	0	10	0	0	0	0	0	0	0	0	0
"LZIC"	1508	13611	34	10	27	7	5	5	22	9	0	0	229	227	540	379	462	238
"LZP"	1953	39450	0	0	0	0	0	0	0	0	0	0	0	0	0	0	0	0
"LZTFL1"	4038	92090	0	0	0	0	0	0	14	0	0	0	217	227	151	66	200	77
"LZTR1"	4379	19576	732	339	367	365	210	129	587	274	294	217	819	834	1254	1027	1947	1236
"LZTS1"	5461	9128	1	0	0	1	0	0	0	13	0	0	1	0	0	0	0	0
"LZTS2"	5737	8354	96	0	53	43	0	0	154	15	105	0	321	196	584	274	625	298
"Lsx"	1605	34142	56	0	44	12	0	0	79	0	0	0	164	237	104	110	123	88
"M-RIP"	1421	12863	676	377	376	300	225	152	494	209	256	348	1266	1428	954	790	1019	790
"M1"	423	16450	0	0	0	0	0	0	0	0	0	0	0	0	0	0	0	0
"M37726"	70	70	0	0	0	0	0	0	17	0	0	0	24	34	40695	51608	266135	50784
"M41"	1640	2274	0	0	0	0	0	0	0	0	0	0	0	0	0	0	0	0
"M55536"	4476	4476	2199	693	1234	965	378	315	925	441	358	348	0	5858	3258	2702	3292	1882
"M6PR"	2460	9289	3045	1609	1669	1376	555	1054	889	829	1261	1757	8267	10962	17977	16013	20313	13518
"M8"	2334	9387	0	0	0	0	0	0	0	0	0	0	0	0	0	0	0	0
"M84131"	974	12606	0	0	0	0	0	0	0	0	0	0	0	0	0	0	0	0
"M9"	971	16300	1035	357	609	426	239	118	474	213	866	1051	1735	1182	2543	2528	3814	2781
"M96"	1975	41041	970	109	540	430	74	35	591	71	165	45	332	212	382	209	381	228
"MA3"	1253	1767	0	0	0	0	0	0	0	0	0	0	0	0	0	0	0	0
"MAB21L1"	2514	2514	0	0	0	0	0	0	0	0	0	0	0	0	0	0	0	0
"MAB21L2"	2768	2768	38	0	38	0	0	0	41	0	0	61	0	0	0	0	0	0
"MACC1"	9156	82727	0	0	0	0	0	0	0	9	0	0	0	4	0	9	0	0
"MACF1"	19320	155981	27786	42040	15553	12233	22919	19121	11126	24473	6808	18987	5745	7708	9582	9175	10358	5700
"MACROD1"	1267	167556	1	0	1	0	0	0	1468	915	0	171	23	23	17	22	25	22
"MACROD2"	4947	2057695	7	0	7	0	0	0	31	8	0	0	37	99	6	0	5	0
"MACROH2A2"	2192	59684	0	0	0	0	0	0	37	0	0	0	24	21	157	127	59	56
"MACS"	1730	68021	2037	5177	1087	950	3191	1986	269	793	246	3456	146	344	3	6	15	4
"MAD1"	2377	417157	27083	15873	15007	12076	8445	7428	14929	13042	15664	19761	731	706	877	800	1148	690
"MAD1L1"	2792	335259	27083	15873	15007	12076	8445	7428	14929	13042	15664	19761	731	706	877	800	1148	690
"MAD2L1"	1441	7436	0	0	0	0	0	0	25	0	0	0	42	39	36	18	59	19
"MAD2L1BP"	1549	11409	52	19	34	18	0	19	15	19	0	0	431	446	707	450	894	443
"MAD2L2"	1841	17142	148	0	75	73	0	0	123	81	52	33	556	601	580	526	835	484
"MADCAM1"	1541	8854	0	0	0	0	0	0	20	13	0	0	0	0	0	0	1	0
"MADD"	6052	60385	5012	1494	2776	2236	861	633	1908	941	2004	1477	2655	2519	3395	3198	4079	2641
"MAEA"	2454	11081	1989	1566	1048	941	771	795	1155	1419	1054	2114	1050	1275	1375	1118	1621	948
"MAEL"	1743	32930	0	0	0	0	0	0	0	0	0	0	0	0	0	0	0	0
"MAF"	6878	6878	1206	497	728	478	270	227	553	371	42	0	3694	4240	4963	3593	4515	2338
"MAF1"	1783	3212	80	49	9	71	24	25	139	62	192	29	3306	2506	3269	3193	4685	3112
"MAFA"	1063	1063	0	0	0	0	0	0	0	0	0	0	217	60	123	27	322	86
"MAFB"	3359	3359	408	160	183	225	105	55	351	134	182	114	5102	1375	5960	1588	6218	1919
"MAFF"	2466	14578	1380	4137	796	584	2172	1965	321	1867	650	5437	1745	7714	2439	7877	2458	8018
"MAFG"	5040	9443	2174	1365	1227	947	705	660	648	503	1958	1230	50	2807	3546	3785	3884	3174
"MAFK"	3352	12312	1673	744	920	753	410	334	413	379	1359	1051	1117	1144	1557	1511	2260	1765
"MAG"	2437	21671	0	0	0	0	0	0	245	96	0	0	4	6	34	18	4	11
"MAGE-E1a"	920	2716	0	0	0	0	0	0	0	0	0	0	0	0	0	0	0	0
"MAGEA1"	1712	4596	0	0	0	0	0	0	0	0	0	0	0	0	0	0	0	0
"MAGEA10"	1599	4120	0	0	0	0	0	0	0	0	0	0	0	0	0	0	0	0
"MAGEA11"	1940	5243	0	0	0	0	0	0	0	21	0	0	0	0	0	0	0	0
"MAGEA12"	1859	3804	0	0	0	0	0	0	0	8	0	0	0	0	0	0	0	0
"MAGEA2"	1987	3978	0	0	0	0	0	0	0	0	0	0	0	0	0	0	0	0
"MAGEA3"	1726	3589	0	0	0	0	0	0	0	0	0	0	0	0	0	0	0	0
"MAGEA4"	1728	8933	0	0	0	0	0	0	0	0	0	0	0	0	0	0	0	0
"MAGEA5"	1692	3917	0	0	0	0	0	0	0	0	0	0	0	0	0	0	0	0
"MAGEA6"	1765	3571	0	0	0	0	0	0	0	0	0	0	0	0	0	0	0	0
"MAGEA8"	1780	4614	0	0	0	0	0	0	0	0	0	0	0	0	0	0	0	0
"MAGEA9"	1816	5807	0	0	0	0	0	0	0	0	0	0	0	0	0	0	0	0
"MAGEA9B"	1769	5168	0	0	0	0	0	0	0	0	0	0	0	0	0	0	0	0
"MAGEB1"	1868	8308	0	0	0	0	0	0	0	0	0	0	0	0	0	0	0	0
"MAGEB10"	1569	14639	0	0	0	0	0	0	0	0	0	0	0	0	0	0	0	0
"MAGEB16"	1820	5395	0	0	0	0	0	0	0	0	0	0	0	0	0	0	0	0
"MAGEB18"	1811	2391	0	0	0	0	0	0	0	0	0	0	0	0	0	0	0	0
"MAGEB2"	1612	4531	0	0	0	0	0	0	0	0	0	0	0	0	0	0	0	0
"MAGEB3"	2308	7056	0	0	0	0	0	0	0	0	0	0	0	0	0	0	0	0
"MAGEB4"	2139	2139	0	0	0	0	0	0	0	0	0	0	0	0	0	0	0	0
"MAGEB6"	1950	3207	0	0	0	0	0	0	0	0	0	0	0	0	0	0	0	0
"MAGEC1"	4282	5504	0	0	0	0	0	0	0	0	0	0	0	0	0	0	0	0
"MAGEC2"	1995	2948	0	0	0	0	0	0	0	0	0	0	0	0	0	0	0	0
"MAGEC3"	1939	59517	0	0	0	0	0	0	0	0	0	0	0	0	0	0	0	0
"MAGED1"	2924	8752	210	18	102	108	0	18	197	7	0	34	401	385	346	312	335	267
"MAGED2"	2167	6954	206	49	135	71	18	31	172	35	44	0	1556	1845	962	741	4768	1754
"MAGED4"	2595	7445	0	0	0	0	0	0	0	0	0	0	0	0	0	0	0	0
"MAGED4B"	2683	7445	0	0	0	0	0	0	0	0	0	0	0	0	0	0	0	0
"MAGEE1"	3629	3629	0	0	0	0	0	0	0	0	0	0	0	0	0	0	0	0
"MAGEE2"	2250	2250	0	0	0	0	0	0	0	0	0	0	0	0	0	0	0	0
"MAGEF1"	1682	1682	0	0	0	0	0	0	0	0	0	0	81	60	36	0	155	66
"MAGEH1"	1462	1462	0	0	0	0	0	0	0	0	0	0	51	43	40	54	40	31
"MAGEL2"	2479	2479	0	0	0	0	0	0	0	0	0	0	0	0	0	0	0	0
"MAGI1"	7259	684604	0	0	0	0	0	0	9	0	0	0	131	180	0	0	0	0
"MAGI2"	6901	1436517	0	0	0	0	0	0	14	0	0	0	10	0	5	0	0	0
"MAGI3"	7308	295062	4	0	4	0	0	0	18	16	0	0	179	213	392	592	733	545
"MAGIX"	2626	3568	19	0	19	0	0	0	18	0	0	0	11	0	10	21	28	0
"MAGOH"	2871	9391	87	248	65	22	131	117	49	166	3	196	303	482	434	341	480	378
"MAGOHB"	2584	9391	0	15	0	0	15	0	16	8	3	0	59	144	86	93	119	97
"MAGP2"	2861	16895	0	0	0	0	0	0	9	0	0	0	0	0	0	0	0	0
"MAGT1"	4029	69203	556	711	287	269	379	332	205	724	47	671	540	678	2076	1969	1813	1386
"MAK"	4155	75758	836	89	498	338	36	53	782	44	91	46	26	3	1	5	9	4
"MAK10"	2679	81161	1229	216	705	524	129	87	885	183	58	139	592	529	424	385	515	308
"MAK16"	3583	16094	152	25	112	40	25	0	90	12	20	0	772	635	685	437	753	470
"MAL"	1060	28258	0	0	0	0	0	0	54	10	0	0	10	0	0	5	7	0
"MAL2"	2821	37303	0	0	0	0	0	0	0	0	0	0	0	0	0	0	0	0
"MALL"	3060	32693	0	0	0	0	0	0	27	0	0	0	0	0	0	0	0	0
"MALS-1"	1314	140525	1853	385	1059	794	230	155	746	88	0	0	606	859	91	106	117	72
"MALT1"	5046	78754	2075	1788	1170	905	877	911	1195	581	224	637	1419	1544	877	844	980	785
"MAMDC2"	3632	183393	0	9	0	0	9	0	0	0	0	0	0	0	0	0	0	0
"MAMDC4"	3685	8432	754	169	403	351	71	98	349	210	258	248	39	31	163	127	278	133
"MAML1"	7084	63663	5347	3498	2951	2396	1889	1609	2309	2439	3218	4971	2104	2236	2345	2110	3127	1785
"MAML2"	5433	364906	31563	43831	17503	14060	23680	20151	15542	21853	3463	15937	208	253	219	241	236	113
"MAML3"	7094	437689	4989	1327	2887	2102	673	654	5316	3160	240	923	442	381	405	287	522	225
"MAMLD1"	4612	68728	24	2797	8	16	1290	1507	37	2638	0	2989	8	62	0	0	6	0
"MAMSTR"	1831	3961	0	0	0	0	0	0	34	38	0	0	0	0	0	0	0	0
"MAN1A1"	4134	171661	8073	65146	4431	3642	34756	30390	2652	9483	349	15996	1047	1721	1761	1753	1270	879
"MAN1A2"	5401	158237	3202	1181	1869	1333	662	519	2064	712	280	696	1433	1736	1739	1490	1573	941
"MAN1B1"	3952	5841	1748	645	964	784	297	348	984	417	2225	719	1606	1127	1879	1245	2666	1682
"MAN1C1"	3339	167301	34620	7562	19050	15570	4200	3362	11418	2426	10087	2197	1843	2311	1180	859	2425	1018
"MAN2A1"	5150	178275	7306	2043	4201	3105	1155	888	4515	1886	1621	1414	3608	4030	5049	4174	4570	3325
"MAN2A2"	6290	18396	7427	2920	4068	3359	1623	1297	2214	988	4016	1265	4686	4692	5502	3222	8935	3958
"MAN2B1"	3248	20271	8346	9730	4768	3578	5246	4484	1928	4140	5224	10975	16174	22363	19881	21185	23309	18780
"MAN2B2"	7776	47228	593	185	343	250	113	72	789	354	232	73	1278	1317	1641	1638	2126	1488
"MAN2C1"	3329	12808	2360	2285	1745	615	1169	1116	1461	1432	2708	2370	969	1170	3526	3697	5857	4008
"MANBA"	3327	129509	14743	8657	8236	6507	4771	3886	6676	2739	5867	4342	1728	1777	2368	1789	2377	1699
"MANBAL"	1557	27612	1622	1714	916	706	933	781	847	1031	561	1485	507	944	412	434	506	327
"MANEA"	4579	31915	0	0	0	0	0	0	23	0	0	0	599	682	499	427	515	336
"MANEAL"	2862	7506	0	0	0	0	0	0	11	0	0	0	70	37	156	133	132	144
"MANF"	931	4126	44	0	19	25	0	0	56	18	0	30	449	784	1036	612	706	898
"MANSC1"	2301	20953	0	0	0	0	0	0	0	0	0	0	0	0	0	0	0	0
"MAOA"	4196	90660	7881	27018	4306	3575	14633	12385	1723	14774	969	24003	6931	10447	9087	11959	7240	7821
"MAOB"	2653	115865	0	0	0	0	0	0	0	0	0	0	190	175	233	247	102	109
"MAP1A"	10280	14013	411	25	207	204	25	0	279	86	11	0	2670	2111	2111	1454	3990	2537
"MAP1B"	11985	102280	0	0	0	0	0	0	17	0	0	0	0	0	0	0	0	0
"MAP1D"	1629	80784	0	0	0	0	0	0	23	0	0	0	23	21	17	28	22	9
"MAP1LC3A"	971	1632	0	0	0	0	0	0	43	0	0	0	43	54	46	88	55	58
"MAP1LC3B"	2291	12580	366	435	243	123	255	180	260	164	106	418	3373	3570	4729	4321	4183	3399
"MAP1LC3B2"	834	17241	0	0	0	0	0	0	0	0	0	0	702	723	0	0	914	710
"MAP1LC3C"	1196	3595	0	0	0	0	0	0	0	0	0	0	0	0	0	0	0	0
"MAP1S"	3302	14232	1589	68	859	730	39	29	597	141	1642	290	4298	1390	4774	1025	5784	1392
"MAP2"	9460	154433	0	0	0	0	0	0	0	0	0	0	0	0	0	0	0	0
"MAP2K1"	2596	104672	10112	13055	5536	4576	7084	5971	3768	6639	4450	16673	4033	1968	3445	3406	4675	3277
"MAP2K2"	1779	12875	799	257	485	314	140	117	681	579	699	762	869	531	990	948	1294	863
"MAP2K3"	2454	30583	4979	22451	2687	2292	11844	10607	1092	14280	394	28864	1139	10050	1259	12727	1485	9354
"MAP2K4"	3787	122917	4472	2907	2450	2022	1691	1216	2872	1672	340	2576	1077	1361	1337	1037	1528	977
"MAP2K5"	2385	264432	4307	1776	2556	1751	1075	701	4188	2096	549	2749	527	499	424	364	520	321
"MAP2K6"	1873	127626	1965	70	1116	849	37	33	1450	19	343	42	1568	885	826	486	948	599
"MAP2K7"	3511	10599	1193	446	642	551	226	220	409	231	1096	533	1001	730	1155	836	1424	770
"MAP3K1"	7529	81078	9294	246	5097	4197	141	105	5474	392	4014	368	2616	1151	3000	899	2833	1079
"MAP3K10"	3445	23832	11	3	0	11	0	3	58	19	0	0	88	98	131	179	198	123
"MAP3K11"	3582	16495	3362	3073	1763	1599	1540	1533	959	2445	2927	6689	4137	5532	5200	10080	6278	8810
"MAP3K12"	3477	18993	1070	664	620	450	334	330	815	464	552	601	2282	260	2737	2374	3581	2681
"MAP3K13"	3567	119656	1332	1017	785	547	559	458	938	455	9	274	6985	8420	6206	6922	8874	6901
"MAP3K14"	4602	27854	10821	4268	6101	4720	2337	1931	4431	2299	9031	5069	1674	1161	1850	955	2751	1563
"MAP3K15"	4727	122222	245	224	142	103	144	80	99	167	0	270	943	1198	973	1080	1153	1000
"MAP3K2"	4957	38633	4588	2043	2260	2328	1147	896	2157	741	2003	1259	5138	5770	4865	3353	4922	2657
"MAP3K3"	4842	73870	5360	670	2503	2857	422	248	2213	380	2041	578	686	874	7072	5815	10005	6272
"MAP3K4"	5609	125596	3669	28556	2055	1614	15444	13112	1521	11759	122	8348	845	2337	1165	2878	1404	1311
"MAP3K5"	5224	235470	22123	10219	12347	9776	5652	4567	11301	6939	7546	7583	5815	5646	4319	3469	3511	2509
"MAP3K6"	4357	11669	215	34	121	94	24	10	197	90	179	18	448	401	666	486	620	494
"MAP3K7"	3010	71556	2536	2224	1461	1075	1177	1047	1553	1628	289	1374	689	895	969	730	822	538
"MAP3K7IP1"	5195	81933	342	4	196	146	4	0	861	182	342	11	627	505	1204	861	1311	1002
"MAP3K7IP2"	4431	68929	11995	35202	6592	5403	19005	16197	5038	15246	3435	26015	3509	6057	5033	7442	4196	3896
"MAP3K7IP3"	6797	61953	1646	278	937	709	135	143	880	215	168	80	2039	2238	2046	1532	2251	1177
"MAP3K8"	3105	27897	3961	22003	2205	1756	11810	10193	911	13834	604	14631	1118	22271	1044	25102	1142	10641
"MAP3K9"	5611	81034	0	0	0	0	0	0	27	0	0	0	0	0	0	0	0	0
"MAP4"	6346	238591	10054	3855	5594	4460	2124	1731	4672	2765	3052	5031	5218	5710	4847	4284	6591	4377
"MAP4K1"	2811	30364	490	183	251	239	84	99	321	141	805	246	1032	1124	742	650	2200	1227
"MAP4K2"	2986	14105	206	39	124	82	28	11	244	126	211	43	456	684	640	564	919	546
"MAP4K3"	4146	187798	1450	587	803	647	337	250	1327	597	152	199	313	367	720	608	531	282
"MAP4K4"	7490	196665	15826	55970	8925	6901	30498	25472	4382	29872	2688	21120	1922	2463	3499	3325	3621	2408
"MAP4K5"	4431	114131	2063	311	1154	909	190	121	1483	126	146	82	699	771	615	770	714	727
"MAP6"	4331	65575	0	0	0	0	0	0	33	0	0	0	0	0	0	0	0	0
"MAP6D1"	2141	9731	91	0	40	51	0	0	82	0	0	19	51	16	84	0	77	4
"MAP7"	4080	183873	0	0	0	0	0	0	12	0	0	0	41	34	115	77	128	48
"MAP7D1"	3336	24635	2263	840	1250	1013	437	403	776	446	1389	1557	3874	2495	4405	3424	5424	3176
"MAP7D2"	3672	109789	0	0	0	0	0	0	0	0	0	0	0	0	0	0	0	0
"MAP7D3"	4459	38229	22	8	10	12	8	0	55	0	0	0	278	248	247	252	288	178
"MAP9"	7343	34310	0	0	0	0	0	0	0	0	0	0	0	0	0	0	0	0
"MAPK1"	5922	108023	19049	5248	10725	8324	2905	2343	7374	2000	13089	5921	8849	10108	9147	6863	10891	6372
"MAPK10"	3095	342392	871	343	490	381	166	177	685	183	38	248	643	1105	349	743	973	317
"MAPK11"	2403	6638	38	19	32	6	0	19	44	118	24	30	100	113	115	125	158	91
"MAPK12"	4605	11599	163	51	77	86	33	18	255	187	116	17	153	158	280	217	393	219
"MAPK13"	1899	9581	80	4	63	17	0	4	41	43	0	0	365	258	772	753	655	508
"MAPK14"	4364	83560	11249	4907	6295	4954	2636	2271	4773	2239	4731	3394	3792	3871	4131	3520	4861	2866
"MAPK15"	1900	6126	11	0	11	0	0	0	26	11	0	0	0	0	0	0	0	0
"MAPK1IP1L"	6473	18552	1725	2675	968	757	1418	1257	750	1189	416	2304	3091	5293	2570	3467	3062	2778
"MAPK3"	2575	8864	3	0	0	3	0	0	30	3	12	0	522	360	557	537	760	518
"MAPK4"	4741	171713	0	0	0	0	0	0	47	39	0	0	0	0	0	0	0	0
"MAPK6"	4230	47052	2294	9542	1318	976	5104	4438	984	3654	1092	9481	1964	5971	2444	5189	2317	3402
"MAPK7"	3156	5824	181	0	95	86	0	0	109	76	0	36	466	345	576	372	745	365
"MAPK8"	1900	128494	7188	2335	3926	3262	1243	1092	3884	1283	946	1560	667	1145	396	788	1009	341
"MAPK8IP1"	3061	20815	53	0	45	8	0	0	113	165	0	0	0	0	0	0	20	5
"MAPK8IP2"	3373	10849	2	0	1	1	0	0	56	2	0	0	8	7	0	0	0	0
"MAPK8IP3"	5658	64098	7228	2310	3922	3306	1151	1159	3497	1556	9111	3198	1416	1567	2934	2768	3777	1684
"MAPK9"	4350	58476	2137	77	1237	900	30	47	1129	193	228	63	1406	1476	1532	709	1979	1249
"MAPKAP1"	3530	269841	9865	3607	5475	4390	1936	1671	6540	2997	1382	3070	1915	1598	2495	2369	2888	2091
"MAPKAPK2"	3599	49339	3508	6096	1964	1544	3268	2828	1422	3994	912	7644	2029	2436	2398	2861	2772	2394
"MAPKAPK3"	3000	37382	14223	3711	8069	6154	1985	1726	5119	2315	14398	12983	3737	14393	20595	15206	23888	15739
"MAPKAPK5"	2057	50950	1526	2580	869	657	1375	1205	867	1535	627	2992	835	874	992	976	1047	712
"MAPKBP1"	7778	52688	2154	1364	1173	981	729	635	1233	1997	652	2781	637	1081	892	980	1228	927
"MAPKSP1"	4287	16210	513	1356	353	160	769	587	229	556	0	497	1234	1819	1308	1517	1648	1514
"MAPRE1"	2629	30513	1710	3358	896	814	1840	1518	584	1680	538	3935	5148	5757	5924	6693	6417	5424
"MAPRE2"	3274	164171	317	57	183	134	37	20	443	42	0	6	848	721	966	985	964	773
"MAPRE3"	1876	56563	18	9	0	18	0	9	177	15	16	0	101	190	158	112	238	142
"MAPT"	6826	133949	3	0	3	0	0	0	106	107	0	23	0	0	0	0	0	0
"MARCH1"	2706	856155	29404	3931	16356	13048	2133	1798	14085	674	9700	718	11031	1276	1352	660	1129	669
"MARCH10"	3403	103398	0	0	0	0	0	0	45	0	0	0	2	0	0	0	0	0
"MARCH11"	1532	112425	0	0	0	0	0	0	12	0	0	0	0	0	0	0	0	0
"MARCH2"	1655	25712	346	2	162	184	0	2	213	75	0	57	922	624	791	867	1008	859
"MARCH3"	4140	163035	800	908	476	324	528	380	644	653	0	956	34	55	86	104	136	105
"MARCH4"	4453	114166	0	0	0	0	0	0	17	9	0	0	0	0	0	0	0	0
"MARCH5"	4006	62799	409	120	275	134	80	40	321	535	27	500	825	752	759	774	1016	497
"MARCH6"	4637	81665	4851	5164	2586	2265	2823	2341	2300	2791	1076	3836	1956	3011	3201	3068	3397	2046
"MARCH7"	3607	56075	9007	9850	4690	4317	5541	4309	4514	5148	3386	7726	8904	9382	1959	1908	4800	3133
"MARCH8"	2839	78004	3553	284	2046	1507	160	124	1964	205	1198	284	1979	1821	2083	246	489	316
"MARCH9"	2466	4791	0	0	0	0	0	0	0	7	0	0	74	57	67	58	111	53
"MARCKS"	4291	6125	214	2438	130	84	1342	1096	35	1176	0	1618	1318	22253	1743	20545	1652	12804
"MARCKSL1"	1547	2395	20	214	20	0	91	123	0	47	0	91	428	1422	366	561	429	482
"MARCO"	1986	52493	3	0	3	0	0	0	84	0	0	0	108	134	246	245	499	360
"MARK1"	5296	136232	0	0	0	0	0	0	0	0	0	0	0	0	0	0	0	0
"MARK2"	4747	72093	10904	8278	6025	4879	4552	3726	4216	5908	10583	14342	2064	1416	2041	1737	2724	1875
"MARK3"	3546	118465	8035	2806	4418	3617	1480	1326	4192	3069	5579	4833	1886	1985	1969	1705	2563	1568
"MARK4"	4935	53701	260	30	159	101	20	10	350	178	12	201	423	311	406	400	627	414
"MARKL1"	567	29152	205	30	121	84	20	10	292	114	12	191	205	107	183	202	317	199
"MARS"	3597	30259	2351	1180	1351	1000	582	598	1030	639	1137	846	3878	4133	3647	3396	4891	3434
"MARS2"	3028	3028	29	0	17	12	0	0	40	0	59	0	276	103	322	110	366	71
"MARVELD2"	2391	28895	0	0	0	0	0	0	0	0	0	0	0	0	0	0	20	0
"MARVELD3"	2235	15798	0	0	0	0	0	0	0	0	0	0	0	0	0	0	4	0
"MAS1"	1133	1133	0	0	0	0	0	0	0	0	0	0	0	0	0	0	0	0
"MAS1L"	1138	1138	0	0	0	0	0	0	0	0	0	0	0	0	0	0	0	0
"MASP1"	4369	73816	0	0	0	0	0	0	49	0	0	0	0	0	0	0	0	0
"MASP2"	2454	20706	1119	411	296	823	231	180	748	103	58	153	3050	254	209	122	295	91
"MAST1"	4948	36508	0	19	0	0	0	19	147	79	0	0	0	3	0	0	0	0
"MAST2"	5768	232514	1102	347	575	527	214	133	1194	272	82	253	951	911	1013	1062	1372	1034
"MAST3"	5919	53897	870	95	454	416	38	57	704	199	565	11	707	618	886	556	1135	722
"MAST4"	7614	338490	0	0	0	0	0	0	0	0	0	0	55	18	61	3	21	0
"MASTL"	3674	32133	224	1420	123	101	1017	403	185	472	73	423	611	852	278	733	463	495
"MAT1A"	3412	17859	0	2	0	0	1	1	0	29	0	0	0	0	0	0	0	0
"MAT2A"	2826	6115	6141	3935	3403	2738	2075	1860	2985	2110	4122	2393	2	0	22464	17278	25876	15113
"MAT2B"	3449	13750	722	420	418	304	200	220	385	132	17	143	6160	7161	5633	4767	6389	5006
"MATE2-K"	2757	40665	254	0	75	179	0	0	138	0	0	0	1	0	1	1	1	1
"MATK"	2151	8449	1314	1207	724	590	596	611	329	603	1221	1109	2528	2341	2723	2924	3210	3379
"MATN1"	3836	12308	1	0	1	0	0	0	99	75	0	0	2	1	0	0	0	0
"MATN2"	4125	167635	14	0	0	14	0	0	52	5	0	0	14	64	21	39	42	8
"MATN3"	2590	20643	0	0	0	0	0	0	0	0	0	0	0	0	0	0	0	0
"MATN4"	2263	14882	0	0	0	0	0	0	0	0	0	0	0	0	0	0	0	0
"MATR3"	5602	18679	4719	3762	2608	2111	2151	1611	2242	2040	1387	3204	5366	6355	4675	3991	5963	3612
"MAVS"	11766	29314	3916	1419	2185	1731	793	626	1566	596	2994	1259	4341	4344	2734	2074	3675	1767
"MAX"	2109	27384	3556	357	2151	1405	205	152	2244	386	1225	652	2036	1588	1949	1408	2276	1487
"MAZ"	2783	4649	580	13	343	237	0	13	255	135	338	55	4485	3523	5764	4020	6876	4333
"MAZi"	1467	4598	580	13	343	237	0	13	255	135	338	55	4485	3523	5764	1709	6876	4333
"MB"	1173	16591	0	0	0	0	0	0	19	0	0	0	0	1	0	0	0	0
"MBD1"	3276	12929	1121	502	639	482	289	213	600	366	427	436	1870	1678	1560	1438	2017	1092
"MBD2"	2591	70585	4035	705	2192	1843	416	289	2130	633	797	889	833	1471	1821	1517	1740	1588
"MBD3"	2565	15976	1470	1008	771	699	520	488	461	409	1218	1457	2373	1897	2411	1981	2922	502
"MBD3L1"	749	749	0	0	0	0	0	0	0	0	0	0	0	0	0	0	0	0
"MBD3L2"	776	2397	0	0	0	0	0	0	0	0	0	0	0	0	0	0	0	0
"MBD3L5"	774	2429	0	0	0	0	0	0	0	0	0	0	0	0	0	0	0	0
"MBD4"	2478	9061	561	31	281	280	16	15	322	34	141	56	1312	1002	1439	603	2028	704
"MBD5"	6020	492455	3487	348	1912	1575	199	149	3682	712	903	399	199	330	211	193	194	125
"MBD6"	4163	7274	1305	637	761	544	353	284	421	244	1173	715	1341	1455	1517	1394	2746	1670
"MBIP"	1657	22120	18	16	7	11	11	5	37	0	0	0	194	107	178	71	194	94
"MBL1P1"	1969	46131	0	0	0	0	0	0	30	0	0	0	2	6	0	0	11	0
"MBL2"	3572	6321	0	0	0	0	0	0	11	0	0	0	0	0	0	0	0	0
"MBLAC1"	1499	1801	10	0	0	10	0	0	0	0	0	0	0	0	0	7	0	0
"MBLAC2"	4280	16565	0	0	0	0	0	0	23	0	0	0	131	95	84	0	109	5
"MBLL"	4730	171800	2824	811	1592	1232	458	353	2098	476	148	350	880	955	826	683	808	584
"MBNL1"	6414	197741	144656	176394	79212	65444	95506	80888	57338	91521	61903	77968	16694	21368	14391	11816	15923	9277
"MBNL2"	4711	171800	2824	811	1592	1232	458	353	2098	476	148	350	880	955	826	683	808	584
"MBNL3"	3291	62165	449	165	304	145	79	86	484	232	24	13	990	209	136	167	139	579
"MBOAT1"	3288	111737	399	26	199	200	0	26	358	39	63	77	363	394	644	530	523	387
"MBOAT2"	3817	147177	583	14	368	215	6	8	1301	70	121	0	646	725	472	322	979	407
"MBOAT4"	1665	13014	10	0	0	10	0	0	16	0	0	0	106	132	6	32	10	23
"MBOAT5"	2313	40496	2075	294	1249	826	182	112	1329	449	459	318	784	2504	2304	1854	2791	1915
"MBOAT7"	2606	16628	699	60	312	387	28	32	306	113	898	103	2623	2393	2310	1896	3173	2232
"MBP"	10275	38435	25829	21202	14175	11654	11385	9817	10368	10732	12850	14073	5862	5732	5837	3893	6745	3812
"MBTD1"	5397	82641	6082	1096	3507	2575	617	479	2743	402	1654	624	1564	731	1344	745	772	399
"MBTPS1"	4367	63148	3040	747	1662	1378	449	298	1705	541	1458	1039	2314	2196	2293	2607	3129	2639
"MBTPS2"	4535	45886	0	0	0	0	0	0	50	9	0	4	516	519	635	590	605	418
"MC1R"	3099	3099	0	19	0	0	0	19	40	86	0	37	36	60	0	30	79	56
"MC2R"	3654	33494	0	0	0	0	0	0	0	0	0	0	0	0	0	0	0	0
"MC3R"	1085	1085	0	0	0	0	0	0	0	0	0	0	0	0	0	0	0	0
"MC4R"	1439	1439	0	0	0	0	0	0	0	0	0	0	0	0	0	0	0	0
"MC5R"	977	977	0	0	0	0	0	0	0	0	0	0	0	0	0	0	0	0
"MCAM"	3347	8607	4144	0	2214	1930	0	0	1952	0	0	0	0	0	0	0	0	0
"MCART1"	3728	26780	708	184	423	285	75	109	314	60	83	19	1212	1193	971	687	1211	592
"MCART2"	1186	1186	0	0	0	0	0	0	0	0	0	0	0	0	0	0	0	0
"MCART3P"	1605	1605	0	0	0	0	0	0	0	0	0	0	0	0	0	0	0	0
"MCART6"	6225	57811	1062	212	510	552	74	138	505	361	186	461	712	657	169	96	249	63
"MCAT"	2063	11193	9	0	9	0	0	0	32	27	0	0	90	73	152	86	169	76
"MCC"	8729	363114	563	10	300	263	0	10	361	76	35	0	10	0	4	0	0	0
"MCC-B"	2962	84025	1356	920	748	608	459	461	1088	440	309	452	790	785	771	784	1159	854
"MCCC1"	2787	100854	1356	921	748	608	460	461	1088	450	309	452	790	785	771	784	1159	854
"MCCC2"	3688	71415	500	211	280	220	101	110	371	267	34	252	1257	1384	1367	1275	1533	1018
"MCCD1"	711	1271	0	0	0	0	0	0	1786	2101	0	0	4904	5892	0	0	0	0
"MCEE"	873	20590	146	0	87	59	0	0	176	0	0	0	212	0	6	79	69	50
"MCF2"	3896	126453	0	0	0	0	0	0	0	0	0	0	0	0	3	0	0	0
"MCF2L"	5475	130108	0	0	0	0	0	0	594	303	0	0	1	0	0	0	3	0
"MCF2L2"	4802	250026	4874	3946	2707	2167	2109	1837	1492	1013	739	1508	4457	4673	2688	2239	3304	2320
"MCFD2"	4204	39863	511	0	263	248	0	0	271	29	308	3	1856	1558	928	714	1031	643
"MCHR1"	2424	3637	0	0	0	0	0	0	13	10	0	0	0	0	0	0	0	0
"MCHR2"	2374	74315	0	0	0	0	0	0	0	0	0	0	0	0	0	0	0	0
"MCL1"	4000	5101	4217	13284	2396	1821	8141	5143	1594	7797	3197	11284	13058	28592	14293	24216	17869	18011
"MCM10"	4628	49521	0	0	0	0	0	0	8	0	0	0	0	0	0	0	0	0
"MCM2"	3465	24023	0	0	0	0	0	0	36	73	0	0	138	141	203	183	242	163
"MCM3"	3128	20772	71	0	59	12	0	0	51	36	30	0	703	496	937	600	817	636
"MCM3AP"	6141	50190	4925	3012	2949	1976	1667	1345	2591	2245	3050	4652	3944	3540	3126	2496	4528	3071
"MCM3APAS"	2519	22448	1154	608	673	481	287	321	731	638	629	975	1197	1990	1392	1202	2367	1790
"MCM4"	3549	16576	0	0	0	0	0	0	7	0	0	0	374	485	331	223	367	249
"MCM5"	4608	14094	509	58	302	207	44	14	523	71	367	51	965	729	1452	1194	1844	876
"MCM6"	3760	36809	67	0	37	30	0	0	23	0	0	0	416	505	782	768	745	618
"MCM7"	2914	7978	371	524	186	185	277	247	266	268	53	229	500	516	479	876	707	1040
"MCM8"	3831	44533	40	0	22	18	0	0	29	6	0	0	124	163	70	76	111	67
"MCM9"	2471	24541	1737	54	948	789	31	23	1025	59	246	316	160	195	600	204	205	151
"MCOLN1"	2296	11351	588	38	316	272	10	28	399	121	420	55	1527	1301	2435	2546	3268	1782
"MCOLN2"	3057	71531	6872	73541	3871	3001	39523	34018	225	31982	0	56552	307	1286	379	4927	257	2073
"MCOLN3"	2968	23937	4	346	0	4	200	146	37	330	0	868	100	170	204	235	78	115
"MCP3"	688	2017	0	0	0	0	0	0	0	0	0	0	0	1	0	0	0	0
"MCPH1"	8045	241906	3906	1662	2054	1852	934	728	2339	1059	537	1348	656	615	435	272	500	222
"MCRS1"	2462	9448	241	83	153	88	31	52	260	163	121	43	697	820	1269	1123	1712	940
"MCTP1"	3935	577992	981	22280	566	415	12153	10127	547	11450	65	18553	250	391	259	473	334	167
"MCTP2"	8061	252227	25	13	25	0	7	6	23	13	19	22	15	48	20	16	9	0
"MCTS1"	9792	17269	405	0	233	172	0	0	276	0	0	0	584	511	656	366	903	410
"MDC1"	7382	17875	309	74	190	119	54	20	133	92	22	24	798	834	841	708	829	520
"MDFI"	1744	17053	0	0	0	0	0	0	50	38	0	0	0	0	0	0	0	0
"MDFIC"	4610	97056	15800	13750	8931	6869	7398	6352	7317	6228	4818	7891	3292	3723	2949	2685	3322	2144
"MDGA1"	8924	65484	0	0	0	0	0	0	361	40	0	0	0	0	0	0	5	0
"MDGA2"	5388	835160	0	0	0	0	0	0	0	0	0	0	0	0	0	0	0	0
"MDH1"	1370	17963	2832	853	1614	1218	433	420	1321	390	1240	559	13177	10453	13106	12400	15746	9665
"MDH1B"	2341	27562	0	0	0	0	0	0	0	0	0	0	1	1	0	0	0	0
"MDH2"	1312	18537	497	42	291	206	27	15	277	102	197	100	3421	2073	2498	2510	3561	2324
"MDK"	1861	3016	0	0	0	0	0	0	45	20	0	0	0	0	32	21	0	15
"MDL1"	3310	19628	10	0	7	3	0	0	0	0	0	0	0	48	0	0	0	0
"MDM1"	2983	37817	0	0	0	0	0	0	8	0	0	0	101	110	143	71	177	82
"MDM2"	7374	37242	4405	5532	2548	1857	3058	2474	1901	2033	2048	4222	2674	4059	2950	3786	2444	2799
"MDM4"	10083	41738	9003	5873	5084	3919	3161	2712	3982	2116	5652	4800	2496	2582	1067	674	1416	802
"MDMX"	4912	110621	9003	5873	5084	3919	3161	2712	3912	2107	5652	4800	2496	2582	1067	674	1416	802
"MDN1"	17502	176213	1433	509	792	641	289	220	917	548	346	367	1408	2080	1756	1879	1824	1144
"MDP1"	2154	3298	236	1	97	139	1	0	138	0	0	0	168	915	280	200	464	160
"MDS025"	1993	24537	704	124	392	312	71	53	470	113	191	183	449	521	474	317	578	407
"MDS1"	934	514174	0	0	0	0	0	0	12	0	0	0	1855	2148	2641	2902	3485	2720
"MDS2"	1786	59073	0	0	0	0	0	0	143	15	0	0	0	0	0	0	0	0
"MDSRP"	3684	25769	1244	5741	690	554	2781	2960	371	2530	92	3065	654	4967	624	1445	1033	1088
"ME1"	3370	220669	1080	1264	599	481	733	531	627	721	0	340	400	472	599	699	557	383
"ME2"	2731	68825	1191	115	664	527	70	45	799	69	239	14	1777	1222	2279	1981	2191	1590
"ME3"	2326	231528	8	0	5	3	0	0	112	32	0	0	33	33	140	163	60	71
"MEA1"	907	33580	556	94	303	253	64	30	474	160	121	19	2111	1860	1888	1622	2485	1678
"MEAF6"	2155	22190	693	93	388	305	52	41	481	87	371	68	846	1625	1688	1160	2305	1246
"MECOM"	5755	64237	0	0	0	0	0	0	12	0	0	0	1855	2148	2641	2902	3485	2720
"MECP2"	10245	75926	4982	4577	2790	2192	2752	1825	2347	2560	2360	5413	1665	215	252	1746	2611	175
"MECR"	2645	38071	25	0	25	0	0	0	147	52	0	0	78	131	161	123	184	117
"MED1"	8163	46989	864	374	464	400	200	174	354	447	110	803	387	3050	2684	2636	3138	1803
"MED10"	1031	6601	319	181	179	140	101	80	187	67	0	175	371	441	468	408	638	320
"MED11"	831	2173	31	51	31	0	51	0	36	57	0	0	5	4	87	1064	977	893
"MED12"	7013	23899	1079	1208	472	607	628	580	711	725	152	1446	1269	1440	1464	1810	2096	1268
"MED12L"	7827	347226	0	0	0	0	0	0	330	2	0	0	256	255	333	218	483	206
"MED13"	10494	122678	11359	16782	6443	4916	9126	7656	4653	7226	4515	13932	3450	5317	4319	4900	4369	3035
"MED13L"	9407	318610	33910	53663	19061	14849	29102	24561	14765	23973	11249	35686	2163	3150	2339	2400	3157	2105
"MED14"	6797	86009	4300	6862	2049	2251	3756	3106	1850	2968	1067	3157	2335	3050	2258	1996	3001	1723
"MED15"	3646	33394	8804	8829	4872	3932	4821	4008	3310	5606	6000	12207	2057	2373	2906	3303	3559	2158
"MED16"	3159	25256	210	56	132	78	14	42	446	351	284	205	542	429	667	645	1016	730
"MED17"	3508	29092	596	336	337	259	208	128	344	336	18	326	720	611	796	674	861	662
"MED18"	1871	6966	8	0	0	8	0	0	27	0	0	0	711	337	438	161	458	247
"MED19"	1516	8486	134	21	70	64	21	0	79	135	82	142	106	90	73	120	104	57
"MED20"	2481	15786	7	9	4	3	0	9	40	27	0	0	281	214	204	123	245	119
"MED21"	1757	7201	129	54	67	62	54	0	91	0	0	7	448	443	440	255	511	304
"MED22"	3875	7218	839	88	510	329	60	28	31	125	820	171	39	51	149	21	118	52
"MED23"	5256	41492	1011	38	507	504	38	0	654	47	70	32	1029	889	1353	860	1382	816
"MED24"	3740	35540	349	104	192	157	69	35	581	185	228	114	1098	1166	1317	1030	1690	1026
"MED25"	2351	18693	2029	315	1113	916	221	94	1073	318	2263	344	1337	1067	1127	759	1701	1022
"MED26"	3187	53299	4388	4356	2473	1915	2456	1900	2543	4527	1653	8780	3437	3764	3259	3323	3852	2647
"MED27"	2050	141938	2836	1433	1621	1215	867	566	2474	2370	189	1950	101	110	241	256	286	247
"MED28"	1285	9889	1383	933	748	635	534	399	630	515	1361	1155	1494	1761	1708	1097	2094	1090
"MED29"	3569	9240	176	13	84	92	13	0	200	128	58	37	1110	945	717	578	868	556
"MED30"	974	19536	15	25	15	0	13	12	39	18	0	0	147	205	173	204	202	148
"MED31"	1659	8322	1390	16	451	939	16	0	857	32	252	32	726	340	1052	493	743	319
"MED4"	2029	19150	1986	1567	1085	901	883	684	830	816	206	1089	654	907	692	647	901	616
"MED6"	1372	16428	525	106	313	212	51	55	305	212	123	253	173	262	339	311	353	272
"MED7"	1384	4335	58	37	39	19	19	18	100	10	0	0	13	335	8	2	6	1
"MED8"	1495	5897	197	0	94	103	0	0	136	51	55	92	874	531	675	386	1060	534
"MED9"	2224	16236	18	11	0	18	11	0	188	77	0	76	295	213	442	197	489	195
"MEF2A"	5766	150496	34518	40689	19142	15376	21893	18796	12996	11951	16352	24854	3569	5028	3549	2870	4242	2999
"MEF2B"	2255	47026	1471	375	858	613	206	169	1056	498	1852	619	647	496	398	265	613	401
"MEF2C"	6469	165246	97	80	28	69	50	30	280	204	18	162	448	436	352	339	323	152
"MEF2D"	6220	37011	3891	350	2163	1728	248	102	1653	378	3504	767	1551	1202	2028	957	2022	1311
"MEF2D variant protein"	5520	37011	3891	350	2163	1728	248	102	1653	378	3504	767	1551	1202	2028	957	2022	1311
"MEFV"	3509	14601	0	0	0	0	0	0	56	45	0	33	3	167	6	105	38	123
"MEG3"	2677	21180	0	0	0	0	0	0	108	38	0	0	0	0	0	0	0	0
"MEG8"	502	12200	0	0	0	0	0	0	0	0	0	0	0	0	0	0	0	0
"MEGF10"	7709	170454	0	0	0	0	0	0	15	0	0	0	0	0	0	0	0	0
"MEGF11"	5937	358443	906	45	524	382	45	0	985	433	97	126	0	0	1	0	0	0
"MEGF2"	3771	7463	0	0	0	0	0	0	140	52	0	10	22	0	24	15	20	0
"MEGF4"	1026	28594	0	0	0	0	0	0	35	67	0	0	0	0	0	0	0	0
"MEGF5"	2643	73536	0	0	0	0	0	0	34	0	0	0	0	0	0	0	0	0
"MEGF6"	7469	123548	99	0	42	57	0	0	1686	676	13	0	54	78	94	80	104	44
"MEGF7"	2778	6067	0	0	0	0	0	0	0	0	0	0	0	0	0	0	0	0
"MEGF8"	11006	53161	425	65	217	208	44	21	660	296	321	56	1311	1191	1310	1252	1585	1308
"MEGF9"	6305	113523	4147	4617	2341	1806	2563	2054	2517	4512	654	1127	2224	1882	2208	1370	2366	1202
"MEI1"	4555	99943	1	0	0	1	0	0	58	7	0	0	18	40	21	21	28	40
"MEIG1"	628	13414	0	0	0	0	0	0	1	0	0	0	0	0	0	0	0	0
"MEIS1"	3193	137360	0	0	0	0	0	0	0	0	0	0	0	0	0	0	0	0
"MEIS2"	5275	137051	0	0	0	0	0	0	18	0	0	0	0	0	0	0	0	0
"MEIS3"	2855	2855	0	0	0	0	0	0	160	92	0	0	0	0	0	0	0	0
"MELK"	2456	104775	0	0	0	0	0	0	11	8	0	0	17	21	0	0	38	0
"MELKv2"	2493	104775	0	0	0	0	0	0	11	8	0	0	17	21	0	0	38	0
"MELKv3"	2251	104775	0	0	0	0	0	0	11	8	0	0	17	21	0	0	38	0
"MEMO1"	1819	142804	17809	8237	10054	7755	4573	3664	7618	3662	7687	6272	655	656	709	534	700	499
"MEN1"	3172	7772	131	16	69	62	8	8	135	56	28	0	528	436	703	459	1058	589
"MEOX1"	2308	21166	0	0	0	0	0	0	11	0	0	0	0	0	0	0	0	0
"MEOX2"	2372	75471	0	0	0	0	0	0	0	0	0	0	0	0	0	0	0	0
"MEP1A"	3080	46393	0	0	0	0	0	0	0	0	0	4	17	22	53	44	9	12
"MEP1B"	2324	30379	0	0	0	0	0	0	0	0	0	0	0	0	0	0	0	0
"MEPCE"	2750	4213	540	288	294	246	143	145	185	159	172	302	1701	1155	1979	532	929	1736
"MEPE"	2166	13804	0	0	0	0	0	0	0	0	0	0	0	0	0	0	0	0
"MERTK"	3645	130756	0	0	0	0	0	0	24	0	0	0	198	196	57	128	102	55
"MESDC1"	3051	3051	83	14	51	32	14	0	17	40	0	80	887	1061	1204	1642	1348	1341
"MESDC2"	4246	14112	756	0	456	300	0	0	466	26	172	55	1438	1098	1730	1052	1611	1154
"MESP1"	1162	1442	0	1	0	0	0	1	0	0	0	0	0	0	0	0	0	0
"MESP2"	1611	2393	0	1	0	0	0	1	27	0	0	0	0	2	0	0	0	0
"MEST"	2469	14193	0	0	0	0	0	0	13	0	0	0	0	0	0	5	26	0
"MESTIT1"	3242	4115	0	0	0	0	0	0	0	0	0	0	0	0	0	0	0	0
"MET"	6696	125982	0	0	0	0	0	0	0	0	0	0	0	0	0	0	0	0
"METAP1"	6359	40040	1544	81	891	653	44	37	934	17	87	56	1774	1520	1683	1191	1994	1215
"METAP2"	3513	41791	393	177	227	166	107	70	315	263	53	307	938	1166	1462	1303	1519	1235
"METRN"	1094	2307	142	34	62	80	15	19	50	81	248	39	70	48	144	91	178	86
"METRNL"	1903	10642	2857	2463	1596	1261	1225	1238	904	1564	1956	2876	2227	2932	3064	4464	3205	3744
"METT10D"	5761	95852	883	239	506	377	163	76	678	278	170	715	984	147	799	590	869	514
"METT11D1"	1829	7229	395	96	187	208	62	34	181	38	96	0	980	707	1018	686	1462	713
"METT5D1"	4424	225258	1076	135	587	489	94	41	1422	295	149	169	181	175	205	190	170	125
"METTL1"	1312	3564	80	257	63	17	139	118	89	235	0	215	171	622	275	881	426	384
"METTL10"	2590	33035	809	138	444	365	85	53	403	111	374	368	190	290	189	141	164	149
"METTL11A"	1006	9446	519	118	291	228	86	32	333	277	185	333	1224	889	613	696	1367	796
"METTL11B"	942	21737	0	0	0	0	0	0	0	0	0	0	0	0	0	0	0	0
"METTL12"	2862	3175	138	528	69	69	243	285	38	373	341	36	149	21	159	66	171	32
"METTL13"	3414	16096	158	0	81	77	0	0	79	9	0	13	755	590	1072	631	1071	766
"METTL14"	2116	25503	200	47	122	78	15	32	174	19	30	66	592	591	675	425	717	438
"METTL2A"	2743	26220	92	69	66	26	35	34	25	55	0	16	275	287	309	312	394	263
"METTL2B"	2190	26196	333	147	189	144	74	73	173	195	0	223	520	693	354	369	450	325
"METTL3"	1965	13176	821	244	462	359	220	24	469	344	123	378	1561	1659	1169	1188	1644	849
"METTL4"	3682	33966	111	50	53	58	38	12	125	21	0	0	261	296	210	162	242	169
"METTL5"	1392	13077	107	0	51	56	0	0	85	13	0	0	587	154	202	94	557	181
"METTL6"	3249	32887	0	0	0	0	0	0	30	27	0	0	139	129	159	55	115	53
"METTL7A"	3391	7767	516	308	480	36	187	121	460	79	771	97	7993	6852	5311	2810	6151	2818
"METTL7B"	1505	3064	0	0	0	0	0	0	0	0	0	0	12	37	58	27	111	31
"METTL8"	8163	116612	488	77	291	197	50	27	598	120	0	102	367	381	336	231	385	238
"METTL9"	3199	57937	5386	2544	3097	2289	1416	1128	2847	1557	3243	2942	17843	17695	17661	18254	18279	15306
"MEX3A"	6124	9985	0	0	0	0	0	0	88	12	0	0	3	3	0	0	0	0
"MEX3B"	3400	4235	58	0	25	33	0	0	34	0	0	0	304	149	440	121	475	165
"MEX3C"	3781	22770	508	1018	285	223	548	470	418	534	0	427	1162	1498	1126	1126	1427	840
"MEX3D"	2851	13390	0	0	0	0	0	0	42	0	0	0	107	110	153	161	268	169
"MFAP1"	2072	20220	78	0	33	45	0	0	68	114	0	175	509	562	678	608	790	521
"MFAP2"	1109	6175	0	0	0	0	0	0	18	30	0	0	0	0	0	0	0	0
"MFAP3"	5349	18497	250	0	130	120	0	0	176	0	0	0	1020	1266	1057	878	1182	818
"MFAP3L"	6190	39681	0	0	0	0	0	0	0	0	0	0	0	0	0	0	0	0
"MFAP4"	1936	3748	40	0	18	22	0	0	27	0	0	0	115	68	89	60	120	56
"MFAP5"	2892	16895	0	0	0	0	0	0	9	0	0	0	0	0	0	0	0	0
"MFF"	2172	32571	725	260	342	383	151	109	662	81	154	26	881	762	934	680	1272	770
"MFGE8"	2049	14749	0	0	0	0	0	0	73	9	0	0	54	59	64	35	101	52
"MFHAS1"	5258	109134	4931	22454	2741	2190	12283	10171	2582	17083	264	23519	1301	2180	1379	2742	1606	1453
"MFI2"	2432	26531	9	5	0	9	5	0	136	159	0	3	163	124	498	441	429	356
"MFN1"	3529	45528	1657	83	921	736	63	20	1056	117	282	143	1106	1423	1002	859	1003	738
"MFN2"	4695	33335	1234	782	698	536	496	286	641	847	298	1418	3091	2765	4284	4463	5065	3704
"MFNG"	2042	17284	1494	386	1094	400	219	167	816	532	1372	2246	1231	1842	1668	1932	2998	1998
"MFRP"	3932	7733	0	0	0	0	0	0	112	49	0	0	0	0	0	0	0	0
"MFSD1"	2177	27594	2926	1526	1584	1342	817	709	1743	841	702	954	7525	8225	11018	10576	10395	7391
"MFSD10"	1969	3676	218	81	88	130	63	18	110	116	144	218	841	775	1030	1277	1149	930
"MFSD11"	3239	43066	1543	445	811	732	249	196	899	848	1077	1368	5330	7236	6055	7721	6848	6315
"MFSD2"	1913	14845	250	5080	174	76	2700	2380	116	2811	0	5886	151	3899	356	10926	333	4817
"MFSD2A"	2214	14845	250	5080	174	76	2700	2380	116	2811	0	5886	151	3899	356	10926	333	4817
"MFSD2B"	1517	14190	0	0	0	0	0	0	13	20	0	0	0	1	0	0	0	0
"MFSD3"	1451	2039	552	154	340	212	74	80	292	77	1377	268	54	970	969	604	169	584
"MFSD4"	4097	33935	16	0	0	16	0	0	98	20	0	0	9	0	0	0	0	0
"MFSD5"	1972	2753	0	0	0	0	0	0	18	32	0	0	1035	881	1046	891	1509	1081
"MFSD6"	4805	93962	3240	455	1732	1508	202	253	1822	247	148	166	3301	3931	2692	2109	4303	2830
"MFSD6L"	2104	2104	146	0	72	74	0	0	26	0	0	0	0	0	0	0	0	0
"MFSD7"	1878	7356	2822	1238	1527	1295	676	562	781	605	2925	1916	672	583	1224	1193	1565	1066
"MFSD8"	4557	48180	364	49	253	111	23	26	354	20	0	22	372	265	365	213	389	202
"MFSD9"	2797	19673	26	0	17	9	0	0	45	0	0	0	60	216	190	102	182	101
"MGA"	12064	109531	3583	1263	2112	1471	665	598	1717	526	376	596	1890	2349	2349	1711	2530	1316
"MGAM"	6531	110869	0	0	0	0	0	0	8	0	0	0	0	0	0	0	0	0
"MGAT1"	3171	19276	15583	39074	8638	6945	20766	18308	4347	16055	9429	25846	13889	13619	3624	25225	3992	24085
"MGAT2"	2711	2711	159	10	86	73	0	10	65	30	0	63	3073	2798	0	0	3445	2179
"MGAT3"	5086	34874	0	0	0	0	0	0	279	118	0	0	0	0	134	27	31	0
"MGAT4A"	8396	112020	13439	1052	7439	6000	608	444	7017	285	5534	510	6578	8687	5694	4714	5918	4006
"MGAT4B"	2915	5277	1769	697	957	812	318	379	617	363	1786	677	3282	2360	3332	2974	5379	2607
"MGAT4C"	2723	277053	0	0	0	0	0	0	0	0	0	0	0	0	0	0	0	0
"MGAT5"	2437	194640	11014	9086	6320	4694	4994	4092	6821	7531	2985	7521	858	5136	1779	1779	1632	1023
"MGAT5B"	4254	81674	0	0	0	0	0	0	427	96	0	0	0	0	0	0	0	0
"MGC12916"	2006	2006	472	2718	266	206	1424	1294	15	2136	0	1167	0	129	0	465	0	0
"MGC12965"	2420	5094	0	0	0	0	0	0	0	0	0	0	53	33	5	0	0	0
"MGC12982"	2507	2507	251	23	156	95	0	23	103	12	79	16	416	192	457	205	552	232
"MGC13053"	2054	2054	0	0	0	0	0	0	16	0	0	0	0	0	0	0	0	0
"MGC131512"	1724	52986	18	0	0	18	0	0	41	0	0	0	15	19	8	5	5	0
"MGC14436"	1185	40163	2	0	2	0	0	0	192	107	0	2	21	23	41	56	101	73
"MGC15875"	1994	17541	5926	3132	3409	2517	1655	1477	2392	1519	4818	3664	2280	2749	4213	3397	2128	2720
"MGC15885"	2318	8011	0	0	0	0	0	0	0	0	0	0	0	0	0	0	0	0
"MGC16025"	2128	2128	160	60	96	64	27	33	180	53	52	0	0	0	0	0	0	0
"MGC16075"	1190	5297	0	0	0	0	0	0	0	0	0	0	0	0	0	0	0	0
"MGC16121"	788	3254	167	128	86	81	81	47	28	63	0	86	32	49	81	214	188	112
"MGC16142"	1290	1290	0	0	0	0	0	0	8	0	0	0	0	0	0	0	0	0
"MGC16275"	2481	3321	256	1853	158	98	994	859	94	603	0	1236	139	2522	113	743	117	378
"MGC16384"	1548	1548	323	28	157	166	18	10	107	12	96	0	34	128	168	0	26	0
"MGC16703"	2099	6074	0	0	0	0	0	0	16	10	0	0	0	0	0	0	3	0
"MGC20647"	784	784	0	0	0	0	0	0	0	0	0	0	0	1	0	1	0	0
"MGC21881"	2583	2679	0	0	0	0	0	0	10	0	0	0	0	0	15	17	22	10
"MGC23270"	2519	2519	0	0	0	0	0	0	12	18	0	0	26	9	0	0	0	9
"MGC23284"	2433	12134	775	4	401	374	4	0	572	224	1008	227	1562	315	2453	893	2620	834
"MGC24125"	2156	13223	0	0	0	0	0	0	0	0	0	0	0	0	0	0	0	0
"MGC26484"	2894	2894	0	0	0	0	0	0	0	0	0	0	0	0	0	0	0	0
"MGC26647"	1020	1612	0	0	0	0	0	0	0	0	0	0	0	0	0	0	0	0
"MGC26733"	2590	149678	0	0	0	0	0	0	23	0	0	0	0	0	0	0	0	0
"MGC27016"	3631	47309	0	0	0	0	0	0	0	0	0	0	0	0	0	0	0	0
"MGC2714"	1396	30086	175	12	85	90	7	5	293	37	37	72	227	277	185	179	243	163
"MGC27345"	2121	2121	94	12	56	38	0	12	16	0	0	16	264	34	180	50	253	102
"MGC27382"	1999	64293	0	0	0	0	0	0	0	0	0	0	0	0	0	0	0	0
"MGC2752"	3344	8999	125	0	86	39	0	0	164	18	0	22	921	878	989	742	1119	758
"MGC2889"	2194	2194	0	0	0	0	0	0	0	0	0	0	0	0	0	0	0	0
"MGC29506"	912	2349	0	0	0	0	0	0	42	0	0	0	0	6	0	0	4	4
"MGC31957"	1243	19202	0	2	0	0	2	0	17	14	0	0	1	14	4	0	31	0
"MGC34774"	1794	12211	0	0	0	0	0	0	0	0	0	0	0	0	0	0	0	0
"MGC3771"	1222	5140	0	0	0	0	0	0	99	12	0	0	42	10	27	9	58	13
"MGC39372"	1253	21854	0	22	0	0	14	8	0	69	0	0	35	78	0	20	0	6
"MGC39545"	2167	3058	0	0	0	0	0	0	0	0	0	0	0	3	0	0	0	0
"MGC39584"	1424	12143	0	0	0	0	0	0	0	0	0	0	0	0	0	0	0	0
"MGC40574"	1646	1646	0	12	0	0	12	0	46	37	0	0	0	10	0	0	0	0
"MGC42105"	2316	88626	0	0	0	0	0	0	24	0	0	0	0	0	0	0	0	0
"MGC4473"	952	5943	0	0	0	0	0	0	0	0	0	0	0	0	0	0	0	0
"MGC45800"	4957	5511	0	0	0	0	0	0	12	0	0	0	0	0	0	0	0	0
"MGC45922"	938	1198	0	0	0	0	0	0	38	0	0	0	0	0	0	0	0	0
"MGC4836"	3088	416115	0	0	0	0	0	0	28	0	0	19	0	0	0	0	0	0
"MGC52282"	751	3138	1	1	1	0	0	1	50	8	0	0	0	0	3	0	0	0
"MGC5590"	1217	18108	0	0	0	0	0	0	0	0	0	0	0	0	0	0	0	0
"MGC57346"	2611	18230	0	0	0	0	0	0	0	0	0	0	0	36	0	0	0	0
"MGC70857"	1935	2857	297	0	154	143	0	0	43	15	227	31	143	356	163	76	719	75
"MGC70863"	1523	42552	85	0	37	48	0	0	101	16	0	0	363	310	742	555	898	515
"MGC70870"	3102	3102	0	0	0	0	0	0	0	0	0	0	0	0	0	0	0	0
"MGC72080"	934	97973	407	52	268	139	38	14	478	153	112	31	154	100	138	108	207	142
"MGC87042"	1201	61762	0	0	0	0	0	0	0	0	0	0	0	0	0	0	0	0
"MGC9913"	664	17253	0	0	0	0	0	0	13	0	0	0	45	22	21	0	26	0
"MGEA5"	5218	34024	4455	2917	2785	1670	1584	1333	1929	958	3005	1954	3775	4190	3895	2897	4713	2368
"MGLL"	4620	133792	503	13346	261	242	7114	6232	673	14530	75	17020	609	729	1759	3107	1427	1499
"MGMT"	1270	300331	1549	497	872	677	274	223	2287	1389	24	420	207	189	229	215	296	230
"MGP"	665	4003	0	0	0	0	0	0	0	0	0	0	0	0	0	0	0	0
"MGRN1"	6486	66150	7500	5763	4129	3371	2989	2774	3225	4211	6435	10759	3714	3661	3825	3225	5808	3338
"MGST1"	983	16633	1222	49	688	534	30	19	717	0	313	12	2972	2355	2379	1720	3334	2191
"MGST2"	1183	74979	1122	25	628	494	25	0	780	16	0	17	475	482	5057	4836	5651	2294
"MGST3"	681	24378	1187	26	593	594	21	5	667	11	396	0	1479	1388	1333	898	1706	881
"MHC2TA"	1222	33063	62585	6253	34737	27848	3331	2922	14188	2026	60219	4804	6749	4388	6684	3528	10089	3956
"MIA"	615	2094	38	0	30	8	0	0	44	0	0	0	6	7	19	9	18	5
"MIA2"	2285	19450	0	0	0	0	0	0	0	0	0	0	0	0	0	0	0	0
"MIA3"	8150	49908	814	910	527	287	424	486	585	622	28	243	1885	2336	2494	2150	2956	1791
"MIAT"	10147	18956	807	448	429	378	218	230	194	97	134	129	81	75	16	25	263	66
"MIB1"	9325	129367	2440	2925	1370	1070	1630	1295	1481	1584	200	1746	1325	1775	1587	1477	1686	935
"MIB2"	3330	14296	465	192	234	231	121	71	409	374	363	396	337	388	566	667	775	571
"MIC1"	1052	20678	1303	1145	720	583	587	558	633	336	401	507	1104	1455	1677	1664	1751	1556
"MICA"	2683	16241	1306	989	752	554	519	470	503	921	384	413	200	338	307	275	692	286
"MICAL1"	3703	21905	1868	3425	1034	834	1815	1610	2049	764	2504	2506	5071	5219	6747	4680	11186	6277
"MICAL2"	6320	56059	7285	1808	3986	3299	968	840	4331	1172	2894	2255	2442	3003	2212	1902	3120	2086
"MICAL2PV1"	6637	101705	5831	1806	3206	2625	967	839	3276	1157	2501	2255	2442	3001	2199	1891	3120	2077
"MICAL2PV2"	6573	101705	5831	1806	3206	2625	967	839	3276	1157	2501	2255	2442	3001	2199	1891	3120	2077
"MICAL3"	9474	236909	325	551	175	150	312	239	1095	1086	19	699	254	367	294	273	276	129
"MICALCL"	3053	72246	270	173	115	155	95	78	217	149	45	56	215	421	122	87	126	96
"MICALL1"	3880	35681	295	966	155	140	531	435	379	1052	89	1945	563	682	852	1219	1005	937
"MICALL2"	3115	25115	1740	622	981	759	341	281	1089	1008	2584	1240	440	421	1218	1087	1815	1115
"MICB"	2486	13045	232	14	84	148	3	11	167	136	51	179	699	1001	387	262	547	310
"MID1"	6226	175079	0	0	0	0	0	0	0	9	0	0	0	0	0	0	0	0
"MID1IP1"	2442	2710	86	30	53	33	30	0	23	17	0	0	1406	948	2073	1332	2058	1468
"MID2"	7353	105783	292	0	175	117	0	0	221	0	0	0	419	371	552	404	812	530
"MIDN"	3798	10589	1230	351	723	507	183	168	471	352	1278	1265	2465	1371	2380	1797	2532	1641
"MIER1"	5643	63726	4095	1313	2336	1759	693	620	2103	904	480	1473	1796	1609	1566	1152	1771	996
"MIER2"	2776	39218	1579	271	848	731	146	125	1133	349	1862	838	418	264	627	396	761	523
"MIER3"	5261	32527	323	52	205	118	19	33	321	172	57	70	194	905	843	466	216	375
"MIF"	653	841	295	0	180	115	0	0	28	15	0	0	1445	613	1492	1329	0	481
"MIF4GD"	1573	4928	115	17	61	54	16	1	198	28	94	0	2644	2118	1010	760	3518	779
"MIG7"	971	21820	0	2	0	0	0	2	18	0	0	0	0	0	0	0	0	0
"MIIP"	1598	12596	475	9	299	176	9	0	294	85	461	0	526	464	812	527	1117	730
"MIMT1"	1290	7654	0	0	0	0	0	0	0	0	0	0	0	0	0	0	0	0
"MINA"	5281	30565	970	327	563	407	171	156	485	99	101	128	1582	1599	1053	688	1784	986
"MINK1"	5005	64674	6643	3076	3715	2928	1621	1455	2762	2847	3131	6847	3170	3927	4113	5892	6224	4426
"MINPP1"	2852	48947	56	0	56	0	0	0	158	17	39	26	561	614	685	505	855	560
"MIOS"	3329	40489	1450	799	814	636	472	327	672	558	65	292	929	914	856	728	773	667
"MIOX"	1447	3539	0	0	0	0	0	0	69	28	0	0	1	23	0	0	0	0
"MIP"	2007	4546	0	0	0	0	0	0	0	0	0	0	0	0	0	0	0	0
"MIPEP"	2419	159232	72	19	41	31	11	8	67	0	0	0	289	291	339	302	362	306
"MIPOL1"	7562	309873	0	0	0	0	0	0	0	0	0	0	0	0	0	0	0	0
"MIPP"	2753	48947	56	0	56	0	0	0	158	17	39	26	561	614	685	505	855	560
"MIR cl-10"	2796	6755	388	155	228	160	62	93	209	263	272	167	624	1170	992	2141	1506	1481
"MIR cl-7"	2611	6527	2820	1072	1456	1364	546	526	801	750	2369	1598	4266	4671	4163	3700	2995	2833
"MIR155HG"	1470	13018	3272	124920	1847	1425	67340	57580	34	41616	0	31048	35	18917	35	8036	56	4840
"MIR16"	2937	20435	43	0	29	14	0	0	104	0	0	0	1855	1431	1684	1069	1921	1254
"MIRO-2"	1769	2044	376	45	164	212	38	7	108	113	251	282	516	498	318	160	449	232
"MIS12"	2502	3883	77	50	45	32	33	17	96	57	0	99	769	1084	588	649	698	572
"MITD1"	917	11768	73	9	43	30	5	4	56	12	22	0	307	281	318	209	439	200
"MITF"	4776	228855	25417	41265	14074	11343	22267	18998	12296	29153	8352	25007	1401	1364	2276	2215	1576	1458
"MITF-C"	277	3045	183	235	155	28	216	19	361	201	0	48	13	0	126	41	87	65
"MIXL1"	700	2131	0	0	0	0	0	0	0	0	0	0	0	0	0	0	0	0
"MJD"	651	25658	1144	116	578	566	31	85	592	46	531	97	200	280	305	292	312	228
"MKI67"	12508	29543	6	0	0	6	0	0	0	0	0	2	194	119	30	10	119	43
"MKI67IP"	1744	9983	187	44	81	106	26	18	60	127	0	50	489	847	546	776	1032	775
"MKK7"	1529	3168	562	216	315	247	113	103	123	110	739	251	144	85	181	73	170	47
"MKKS"	2668	26739	1724	669	947	777	369	300	1001	347	280	458	2268	1957	1349	1134	2551	1181
"MKL1"	4515	226400	33207	26047	18457	14750	10702	15345	9125	23187	20067	41828	6401	4206	6056	4256	11187	8473
"MKL2"	8800	195435	728	106	500	228	40	66	1255	78	0	47	803	684	673	423	809	364
"MKLN1"	11273	386544	11358	7360	6289	5069	4131	3229	5184	2791	1612	4032	2296	2270	2431	1658	2488	1382
"MKNK1"	2812	46877	15668	29230	8618	7050	15655	13575	5558	15894	6388	29781	7180	24838	9965	26969	9210	23154
"MKNK2"	3799	13775	885	527	438	447	286	241	469	619	541	1189	2203	2134	2254	1762	2592	2313
"MKRN1"	3159	26531	1867	383	1117	750	216	167	927	219	1088	488	3477	2779	2031	2411	5303	3074
"MKRN2"	2771	26616	811	241	159	652	223	18	238	650	38	213	1727	2396	2164	1652	2770	1576
"MKRN3"	2712	2712	0	0	0	0	0	0	0	0	0	0	0	0	0	0	0	0
"MKS1"	2415	13870	0	0	0	0	0	0	16	0	0	0	118	83	112	70	174	125
"MKSTYX"	1589	49666	1397	335	755	642	219	116	693	275	1518	854	600	559	523	527	707	519
"MKX"	3645	72976	0	0	0	0	0	0	7	0	0	0	45	25	1	0	1	0
"MLANA"	1529	18915	727	140	329	398	100	40	450	127	0	52	57	125	0	3	69	0
"MLAS"	1988	12061	0	0	0	0	0	0	15	0	0	0	0	0	1709	1219	2701	987
"MLC-3"	1976	3186	893	0	1	892	0	0	0	907	604	2185	13691	17146	21368	23506	24897	19992
"MLC1"	3972	26540	0	0	0	0	0	0	12	13	0	0	0	14	0	0	12	7
"MLCK"	3512	51962	113	0	72	41	0	0	209	9	0	0	93	66	63	3	74	4
"MLCK2"	1499	3686	0	0	0	0	0	0	13	0	0	0	0	0	0	0	0	0
"MLEC"	6354	14720	1847	506	981	866	294	212	728	204	696	45	7066	6671	8411	6260	9015	5122
"MLF1"	2533	35301	0	0	0	0	0	0	0	0	0	0	0	0	0	0	0	0
"MLF1IP"	2562	40068	22	61	22	0	21	40	21	104	0	59	180	217	103	102	185	159
"MLF2"	1895	5478	141	25	103	38	7	18	168	69	126	31	2879	2717	2359	2119	2847	2383
"MLH1"	2626	57070	2199	2903	1162	1037	1490	1413	977	1582	439	3216	1750	2408	1567	3061	3777	1549
"MLH3"	7909	37770	789	45	431	358	45	0	556	30	186	0	452	371	682	320	599	303
"MLIV"	1189	3367	139	0	73	66	0	0	104	29	0	0	215	222	85	454	227	286
"MLKL"	2517	29038	277	22	155	122	14	8	262	24	116	12	736	552	607	491	479	430
"MLL"	15025	88731	4464	1945	2625	1839	1068	877	2151	1007	852	1688	2179	2306	2458	1864	3159	1561
"MLL2"	19469	36347	6837	2650	3628	3209	1437	1213	2760	1607	5311	2755	3234	4092	5285	4880	6709	4090
"MLL3"	16919	301080	35096	28909	19568	15528	15604	13305	15148	13762	15178	19053	4569	7298	6300	6883	6253	3960
"MLL4"	8497	20859	2240	661	1275	965	360	301	1261	823	1831	1573	3490	2716	4603	3330	6172	3203
"MLL5"	6889	99896	17637	15063	9890	7747	8270	6793	7271	9704	8173	11748	4865	5023	3527	4284	5866	3372
"MLLT1"	4516	69568	1346	153	726	620	106	47	1328	635	800	680	998	841	1658	1405	947	1534
"MLLT10"	5221	209455	8910	3266	4955	3955	1833	1433	4806	1814	2024	2224	1365	1683	1207	952	1272	798
"MLLT11"	2159	8823	0	0	0	0	0	0	10	0	0	0	35	42	426	7	31	0
"MLLT3"	3505	276194	33	37	22	11	18	19	10	9	0	15	20	9	11	14	9	0
"MLLT4"	7768	145033	370	898	198	172	483	415	190	404	5	322	386	559	876	799	529	281
"MLLT6"	7519	24184	4384	3968	2417	1967	2045	1923	1477	2139	3797	5969	3827	5214	4940	5611	7281	5081
"MLN"	577	9346	0	0	0	0	0	0	76	17	0	0	0	0	0	0	0	0
"MLNR"	1239	2039	0	0	0	0	0	0	0	0	0	0	0	0	0	0	0	0
"MLPH"	3771	68084	0	0	0	0	0	0	310	77	0	0	0	0	0	0	0	0
"MLSN1"	4949	66744	87	0	87	0	0	0	28	11	0	0	0	1	0	0	26	9
"MLST8"	2143	3947	128	64	97	31	39	25	83	89	92	24	632	485	691	649	789	735
"MLX"	2569	6144	510	30	293	217	22	8	262	5	47	0	1867	1790	2543	1834	3056	1854
"MLXIP"	5383	112207	6651	1188	3826	2825	659	529	2742	745	3974	1559	2990	2405	2391	1585	3361	1634
"MLXIPL"	3295	31348	1	0	1	0	0	0	95	43	0	0	0	0	72	95	15	30
"MLYCD"	2198	17057	1369	41	796	573	30	11	835	98	566	74	441	356	576	342	763	484
"MMAA"	5949	40648	433	87	272	161	37	50	278	80	297	93	568	502	266	106	390	164
"MMAB"	4303	19837	195	12	130	65	5	7	306	53	53	23	523	505	402	314	472	299
"MMACHC"	2852	10883	93	0	57	36	0	0	178	130	0	0	2002	2041	38	2126	2468	5
"MMADHC"	1741	17968	281	43	164	117	26	17	322	51	0	61	1398	740	1029	963	1138	1078
"MMD"	2729	29368	21	28	11	10	15	13	60	35	0	46	488	645	648	623	644	454
"MMD-1"	505	5370	324	52	183	141	32	20	443	140	37	78	549	84	435	390	143	500
"MMD2"	2422	53225	0	0	0	0	0	0	77	41	0	0	0	0	0	0	0	0
"MME"	5757	159607	0	0	0	0	0	0	0	0	0	0	0	0	3	0	0	0
"MMEL1"	2926	42402	74	0	36	38	0	0	84	189	0	0	568	549	551	483	752	578
"MMGT1"	3652	11905	47	0	17	30	0	0	43	90	0	71	56	85	809	702	709	1188
"MMP1"	2065	8327	0	0	0	0	0	0	0	0	0	0	0	0	0	0	0	0
"MMP10"	1753	10112	0	0	0	0	0	0	0	0	0	0	10	3	0	0	27	0
"MMP11"	2268	11468	0	0	0	0	0	0	63	26	4	0	0	0	0	0	0	0
"MMP12"	1832	12249	667	517	395	272	295	222	24	94	0	78	3460	8188	1227	704	3475	924
"MMP13"	2724	12739	0	0	0	0	0	0	49	7	0	0	0	1	0	0	0	0
"MMP14"	3547	11011	253	201	118	135	127	74	286	237	21	247	1911	1902	6494	8991	4092	3873
"MMP15"	4445	21522	0	0	0	0	0	0	40	25	0	0	2	10	0	0	0	0
"MMP16"	6343	290257	0	0	0	0	0	0	0	0	0	0	0	0	0	0	0	0
"MMP17"	2418	23377	0	0	0	0	0	0	135	89	0	7	11	0	41	33	51	29
"MMP19"	3339	7522	69	42	24	45	29	13	43	206	0	28	208	164	414	1260	274	439
"MMP2"	3537	27505	1	7	1	0	0	7	1	0	0	4	0	0	0	6	0	0
"MMP20"	1965	48498	0	0	0	0	0	0	17	0	0	0	0	0	0	0	0	0
"MMP21"	1920	9364	0	0	0	0	0	0	0	0	0	0	0	0	0	0	3	0
"MMP21/22B"	912	1871	0	0	0	0	0	0	0	0	0	0	0	0	10	3	8	10
"MMP23B"	1247	2471	0	0	0	0	0	0	0	0	0	0	1	4	10	3	13	10
"MMP24"	4342	50267	1712	851	937	775	446	405	1184	768	1007	1616	199	1068	135	160	183	87
"MMP25"	3559	14042	779	143	421	358	56	87	246	145	211	200	940	927	767	488	1888	798
"MMP26"	995	4235	0	0	0	0	0	0	0	0	0	0	0	0	0	0	0	0
"MMP27"	1657	14055	0	0	0	0	0	0	0	0	0	0	0	0	0	0	0	0
"MMP28"	2471	29766	0	0	0	0	0	0	31	23	0	0	0	1	0	0	0	0
"MMP3"	1838	7816	0	0	0	0	0	0	0	0	0	0	0	0	0	0	0	0
"MMP7"	1320	6469	0	9	0	0	4	5	0	1	0	0	3	20	10	43	41	24
"MMP8"	3155	13161	0	0	0	0	0	0	0	0	0	0	0	0	0	0	0	0
"MMP9"	2348	7654	418	257	218	200	103	154	56	145	0	522	1639	1992	1644	1031	840	746
"MMRN1"	4975	59728	0	0	0	0	0	0	0	0	0	0	0	0	0	0	0	0
"MMRN2"	4184	22127	0	0	0	0	0	0	0	0	0	0	0	0	0	0	0	0
"MMS19"	3715	40285	1902	350	1088	814	179	171	1022	173	655	235	1732	1445	1893	1469	2478	1538
"MN1"	7557	53222	8	89	8	0	53	36	304	124	0	0	17	33	0	0	0	0
"MNAT1"	1378	233928	407	229	146	261	139	90	999	516	27	68	148	196	141	153	156	156
"MNB/DYRK"	435	105325	16273	11288	9046	7227	6103	5185	6946	5167	6389	9668	75	104	85	90	179	107
"MND1"	949	70444	0	0	0	0	0	0	0	0	0	0	0	0	0	0	0	0
"MNDA"	1674	18104	521	0	307	214	0	0	383	0	0	0	2550	1391	4352	2748	1305	1397
"MNS1"	2033	36408	0	0	0	0	0	0	0	0	0	0	0	0	0	0	0	0
"MNT"	4847	16905	1326	418	705	621	242	176	524	209	802	490	1281	538	1217	424	1497	698
"MNX1"	2179	5802	0	0	0	0	0	0	0	0	0	0	0	0	0	0	0	0
"MOAP1"	2418	2708	111	0	64	47	0	0	0	0	0	0	563	459	518	312	496	320
"MOAT-B"	2436	135277	549	642	287	262	370	272	524	876	31	301	671	885	485	412	722	482
"MOBKL1A"	7076	85828	7350	1968	4213	3137	1055	913	3217	1029	2793	947	3588	4523	3710	2946	4165	2283
"MOBKL1B"	1803	14848	2646	939	1882	764	453	486	989	815	743	1433	14697	2269	2221	1957	2551	1431
"MOBKL2A"	3334	25234	3993	5621	2234	1759	2888	2733	1272	2929	4232	11651	4287	7162	2108	2595	3391	3974
"MOBKL2B"	6528	204644	27179	21560	15135	12044	11667	9893	12089	7519	5774	10850	3126	911	1998	1550	2601	1574
"MOBKL2C"	2825	9177	1807	129	1030	777	75	54	585	91	579	23824	506	4041	767	5163	890	4352
"MOBKL3"	2869	36744	565	144	265	300	88	56	269	235	46	296	546	653	645	685	764	568
"MOBP"	3980	4096	0	0	0	0	0	0	0	0	0	0	0	0	0	0	0	0
"MOCOS"	2741	81206	1056	101	601	455	44	57	940	128	320	27	774	1022	122	53	618	233
"MOCS1"	4161	23411	0	0	0	0	0	0	22	0	0	0	0	0	0	0	0	0
"MOCS2"	1523	11430	13	12	13	0	12	0	16	0	0	0	371	393	470	246	470	186
"MOCS3"	2459	2459	0	0	0	0	0	0	37	0	0	0	334	135	328	114	368	93
"MOD5"	1891	13032	1951	13	1118	833	11	2	1121	6	661	48	624	460	644	331	789	301
"MOG"	2258	15339	0	0	0	0	0	0	25	0	0	0	0	0	0	1	0	0
"MOGAT1"	1102	38194	0	0	0	0	0	0	9	0	0	2	1	1	11	0	10	0
"MOGAT2"	1837	11440	1	0	0	1	0	0	14	0	0	0	0	0	0	0	0	0
"MOGAT3"	1412	5289	0	0	0	0	0	0	11	11	0	0	0	0	0	0	0	0
"MOGS"	2898	4354	745	242	340	405	141	101	268	168	689	276	1276	1119	1724	1452	2117	1418
"MOK"	2049	16112	0	0	0	0	0	0	16	0	0	0	0	0	3	0	4	0
"MON1A"	2557	21139	7	0	1	6	0	0	30	10	0	10	192	90	189	94	283	146
"MON1B"	3316	8707	729	287	420	309	153	134	200	169	483	275	2176	1907	2009	1512	2060	1251
"MON2"	10492	130767	5633	3354	3145	2488	1784	1570	3230	1892	1478	2210	1708	2205	1721	1609	1917	1039
"MOP3"	2758	109487	11044	5097	6034	5010	2611	2486	4104	2047	3008	4908	1080	948	1101	617	1498	856
"MORC1"	3793	159906	0	0	0	0	0	0	0	0	0	0	0	0	0	0	0	0
"MORC2"	4494	41589	417	52	250	167	32	20	405	21	134	22	742	573	599	355	600	336
"MORC3"	4262	56458	3126	1618	1727	1399	893	725	1425	970	336	1553	1805	1762	1955	1352	2088	1229
"MORC4"	3818	59479	0	0	0	0	0	0	9	0	0	0	40	29	15	20	36	7
"MORF4"	708	708	0	0	0	0	0	0	0	0	0	0	0	0	0	0	0	0
"MORF4L1"	1953	24902	2140	2235	1158	982	1280	955	1058	1056	764	2186	2332	3035	5053	4732	5952	4516
"MORF4L2"	2764	10729	2535	3332	1365	1170	1894	1438	1261	1482	781	2577	4269	5877	7189	5488	7826	6097
"MORG1"	1453	9019	1147	1112	633	514	541	571	640	486	506	1367	1610	1739	1939	2148	2629	2421
"MORN1"	1838	59429	217	40	123	94	40	0	414	197	0	10	42	47	21	18	28	3
"MORN2"	744	6747	0	0	0	0	0	0	0	0	0	0	14	16	72	58	47	41
"MORN3"	1163	18268	172	134	99	73	98	36	140	283	211	1007	0	9	0	0	0	0
"MORN4"	2426	19035	0	0	0	0	0	0	14	0	0	0	0	0	0	0	0	0
"MORN5"	1570	15783	0	0	0	0	0	0	0	0	0	0	0	0	0	0	0	0
"MOS"	1041	1041	0	0	0	0	0	0	0	0	0	0	0	0	0	0	0	0
"MOSC1"	2300	27703	12	0	12	0	0	0	33	0	0	0	158	186	122	81	162	110
"MOSC2"	1586	35920	8	0	0	8	0	0	39	0	0	0	115	90	32	22	136	86
"MOSPD1"	2363	27636	16	0	16	0	0	0	11	0	0	0	439	208	822	631	588	516
"MOSPD2"	3184	47894	572	49	399	173	37	12	540	27	52	110	1508	1612	1866	1545	2185	1504
"MOSPD3"	1206	2886	0	11	0	0	8	3	52	37	0	0	158	122	156	127	264	140
"MOV10"	4405	26321	741	206	470	271	118	88	591	205	445	201	552	526	765	754	944	659
"MOV10L1"	3983	71682	0	0	0	0	0	0	137	47	0	0	2	1	0	0	0	0
"MOX2"	2131	29742	0	0	0	0	0	0	0	0	0	0	16	45	11	0	23	17
"MOXD1"	3050	105471	1	0	1	0	0	0	0	0	0	0	0	0	0	0	0	0
"MOXD2"	441	2640	0	0	0	0	0	0	0	0	0	0	0	0	0	0	0	0
"MPDU1"	1765	4562	402	135	251	151	78	57	194	217	90	269	26957	23482	3474	3521	3516	3060
"MPDZ"	7649	173856	0	0	0	0	0	0	0	0	0	0	0	0	0	0	0	0
"MPDZ variant protein"	3990	70184	0	0	0	0	0	0	0	0	0	0	0	0	0	0	0	0
"MPEG1"	4507	4507	115	69	47	68	44	25	99	0	0	24	1988	2418	1776	1771	3144	1659
"MPG"	1285	7674	473	0	371	102	0	0	321	58	163	0	1115	61	1221	772	2218	324
"MPHOSPH10"	2494	19788	181	33	109	72	33	0	125	62	46	132	855	738	665	519	786	565
"MPHOSPH6"	1105	22063	1356	1458	710	646	797	661	668	1019	500	1536	697	1283	715	714	664	624
"MPHOSPH8"	3229	38760	1615	590	906	709	322	268	1158	213	327	349	1806	1896	1554	1266	1690	1030
"MPHOSPH9"	3916	76712	516	163	254	262	106	57	605	94	147	114	566	718	580	525	675	416
"MPI"	1779	8157	110	0	89	21	0	0	436	23	0	0	273	247	363	230	401	260
"MPL"	3656	16661	0	0	0	0	0	0	34	0	0	0	0	0	0	0	0	0
"MPND"	1669	16560	230	197	105	125	84	113	240	476	797	552	582	1171	563	1389	700	636
"MPO"	3227	11081	0	0	0	0	0	0	82	59	0	0	293	243	89	63	209	309
"MPP1"	2162	26797	709	166	397	312	88	78	377	328	92	83	1271	1145	2251	2125	2428	1191
"MPP2"	4425	32388	0	0	0	0	0	0	192	54	0	0	0	0	0	0	0	0
"MPP3"	3012	31443	0	0	0	0	0	0	92	35	0	0	9	10	0	0	11	3
"MPP4"	2479	53821	0	0	0	0	0	0	0	0	0	0	0	0	0	0	0	0
"MPP5"	5371	94516	1777	770	1028	749	444	326	820	620	118	594	1549	354	775	549	682	464
"MPP6"	2199	114414	0	0	0	0	0	0	0	0	0	0	20	25	10	0	7	7
"MPP7"	5225	231146	0	0	0	0	0	0	8	3	0	0	0	14	0	11	3	0
"MPPE1"	3129	25169	1133	100	651	482	56	44	639	70	491	42	680	455	823	497	933	652
"MPPED1"	2768	90179	0	0	0	0	0	0	271	96	0	0	0	0	0	0	0	0
"MPPED2"	5700	201892	0	0	0	0	0	0	9	7	0	0	0	0	0	0	0	0
"MPRIP"	3925	142768	2734	581	1602	1132	327	254	2395	729	645	535	1901	2090	2104	2059	2363	1844
"MPSK1"	3377	4443	75	45	35	40	0	45	56	32	0	0	2766	2175	1656	223	3188	489
"MPST"	6012	10153	37	0	37	0	0	0	81	13	0	1	539	335	347	296	788	423
"MPV17"	2017	16187	1399	648	771	628	385	263	657	371	1422	932	1574	1083	1197	1588	1615	873
"MPV17L"	2313	13934	0	0	0	0	0	0	0	0	0	0	0	0	0	0	0	0
"MPV17L2"	1361	3510	7	0	4	3	0	0	122	53	0	0	330	278	341	195	598	362
"MPZ"	1959	5237	0	0	0	0	0	0	0	0	0	0	47	21	85	59	100	53
"MPZL1"	5015	69970	521	0	263	258	0	0	512	16	0	0	1113	1091	971	757	1326	868
"MPZL2"	2621	10876	0	0	0	0	0	0	0	0	0	0	0	1	0	0	7	0
"MPZL3"	988	22676	142	0	78	64	0	0	50	0	0	0	710	94	58	49	97	46
"MR"	5379	363729	9978	6312	5519	4459	3314	2998	3980	2728	3122	2074	220	293	3	1	1	0
"MR1"	1575	17248	298	134	115	183	65	69	347	173	61	48	1829	1524	1233	899	1223	660
"MR1B"	886	21496	298	134	115	183	65	69	347	173	61	48	1829	1524	1233	899	1223	660
"MRAP"	1001	20475	38	0	16	22	0	0	35	0	0	0	0	89	0	0	0	21
"MRAP2"	2215	57185	0	0	0	0	0	0	0	0	0	0	0	0	0	0	0	0
"MRAS"	4459	57753	5141	3211	2817	2324	1745	1466	2325	1813	4148	3331	3442	3365	6195	7204	5067	4774
"MRC1"	5200	101817	6205	705	3551	2654	404	301	5081	452	2180	807	10786	12901	136178	128583	124739	94288
"MRC2"	6010	66190	7035	8302	3762	3273	4428	3874	2404	6072	4379	6716	2931	3541	3768	3565	6713	4097
"MRDS1"	2212	176674	0	0	0	0	0	0	32	8	0	0	0	0	0	0	0	0
"MRE11A"	5180	76573	1499	438	813	686	260	178	991	123	202	111	885	726	939	657	684	639
"MRE11B"	5298	76573	1499	438	813	686	260	178	991	123	202	111	885	726	939	657	684	639
"MREG"	3217	71033	11342	35335	6315	5027	19186	16149	3230	15681	4830	32113	2495	570	3652	5456	3412	3923
"MRFAP1"	2045	2633	231	191	137	94	104	87	57	79	0	0	4914	4879	4525	4310	5212	4068
"MRFAP1L1"	1587	2173	113	0	49	64	0	0	136	0	0	0	1225	672	1269	422	1473	438
"MRGPRD"	966	966	0	0	0	0	0	0	17	0	0	0	0	0	0	0	0	0
"MRGPRE"	1297	4576	0	0	0	0	0	0	0	0	0	0	0	0	0	0	0	0
"MRGPRF"	2285	8989	2	0	0	2	0	0	35	0	0	0	0	0	0	0	0	0
"MRGPRX1"	1190	1190	0	0	0	0	0	0	0	0	0	0	0	0	0	0	0	0
"MRGPRX2"	2035	6225	0	0	0	0	0	0	0	0	0	0	0	0	0	0	0	0
"MRGPRX3"	1640	17525	0	0	0	0	0	0	0	0	0	0	0	0	0	0	0	0
"MRGPRX4"	1445	1445	0	0	0	0	0	0	0	0	0	0	0	0	0	0	0	0
"MRI"	1615	5000	772	520	421	351	265	255	300	298	652	369	2581	2222	2232	1928	450	365
"MRI1"	3182	9760	239	32	110	129	11	21	188	27	35	7	713	393	321	207	223	146
"MRJ"	2484	80424	21814	62704	12147	9667	33475	29229	6200	39736	12895	62038	3508	10180	5401	14059	7234	9301
"MRM1"	1837	7383	76	0	36	40	0	0	162	38	0	0	118	65	138	93	192	117
"MRO"	5265	24945	0	0	0	0	0	0	0	0	0	0	0	0	0	0	0	0
"MRP5"	2056	34187	358	298	159	199	147	151	112	191	480	360	74	104	194	187	198	110
"MRP6"	4770	73907	99	33	42	57	33	0	145	95	0	0	156	40	0	0	0	0
"MRP63"	2655	2848	0	0	0	0	0	0	18	0	0	0	719	613	650	550	734	515
"MRPL1"	1368	90141	161	17	86	75	17	0	220	11	0	0	272	293	247	168	267	167
"MRPL10"	1891	8259	0	0	0	0	0	0	93	53	0	0	407	264	419	226	741	332
"MRPL11"	1691	3761	0	0	0	0	0	0	62	0	0	0	324	134	409	450	588	475
"MRPL12"	1005	4143	216	0	110	106	0	0	93	127	0	0	540	741	483	605	779	464
"MRPL13"	1116	49565	73	0	49	24	0	0	37	0	0	0	396	500	497	432	539	387
"MRPL14"	776	13819	137	422	61	76	204	218	104	394	35	947	123	222	331	421	559	184
"MRPL15"	1754	13295	58	18	32	26	9	9	48	23	36	77	939	809	958	768	1139	825
"MRPL16"	1186	4739	230	41	133	97	17	24	125	0	0	0	801	483	666	535	893	101
"MRPL17"	2369	3018	3	0	0	3	0	0	3	0	0	0	396	293	551	335	686	410
"MRPL18"	980	7970	82	35	54	28	16	19	90	53	0	121	580	868	566	792	682	611
"MRPL19"	7832	15426	249	0	163	86	0	0	146	0	18	0	1068	996	790	503	891	519
"MRPL2"	1293	5477	28	0	11	17	0	0	127	0	0	0	176	59	319	120	228	210
"MRPL20"	1151	2282	922	526	523	399	269	257	300	245	918	723	1606	1516	678	1543	2196	1425
"MRPL21"	1270	11633	46	35	23	23	17	18	80	63	0	107	376	337	331	345	360	425
"MRPL22"	3179	28339	152	16	104	48	9	7	170	16	0	0	324	257	253	205	325	215
"MRPL23"	745	9337	36	1	1	35	1	0	95	41	118	4	515	239	541	476	734	441
"MRPL24"	933	3831	16	0	10	6	0	0	59	50	0	75	401	418	247	427	288	511
"MRPL27"	2438	5335	119	45	60	59	29	16	136	105	38	179	81	379	280	559	350	524
"MRPL28"	1105	3146	18	0	18	0	0	0	74	54	0	0	330	234	316	201	626	401
"MRPL3"	1824	40785	1810	151	1050	760	84	67	1117	138	38	403	1237	1371	952	827	1053	697
"MRPL30"	2574	16512	289	9	198	91	5	4	301	12	81	0	2092	1890	1522	1056	1945	1132
"MRPL32"	2998	5514	20	19	0	20	19	0	46	54	0	0	671	719	461	648	554	502
"MRPL33"	522	8026	192	0	113	79	0	0	167	0	14	0	708	284	489	377	829	457
"MRPL34"	970	1177	23	0	14	9	0	0	20	14	0	0	1436	1053	1034	713	985	621
"MRPL35"	3314	13922	50	0	35	15	0	0	37	0	0	0	657	682	1037	650	1076	728
"MRPL36"	615	1458	0	0	0	0	0	0	15	13	0	0	290	197	300	260	415	298
"MRPL37"	1618	25299	163	26	89	74	26	0	247	59	46	0	1507	1233	583	419	710	553
"MRPL38"	1584	6459	91	16	49	42	0	16	112	164	27	34	448	281	598	474	764	481
"MRPL39"	1180	21833	446	125238	175	271	67525	57713	48	7879	0	5664	207	19376	232	284	247	2181
"MRPL4"	2410	8096	264	19	138	126	13	6	169	131	112	33	1249	788	882	938	1570	697
"MRPL40"	962	3494	24	0	0	24	0	0	58	0	41	47	451	247	207	428	574	173
"MRPL41"	605	699	0	0	0	0	0	0	26	29	0	0	597	437	730	625	883	686
"MRPL42"	2048	35163	12	20	12	0	11	9	98	18	0	0	472	463	369	367	415	331
"MRPL42P5"	668	668	22	0	0	22	0	0	24	0	0	0	28	0	0	1	45	0
"MRPL43"	2284	9695	59	0	29	30	0	0	112	13	0	0	687	495	680	464	852	485
"MRPL44"	1750	10310	11	0	9	2	0	0	29	9	0	22	658	591	715	454	889	523
"MRPL45"	1703	26104	14	0	14	0	0	0	47	11	0	0	398	426	544	434	727	510
"MRPL46"	5589	6298	12	0	0	12	0	0	21	0	0	0	230	106	277	225	228	214
"MRPL47"	1185	16179	21	0	18	3	0	0	48	0	0	37	311	551	521	504	293	513
"MRPL48"	1242	76740	197	9	77	120	9	0	242	0	0	0	118	126	420	320	473	313
"MRPL49"	2093	5115	32	12	24	8	0	12	63	105	0	0	1721	1264	116	824	1702	99
"MRPL50"	1061	9798	23	25	12	11	13	12	11	24	0	0	575	775	482	480	532	441
"MRPL51"	680	1157	0	0	0	0	0	0	26	18	0	0	592	1108	822	820	497	316
"MRPL52"	1299	5149	160	0	75	85	0	0	57	12	0	148	447	470	436	408	547	370
"MRPL53"	614	815	66	16	28	38	0	16	73	23	0	0	123	86	546	511	0	131
"MRPL54"	625	4899	20	0	7	13	0	0	58	32	0	24	159	307	547	612	752	642
"MRPL55"	1214	2326	75	0	37	38	0	0	52	58	0	29	201	71	303	241	420	209
"MRPL9"	1337	3917	68	0	36	32	0	0	18	26	0	0	659	601	848	564	1148	334
"MRPS10"	2172	11095	120	0	59	61	0	0	0	11	0	0	780	734	986	729	807	667
"MRPS11"	2261	10812	355	27	205	150	27	0	207	12	0	0	378	278	491	388	523	344
"MRPS12"	1077	2065	3	0	0	3	0	0	81	0	0	0	451	375	513	371	664	471
"MRPS14"	1174	9433	84	50	66	18	26	24	116	8	30	0	1662	409	438	115	161	110
"MRPS15"	973	8680	59	6	39	20	0	6	24	14	0	43	540	191	685	520	366	562
"MRPS16"	2651	3852	554	112	313	241	60	52	251	101	513	35	1966	1752	1738	1268	1982	910
"MRPS17"	1647	67871	30	3	30	0	0	3	104	28	0	47	466	424	242	188	315	182
"MRPS18A"	1287	16488	164	0	110	54	0	0	291	99	55	97	275	96	299	117	172	93
"MRPS18B"	1541	8690	13	0	9	4	0	0	52	14	0	24	788	410	614	323	763	445
"MRPS18C"	1125	5811	175	0	114	61	0	0	86	11	78	42	393	320	554	341	540	320
"MRPS2"	1707	4037	0	0	0	0	0	0	26	47	0	0	444	327	565	355	764	452
"MRPS21"	940	14551	97	21	61	36	21	0	147	39	46	140	516	537	676	542	932	547
"MRPS22"	1191	13089	424	314	218	206	250	64	315	202	44	64	371	1399	1152	338	420	902
"MRPS23"	906	10557	25	0	8	17	0	0	10	8	0	0	195	204	436	256	416	483
"MRPS24"	700	2990	2	0	2	0	0	0	0	17	0	0	446	161	81	112	525	446
"MRPS25"	4569	16798	4055	1169	2312	1743	416	753	1704	844	1916	1021	3027	410	3602	2418	3997	2059
"MRPS26"	1042	2222	17	0	17	0	0	0	0	8	0	0	309	199	457	170	517	245
"MRPS27"	2833	100848	1072	21	642	430	11	10	728	70	64	54	1351	1186	1063	628	1379	817
"MRPS28"	709	111412	2169	496	1347	822	250	246	1687	824	361	644	81	107	247	272	299	270
"MRPS30"	1673	6589	101	0	48	53	0	0	84	0	27	28	854	617	592	297	610	347
"MRPS31"	1345	41916	290	0	137	153	0	0	331	33	28	0	390	345	368	227	376	217
"MRPS33"	748	8519	0	0	0	0	0	0	12	0	0	0	237	149	298	226	248	278
"MRPS34"	1022	1241	33	0	1	32	0	0	21	0	0	0	969	59	1108	655	1397	916
"MRPS35"	1872	45500	80	10	42	38	10	0	159	0	0	0	1201	1190	1411	1129	1413	1046
"MRPS36"	1485	12326	109	20	76	33	20	0	69	0	65	29	115	357	403	334	512	401
"MRPS5"	1875	18258	1410	259	902	508	147	112	769	185	251	442	1618	1127	1466	1088	1508	830
"MRPS6"	993	69513	38346	80316	21477	16869	43250	37066	11526	22577	25723	64497	9223	15774	10558	20535	8857	9851
"MRPS7"	1727	2824	184	24	72	112	16	8	251	35	18	0	2998	1865	67	490	3541	443
"MRPS9"	1468	61936	324	0	188	136	0	0	383	4	0	0	430	386	386	272	500	333
"MRRF"	1980	52615	1139	466	668	471	242	224	873	427	300	727	582	744	654	584	966	574
"MRS2"	3362	22658	587	5	371	216	0	5	340	22	82	15	1096	914	1266	794	1241	788
"MRS2P2"	2689	2689	29	0	29	0	0	0	69	0	0	0	25	40	0	0	0	0
"MRTO4"	2280	8548	140	31	82	58	31	0	121	141	52	90	620	527	414	384	296	259
"MRVI1"	6387	120899	1	0	0	1	0	0	58	0	0	0	0	0	0	0	0	0
"MS4A1"	3601	14944	0	0	0	0	0	0	0	18	0	14	196	284	88	128	159	129
"MS4A10"	2304	15959	0	0	0	0	0	0	83	0	0	0	0	0	0	0	0	0
"MS4A12"	1166	14646	0	0	0	0	0	0	16	0	0	0	0	0	0	0	0	0
"MS4A13"	930	27305	0	0	0	0	0	0	0	0	0	0	0	0	0	0	0	0
"MS4A14"	3525	21741	554	3591	311	243	1926	1665	889	3595	0	1639	1286	4324	2625	8959	1882	2338
"MS4A15"	2254	19866	0	0	0	0	0	0	11	0	0	0	0	0	0	0	0	0
"MS4A2"	3729	9879	0	0	0	0	0	0	0	0	0	0	277	430	445	450	272	140
"MS4A3"	1661	14488	0	0	0	0	0	0	0	0	0	0	163	208	212	216	108	74
"MS4A4A"	1677	28307	9	0	5	4	0	0	0	0	0	0	358	350	803	722	464	400
"MS4A4E"	575	16978	513	67	316	197	35	32	814	226	135	101	114	259	66	53	61	5
"MS4A5"	721	18199	0	0	0	0	0	0	0	0	0	0	0	0	0	0	0	0
"MS4A6"	1417	10833	3030	391	1654	1376	201	190	1887	67	1830	12	9829	3102	14324	4685	6700	2164
"MS4A6A"	1798	13060	3030	396	1654	1376	204	192	1887	67	1867	12	9829	5816	14336	4696	6979	4236
"MS4A6E"	663	6087	0	0	0	0	0	0	0	0	0	0	0	0	17	26	0	0
"MS4A7"	3013	17468	542	3441	299	243	1854	1587	793	3490	0	1639	1186	4164	2175	8351	1625	2107
"MS4A8B"	1358	16237	0	0	0	0	0	0	0	0	0	0	0	0	0	0	0	0
"MSC"	2060	2956	5748	1798	316	5432	951	847	1054	2927	0	919	2363	7281	1743	360	2154	4566
"MSGN1"	582	582	0	0	0	0	0	0	0	0	0	0	0	0	0	0	0	0
"MSH2"	3334	276247	46	3	15	31	3	0	176	19	18	0	505	354	645	433	885	501
"MSH3"	4643	222341	551	212	343	208	131	81	742	207	98	163	538	560	372	293	335	227
"MSH4"	3223	116295	104	0	60	44	0	0	47	0	0	0	0	0	0	0	0	0
"MSH5"	5261	8215	115	13	35	80	6	7	289	92	73	69	72	120	112	111	157	92
"MSH6"	4330	23865	1282	729	777	505	433	296	873	326	306	607	2824	1442	2470	909	2724	730
"MSI1"	2965	27827	0	0	0	0	0	0	75	11	0	0	0	0	0	0	0	0
"MSI2"	2152	376171	4757	1247	2658	2099	750	497	3468	1644	399	1538	385	890	151	191	191	73
"MSK1"	1507	160040	0	0	0	0	0	0	41	0	0	0	10	12	18	29	18	21
"MSL1"	3825	14252	916	319	523	393	178	141	532	130	653	214	1869	1750	2444	1605	2960	1681
"MSL2"	4698	46930	5404	3343	3084	2320	1900	1443	1893	1218	2542	3055	1738	1214	1603	737	1815	652
"MSL3"	3533	9820	1003	277	573	430	169	108	384	57	270	78	1766	1645	2052	1264	2623	1328
"MSLN"	2432	8100	1	0	1	0	0	0	32	0	0	0	32	24	85	86	60	41
"MSLNL"	3178	13500	1	0	0	1	0	0	49	50	0	0	0	1	0	0	0	0
"MSMB"	571	13039	0	0	0	0	0	0	0	0	0	0	0	0	0	0	0	0
"MSMP"	675	1283	179	0	105	74	0	0	68	37	94	75	0	1034	585	417	653	375
"MSN"	3982	74283	9099	20093	5069	4030	10764	9329	2200	15204	2273	23834	12620	20493	19001	26175	21215	18452
"MSN/ALK fusion"	356	49536	5670	15464	3170	2500	7746	7718	1514	13388	1466	19705	0	73	1202	1453	1371	901
"MSR1"	3770	84914	15	0	6	9	0	0	0	3	0	0	353	359	794	660	809	799
"MSRA"	1713	333335	11395	8211	6442	4953	4567	3644	6313	6056	2503	6680	495	680	557	570	685	612
"MSRB2"	1815	26516	0	0	0	0	0	0	0	0	0	0	10	16	23	23	10	18
"MSRB3"	4517	188194	0	0	0	0	0	0	0	0	0	0	0	0	0	0	0	0
"MST048"	1317	55173	3780	586	2078	1702	322	264	2120	443	1035	443	1028	1020	749	632	985	658
"MST066"	2991	95963	12197	922	6760	5437	483	439	6150	556	6273	504	2074	1299	2026	2240	4339	2126
"MST076"	1867	12643	61	0	51	10	0	0	28	0	0	0	614	661	658	607	825	697
"MST077"	721	1393	249	8	132	117	0	8	33	12	0	0	5	22	17	19	50	20
"MST089"	3896	39230	1095	1175	647	448	643	532	662	713	113	721	4044	2388	1999	2044	3953	2617
"MST091"	5669	14229	545	288	261	284	156	132	299	94	66	236	1113	1246	1028	734	1010	801
"MST093"	3481	115951	4785	140	4429	356	99	41	497	103	166	97	496	606	667	601	703	665
"MST096"	2739	10264	398	144	277	121	78	66	281	145	28	186	1335	1222	1736	1481	1961	1517
"MST097"	4237	71612	1921	510	1042	879	256	254	1106	318	664	648	661	730	955	713	871	478
"MST1"	2748	4052	71	21	18	53	9	12	365	24	15	0	12	28	69	80	115	330
"MST109"	3660	39974	6546	4092	2141	4405	2195	1897	4322	2167	7100	3282	1991	2490	3146	2699	3357	1395
"MST114"	5643	31953	0	0	0	0	0	0	124	88	0	0	0	0	0	0	0	0
"MST118"	2052	109452	2953	575	1776	1177	365	210	1961	593	1442	915	808	728	1053	707	644	277
"MST119"	1516	13929	0	0	0	0	0	0	0	0	0	0	0	0	0	0	0	0
"MST123"	5981	57697	1513	202	831	682	110	92	769	172	544	415	822	822	1109	1231	1755	1422
"MST151"	3250	203090	0	0	0	0	0	0	15	0	0	0	2	0	0	0	0	0
"MST154"	3208	8296	326	23	213	113	12	11	121	21	68	31	486	236	801	102	452	124
"MST1R"	4789	16870	7	0	3	4	0	0	77	50	0	0	0	0	0	0	0	0
"MST4"	3415	52728	95	3613	68	27	2025	1588	103	2027	20	2200	618	1725	624	2176	713	767
"MSTN"	2821	7030	0	0	0	0	0	0	0	0	0	0	0	0	0	0	0	0
"MSTO1"	3446	4752	38	70	22	16	29	41	36	22	0	0	92	73	815	536	913	493
"MSTP9"	4410	9575	0	0	0	0	0	0	25	12	0	0	0	3	0	0	12	7
"MSX1"	1937	4268	0	0	0	0	0	0	0	0	0	0	0	0	0	0	0	0
"MSX2"	2209	6328	0	0	0	0	0	0	0	0	0	0	0	0	0	0	0	0
"MSX2P1"	2160	2160	0	0	0	0	0	0	0	0	0	0	0	0	0	0	0	0
"MT1A"	397	1421	0	0	0	0	0	0	0	13	0	0	0	0	0	0	0	0
"MT1B"	382	1306	0	0	0	0	0	0	45	0	0	0	0	0	0	0	0	0
"MT1E"	854	1439	0	0	0	0	0	0	0	0	0	0	28	0	16	0	22	17
"MT1F"	443	1361	0	0	0	0	0	0	0	14	0	0	0	18	41	19	41	42
"MT1G"	402	1326	0	0	0	0	0	0	0	0	0	0	0	3	29	23	32	13
"MT1H"	399	1316	0	0	0	0	0	0	0	0	0	0	0	0	0	4	15	0
"MT1IP"	2006	2006	0	0	0	0	0	0	20	10	0	0	0	0	0	0	1	0
"MT1M"	442	1365	0	0	0	0	0	0	12	0	0	0	0	0	0	0	0	0
"MT1X"	562	1727	0	0	0	0	0	0	16	24	0	0	21	0	135	117	108	108
"MT2A"	421	932	0	0	0	0	0	0	74	13	0	0	28	0	376	335	300	326
"MT3"	584	1734	0	0	0	0	0	0	0	0	0	0	0	0	0	0	0	0
"MT4"	297	3910	0	0	0	0	0	0	0	0	0	0	0	0	0	0	0	0
"MTA1"	2852	50864	2617	476	1530	1087	306	170	1390	550	2471	760	870	829	1283	1013	1323	913
"MTA2"	3078	8630	724	276	389	335	125	151	397	246	216	258	2987	1692	3120	2341	4370	2355
"MTA3"	5849	262379	7	0	0	7	0	0	80	36	0	0	150	153	177	91	161	95
"MTABC"	4648	8810	828	181	448	380	106	75	546	142	841	54	3004	2310	3000	2011	5019	2638
"MTAP"	4927	63334	2587	3044	1571	1016	1695	1349	2002	1647	145	468	701	2405	535	1031	553	598
"MTB"	979	1325	0	0	0	0	0	0	0	0	0	0	0	0	0	0	0	0
"MTBP"	3081	78211	20	0	10	10	0	0	12	0	0	0	15	53	48	15	37	21
"MTCH1"	1986	18034	2095	1413	1308	787	638	775	650	1002	1345	2269	2538	688	4569	4205	6181	4167
"MTCH2"	2640	25349	901	131	486	415	93	38	429	146	415	471	843	1639	1935	1932	2201	1685
"MTCP1"	2325	7240	0	9	0	0	0	9	100	17	0	13	204	158	217	125	200	135
"MTCP1NB"	1015	9647	0	9	0	0	0	9	100	17	0	13	315	275	360	233	357	249
"MTDH"	7678	86082	6488	600	3661	2827	334	266	2779	255	3241	217	7964	7396	7132	5317	8396	4855
"MTE"	245	1633	0	0	0	0	0	0	20	10	0	0	0	0	0	0	1	0
"MTERF"	2268	7997	294	9	154	140	9	0	389	31	0	0	276	157	238	66	225	75
"MTERFD1"	1477	22153	95	0	47	48	0	0	95	14	0	0	100	53	233	123	298	77
"MTERFD2"	2597	5367	392	18	177	215	18	0	249	55	0	80	106	246	203	234	678	295
"MTERFD3"	3245	9587	0	0	0	0	0	0	45	0	0	0	115	76	92	45	142	39
"MTF"	434	16526	0	0	0	0	0	0	52	0	0	0	28	0	16	0	23	17
"MTF1"	7983	50055	815	2541	430	385	1389	1152	489	1740	29	5077	2456	4116	1630	2567	972	3776
"MTF2"	4146	59846	2168	263	1229	939	137	126	1209	159	218	104	1286	726	1141	553	1164	668
"MTFMT"	2754	28128	1917	14	1102	815	14	0	712	0	123	0	1119	592	543	315	713	371
"MTFR1"	2741	65912	687	263	371	316	145	118	296	119	0	93	930	923	1018	890	1063	198
"MTG1"	1624	26554	2585	803	1446	1139	398	405	1389	535	3211	1396	488	438	737	450	884	573
"MTG8"	2555	32967	0	0	0	0	0	0	0	0	0	0	0	0	0	0	0	0
"MTHFD1"	3478	71970	678	102	356	322	57	45	696	69	67	101	1615	1626	3660	2924	3957	2808
"MTHFD1L"	3977	226643	4460	3868	2470	1990	2217	1651	2127	1978	603	2550	721	830	919	856	797	639
"MTHFD2"	2292	16734	1618	3152	930	688	1653	1499	531	1932	659	6308	3813	9510	3460	7121	4069	5029
"MTHFD2L"	2370	4142	110	0	66	44	0	0	78	10	0	0	98	107	81	62	79	33
"MTHFR"	7199	17655	2384	1164	940	1444	712	452	1511	421	2371	641	2354	1700	3208	1910	4015	1750
"MTHFS"	887	52052	0	0	0	0	0	0	0	99	0	0	9	28	40	58	40	50
"MTHFSD"	3116	25060	258	57	137	121	38	19	470	220	165	172	421	288	333	151	459	172
"MTIF2"	2964	32559	709	700	397	312	412	288	409	203	69	369	2459	2935	868	778	950	631
"MTIF3"	2093	6028	724	0	426	298	0	0	354	22	109	43	1395	1054	1439	923	1806	922
"MTK1"	5602	125596	3669	28556	2055	1614	15444	13112	1521	11759	122	8348	845	2337	1165	2878	1404	1311
"MTL5"	3631	15390	0	0	0	0	0	0	0	17	0	0	0	0	0	0	0	0
"MTM"	505	1138	0	0	0	0	0	0	26	0	0	0	0	0	0	0	0	0
"MTM1"	3449	104569	3643	313	2146	1497	129	184	2431	274	401	350	1119	1162	1071	790	1154	776
"MTMR1"	4368	71530	1546	159	828	718	66	93	841	57	237	85	1084	1008	975	713	1228	818
"MTMR10"	5694	52658	12853	2636	6649	6204	1418	1218	5978	735	7831	1328	5217	4438	5423	3358	7202	897
"MTMR11"	2875	8249	0	0	0	0	0	0	31	0	0	0	0	0	9	3	10	6
"MTMR12"	5202	86004	3192	286	1797	1395	221	65	1961	322	1622	547	1757	1551	1729	1063	2265	1227
"MTMR14"	2515	52934	11906	19231	6590	5316	10362	8869	3713	8655	6488	29458	3554	7030	4699	7169	5883	7231
"MTMR15"	5050	39233	3364	896	1364	2000	488	408	904	265	1567	556	4489	3888	4339	2950	5703	516
"MTMR2"	4878	91327	25	271	0	25	160	111	96	244	28	21	435	417	571	519	397	305
"MTMR3"	9010	147699	6893	3160	3931	2962	1855	1305	3622	1877	1610	4207	2019	1967	2396	1836	2846	1646
"MTMR4"	5848	28360	1451	587	811	640	337	250	668	190	484	240	1724	1324	1161	982	2577	1039
"MTMR6"	5226	41363	1486	337	882	604	193	144	804	221	62	350	2449	2883	2032	1657	2209	1519
"MTMR7"	5299	116734	1025	536	605	420	302	234	547	350	74	113	681	692	592	321	654	394
"MTMR8"	2652	127351	51	0	18	33	0	0	11	0	0	0	9	5	3	9	4	4
"MTMR9"	7466	43654	1158	455	699	459	279	176	753	447	0	496	620	840	724	637	807	513
"MTMR9L"	2722	10051	0	0	0	0	0	0	48	19	0	0	0	0	0	0	0	0
"MTND5"	2309	2309	0	0	0	0	0	0	0	0	0	0	0	0	0	0	0	0
"MTNR1A"	1107	21730	0	0	0	0	0	0	0	0	0	0	0	0	0	0	0	0
"MTNR1B"	1664	13161	0	0	0	0	0	0	0	12	0	0	0	0	0	0	0	0
"MTO1"	3055	39725	361	5	202	159	5	0	265	43	109	6	805	737	901	649	793	647
"MTOR"	8782	156021	1961	991	1037	924	515	476	1477	747	830	1136	1811	1888	2159	2125	2601	1693
"MTP18"	1173	3323	531	46	349	182	19	27	371	122	77	113	398	508	478	559	677	481
"MTPAP"	7335	64648	583	146	293	290	77	69	241	208	99	354	617	638	585	401	774	404
"MTPN"	3886	50701	2876	1675	1667	1209	903	772	1561	1023	302	1142	8173	9243	7738	6398	9022	5916
"MTR"	10590	108701	2650	1255	1518	1132	720	535	1690	748	232	630	1308	1371	1395	1082	1270	781
"MTRF1"	2554	47105	125	32	65	60	24	8	109	37	0	0	270	310	312	240	321	196
"MTRF1L"	3884	15526	154	50	90	64	14	36	111	36	0	0	291	242	487	467	587	370
"MTRR"	3311	32018	2459	1567	1379	1080	863	704	1029	658	523	1509	1363	1444	1509	1315	1954	1084
"MTSS1"	5034	177704	2298	584	1272	1026	329	255	3143	1757	707	2495	1425	1727	523	215	899	592
"MTSS1L"	4991	24848	305	63	163	142	34	29	217	138	0	16	6	40	67	80	137	26
"MTTP"	4108	59915	0	0	0	0	0	0	0	0	0	0	0	0	0	0	0	0
"MTUS1"	6433	157124	49	0	27	22	0	0	48	11	0	0	315	294	601	540	302	338
"MTVR2"	813	813	0	0	0	0	0	0	0	14	0	0	0	0	0	0	0	0
"MTX1"	1648	5134	98	0	27	71	0	0	172	51	83	111	515	438	335	381	2745	1481
"MTX2"	1601	68630	2959	176	1663	1296	137	39	1503	87	637	95	246	522	518	471	604	445
"MTX3"	7941	14549	107	0	73	34	0	0	133	0	0	0	358	291	338	51	336	75
"MUC 5AC"	4052	16477	59	0	36	23	0	0	185	150	0	42	1	0	0	0	0	0
"MUC1"	1775	4384	3	0	0	3	0	0	7	11	0	0	1	7	0	9	3	15
"MUC12"	2088	14143	0	76	0	0	27	49	22	104	0	97	0	46	0	0	0	9
"MUC13"	2873	29293	0	0	0	0	0	0	0	0	0	0	0	0	0	0	0	0
"MUC15"	3396	13237	0	0	0	0	0	0	0	0	0	0	0	0	0	0	0	0
"MUC16"	43899	132499	0	0	0	0	0	0	11	0	0	0	0	0	0	0	0	0
"MUC17"	14363	38778	0	0	0	0	0	0	62	10	0	0	0	0	0	0	0	0
"MUC2"	8674	29544	0	1	0	0	0	1	451	212	0	0	0	0	0	0	0	0
"MUC20"	6448	13443	92	30	49	43	30	0	126	32	0	96	32	27	70	152	111	83
"MUC21"	3839	6392	0	0	0	0	0	0	0	0	0	0	0	0	0	0	0	0
"MUC3A"	3938	60363	0	2	0	0	0	2	171	80	0	0	0	0	0	0	0	0
"MUC3B"	2496	57624	0	2	0	0	0	2	171	80	0	0	0	0	0	0	0	0
"MUC4"	16748	65510	6	3	2	4	1	2	216	101	0	0	0	0	0	0	0	0
"MUC5AC"	18817	146254	541	253	309	232	151	102	1109	738	87	243	47	57	0	0	0	0
"MUC5B"	17973	39112	188	111	102	86	37	74	533	415	0	42	1	0	0	0	0	0
"MUC6"	8036	23884	4057	1264	2211	1846	707	557	1577	869	457	394	0	1	0	0	19	0
"MUC7"	2544	52506	0	0	0	0	0	0	0	0	0	0	0	0	0	0	0	0
"MUCDHL"	539	1867	0	0	0	0	0	0	32	11	41	0	0	0	0	0	0	0
"MUCL1"	491	3875	0	0	0	0	0	0	0	0	0	0	3	0	0	0	0	0
"MUDENG"	3144	21192	1109	179	600	509	72	107	541	70	0	38	2349	2181	1597	1115	1845	1101
"MUL1"	2460	8733	100	24	55	45	0	24	61	65	74	15	857	620	932	92	1321	133
"MUM1"	4228	22109	517	87	314	203	43	44	296	61	120	8	684	594	735	526	892	483
"MUM1L1"	4176	40652	0	0	0	0	0	0	0	0	0	0	0	0	0	0	0	0
"MUPCDH"	3645	8492	349	12	271	78	0	12	206	108	21	0	0	0	0	0	3	0
"MURC"	2625	9837	9	0	9	0	0	0	8	0	0	0	0	13	0	3	0	0
"MUS81"	2414	6042	574	182	333	241	99	83	429	288	254	567	906	869	966	1077	1400	879
"MUSK"	2732	132193	0	0	0	0	0	0	0	24	0	0	0	0	0	0	0	0
"MUSTN1"	1130	3891	120	100	56	64	60	40	409	67	0	0	27	0	52	17	115	19
"MUT"	2968	32039	0	0	0	0	0	0	50	14	0	0	534	662	650	665	674	546
"MUTED"	2466	50432	228	0	155	73	0	0	257	0	38	25	75	66	404	182	562	324
"MUTYH"	1945	11229	33	21	13	20	12	9	34	35	0	30	136	78	209	184	242	161
"MVD"	2353	5328	1040	1073	555	485	607	466	339	638	86	1531	1285	1109	536	1051	1838	1616
"MVK"	2083	23572	378	153	188	190	74	79	342	253	85	156	508	430	450	353	781	463
"MVP"	2850	27557	3152	1004	1634	1518	548	456	1192	648	1906	902	3591	3731	4047	2809	7024	2196
"MX1"	3410	38622	605	727	356	249	345	382	1184	2040	79	629	810	1909	1748	307	779	947
"MX2"	4073	5285	1762	4686	981	781	2533	2153	1038	3475	110	1670	1037	3106	1702	788	800	795
"MXD1"	5775	27873	2286	5713	1297	989	3039	2674	843	2024	333	2680	1787	4498	1913	3417	2167	2932
"MXD3"	2668	6793	259	72	135	124	56	16	99	134	0	46	514	1072	1159	1249	1562	1126
"MXD4"	3779	14581	1678	208	929	749	94	114	735	216	2051	361	2519	1310	3601	1457	5149	2010
"MXI1"	3474	79760	406	24	230	176	11	13	737	7	34	0	780	885	944	801	1013	758
"MXRA5"	9797	38075	0	0	0	0	0	0	0	0	0	0	0	0	0	0	0	0
"MXRA7"	2508	35249	1	0	0	1	0	0	248	46	0	0	13	16	0	0	32	0
"MXRA8"	2738	9087	492	315	247	245	167	148	255	195	681	412	64	117	282	235	466	293
"MYADM"	3215	6903	36	0	36	0	0	0	16	62	47	198	1683	1559	1384	1748	1325	1248
"MYADML2"	2455	7590	0	0	0	0	0	0	11	28	0	0	0	0	0	0	0	0
"MYB"	3810	37862	0	6	0	0	0	6	4	0	0	0	21	35	37	56	35	22
"MYBBP1A"	4593	16491	274	50	153	121	36	14	302	160	164	18	661	524	661	575	940	676
"MYBL1"	5203	51071	0	5	0	0	0	5	0	0	3	8	19	77	13	3	41	4
"MYBL2"	2727	49415	4	0	3	1	0	0	21	41	0	0	4	2	0	0	10	4
"MYBPC1"	3967	90912	0	0	0	0	0	0	0	0	0	0	1	0	0	0	0	0
"MYBPC2"	3626	33425	0	0	0	0	0	0	162	67	0	0	3	1	0	0	0	0
"MYBPC3"	4250	21297	109	37	53	56	26	11	193	256	49	148	5	8	46	90	72	68
"MYBPH"	1817	8005	0	0	0	0	0	0	50	81	0	0	0	2	0	0	0	0
"MYBPHL"	1381	14678	0	0	0	0	0	0	0	9	0	0	1	0	0	0	0	0
"MYC"	2367	5365	1202	375	625	577	210	165	2092	1307	831	1429	1491	567	1800	908	2030	706
"MYCBP"	2095	10415	809	56	443	366	16	40	590	70	539	92	836	992	724	562	261	618
"MYCBP2"	14818	282386	6981	3807	3754	3227	2230	1577	5080	2828	1384	2870	2154	2962	3506	3314	3294	2082
"MYCBPAP"	3208	23118	1	0	1	0	0	0	51	22	0	0	0	0	0	0	0	0
"MYCL1"	3624	6591	406	52	269	137	52	0	220	0	100	26	2288	912	2379	106	4046	1425
"MYCN"	2607	6447	0	0	0	0	0	0	0	0	0	0	0	0	0	0	0	0
"MYCNOS"	773	1827	0	0	0	0	0	0	0	0	0	0	0	0	0	0	0	0
"MYCT1"	3043	26685	0	0	0	0	0	0	0	0	0	0	0	0	0	0	0	0
"MYD88"	2876	4543	301	25	146	155	25	0	61	107	59	55	2443	2265	3685	3064	3249	2772
"MYEF2"	5418	38929	0	0	0	0	0	0	3	0	0	0	4	36	0	3	0	0
"MYEOV"	2383	3133	0	0	0	0	0	0	12	0	0	0	0	0	0	0	0	0
"MYEOV2"	764	9786	74	0	48	26	0	0	61	50	0	20	387	370	453	441	665	439
"MYF5"	1523	2741	0	0	0	0	0	0	0	0	0	0	0	0	0	0	0	0
"MYF6"	1297	1807	0	0	0	0	0	0	0	0	0	0	0	0	0	0	0	0
"MYH1"	6059	26233	0	0	0	0	0	0	0	0	0	0	0	0	0	0	0	0
"MYH10"	7753	156506	1533	2292	879	654	1111	1181	732	1156	166	1920	35	268	0	1	6	5
"MYH10 variant protein"	451	28027	0	0	0	0	0	0	0	0	0	0	0	0	0	0	0	0
"MYH11"	6983	153895	1192	135	712	480	63	72	863	337	550	176	512	450	492	324	696	393
"MYH13"	6033	72141	0	0	0	0	0	0	24	0	0	0	0	0	0	0	0	0
"MYH14"	6955	106918	0	2	0	0	2	0	208	113	0	0	0	3	0	0	0	0
"MYH15"	7116	148955	0	0	0	0	0	0	0	0	0	0	0	0	0	0	0	0
"MYH16"	2281	24670	1	0	1	0	0	0	22	0	0	0	0	1	0	0	0	0
"MYH2"	6122	28473	0	0	0	0	0	0	0	0	0	0	0	0	0	0	0	0
"MYH3"	6057	27624	0	0	0	0	0	0	17	0	0	0	10	10	6	8	40	13
"MYH4"	6053	26268	0	0	0	0	0	0	0	0	0	0	0	0	0	0	0	0
"MYH6"	5976	26285	0	0	0	0	0	0	205	76	0	0	0	0	0	0	0	0
"MYH7"	6069	22924	0	0	0	0	0	0	58	45	0	0	0	0	0	0	0	0
"MYH7B"	6332	27032	463	49	436	27	19	30	184	222	0	26	1355	3	0	0	0	0
"MYH8"	6078	31627	0	0	0	0	0	0	0	0	0	0	0	0	0	0	0	0
"MYH9"	7545	106741	24654	25236	13614	11040	12961	12275	7091	17827	16106	38127	23990	21370	26520	20548	37607	24594
"MYL1"	1058	25028	0	0	0	0	0	0	0	0	0	0	0	0	0	0	0	0
"MYL10"	1016	15972	0	0	0	0	0	0	37	0	0	0	0	0	0	0	0	0
"MYL12A"	1227	8702	785	1026	436	349	524	502	401	515	226	598	10554	9376	8609	10009	16210	11807
"MYL12B"	1027	15671	494	779	258	236	418	361	280	462	0	286	3615	6707	5985	4992	6435	4627
"MYL2"	834	9780	0	0	0	0	0	0	0	0	0	0	0	0	0	0	0	0
"MYL3"	936	5618	0	0	0	0	0	0	155	57	0	0	0	0	0	0	0	0
"MYL4"	915	14618	0	0	0	0	0	0	0	0	0	0	0	0	0	0	0	0
"MYL5"	2964	8449	6207	1988	3263	2944	1054	934	1873	1192	5081	3161	1342	1574	1862	1726	3025	1909
"MYL6"	1692	3169	893	0	1	892	0	0	0	907	604	2185	13691	17146	21368	23506	24897	19992
"MYL6B"	1302	3693	0	0	0	0	0	0	74	23	0	0	39	75	81	79	81	67
"MYL7"	602	2453	0	0	0	0	0	0	0	15	0	0	0	0	0	0	0	0
"MYL9"	1191	8331	16	11	11	5	11	0	14	87	0	170	727	436	726	888	720	714
"MYLIP"	3076	19161	2844	1438	1575	1269	744	694	1923	831	1028	182	1467	974	1266	764	2138	866
"MYLK"	7868	272006	113	0	72	41	0	0	237	9	0	0	93	66	63	3	74	4
"MYLK2"	2806	15324	0	0	0	0	0	0	46	9	0	4	0	0	0	0	0	0
"MYLK3"	8009	46027	0	0	0	0	0	0	34	12	0	0	2	0	0	0	0	0
"MYLK4"	5772	87292	17	0	8	9	0	0	86	0	0	0	57	39	12	4	4	4
"MYLPF"	662	3189	0	0	0	0	0	0	50	0	0	0	10	11	7	17	15	13
"MYNN"	3207	14484	312	138	150	162	44	94	201	78	0	54	573	601	603	448	570	317
"MYO10"	11470	274370	0	170	0	0	93	77	97	388	0	27	5	0	3	4	0	0
"MYO15A"	11927	71097	13	0	13	0	0	0	829	244	0	0	91	37	88	62	165	94
"MYO15B"	6182	27828	3937	1956	2225	1712	966	990	1605	1349	5985	4772	620	811	2282	2677	1974	1164
"MYO16"	7472	578787	0	0	0	0	0	0	0	10	0	0	0	0	0	0	0	0
"MYO18A"	7625	106881	16422	3636	7971	8451	1829	1807	6943	1880	18631	2568	5297	5742	11678	8202	18398	10779
"MYO18B"	8609	288889	4	0	0	4	0	0	75	26	0	0	0	0	0	0	0	0
"MYO19"	5448	39441	787	196	429	358	161	35	559	233	69	199	716	710	890	574	906	701
"MYO1A"	3648	21601	1	3	1	0	3	0	0	40	0	0	0	1	0	0	0	0
"MYO1B"	5126	180010	0	0	0	0	0	0	0	0	0	0	4	0	0	0	0	0
"MYO1C"	4982	28521	1555	1195	807	748	623	572	818	1159	992	1985	3945	2509	2449	3233	3676	2719
"MYO1D"	5204	384276	1882	622	1141	741	339	283	384	129	76	30	579	525	257	213	379	254
"MYO1E"	4742	236509	44516	62051	25080	19436	33314	28737	14595	28840	21544	53699	2382	2486	2577	2966	3980	3560
"MYO1F"	3852	56310	12180	3146	6757	5423	1732	1414	3857	1266	14191	3419	11047	8588	12343	9655	15665	10142
"MYO1F variant protein"	1693	31981	7317	2009	4278	3039	1102	907	2335	780	9049	2375	4592	3869	5539	4767	8276	4680
"MYO1G"	5536	12568	324	2560	208	116	1290	1270	178	1494	0	3033	284	759	381	817	417	438
"MYO1H"	4289	59654	54	0	21	33	0	0	86	41	0	9	9	10	4	6	0	0
"MYO3A"	5819	278465	0	0	0	0	0	0	24	10	0	0	0	0	0	0	0	0
"MYO3B"	5588	476330	0	0	0	0	0	0	0	0	0	0	0	0	0	0	0	0
"MYO5A"	12266	221769	13652	4498	7678	5974	2364	2134	7016	2458	3957	2219	4277	5129	5340	5331	5926	3593
"MYO5B"	9560	372297	99	0	57	42	0	0	307	12	0	0	2	2	0	0	0	0
"MYO5C"	6987	103453	0	0	0	0	0	0	46	9	0	16	3	0	0	0	0	0
"MYO6"	8697	170347	0	0	0	0	0	0	14	0	0	0	2	0	4	0	4	5
"MYO7A"	7514	86978	0	0	0	0	0	0	400	305	0	0	2	4	7	31	43	17
"MYO7B"	6761	101926	2	164	0	2	60	104	382	472	0	66	0	13	0	7	0	0
"MYO9A"	8887	157164	2032	855	1171	861	493	362	1664	773	304	607	595	1603	750	673	763	422
"MYO9B"	7662	137514	20640	8998	11398	9242	4837	4161	7433	5840	20089	13924	8359	8056	13973	13561	14933	11074
"MYO9B variant protein"	2188	6607	2899	1683	1549	1350	844	839	1099	763	2209	1134	4685	4204	7191	6823	7569	5753
"MYOC"	2046	17216	0	0	0	0	0	0	0	0	0	0	0	0	0	0	0	0
"MYOCD"	6964	101446	0	0	0	0	0	0	0	0	0	0	0	0	0	0	0	0
"MYOD1"	1808	2569	0	0	0	0	0	0	0	0	0	0	0	0	0	0	0	0
"MYOF"	6896	175889	8553	18459	4853	3700	9979	8480	3580	6559	2646	6506	5679	6414	6680	6056	9271	7223
"MYOG"	1745	3120	0	0	0	0	0	0	0	19	0	0	0	0	0	0	0	0
"MYOM1"	5884	153302	30	0	26	4	0	0	64	21	25	13	129	193	136	109	188	120
"MYOM2"	5047	100223	13	0	7	6	0	0	119	20	0	0	9	16	56	51	32	36
"MYOM3"	5836	56135	1	0	0	1	0	0	181	40	0	0	0	0	0	0	0	0
"MYOT"	2281	19996	3087	3451	1892	1195	1886	1565	2823	1836	857	3222	3589	3766	3462	3255	4795	3173
"MYOZ1"	1544	10102	0	0	0	0	0	0	11	0	0	0	10	5	23	24	13	14
"MYOZ2"	2594	51998	0	0	0	0	0	0	0	0	0	0	0	0	0	0	0	0
"MYOZ3"	3838	18523	0	0	0	0	0	0	0	0	0	0	0	0	0	0	0	0
"MYPN"	6030	102779	3	0	0	3	0	0	0	0	0	0	0	0	0	0	0	0
"MYPOP"	1888	12581	278	174	165	113	95	79	138	185	113	1225	179	429	55	297	344	317
"MYR12"	699	13673	1440	1057	870	570	585	472	894	482	397	517	565	416	526	388	423	391
"MYRIP"	4879	450503	81	95	47	34	54	41	437	143	0	263	1	0	1	0	2	0
"MYSM1"	4468	13971	4075	2292	1937	2138	1298	994	1308	1182	777	1720	572	847	711	628	561	255
"MYST1"	2457	5760	1355	544	749	606	321	223	455	310	763	531	1972	1307	1125	649	1350	667
"MYST2"	3947	39649	1201	478	628	573	246	232	911	292	438	508	868	740	1344	739	1501	899
"MYST3"	9302	122509	8633	5695	4825	3808	3069	2626	3720	3173	1887	4493	2127	1973	2357	1474	2681	1384
"MYST4"	8568	206262	5458	4561	3066	2392	2552	2009	2660	2135	928	3803	955	1111	1040	923	1097	659
"MYT1"	5556	77779	0	0	0	0	0	0	432	233	0	0	0	1	0	0	0	0
"MYT1L"	7165	542160	0	0	0	0	0	0	291	131	0	0	0	0	0	0	0	0
"MZF1"	2926	11659	2684	1490	1456	1228	784	706	992	618	2596	1599	875	829	1078	480	1554	859
"MacGAP"	3387	133131	42954	15293	17212	25742	10774	4519	24374	4710	20309	3592	5918	7556	6267	5791	6756	3659
"Magmas"	3073	67434	6979	1821	3735	3244	1018	803	2905	1747	5860	2721	3869	3637	4500	4141	6683	4521
"Mib"	958	1112	960	92	944	16	75	17	886	1	125	1	2638	2913	1713	1871	1661	180
"Mob3"	2780	36744	565	144	265	300	88	56	269	235	46	296	546	653	645	685	764	568
"N-TAF1"	2394	123768	1551	558	749	802	332	226	817	290	449	1180	1055	1331	883	633	1061	717
"N-Tes"	2943	501207	0	0	0	0	0	0	0	0	0	0	3	0	0	0	0	0
"N4BP1"	7111	71483	24354	47853	13495	10859	25961	21892	8650	22605	10257	40169	5871	13578	6164	13078	7323	9292
"N4BP2"	6921	98495	567	147	317	250	99	48	453	133	78	33	940	1380	793	888	620	325
"N4BP2L1"	3051	27456	1008	6836	516	492	3636	3200	569	3887	67	4443	558	4270	745	4925	656	2507
"N4BP2L2"	2844	21903	14954	12368	8397	6557	6876	5492	6911	4264	7521	7260	3610	4561	3142	2752	3676	2057
"N4BP3"	5992	12553	5	21	5	0	11	10	0	96	0	32	5	27	0	50	9	9
"N6AMT1"	4871	13182	0	0	0	0	0	0	18	0	0	0	26	0	28	23	30	16
"N6AMT2"	877	44986	0	0	0	0	0	0	22	0	0	0	14	18	29	34	32	30
"NAAA"	1873	27358	5450	691	2987	2463	328	363	2458	129	4212	487	8356	7653	6703	4613	8068	3672
"NAALAD2"	3206	57954	70	134	62	8	71	63	66	51	0	17	36	0	0	0	0	0
"NAALADL1"	2703	13714	0	0	0	0	0	0	59	15	0	0	161	8	174	0	47	114
"NAALADL2"	4924	946317	115	21	69	46	21	0	369	0	0	0	0	2	0	0	4	0
"NAB1"	4478	43645	3219	3227	1749	1470	1712	1515	1439	1822	745	2012	1390	2084	1533	1307	2099	1048
"NAB2"	2717	6583	2573	2609	1367	1206	327	2282	604	473	1502	5288	6592	1090	8234	8026	1571	8321
"NACA"	6639	13117	960	732	547	413	418	314	477	404	685	886	2771	3122	7334	6966	7687	5425
"NACA2"	771	771	0	0	0	0	0	0	0	0	0	0	721	821	0	0	0	0
"NACAD"	4768	8458	0	0	0	0	0	0	38	0	0	0	0	0	0	0	0	0
"NACAP1"	704	704	0	0	0	0	0	0	0	0	0	0	242	0	0	0	1202	0
"NACC1"	4496	22851	1691	274	954	737	114	160	802	620	1491	1240	2138	1657	2507	1671	3242	2008
"NACC2"	2083	83928	2445	187	1473	972	131	56	1468	710	2458	1018	64	81	221	226	269	169
"NADC3"	3907	93637	0	0	0	0	0	0	59	0	0	0	0	0	0	0	0	0
"NADK"	3660	28832	1847	1554	1022	825	849	705	922	959	1350	2748	1735	1514	1293	1208	3627	855
"NADSYN1"	3644	46425	2434	760	1309	1125	385	375	1537	730	905	1023	1992	1832	2024	1705	2844	1578
"NAE1"	1931	28099	245	0	134	111	0	0	124	47	0	9	613	605	612	411	676	433
"NAF1"	3305	51491	17822	64163	9821	8001	29367	34796	2292	242	3312	99065	2665	7819	3525	15458	4242	5658
"NAG"	7137	394424	2498	1306	1420	1078	778	528	2643	1284	414	1020	1036	1198	1358	1238	1545	911
"NAG-7"	2114	2114	0	0	0	0	0	0	0	0	0	0	0	0	0	0	0	0
"NAG11"	3218	35379	329	275	180	149	109	166	141	94	97	122	4	4	63	7	46	1
"NAG8"	2570	2570	540	520	310	230	243	277	363	409	137	399	0	0	0	0	0	0
"NAGA"	3734	12509	2925	636	1628	1297	346	290	1135	363	2481	501	12147	2716	3666	2564	4907	9163
"NAGK"	2998	9991	5250	1356	2892	2358	723	633	1869	302	3122	736	3745	2816	6136	3276	10176	5317
"NAGLU"	2786	8515	395	13	187	208	0	13	247	35	534	64	1079	581	1638	1170	1819	1327
"NAGPA"	2315	9092	1983	258	1080	903	159	99	731	215	1440	262	4246	2316	4733	2873	6675	3047
"NAGS"	2102	4405	0	0	0	0	0	0	33	0	0	0	96	4	69	0	110	15
"NAIF1"	3399	6088	10	0	0	10	0	0	54	9	0	0	363	175	352	109	393	199
"NAIP"	6568	56633	1452	453	795	657	251	202	866	205	848	368	3342	4050	13762	9552	13573	7271
"NALCN"	6967	362685	0	0	0	0	0	0	12	9	0	0	0	0	0	0	0	0
"NALP12"	3525	30793	0	0	0	0	0	0	14	0	0	0	0	3	13	12	4	0
"NAMPT"	4590	36906	3263	25202	1802	1461	8726	16476	158	6101	0	12602	660	12923	1307	8772	1140	2823
"NANOG"	2102	6662	0	0	0	0	0	0	0	0	0	0	0	0	0	0	0	0
"NANOGP1"	1180	26364	0	0	0	0	0	0	0	0	0	0	0	0	0	0	0	0
"NANOS1"	4628	4628	63	240	27	36	149	91	122	0	0	60	0	2447	0	0	0	0
"NANOS2"	1563	1563	0	0	0	0	0	0	21	0	0	0	0	0	0	0	0	0
"NANOS3"	947	3622	0	0	0	0	0	0	83	15	0	0	0	0	0	0	0	0
"NANP"	3799	11075	11	0	0	11	0	0	35	56	0	0	310	235	376	310	370	232
"NANS"	1756	37477	1360	1069	780	580	574	495	630	681	401	288	581	826	2464	1543	2072	919
"NAP1L1"	5140	40068	3664	4040	2075	1589	2289	1751	1615	2057	1382	3497	2984	2943	5419	5035	7198	5019
"NAP1L2"	2531	2531	0	0	0	0	0	0	0	0	0	0	0	0	0	0	0	0
"NAP1L3"	2681	2681	0	0	0	0	0	0	0	0	0	0	0	0	0	0	0	0
"NAP1L4"	2638	47948	2970	1073	1627	1343	593	480	1650	537	890	1298	1236	1199	1599	1014	1925	1116
"NAP1L5"	1954	1954	190	23	106	84	23	0	186	33	117	98	9	15	0	9	0	0
"NAP1L6"	2045	2045	0	0	0	0	0	0	0	0	0	0	0	0	0	0	0	0
"NAP5"	1922	496873	334	357	194	140	176	181	205	102	0	0	0	0	4	3	8	0
"NAPA"	1853	27608	2278	2092	1121	1157	1135	957	990	1072	1478	1849	2538	2291	4310	3759	4498	3676
"NAPB"	3893	47001	805	0	426	379	0	0	776	0	193	41	205	130	256	105	67	101
"NAPEPLD"	5368	49548	162	0	87	75	0	0	268	0	0	0	508	473	360	248	393	150
"NAPG"	3871	13643	995	941	493	502	578	363	598	441	175	914	897	1063	826	768	785	513
"NAPOR-1"	4910	167158	42840	25079	23933	18907	13633	11446	17244	12122	23684	17865	4332	5149	4333	3209	5398	3446
"NAPRT1"	1887	3559	266	128	149	117	86	42	131	111	253	85	1029	699	1105	1017	1103	397
"NAPSA"	1400	7198	8	0	0	8	0	0	26	0	0	0	0	0	11	17	28	0
"NAPSB"	1337	10948	342	27	185	157	10	17	127	58	79	5	374	418	629	427	711	344
"NARF"	2114	26288	1014	201	534	480	110	91	539	179	196	71	707	664	784	838	1051	851
"NARFL"	3217	11165	338	29	172	166	13	16	347	155	185	117	532	360	502	347	700	365
"NARG1"	5574	89261	2426	4128	1443	983	2226	1902	1322	2662	356	3956	1402	1747	1606	1462	1619	1297
"NARG1L"	4367	65827	721	32	468	253	20	12	541	5	6	6	403	341	493	250	468	178
"NARG2"	7224	59537	326	0	184	142	0	0	504	13	0	17	559	626	712	491	699	438
"NARS"	2879	21285	1063	379	620	443	235	144	331	143	437	297	3168	4787	4008	3484	4228	2007
"NARS2"	2523	138894	130	0	68	62	0	0	220	9	15	5	286	337	327	302	344	248
"NASP"	3422	7455	846	288	461	385	148	140	473	139	112	173	650	755	1043	904	1640	835
"NAT1"	2337	13581	10	91	10	0	74	17	0	54	0	0	276	673	291	354	374	332
"NAT10"	4069	41348	228	147	142	86	104	43	484	210	135	219	632	615	822	844	925	805
"NAT11"	3407	17637	976	291	558	418	154	137	517	103	602	109	1023	1189	888	501	1565	777
"NAT12"	4481	22198	178	49	71	107	23	26	170	42	0	0	537	517	574	397	668	355
"NAT13"	3581	27257	2879	1951	1661	1218	1084	867	1236	1133	841	2192	406	601	444	328	423	287
"NAT14"	1316	2343	0	0	0	0	0	0	44	0	0	0	13	0	28	17	32	10
"NAT15"	2685	43296	2115	968	1135	980	471	497	1240	828	1480	1653	1501	1110	1720	1472	2448	1557
"NAT2"	1319	9970	0	0	0	0	0	0	11	0	0	0	0	0	0	0	0	0
"NAT5"	1084	16333	1097	732	552	545	386	346	522	360	381	334	1580	1730	1892	1412	1923	1385
"NAT6"	1890	3018	39	0	27	12	0	0	187	78	0	0	123	104	61	35	104	101
"NAT8"	1075	1689	0	0	0	0	0	0	0	0	0	0	0	0	0	0	0	0
"NAT8B"	829	833	0	0	0	0	0	0	0	0	0	0	17	0	28	0	0	0
"NAT8L"	2345	6050	0	0	0	0	0	0	0	0	0	0	64	22	193	172	115	87
"NAT9"	1879	5783	226	15	131	95	0	15	98	64	68	66	154	285	593	374	764	115
"NAV1"	13038	178649	106	120	50	56	84	36	588	389	60	174	645	638	410	334	486	227
"NAV2"	11031	408267	0	0	0	0	0	0	157	11	0	0	0	0	0	0	0	0
"NAV3"	9862	381721	0	0	0	0	0	0	0	0	0	0	0	0	0	0	0	0
"NBAS"	7334	394424	2498	1306	1420	1078	778	528	2643	1284	414	1020	1036	1198	1358	1238	1545	911
"NBC4"	5146	151823	1442	2201	804	638	1194	1007	604	1139	313	3094	4382	7970	4012	5990	4792	5084
"NBEA"	10840	730418	148	129	102	46	83	46	280	24	0	42	60	186	41	63	73	3
"NBEAL1"	9113	203117	280	796	135	145	452	344	254	927	39	531	1209	1461	2415	2301	3042	2104
"NBEAL2"	8881	30022	2902	1506	1664	1238	829	677	1907	933	3860	1437	1879	1994	3563	3564	4079	2576
"NBL1"	2092	14698	2465	3996	1458	1007	2090	1906	1016	2383	1154	3752	2078	2814	1327	2029	1962	1336
"NBN"	4688	51337	768	3031	437	331	1605	1426	509	1319	58	2033	1364	2933	1300	2177	1277	1341
"NBPF1"	4651	25193	80590	77126	46787	33803	41873	35253	25260	50494	18648	47485	59223	26466	81718	48704	90890	36916
"NBPF10"	11006	75313	5839	10466	3358	2481	5983	4483	3720	8153	2926	10513	1995	3030	14184	20474	19464	12524
"NBPF11"	4915	35711	68377	70540	39984	28393	38194	32346	17182	45121	12895	40557	5093	7159	13866	20151	14453	12062
"NBPF12"	2801	95818	22	4	11	11	0	4	51	29	0	0	62	106	1188	1717	2002	943
"NBPF14"	3725	22222	68841	71123	40234	28607	38504	32619	17944	45913	12985	41425	5900	8139	22343	29075	26919	18185
"NBPF15"	4291	35422	518	1419	387	131	1012	407	487	934	197	1081	468	607	6967	12156	9873	6081
"NBPF16"	3847	18871	83	20	32	51	20	0	14	18	0	0	73	31	109	296	153	67
"NBPF20"	3065	213972	470	1400	368	102	992	408	463	928	197	1081	387	548	6857	11937	9725	5951
"NBPF22P"	2685	15102	0	0	0	0	0	0	0	0	0	0	0	0	0	0	0	0
"NBPF3"	4312	44763	0	0	0	0	0	0	0	0	0	0	0	0	22	0	0	0
"NBPF4"	2514	20742	0	0	0	0	0	0	0	0	0	0	0	0	0	0	0	0
"NBPF6"	2237	20357	0	0	0	0	0	0	0	0	0	0	0	0	0	0	0	0
"NBPF7"	1894	10392	0	0	0	0	0	0	0	0	0	0	0	0	0	0	0	0
"NBPF8"	3837	774280	68797	71016	40265	28532	38447	32569	17986	45869	13049	41253	5667	8309	18549	25873	21681	14712
"NBR1"	4994	41197	1141	815	654	487	438	377	660	11360	163	1095	5037	5706	5132	4483	5888	4216
"NBR2"	2104	14742	690	200	403	287	118	82	606	244	200	135	392	569	51	49	126	28
"NCALD"	3814	438366	41	0	17	24	0	0	48	0	9	37	0	14	0	0	5	7
"NCAM1"	5978	317164	0	0	0	0	0	0	32	11	0	0	8	23	0	3	0	0
"NCAM2"	3717	540583	0	0	0	0	0	0	0	0	0	0	0	0	0	0	0	0
"NCAN"	6420	40280	1	0	0	1	0	0	107	67	0	0	0	1	0	0	0	0
"NCAPD2"	4838	37836	2600	1606	1441	1159	7	1599	582	61	149	776	1569	1743	1503	1102	1826	1139
"NCAPD3"	5782	72091	521	149	291	230	67	82	493	81	169	97	713	693	793	660	1027	591
"NCAPG"	4682	33962	92	23	38	54	9	14	181	37	0	0	0	0	313	194	385	247
"NCAPG2"	5312	65034	6	100	0	6	0	100	57	7	0	34	210	321	231	177	270	176
"NCAPH"	4763	39792	5359	360	2958	2401	203	157	2302	87	2426	50	6078	3051	6130	3164	6591	3412
"NCAPH2"	2123	15257	578	2173	44	534	1160	1013	461	3564	84	6792	1211	8995	1648	6190	1796	2637
"NCBP1"	5401	40324	3435	1760	1674	1761	1011	749	2080	1115	1027	1507	1688	1701	1670	1318	1791	1141
"NCBP2"	2477	7005	1039	778	555	484	389	389	402	380	524	589	2915	3180	2802	1105	3439	2491
"NCCRP1"	1979	4920	0	0	0	0	0	0	13	0	0	0	52	72	0	0	49	0
"NCDN"	3710	8987	19	0	0	19	0	0	120	33	57	29	405	361	507	342	671	434
"NCE2"	1617	74978	5411	321	3003	2408	174	147	2980	184	2184	315	1549	1465	2735	2064	3118	1984
"NCEH1"	4319	80574	648	0	313	335	0	0	1108	21	0	0	164	1387	568	3474	2190	1961
"NCF1"	1408	15351	998	3857	521	477	2059	1798	46	2002	112	4167	843	4334	3314	15754	1942	5473
"NCF1C"	1348	15315	281	711	166	115	390	321	17	292	0	559	211	1253	2116	11582	1319	4545
"NCF2"	2426	35043	21737	21232	12130	9607	11402	9830	7176	12500	13156	13807	15541	29012	23960	19560	32082	19963
"NCF4"	1651	17030	330	21	177	153	21	0	417	116	87	0	476	535	1083	832	777	542
"NCK1"	1917	86896	4411	1214	2535	1876	674	540	2024	560	445	1237	1936	1863	2019	1725	2570	2002
"NCK2"	2684	149374	1683	3934	892	791	2165	1769	1064	3616	188	9021	326	377	513	498	592	481
"NCKAP1"	4663	113625	0	0	0	0	0	0	0	0	0	0	30	43	22	11	52	16
"NCKAP1L"	3978	45405	13795	3120	7731	6064	1656	1464	5341	1220	7414	1640	19184	17780	18992	16043	22110	13824
"NCKAP5"	7613	896660	347	357	207	140	176	181	226	132	0	0	0	0	4	3	19	12
"NCKAP5L"	4913	37281	2253	79	1308	945	52	27	1321	181	1296	63	1247	821	1467	926	2101	1081
"NCKIPSD"	2973	12056	1117	133	597	520	79	54	344	85	76	35	1283	969	893	914	1039	837
"NCL"	2730	9747	1101	1159	726	375	705	454	395	887	27	376	5889	6514	9388	9400	10063	6092
"NCLN"	3747	23699	766	87	474	292	52	35	529	201	775	36	1504	1168	2399	1962	2350	1900
"NCLX"	2302	20560	4823	2845	2787	2036	1502	1343	1465	1642	2624	3720	2697	2824	6104	2679	3306	2193
"NCOA1"	7094	206391	3067	1199	1826	1241	608	591	2537	964	588	986	1723	1780	1841	1673	2051	1370
"NCOA2"	6180	291755	8427	2122	4726	3701	1337	785	5954	2464	1093	2288	1314	721	840	692	839	363
"NCOA3"	7954	154957	18281	24307	10094	8187	13114	11193	6611	11491	8289	21428	8128	10118	3974	3174	4829	2804
"NCOA4"	3749	25627	1270	2730	706	564	1482	1248	759	1711	136	2676	2974	12418	9983	22009	10137	11961
"NCOA5"	3587	18966	4379	4612	2519	1860	2474	2138	1681	1896	1777	3261	2179	2793	2059	2453	2842	1845
"NCOA6"	9326	106865	4184	988	2294	1890	540	448	2299	668	980	472	1855	1587	1983	1274	2612	1444
"NCOA7"	5645	149940	7439	3816	4236	3203	2083	1733	2984	1431	937	1077	1508	4853	1838	1632	1358	1029
"NCOR1"	7960	183588	6674	2484	3831	2843	1395	1089	4418	1579	1677	1828	3088	3451	4583	3930	4662	3078
"NCOR2"	8765	211197	52899	45942	29109	23790	24230	21712	18246	25851	46382	61296	5934	7940	8601	8287	12727	8717
"NCR1"	1160	6933	55	0	18	37	0	0	0	0	0	0	0	31	0	0	6	0
"NCR2"	1090	15099	0	0	0	0	0	0	30	14	0	0	0	0	0	0	0	0
"NCR3"	1113	4104	16	0	10	6	0	0	34	11	0	0	3132	2874	1588	1599	2600	1878
"NCRMS"	2108	68747	0	0	0	0	0	0	0	0	0	0	0	0	0	0	0	0
"NCRNA00028"	591	1798	0	0	0	0	0	0	0	0	0	0	0	0	0	0	0	0
"NCRNA00029"	1752	2812	0	0	0	0	0	0	0	0	0	0	0	0	0	0	0	0
"NCRNA00051"	1047	10647	0	0	0	0	0	0	30	0	0	0	0	0	0	0	0	0
"NCRNA00052"	1789	2759	0	0	0	0	0	0	0	0	0	0	0	0	0	0	0	0
"NCRNA00081"	2373	20638	1250	452	674	576	239	213	605	257	94	216	270	287	1010	788	1351	875
"NCRNA00085"	1075	1896	0	0	0	0	0	0	31	14	0	0	0	0	4	0	0	0
"NCRNA00086"	3457	4358	0	0	0	0	0	0	0	0	0	0	0	0	0	0	0	0
"NCRNA00087"	2810	3720	0	0	0	0	0	0	0	0	0	0	0	0	0	0	0	0
"NCRNA00092"	1721	2023	0	0	0	0	0	0	0	0	0	0	0	0	0	0	0	0
"NCRNA00093"	2656	31791	53	15	13	40	7	8	83	0	0	0	103	96	147	98	106	81
"NCRNA00094"	5736	6159	59	5	20	39	0	5	37	16	0	0	120	76	75	52	140	379
"NCRNA00095"	3952	3952	230	71	126	104	58	13	111	74	155	96	180	146	62	43	132	63
"NCRNA00099"	9849	9849	0	0	0	0	0	0	0	0	0	0	0	0	0	0	0	0
"NCRNA00107"	669	669	0	0	0	0	0	0	0	0	0	0	0	0	0	0	0	0
"NCRNA00111"	457	18036	0	0	0	0	0	0	63	11	0	0	0	0	0	0	0	0
"NCRNA00113"	528	28856	0	0	0	0	0	0	0	0	0	0	0	0	0	0	0	0
"NCRNA00116"	1626	11412	1	0	1	0	0	0	4	0	0	0	155	94	222	182	265	167
"NCRNA00119"	2501	151866	0	0	0	0	0	0	0	0	0	0	0	0	0	0	0	0
"NCRNA00152"	808	66056	3022	11417	1646	1376	6247	5170	1191	4805	1210	9169	228	651	475	1035	424	402
"NCRNA00157"	464	49938	0	0	0	0	0	0	0	0	0	0	0	0	0	0	0	0
"NCRNA00158"	1480	45881	0	0	0	0	0	0	0	22	0	0	0	0	0	0	0	0
"NCRNA00159"	394	76189	0	0	0	0	0	0	17	0	0	0	0	0	0	0	0	0
"NCRNA00160"	700	13376	0	0	0	0	0	0	0	0	0	0	0	0	0	0	0	0
"NCRNA00162"	729	5515	1	0	0	1	0	0	94	0	0	0	1	0	0	0	0	0
"NCRNA00164"	1734	14363	159415	168277	89673	69742	88233	80044	24272	49932	65429	57403	1172	1448	0	0	0	0
"NCRNA00167"	2864	2864	4	0	0	4	0	0	8	0	0	0	2	6	6	2	2	1
"NCRNA00168"	651	30361	0	0	0	0	0	0	90	15	0	0	0	0	0	0	0	0
"NCRNA00169"	2307	17744	758	53	457	301	38	15	167	9	194	0	17	10	0	0	0	0
"NCRNA00171"	3303	6590	53	0	35	18	0	0	93	0	0	0	62	114	83	106	114	90
"NCRNA00173"	1599	2101	0	0	0	0	0	0	0	0	0	0	0	0	0	0	0	0
"NCRNA00174"	4428	24365	73	16	40	33	16	0	52	29	0	22	41	69	12	46	121	7
"NCRNA00176"	5267	5619	54	0	31	23	0	0	52	50	0	0	0	0	0	0	0	0
"NCRNA00181"	2133	3214	140	58	61	79	23	35	116	56	104	35	152	233	241	216	397	294
"NCRNA00185"	1496	5728	0	0	0	0	0	0	0	0	0	0	0	16	11	3	0	0
"NCRNA00200"	2437	4906	0	0	0	0	0	0	0	0	0	0	0	0	0	0	0	0
"NCRNA00201"	5046	6304	3564	11268	6	3558	6105	5163	4424	2	303	1684	2	10810	1658	1039	1997	1262
"NCRNA00202"	3625	10797	0	0	0	0	0	0	12	0	0	0	0	0	0	0	0	0
"NCRNA00203"	4681	4681	3872	234	2366	1506	140	94	622	110	3178	226	0	0	0	0	0	0
"NCRNA00204"	709	709	0	0	0	0	0	0	0	0	0	0	0	0	0	0	0	0
"NCSTN"	3091	15680	2373	733	1314	1059	409	324	804	504	1128	733	6540	5597	8035	6477	9468	6235
"NDC80"	2188	45125	2	0	0	2	0	0	12	0	0	0	0	0	0	0	3	0
"NDE1"	3942	83084	2214	311	1304	910	161	150	1211	822	1082	713	892	896	826	735	1085	865
"NDEL1"	2410	32294	3348	5909	1862	1486	3139	2770	1233	2812	1619	5426	1191	2155	1393	2644	1791	2159
"NDFIP1"	3603	45684	4176	1392	2388	1788	757	635	1909	811	1508	788	4149	4995	5314	4491	6180	4127
"NDFIP2"	4656	74948	0	0	0	0	0	0	0	12	0	13	198	307	248	233	246	148
"NDN"	1890	1890	0	0	0	0	0	0	0	0	0	0	42	22	0	0	22	0
"NDNL2"	1660	1660	0	0	0	0	0	0	0	0	0	0	432	297	505	307	538	295
"NDOR1"	4890	13695	1164	164	617	547	83	81	659	413	907	425	700	669	1187	853	1627	930
"NDP"	2005	24899	0	704	0	0	361	343	0	185	0	1587	89	761	92	281	20	142
"NDRG1"	3996	19059	2244	887	1197	1047	473	414	1533	921	845	1033	3828	4445	3697	3871	5198	3462
"NDRG2"	2240	8264	2534	376	1422	1112	187	189	592	129	2216	410	5868	3128	3311	2443	8606	4476
"NDRG3"	2979	94313	101	9	12	89	5	4	194	3	0	0	1382	1439	1030	895	1156	880
"NDRG4"	3575	49530	0	23	0	0	12	11	72	57	0	0	0	0	0	0	0	0
"NDST1"	8044	50100	2924	271	1539	1385	136	135	1770	312	1873	123	2832	2729	4144	3248	4674	3002
"NDST2"	4011	9922	1277	399	680	597	249	150	487	381	483	624	1159	942	1632	1051	2239	989
"NDST3"	5958	224288	0	0	0	0	0	0	0	0	0	0	0	0	0	0	0	0
"NDST4"	3353	286103	0	0	0	0	0	0	8	0	0	0	0	0	0	0	0	0
"NDUFA1"	488	4896	42	12	31	11	12	0	11	7	0	0	2013	2462	1591	2323	1929	2350
"NDUFA10"	3775	13665	4721	1307	2635	2086	666	641	2437	1313	2002	2352	1134	1170	1281	1272	1485	1013
"NDUFA11"	2638	12740	361	15	219	142	15	0	258	126	308	75	814	651	1151	1048	1455	1074
"NDUFA12"	601	32401	274	39	160	114	12	27	252	22	0	33	256	306	685	310	0	0
"NDUFA13"	3245	19415	625	301	357	268	146	155	416	548	357	844	929	1035	1625	2047	2032	1881
"NDUFA2"	588	2283	0	0	0	0	0	0	17	11	0	0	641	619	623	579	929	579
"NDUFA3"	465	4122	102	0	62	40	0	0	75	0	104	43	648	514	0	674	265	547
"NDUFA4"	827	7000	158	9	87	71	0	9	114	38	0	22	2088	75	1962	1823	3157	2189
"NDUFA4L2"	1643	3456	0	0	0	0	0	0	67	53	0	0	1144	0	0	0	0	582
"NDUFA5"	2886	3211	99	11	45	54	0	11	52	19	0	13	1035	1303	211	938	277	926
"NDUFA6"	1186	5359	234	96	77	157	70	26	109	176	57	178	1307	1554	1440	938	1801	1367
"NDUFA7"	539	10048	76	3	44	32	3	0	207	109	81	24	281	201	206	211	290	188
"NDUFA8"	845	15760	33	11	19	14	6	5	47	0	0	0	0	0	549	695	849	485
"NDUFA9"	1278	38116	476	50	231	245	50	0	542	104	0	110	801	786	1432	1320	1611	1207
"NDUFAB1"	669	15303	366	27	186	180	27	0	191	74	166	82	758	730	700	623	813	597
"NDUFAF1"	1715	15091	27	0	10	17	0	0	26	9	82	0	492	471	537	451	603	465
"NDUFAF2"	722	207909	207	209	115	92	109	100	268	122	0	103	98	0	83	62	56	49
"NDUFAF3"	1383	1852	346	110	203	143	54	56	950	174	274	431	1657	1592	1180	1201	1500	962
"NDUFAF4"	1461	7629	28	0	0	28	0	0	25	7	0	0	438	48	434	261	250	348
"NDUFB1"	420	5685	320	0	196	124	0	0	186	70	131	47	725	560	384	357	1014	371
"NDUFB10"	860	2461	23	0	16	7	0	0	56	331	0	0	970	649	1208	1053	1566	765
"NDUFB11"	1126	2995	8	36	8	0	36	0	20	0	0	0	456	365	638	359	1004	781
"NDUFB2"	692	9965	307	172	171	136	98	74	186	76	117	195	1365	1515	1646	1268	2211	1073
"NDUFB3"	756	14011	7	0	0	7	0	0	12	0	0	0	213	193	529	470	516	476
"NDUFB4"	1474	6044	465	187	252	213	80	107	205	154	81	176	1461	1206	1088	827	1979	804
"NDUFB5"	1083	19714	635	69	355	280	35	34	377	35	0	183	2587	2486	1936	1601	2496	1703
"NDUFB6"	866	19661	58	151	46	12	84	67	64	123	0	50	150	282	541	430	169	230
"NDUFB7"	544	5996	89	24	58	31	11	13	133	44	139	0	572	327	466	539	459	596
"NDUFB8"	1263	22456	590	112	339	251	52	60	417	113	478	137	1234	1120	1545	1191	1736	1254
"NDUFB9"	1361	29410	419	189	247	172	145	44	486	255	26	204	2284	1666	815	912	1423	1212
"NDUFC1"	814	11268	337	162	269	68	93	69	110	485	0	984	645	785	459	534	602	607
"NDUFC2"	2471	11867	40	0	0	40	0	0	86	27	14	0	571	858	330	289	414	228
"NDUFS1"	3435	36385	1447	302	797	650	154	148	678	263	543	456	3630	3608	2037	1967	2038	1430
"NDUFS2"	2069	12205	507	117	277	230	67	50	203	76	141	30	2906	2475	2519	1914	3426	1814
"NDUFS3"	1331	2840	180	0	96	84	0	0	244	52	148	24	1174	1061	1334	844	2235	1072
"NDUFS4"	681	122708	3636	2517	2152	1484	1378	1139	2170	1693	422	2765	290	497	611	596	728	565
"NDUFS5"	513	8282	26	0	0	26	0	0	26	0	0	48	0	399	1912	1435	0	1522
"NDUFS6"	535	14656	1699	623	926	773	334	289	719	420	751	1187	689	862	559	643	943	496
"NDUFS7"	3262	11878	409	21	231	178	0	21	339	103	493	158	925	661	874	535	1727	1010
"NDUFS8"	931	3105	416	60	225	191	26	34	252	86	167	61	697	619	999	592	1308	663
"NDUFV1"	1641	5691	1030	410	563	467	206	204	336	228	827	376	2722	2141	3191	2088	3800	2295
"NDUFV2"	884	31663	5811	5406	3214	2597	2948	2458	2402	2103	1902	5328	1362	1982	1322	1549	1978	1531
"NDUFV3"	2133	16396	1983	632	1098	885	353	279	843	273	1548	1348	2014	1335	890	667	1708	912
"NEAT1"	17358	17358	173013	221042	95697	77316	118637	102405	77858	100518	114046	138192	4564	8088	11926	18061	11540	10329
"NEB"	20733	249136	286	1126	127	159	674	452	344	397	0	228	19	92	16	36	54	28
"NEBL"	9961	117628	0	0	0	0	0	0	8	0	0	0	0	0	0	0	0	0
"NECAB1"	5152	167710	12	14	12	0	1	13	5	0	0	0	0	10	0	0	3	0
"NECAB2"	1617	34142	0	0	0	0	0	0	237	62	0	4	1	0	0	0	0	0
"NECAB3"	2050	17372	454	42	244	210	7	35	272	113	370	110	246	334	265	333	580	373
"NECAP1"	2601	15568	543	369	304	239	221	148	331	241	136	480	1026	1236	1029	1345	1185	944
"NECAP2"	2087	19417	3427	2554	1850	1577	1401	1153	1285	1295	2369	2972	6218	6926	6776	6214	8402	5968
"NEDD1"	3968	46462	315	203	206	109	99	104	343	231	0	21	576	620	548	457	720	402
"NEDD4"	7249	90200	0	0	0	0	0	0	0	0	0	0	36	32	9	15	7	0
"NEDD4L"	8504	357155	11	518	0	11	261	257	62	820	25	1024	11	15	36	79	134	132
"NEDD8"	2318	5767	186	0	125	61	0	0	297	0	38	34	22	19	898	869	1021	1540
"NEDD9"	4986	199052	216	166	126	90	71	95	681	667	59	551	91	187	171	476	274	356
"NEDL3"	168	120166	0	220	0	0	128	92	27	561	0	194	0	0	0	0	0	0
"NEFH"	3721	11096	0	0	0	0	0	0	15	0	0	0	375	323	290	291	289	192
"NEFL"	3591	5662	0	0	0	0	0	0	0	0	0	0	0	0	0	0	0	0
"NEFM"	3273	5333	0	0	0	0	0	0	0	0	0	0	0	0	0	0	0	0
"NEGR1"	5803	879781	0	0	0	0	0	0	0	0	0	0	876	956	705	0	962	0
"NEIL1"	1900	8257	371	419	205	166	202	217	168	315	488	346	67	97	138	296	118	373
"NEIL2"	2751	17684	0	0	0	0	0	0	84	11	2	0	127	75	88	41	128	68
"NEIL3"	2412	53103	0	0	0	0	0	0	11	0	0	0	0	0	0	0	0	0
"NEK1"	5662	219306	53	0	47	6	0	0	153	2	10	0	170	238	243	149	228	106
"NEK10"	2663	153816	7	0	4	3	0	0	9	0	0	14	0	0	0	0	0	0
"NEK11"	2976	323616	7402	2610	4237	3165	1447	1163	2675	1021	1929	1696	119	83	0	0	40	0
"NEK2"	2138	12847	0	0	0	0	0	0	0	0	0	0	0	0	0	0	0	0
"NEK3"	3276	24842	396	189	218	178	117	72	181	35	255	201	287	284	335	247	338	187
"NEK4"	3721	60150	59	0	43	16	0	0	152	3	12	8	488	336	563	366	434	263
"NEK5"	2930	64314	2	0	0	2	0	0	0	0	0	0	0	0	0	7	9	4
"NEK6"	2765	94481	33140	24782	18087	15053	12974	11808	10767	19051	31090	54538	11830	12261	17290	15641	16671	10951
"NEK7"	4140	165440	15662	17949	8775	6887	9833	8116	6507	7079	3129	10387	3077	4264	2828	2808	3001	2047
"NEK8"	2871	13952	19	1	6	13	0	1	94	33	1	0	1	10	16	23	7	3
"NEK9"	5564	44961	1787	619	1099	688	327	292	613	212	697	387	1550	3657	4119	3111	5006	3171
"NELF"	3662	11763	258	131	138	120	70	61	297	270	377	284	843	826	1260	1455	1838	1261
"NELL1"	3350	906112	0	0	0	0	0	0	0	0	0	0	0	0	0	0	0	0
"NELL2"	3725	368191	0	0	0	0	0	0	0	0	0	0	0	0	0	3	4	0
"NENF"	951	13492	39	0	39	0	0	0	15	0	39	0	623	568	778	720	921	633
"NEO1"	7063	252670	0	0	0	0	0	0	0	0	0	0	2	4	0	0	0	14
"NES"	5560	8634	0	0	0	0	0	0	74	36	0	0	56	113	8	0	194	174
"NESG1"	1856	20941	0	0	0	0	0	0	12	0	0	0	0	0	0	0	0	0
"NET1"	3408	45908	2293	250	1250	1043	148	102	1243	95	494	65	4663	2056	4152	1148	8281	2449
"NETO1"	2524	120025	0	0	0	0	0	0	0	0	0	0	0	0	0	0	0	0
"NETO2"	3662	62468	3168	17729	1711	1457	9649	8080	1046	7827	280	7462	1534	4315	1123	2673	1518	1697
"NEU1"	2182	3719	179	162	94	85	109	53	142	131	0	77	1539	1822	3424	848	1348	2285
"NEU2"	1144	2386	0	0	0	0	0	0	0	0	0	0	0	0	0	0	0	0
"NEU3"	3084	19419	1958	1834	1078	880	1035	799	761	1111	552	2202	1352	2035	808	827	1008	508
"NEU4"	2488	6663	0	1	0	0	0	1	80	47	0	0	0	0	0	0	0	0
"NEURL"	4320	98575	0	0	0	0	0	0	273	98	0	0	13	1	5	0	5	0
"NEURL1B"	6410	50257	0	0	0	0	0	0	70	43	0	0	0	0	0	0	0	449
"NEURL2"	1261	2636	0	0	0	0	0	0	0	28	8	0	0	0	13	0	30	10
"NEURL3"	1726	7711	3	139	3	0	65	74	22	79	0	0	0	171	0	51	0	0
"NEURL4"	5216	13689	402	79	252	150	41	38	302	249	424	94	484	657	897	679	1370	742
"NEUROD1"	2631	4188	0	0	0	0	0	0	0	0	0	0	0	0	0	0	0	0
"NEUROD2"	3033	4155	0	0	0	0	0	0	11	0	0	0	0	0	0	0	0	0
"NEUROD4"	3957	10073	0	0	0	0	0	0	0	0	0	0	0	0	0	0	0	0
"NEUROD6"	2156	3458	0	0	0	0	0	0	0	0	0	0	0	0	0	0	0	0
"NEUROG1"	1661	1661	0	0	0	0	0	0	0	0	0	0	0	0	0	0	0	0
"NEUROG2"	2287	2656	0	0	0	0	0	0	0	0	0	0	0	0	0	0	0	0
"NEUROG3"	1168	1332	0	0	0	0	0	0	0	0	0	0	0	0	0	0	0	0
"NEXN"	3400	55378	179	119	116	63	86	33	188	108	0	119	0	0	0	0	3	0
"NF1"	12432	282701	7497	4044	4172	3325	2185	1859	3919	2332	1490	2608	16978	16493	15941	11528	18471	12113
"NF2"	6202	95040	1552	77	845	707	44	33	1339	184	179	206	1278	1034	1319	830	1503	929
"NFAM1"	5609	51988	390	110	204	186	62	48	1018	693	567	1051	219	218	2345	2811	3932	2888
"NFASC"	10363	194169	0	0	0	0	0	0	312	98	0	0	0	0	0	0	0	0
"NFAT5"	14235	139558	14791	55158	8250	6541	29835	25323	4459	16886	5095	41901	2492	5758	2617	3416	2764	1648
"NFATC1"	5040	133552	5978	27728	3177	2801	14598	13130	1834	17874	15	21239	424	1596	693	3549	1268	1501
"NFATC2"	3264	151494	8033	6793	4487	3546	3749	3044	4475	5776	1531	3156	427	548	496	403	797	431
"NFATC2IP"	3864	15449	2887	1503	1606	1281	800	703	1056	741	2948	2175	1976	2231	1515	1319	1952	1141
"NFATC3"	4205	138235	17873	2437	9978	7895	1385	1052	8193	943	12574	2347	5475	5113	3959	4460	4609	2925
"NFATC4"	5680	12665	0	0	0	0	0	0	19	19	4	0	0	1	0	0	0	0
"NFE2"	1894	3646	73	0	30	43	0	0	151	21	8	0	1172	41	1344	55	1655	469
"NFE2L1"	4879	13222	1728	335	936	792	201	134	669	231	745	276	5235	4343	6609	4704	8210	4513
"NFE2L2"	2857	34827	19206	64636	10765	8441	34473	30163	6268	32671	9158	56582	5471	30163	5925	30040	1577	19522
"NFE2L3"	3712	34909	15503	26437	8537	6966	14380	12057	5343	12966	3771	21599	44	18567	200	3045	1093	2610
"NFIA"	9492	380481	159	8	101	58	0	8	760	166	120	60	119	151	103	59	24	13
"NFIB"	8391	232099	0	0	0	0	0	0	9	0	0	0	0	0	0	0	0	0
"NFIC"	2435	97031	2292	337	1330	962	156	181	1746	1162	1437	2559	559	435	698	537	774	446
"NFIL3"	2085	14817	2543	2348	1428	1115	1233	1115	1268	1213	1448	1609	18	3648	2972	4105	52	48
"NFIX"	5743	74216	34	0	3	31	0	0	851	429	0	12	369	148	79	122	131	97
"NFKB1"	4230	39589	26459	23369	14531	11928	12710	10659	2826	102370	899	139985	1507	24967	2255	23918	2716	8986
"NFKB2"	3138	7943	926	4411	532	394	2365	2046	242	3395	151	6057	1097	6089	1090	13408	1791	7188
"NFKBIA"	1576	2631	1552	10922	841	711	5914	5008	197	5793	179	8074	3007	7524	2489	67760	2786	66018
"NFKBIB"	2266	8920	256	925	82	174	433	492	87	606	30	867	495	1540	533	1694	658	1328
"NFKBID"	1891	12411	1636	5140	901	735	3313	1827	344	1664	460	20097	326	6221	427	9122	486	10354
"NFKBIE"	2587	7624	2207	3274	1192	1015	1694	1580	332	1514	945	4342	2117	1882	2338	6921	3715	6655
"NFKBIL1"	1486	11254	73	346	38	35	194	152	115	255	0	263	340	272	334	387	465	307
"NFKBIL2"	4539	15649	55	29	17	38	18	11	269	127	14	54	165	135	197	125	354	186
"NFKBIZ"	3934	11509	3253	42408	1747	1506	22775	19633	250	19693	0	27601	282	66361	201	53026	263	42440
"NFRKB"	5167	31821	1204	0	639	565	0	0	709	130	704	234	2835	869	1265	647	1595	853
"NFS1"	2668	30502	45	0	23	22	0	0	127	0	0	19	469	455	559	478	572	465
"NFU1"	1185	41500	43	0	43	0	0	0	36	0	0	57	168	198	335	233	353	286
"NFX1"	4629	80646	3285	2912	1845	1440	1601	1311	1685	1281	665	2527	1864	1732	1525	1145	1948	1143
"NFXL1"	3913	67422	25410	3417	16472	8938	1813	1604	15468	705	6788	467	3603	2179	2162	1100	5596	2084
"NFYA"	6393	29186	482	189	275	207	117	72	228	340	0	478	923	1147	1018	1027	1142	769
"NFYB"	4010	20939	556	193	319	237	132	61	278	48	0	49	728	476	803	496	699	440
"NFYC"	2377	79595	11246	7425	6182	5064	4050	3375	5444	4177	8995	8123	1602	1824	1748	1437	2286	1509
"NG36/G9a"	4197	17066	715	127	415	300	72	55	434	63	251	16	1349	1044	2356	1563	2569	1647
"NGB"	1880	5823	0	0	0	0	0	0	13	0	0	0	0	0	0	0	0	0
"NGDN"	1597	8505	32	111	26	6	57	54	55	83	0	40	465	510	481	421	632	385
"NGEF"	3199	134557	0	0	0	0	0	0	143	23	0	0	0	0	0	0	0	0
"NGF"	1052	52322	0	0	0	0	0	0	0	0	0	0	0	0	0	0	0	0
"NGFR"	3409	19712	0	0	0	0	0	0	40	34	0	0	0	0	0	0	0	0
"NGFRAP1"	958	1726	0	0	0	0	0	0	0	0	0	0	0	0	0	5	0	0
"NGLY1"	2600	64555	3629	560	2021	1608	313	247	1728	263	574	253	1213	574	966	592	1026	648
"NGRN"	1762	6550	140	0	64	76	0	0	143	36	0	46	1066	995	1502	1232	1216	1064
"NHE9"	879	269921	54	11	46	8	11	0	255	51	0	56	62	26	33	58	51	32
"NHEDC1"	1870	118792	61	0	44	17	0	0	33	5	0	0	882	625	802	608	803	559
"NHEDC2"	3371	51518	0	0	0	0	0	0	0	0	0	0	0	0	4	3	6	0
"NHEG1"	1362	11073	0	0	0	0	0	0	0	0	0	0	0	0	0	0	0	0
"NHEJ1"	3514	94768	483	0	268	215	0	0	564	21	15	41	167	134	273	218	388	245
"NHERF"	831	14894	130	0	73	57	0	0	175	118	0	0	191	130	352	314	373	262
"NHLH1"	2561	5779	0	0	0	0	0	0	0	7	0	0	0	0	1	0	0	0
"NHLH2"	2512	4748	0	0	0	0	0	0	0	0	0	0	0	0	0	0	0	0
"NHLRC1"	2135	2135	0	0	0	0	0	0	0	0	0	0	87	7	46	0	0	0
"NHLRC2"	2561	54034	698	80	413	285	49	31	563	56	26	110	879	694	493	402	374	239
"NHLRC3"	3552	11789	2412	901	1313	1099	489	412	1089	169	1170	322	2448	2161	2889	1552	3600	1786
"NHN1"	1983	4903	118	289	59	59	175	114	107	405	0	486	417	755	304	805	516	563
"NHP2"	858	4498	277	0	136	141	0	0	294	59	58	0	703	564	897	693	1143	583
"NHP2L1"	1735	14977	199	18	136	63	0	18	130	49	0	69	201	1506	355	1346	615	1342
"NHS"	8880	49205	0	0	0	0	0	0	11	9	0	0	0	0	0	0	0	0
"NHSL1"	7495	150487	1623	1684	951	672	918	766	1868	2183	137	1696	381	361	571	565	489	359
"NHSL2"	3980	7715	70	0	31	39	0	0	154	24	0	0	987	841	1175	866	1406	1007
"NIACR1"	2066	2066	0	521	0	0	285	236	0	248	0	179	499	5319	192	2190	1120	1492
"NIACR2"	2137	2137	96	531	67	29	316	215	31	266	0	155	464	4645	152	1874	888	1640
"NIBAN"	1521	166876	22421	131605	12689	9732	71022	60583	6822	55917	4665	82802	1922	2406	1556	1168	2265	1215
"NICN1"	3233	6993	262	64	122	140	26	38	224	46	156	102	363	352	375	296	599	311
"NID1"	5892	89342	0	0	0	0	0	0	0	16	0	0	3	0	0	0	7	0
"NID2"	5247	56520	48	0	8	40	0	0	83	8	0	0	620	675	0	0	0	0
"NIF3L1"	2132	12728	181	0	99	82	0	0	132	9	49	26	426	242	492	227	649	333
"NIFUN"	1178	6866	394	21	214	180	21	0	139	72	0	62	2100	1886	2352	1687	2654	1771
"NIN"	10323	111359	7168	2266	3984	3184	1345	921	3150	1524	2166	1912	4631	6521	5740	4941	6521	3927
"NINJ1"	1342	12800	3045	17680	1682	1363	9361	8319	177	11407	232	26977	637	14113	798	20349	1045	15092
"NINJ2"	1082	98230	0	0	0	0	0	0	154	26	0	0	290	204	281	183	252	175
"NINL"	4996	132817	5	0	5	0	0	0	206	96	0	0	36	18	32	34	53	36
"NIP7"	2187	3463	65	0	30	35	0	0	65	25	26	32	711	712	659	541	887	498
"NIPA1"	6651	43157	826	467	498	328	268	199	376	653	324	1370	1149	1839	855	800	1593	840
"NIPA2"	2803	29061	1899	2724	1049	850	1561	1163	944	1892	892	2991	3715	4834	803	875	2666	2178
"NIPAL1"	2194	20289	0	8	0	0	8	0	0	0	0	0	94	86	139	54	86	50
"NIPAL2"	2267	102236	128	27	58	70	7	20	278	48	24	0	839	167	130	108	321	112
"NIPAL3"	5548	57229	187	0	87	100	0	0	298	10	13	0	634	750	507	451	784	509
"NIPAL4"	3284	14704	137	125	77	60	77	48	56	166	0	218	0	9	0	0	0	3
"NIPBL"	10434	189061	13732	7272	7719	6013	3904	3368	6928	3258	3340	4769	2869	3485	3551	3197	3890	2267
"NIPSNAP1"	2062	26346	28	0	12	16	0	0	61	24	0	4	559	200	398	260	639	461
"NIPSNAP3A"	1639	12436	36	0	16	20	0	0	58	0	0	0	534	773	907	701	1192	799
"NIPSNAP3B"	4861	26726	19	0	10	9	0	0	67	133	0	13	470	688	557	758	627	639
"NIRF"	3515	20230	833	385	427	406	207	178	491	209	182	230	695	529	851	429	1028	509
"NISCH"	5259	37565	5335	2095	2881	2454	1073	1022	2220	939	3949	1502	5873	4788	5875	3499	8328	3989
"NIT1"	2103	7344	627	192	354	273	90	102	293	165	260	234	1349	1290	1662	1198	2043	1216
"NIT2"	1700	15295	168	93	76	92	46	47	117	40	0	0	336	373	477	444	582	409
"NIX"	3247	30123	673	0	412	261	0	0	581	54	49	25	3305	3658	2334	1834	3083	2102
"NKAIN1"	2594	59809	0	0	0	0	0	0	12	11	0	0	0	0	0	0	0	0
"NKAIN2"	3385	1021717	0	0	0	0	0	0	0	8	0	0	0	0	0	0	0	0
"NKAIN3"	1572	742129	0	0	0	0	0	0	0	0	0	0	145	145	0	0	0	0
"NKAIN4"	1597	6817	0	0	0	0	0	0	90	13	0	0	1	0	0	0	0	0
"NKAP"	2342	13018	9	10	9	0	6	4	0	0	0	0	329	283	299	152	324	245
"NKAPL"	1639	1639	0	0	0	0	0	0	11	0	0	0	0	0	0	0	0	0
"NKD1"	2596	86402	0	0	0	0	0	0	456	192	0	0	0	0	0	0	0	0
"NKD2"	1988	29759	0	18	0	0	18	0	166	125	0	19	0	0	0	0	0	0
"NKG2-D"	1590	19539	79	42	39	40	21	21	15	0	0	0	61	112	45	35	95	79
"NKG2H"	1067	2762	0	0	0	0	0	0	0	0	0	0	2	3	2	0	3	0
"NKG7"	828	1086	50	53	27	23	19	34	30	0	0	0	220	23	22	123	185	246
"NKIAMRE"	1538	84805	19	0	9	10	0	0	31	9	0	0	3	23	22	16	8	4
"NKIR"	1655	11065	0	0	0	0	0	0	113	13	0	0	58	74	440	449	209	197
"NKIRAS1"	1998	24965	1093	8874	609	484	7808	1066	516	39318	92	2866	11076	16007	11756	14093	15145	13525
"NKIRAS2"	2500	5531	305	21	233	72	0	21	330	327	53	297	1338	1526	1319	1096	1464	1187
"NKPD1"	4690	10401	9	0	0	9	0	0	179	81	0	0	0	0	0	0	0	0
"NKRF"	3736	4808	100	47	85	15	19	28	106	16	0	0	552	11	530	275	582	309
"NKTR"	11500	21556	8397	4561	4641	3756	2490	2071	3824	1388	2890	1946	3463	3588	3909	2277	4350	1687
"NKX1-2"	972	2553	0	0	0	0	0	0	0	0	0	0	0	0	0	0	0	0
"NKX2-1"	2336	3299	0	0	0	0	0	0	0	0	0	0	0	0	0	0	0	0
"NKX2-2"	2078	3002	0	0	0	0	0	0	10	0	0	0	0	0	0	0	0	0
"NKX2-3"	2096	3590	0	0	0	0	0	0	0	0	0	0	0	0	0	0	0	0
"NKX2-4"	1619	2042	0	0	0	0	0	0	0	0	0	0	0	0	0	0	0	0
"NKX2-5"	1587	3126	0	0	0	0	0	0	0	0	0	0	0	0	0	0	0	0
"NKX2-6"	718	3959	0	0	0	0	0	0	16	0	0	0	0	0	0	0	0	0
"NKX2-8"	1804	2571	0	0	0	0	0	0	0	11	0	0	0	0	0	0	0	0
"NKX3-1"	3282	4245	0	0	0	0	0	0	0	0	0	0	0	17	0	109	0	8
"NKX3-2"	2243	3662	0	0	0	0	0	0	0	0	0	0	0	0	0	0	0	0
"NKX3A"	742	2502	0	0	0	0	0	0	0	0	0	0	0	0	0	53	0	8
"NKX6-1"	1119	4953	0	0	0	0	0	0	0	0	0	0	0	0	0	0	0	0
"NKX6-2"	1022	1219	0	0	0	0	0	0	0	0	0	0	0	0	0	0	0	0
"NKX6-3"	573	139558	0	0	0	0	0	0	341	203	0	0	18	10	8	6	4	21
"NLE1"	2721	10956	57	32	34	23	23	9	37	0	0	0	74	66	110	53	113	43
"NLGN1"	5169	698641	0	0	0	0	0	0	0	8	0	0	0	0	0	0	0	0
"NLGN2"	4649	11679	0	0	0	0	0	0	72	10	0	0	0	0	0	0	0	0
"NLGN3"	3900	26340	918	25	466	452	13	12	664	178	543	116	78	9	7	14	29	10
"NLGN4X"	5969	338624	0	0	0	0	0	0	8	0	0	0	0	0	0	0	0	0
"NLGN4Y"	5711	320224	0	0	0	0	0	0	0	0	0	0	0	0	0	0	0	0
"NLK"	3547	153716	14760	5620	8169	6591	3077	2543	6939	2690	5469	3663	1017	1118	1228	1105	1533	1085
"NLN"	2888	101304	1052	2161	561	491	1167	994	356	1805	0	420	912	910	1002	883	898	776
"NLRC3"	6414	38356	65	28	39	26	10	18	102	47	5	5	53	212	29	61	74	22
"NLRC4"	3372	41285	649	41	376	273	32	9	536	26	171	19	1937	1716	1108	524	1096	680
"NLRC5"	6871	94028	3786	1699	1972	1814	868	831	2034	1118	2052	1535	1199	1531	1653	1433	1887	1332
"NLRP1"	5629	70395	1992	8239	1202	790	4417	3822	944	3511	1170	6773	1040	2522	1080	1760	1151	932
"NLRP10"	2022	3905	0	0	0	0	0	0	0	0	0	0	0	0	0	0	0	0
"NLRP11"	4046	51360	0	0	0	0	0	0	0	0	0	0	0	0	0	0	0	0
"NLRP12"	3865	30793	0	0	0	0	0	0	14	0	0	0	0	3	13	12	4	0
"NLRP13"	3166	36391	0	0	0	0	0	0	0	0	0	0	0	0	0	0	0	0
"NLRP14"	3835	51059	0	0	0	0	0	0	0	0	0	0	0	0	0	0	0	0
"NLRP2"	3521	34734	28	18	20	8	10	8	114	0	83	14	208	211	42	13	424	283
"NLRP3"	4460	31051	330	279	173	157	166	113	114	311	81	1347	797	2411	1079	4110	613	1930
"NLRP4"	3682	45276	0	0	0	0	0	0	14	0	0	0	0	0	0	0	0	0
"NLRP5"	3896	62082	0	0	0	0	0	0	10	15	0	0	0	0	0	0	0	0
"NLRP6"	2686	6735	0	0	0	0	0	0	0	13	0	0	0	0	0	0	0	0
"NLRP7"	3844	42735	0	0	0	0	0	0	0	0	0	0	0	1	0	0	0	0
"NLRP8"	3943	40798	0	0	0	0	0	0	0	0	0	0	0	0	0	0	0	0
"NLRP9"	3492	29971	0	0	0	0	0	0	0	0	0	0	0	0	0	0	0	0
"NLRX1"	4093	15245	30	1	12	18	1	0	180	46	45	0	451	360	449	307	700	430
"NMB"	1031	3442	0	3	0	0	0	3	27	0	0	0	15	28	71	64	61	39
"NMBR"	1356	13192	0	0	0	0	0	0	0	0	0	0	0	0	0	0	0	0
"NMD3"	2744	30698	2044	716	1143	901	432	284	719	332	87	555	2092	2699	2253	1825	2761	1858
"NME1"	1081	7045	29	0	15	14	0	0	45	0	0	0	158	208	395	421	390	570
"NME1-NME2"	1059	18186	115	0	56	59	0	0	98	26	0	91	2161	955	3105	3469	2932	2998
"NME2"	1280	18186	115	0	56	59	0	0	98	26	0	91	2161	955	3105	3469	2932	2998
"NME2P1"	694	694	0	0	0	0	0	0	0	0	0	0	0	0	0	0	0	0
"NME3"	1038	1390	682	184	310	372	16	168	182	1	470	0	494	341	387	1148	520	373
"NME4"	1793	3563	68	0	41	27	0	0	98	82	0	4	520	468	823	633	703	441
"NME5"	1231	24272	0	0	0	0	0	0	0	0	0	0	0	0	0	0	0	0
"NME6"	1173	7259	66	8	36	30	0	8	75	0	61	0	137	71	430	232	467	173
"NME7"	5080	84728	216	13030	121	95	9292	3738	176	3389	0	4797	1618	5377	1535	4221	1800	4579
"NMI"	2150	12663	310	205	213	97	110	95	241	125	0	72	990	955	767	734	490	803
"NMNAT1"	3785	42071	19	0	0	19	0	0	134	11	14	10	418	294	342	179	353	158
"NMNAT2"	5667	170360	4	0	1	3	0	0	9	0	0	0	0	0	0	0	0	0
"NMNAT3"	1860	117801	4947	1055	2870	2077	665	390	4704	858	466	582	276	292	366	253	434	270
"NMRAL1"	1721	14613	123	0	57	66	0	0	180	8	85	21	378	195	396	192	598	234
"NMS"	495	12800	0	0	0	0	0	0	0	0	0	0	0	0	0	0	0	0
"NMT1"	4898	47702	1912	732	1115	797	353	379	1058	595	1123	1680	3261	2806	3976	2824	4881	2950
"NMT2"	5093	54355	332	72	202	130	60	12	125	55	0	93	293	311	136	94	234	127
"NMU"	819	41062	0	0	0	0	0	0	0	0	0	0	0	0	0	0	0	0
"NMUR1"	3276	7312	0	0	0	0	0	0	11	8	0	0	0	0	0	0	0	0
"NMUR2"	2068	13740	0	0	0	0	0	0	0	0	0	0	0	0	0	0	0	0
"NM_001085395"	585	585	0	0	0	0	0	0	0	0	0	0	0	0	0	0	0	0
"NM_001126313"	526	11635	0	0	0	0	0	0	0	0	0	0	0	0	0	0	0	0
"NNAT"	1303	2483	2450	789	1311	1139	413	376	725	919	973	1347	110	80	89	241	175	54
"NNMT"	1581	16705	0	0	0	0	0	0	0	11	0	0	0	0	0	0	0	0
"NNT"	4699	102878	5473	759	3184	2289	464	295	4409	287	1452	232	3275	3263	3882	3080	5324	2740
"NO145"	1134	32505	1254	101	726	528	48	53	1096	61	588	85	590	552	799	315	939	657
"NOB1"	1724	13056	33	0	22	11	0	0	62	48	0	122	353	213	614	597	735	411
"NOBOX"	1479	11281	0	0	0	0	0	0	0	0	0	0	0	0	0	0	0	0
"NOC2L"	4299	14336	475	12	232	243	12	0	308	304	0	0	356	481	1378	1205	1206	929
"NOC3L"	3457	29696	93	81	46	47	42	39	58	53	0	71	238	389	404	364	345	253
"NOC4L"	1647	7995	86	51	58	28	11	40	99	145	10	167	323	325	336	388	380	327
"NOD1"	4509	54251	8014	983	4871	3143	506	477	3920	384	6162	356	2785	1070	1855	855	1945	800
"NOD2"	4497	35939	505	16	327	178	4	12	419	324	0	185	670	620	456	256	780	326
"NOD27"	6275	58158	3236	1511	1761	1475	814	697	1593	997	1899	1436	1113	1418	1531	1332	1749	1240
"NODAL"	2089	9775	0	0	0	0	0	0	41	0	0	0	0	0	0	0	0	0
"NOE3"	4268	194665	0	0	0	0	0	0	0	0	0	0	0	0	0	0	0	0
"NOG"	1893	1893	0	0	0	0	0	0	0	0	0	0	0	0	0	0	0	0
"NOL10"	3516	119220	705	180	458	247	112	68	772	318	123	809	398	396	569	476	665	478
"NOL11"	2472	26207	11	54	11	0	34	20	110	61	0	102	377	428	765	743	929	640
"NOL12"	2845	7142	129	72	60	69	34	38	177	105	51	49	236	211	431	316	508	303
"NOL3"	1839	5188	214	83	134	80	49	34	79	62	54	0	380	419	502	407	662	328
"NOL4"	3893	372378	0	0	0	0	0	0	12	0	0	0	0	0	0	0	0	0
"NOL5A"	1655	2766	1390	32	788	602	0	32	258	114	20	42	73	111	1859	1140	2098	919
"NOL6"	4878	12591	343	69	200	143	39	30	200	165	204	59	686	667	1410	983	1880	1142
"NOL7"	881	5569	215	118	103	112	56	62	106	32	62	27	1469	1401	1192	970	1567	1180
"NOL8"	4440	28237	1033	241	590	443	132	109	598	93	110	143	1374	1071	1788	860	2033	817
"NOL9"	2876	29373	290	42	136	154	42	0	199	40	0	38	226	120	264	142	325	167
"NOLC1"	3979	11696	160	442	119	41	228	214	153	380	3	408	1727	2722	1782	2522	2206	2028
"NOM1"	6087	23460	557	83	327	230	52	31	435	157	55	162	726	767	898	713	920	403
"NOMO1"	4277	62372	91	28	63	28	12	16	81	7	41	0	582	628	5092	4981	5595	4192
"NOMO2"	4283	62253	87	0	33	54	0	0	40	16	0	0	505	547	5232	5709	5709	4938
"NOMO3"	4346	62280	49	0	27	22	0	0	8	3	0	0	175	226	1100	993	1029	825
"NONO"	3229	17976	1158	756	635	523	378	378	519	371	482	730	5310	6323	7075	6875	9213	6043
"NOP10"	537	1447	23	9	0	23	9	0	0	0	0	0	45	147	1542	1214	306	329
"NOP14"	3364	25262	883	981	472	411	522	459	604	783	369	1113	1308	851	1180	1482	1296	1065
"NOP16"	1105	2517	84	126	41	43	44	82	171	157	75	181	1070	2292	326	1470	1621	188
"NOP2"	2745	11445	516	354	272	244	164	190	206	249	117	460	1068	1037	1439	1096	1932	1165
"NOP5"	820	18922	327	448	163	164	256	192	172	360	0	579	48	128	290	315	277	167
"NOP56"	2128	5786	2180	54	1205	975	13	41	322	389	69	148	1041	1208	2349	1595	2521	1095
"NOP58"	1978	37869	816	1073	522	294	517	556	324	813	32	1115	787	1396	1032	966	887	768
"NOS1"	7155	148605	0	0	0	0	0	0	110	11	0	0	0	0	0	0	0	0
"NOS1AP"	5561	7042	0	0	0	0	0	0	11	0	0	0	0	0	0	0	0	0
"NOS2"	4232	43764	0	0	0	0	0	0	99	24	0	0	39	39	24	32	58	0
"NOS3"	4364	23544	0	0	0	0	0	0	169	105	0	0	1	0	0	15	23	18
"NOSIP"	1272	23673	110	0	45	65	0	0	292	59	49	54	574	423	632	511	790	546
"NOSTRIN"	2555	78517	2	0	2	0	0	0	0	8	0	0	2	0	0	0	0	0
"NOTCH1"	9328	51343	7012	7774	3903	3109	4002	3772	2154	6344	5473	16529	1485	2713	2135	4917	3091	3416
"NOTCH2"	11457	158100	9163	8215	4929	4234	4729	3486	6001	5316	2948	8956	2055	7212	7563	8117	4513	5937
"NOTCH2NL"	4966	76802	63089	46464	37004	26085	24869	21595	13313	35081	12255	27919	686	1276	1603	2747	1727	1151
"NOTCH3"	8103	41349	4	0	2	2	0	0	104	60	0	0	109	61	247	313	198	152
"NOTCH4"	6775	29223	69	0	30	39	0	0	272	80	63	0	0	0	0	0	0	0
"NOTO"	1450	8955	0	0	0	0	0	0	16	0	0	0	0	0	0	0	0	0
"NOTUM"	2227	8675	0	1	0	0	1	0	57	9	0	0	1	0	0	0	0	0
"NOV"	2606	8128	0	0	0	0	0	0	0	0	0	0	0	9	32	57	0	6
"NOVA1"	4025	151872	0	0	0	0	0	0	0	0	0	0	0	0	0	0	0	0
"NOVA2"	1881	33888	0	0	0	0	0	0	108	24	0	0	2	1	0	0	0	0
"NOX1"	2541	31022	0	0	0	0	0	0	0	0	0	0	105	130	0	42	0	0
"NOX3"	2057	60536	0	0	0	0	0	0	0	0	0	0	0	0	0	0	0	0
"NOX4"	4622	265257	0	0	0	0	0	0	0	0	0	0	0	0	0	0	0	0
"NOX5"	5522	42020	0	0	0	0	0	0	35	0	0	0	39	42	32	20	36	35
"NOXA1"	1646	11012	129	25	79	50	15	10	106	49	0	24	91	84	106	88	216	109
"NOXIN"	1841	56584	30	0	17	13	0	0	221	8	0	0	173	181	375	308	809	481
"NOXO1"	1533	2523	12	0	12	0	0	0	20	14	0	0	0	0	0	0	0	0
"NP"	1700	7706	159	9	94	65	0	9	116	39	125	0	986	961	1196	731	1589	863
"NPAL2"	2238	102236	128	27	58	70	7	20	278	48	24	0	839	167	130	108	321	112
"NPAS1"	2088	25917	0	0	0	0	0	0	104	25	0	0	0	0	0	0	0	0
"NPAS2"	4025	176676	0	0	0	0	0	0	84	46	0	0	6	7	31	40	0	0
"NPAS3"	5944	864924	0	0	0	0	0	0	0	0	0	0	0	0	0	0	0	0
"NPAS4"	3310	5704	0	0	0	0	0	0	63	25	0	0	0	0	0	0	0	0
"NPAT"	5952	65246	1731	267	969	762	145	122	1293	181	567	319	709	667	1135	601	902	554
"NPB"	618	710	0	0	0	0	0	0	0	0	0	0	11	0	13	0	0	7
"NPBWR1"	987	987	0	0	0	0	0	0	0	0	0	0	0	0	0	0	0	0
"NPBWR2"	1002	1002	0	0	0	0	0	0	46	35	0	0	0	0	0	0	0	0
"NPC1"	4838	55119	1701	1925	923	778	1025	900	1037	886	349	731	1888	2109	4217	4793	3544	3489
"NPC1L1"	5066	28780	0	0	0	0	0	0	99	25	0	0	0	0	0	0	0	0
"NPC2"	901	13442	696	186	349	347	113	73	513	69	202	77	12225	7398	9002	14323	17433	9671
"NPCEDRG"	1376	5251	154	64	84	70	26	38	134	26	156	75	363	352	255	202	408	231
"NPCR"	2406	2406	0	0	0	0	0	0	0	0	0	0	0	0	0	0	0	0
"NPDC1"	2208	4637	346	35	0	346	35	0	330	90	0	0	404	33	298	49	75	84
"NPEPL1"	4687	22673	2442	676	1371	1071	339	337	1431	512	2229	945	1090	892	1910	1705	2245	1231
"NPEPPS"	4361	92199	8532	1167	4772	3760	605	562	3110	472	2927	964	4695	4594	5436	3521	6444	4105
"NPFF"	595	950	42	0	27	15	0	0	0	17	0	0	56	45	74	28	16	38
"NPFFR1"	1289	11436	0	0	0	0	0	0	40	11	0	0	0	0	0	0	0	0
"NPFFR2"	2060	116399	0	0	0	0	0	0	0	0	0	0	0	0	0	0	0	0
"NPH4"	2044	9655	2	0	1	1	0	0	109	56	0	0	0	0	0	0	0	0
"NPHP1"	2768	81725	0	0	0	0	0	0	0	0	0	0	144	172	0	0	0	0
"NPHP3"	5397	41824	1670	178	940	730	92	86	1174	143	273	161	1366	1165	1524	903	1703	758
"NPHP4"	5032	129663	195	14	123	72	8	6	1018	212	49	56	146	133	281	283	282	193
"NPHS1"	4897	26467	0	9	0	0	8	1	48	76	0	0	0	1	0	0	0	0
"NPHS2"	1876	25409	0	0	0	0	0	0	0	0	0	0	0	0	0	0	0	0
"NPIP"	1109	14632	0	1	0	0	0	1	21	25	0	0	52	121	2586	2042	3870	1980
"NPIPL1"	724	12315	0	0	0	0	0	0	0	0	0	0	0	0	41	35	31	0
"NPIPL2"	2126	21017	40690	28249	22508	18182	15061	13188	13862	11686	40631	36051	19435	20109	26838	23564	42961	30306
"NPIPL3"	3499	22773	1506	1258	895	611	741	517	1120	867	1502	2910	735	1256	13294	13939	18115	11288
"NPL"	1819	39718	2101	262	1164	937	124	138	1935	80	602	27	1810	1578	4087	2859	2640	1500
"NPLOC4"	4396	80225	5171	9205	2857	2314	4904	4301	2369	5920	2967	12029	744	3731	3765	1834	4438	1319
"NPM1"	1369	23091	1215	1427	667	548	794	633	653	678	186	1295	1626	2062	4211	5660	5390	5414
"NPM2"	1883	12764	0	0	0	0	0	0	13	4	0	0	0	3	0	0	0	0
"NPM3"	882	2089	0	0	0	0	0	0	0	14	0	0	146	139	142	165	184	169
"NPNT"	4686	76224	0	0	0	0	0	0	0	0	0	0	0	0	0	0	0	0
"NPPA"	855	2073	108	91	58	50	36	55	127	78	0	0	9	48	17	51	10	53
"NPPB"	700	1472	0	0	0	0	0	0	0	0	0	0	0	0	0	0	0	0
"NPPC"	383	826	0	0	0	0	0	0	0	0	0	0	0	0	0	0	0	0
"NPR1"	4206	15305	864	116	487	377	65	51	459	145	197	3	1215	1192	709	496	4560	2602
"NPR2"	3451	17323	2	0	0	2	0	0	103	0	0	0	5	5	0	1	3	0
"NPR3"	2653	75589	0	0	0	0	0	0	0	0	0	0	0	0	0	0	0	0
"NPS"	325	3324	0	0	0	0	0	0	0	0	0	0	0	0	0	0	0	0
"NPSR1"	1677	191695	0	0	0	0	0	0	0	0	0	0	41	46	0	0	0	0
"NPTIIc"	2457	5286	75	3	52	23	3	0	96	108	0	22	0	0	0	0	0	0
"NPTN"	2462	73410	12655	9411	7083	5572	5145	4266	5194	5572	6703	10010	3689	4751	2358	4010	4954	3616
"NPTX1"	5442	9773	6	2	3	3	0	2	68	30	2	4	0	0	0	0	0	0
"NPTX2"	2718	12586	0	0	0	0	0	0	10	0	0	0	0	0	0	0	0	0
"NPTXR"	5818	25561	2	0	0	2	0	0	152	62	0	1	0	2	0	0	0	0
"NPVF"	1189	3914	0	0	0	0	0	0	0	0	0	0	0	0	0	0	0	0
"NPW"	1017	1236	0	0	0	0	0	0	0	0	0	0	0	2	8	11	0	11
"NPY"	555	7670	0	0	0	0	0	0	0	8	0	0	0	0	0	0	0	0
"NPY1R"	2762	8633	0	0	0	0	0	0	0	0	0	0	0	0	0	0	0	0
"NPY2R"	3626	8447	0	0	0	0	0	0	0	0	0	0	0	0	0	0	0	0
"NPY5R"	1845	7995	0	0	0	0	0	0	0	0	0	0	0	0	0	0	0	0
"NPY6R"	1954	1954	181	192	92	89	111	81	141	84	0	127	0	0	0	0	0	0
"NQO1"	2596	17230	21	242	21	0	122	120	42	306	41	301	811	806	915	876	928	573
"NQO2"	1664	19929	722	812	356	366	412	400	588	873	646	1288	1697	2233	1259	2014	1475	1546
"NR0B1"	1586	4957	0	0	0	0	0	0	0	0	0	0	0	0	0	0	0	0
"NR0B2"	1272	2593	0	0	0	0	0	0	0	0	0	0	0	0	0	0	0	0
"NR1A2"	803	342387	0	27	0	0	0	27	26	16	0	0	0	4	0	0	0	0
"NR1B3"	1544	7131	63	126	32	31	62	64	107	164	0	148	141	356	116	382	167	347
"NR1C1"	9624	45413	442	24	194	248	17	7	535	93	32	56	778	833	1153	890	1256	739
"NR1D1"	2774	7934	0	0	0	0	0	0	166	63	6	0	109	45	43	30	29	54
"NR1D2"	5374	35360	1192	1201	670	522	645	556	633	710	213	1780	1561	1910	1667	1604	1360	1195
"NR1H2"	2424	53319	721	259	411	310	117	142	527	415	157	332	2035	2197	2706	2613	3481	2633
"NR1H3"	2744	10872	129	0	66	63	0	0	211	184	0	0	317	369	1007	1340	626	682
"NR1H4"	2334	89966	0	0	0	0	0	0	0	0	0	0	0	0	0	0	0	0
"NR1I1"	4731	63494	8739	7410	4905	3834	3942	3468	3020	6301	4298	13071	1070	1815	2833	3781	3281	2892
"NR1I2"	4425	38002	0	0	0	0	0	0	0	13	0	0	0	0	0	0	0	0
"NR1I3"	1454	7866	49	0	0	49	0	0	48	0	0	0	670	508	624	388	909	436
"NR2A1"	549	51676	0	0	0	0	0	0	85	0	0	0	0	0	0	0	0	0
"NR2B1"	5667	10014	3147	608	2250	897	219	389	1166	938	3289	2081	417	383	791	505	1110	498
"NR2C1"	4027	53346	248	6	132	116	6	0	217	20	35	0	402	390	494	348	470	268
"NR2C2"	8343	101544	6553	1659	3819	2734	814	845	3123	1100	2192	1751	2985	175	2631	1677	2722	1349
"NR2C2AP"	1644	1998	5	0	0	5	0	0	67	35	0	8	257	237	256	163	305	241
"NR2E1"	3266	22798	0	0	0	0	0	0	0	0	0	0	0	0	0	0	0	0
"NR2E3"	2110	4378	0	0	0	0	0	0	21	15	0	0	0	0	0	0	0	0
"NR2F1"	3192	10737	0	0	0	0	0	0	0	0	0	0	0	0	0	0	0	0
"NR2F2"	5111	9381	0	0	0	0	0	0	0	0	0	0	0	0	0	0	0	0
"NR2F6"	1807	13458	207	30	103	104	30	0	192	65	0	0	322	32	274	126	420	152
"NR3A1"	4986	260676	354	192	208	146	101	91	516	396	0	221	142	180	294	244	226	141
"NR3B2"	3211	130490	0	0	0	0	0	0	218	78	0	0	0	0	0	0	0	0
"NR3C1"	7397	157582	15523	13401	8622	6901	7334	6067	7769	6551	5386	8638	3017	2857	1395	2320	3343	1982
"NR3C2"	5877	363729	9978	6312	5519	4459	3314	2998	3980	2728	3122	2074	220	293	3	1	1	0
"NR4A1"	2676	8096	0	308	0	0	147	161	257	352	0	323	79	1933	40	2661	56	1868
"NR4A2"	3537	8343	22	338	0	22	190	148	43	194	0	61	80	773	18	293	29	183
"NR4A3"	6397	45038	8662	94363	4764	3898	50767	43596	677	37086	289	34770	1492	17952	3918	17311	2363	6863
"NR5A1"	3102	26186	0	0	0	0	0	0	87	66	0	0	0	1	0	0	0	0
"NR5A2"	5050	149780	0	0	0	0	0	0	13	9	0	0	0	0	0	0	0	0
"NR6A1"	1912	248875	1040	511	601	439	225	286	1176	790	22	250	6	14	30	29	24	7
"NRAP"	5549	75223	0	0	0	0	0	0	13	0	0	0	0	0	0	0	0	0
"NRARP"	2622	2622	0	0	0	0	0	0	20	0	0	0	0	0	0	0	0	0
"NRAS"	4467	12438	1051	571	566	485	313	258	136	731	0	415	2359	3406	2419	2731	2436	2066
"NRBF2"	1899	21780	375	49	210	165	32	17	100	50	0	65	1096	789	1096	617	1334	835
"NRBP1"	2902	14467	1078	442	626	452	259	183	395	201	249	394	3519	2640	4370	3505	5581	3613
"NRBP2"	3763	7230	429	234	262	167	122	112	236	158	272	228	334	422	372	220	647	262
"NRCAM"	6690	308744	15	24	0	15	17	7	22	3	0	9	122	145	26	28	168	142
"NRD1"	4055	89743	6198	6067	3508	2690	3255	2812	2812	2911	2608	6309	6254	8868	6539	6379	6279	4578
"NRF1"	3600	145367	4405	2567	2483	1922	1351	1216	1723	1185	753	1685	352	341	466	373	575	372
"NRG"	46	46	0	0	0	0	0	0	0	0	0	0	0	0	0	0	0	0
"NRG1"	3233	216832	0	0	0	0	0	0	18	0	0	0	0	0	0	0	0	0
"NRG2"	3055	195621	112	256	43	69	201	55	397	177	46	193	0	0	0	0	0	0
"NRG3"	3751	1109494	0	0	0	0	0	0	0	0	0	0	0	0	0	0	0	0
"NRG4"	1127	116226	0	642	0	0	332	310	7	1730	0	365	0	0	0	0	0	0
"NRGN"	1222	7275	746	105	319	427	56	49	402	90	207	101	2095	1725	2561	2693	3752	3071
"NRIF3"	1869	82375	0	0	0	0	0	0	58	0	0	0	38	55	32	21	72	66
"NRIP1"	7560	103572	1700	432	1013	687	223	209	1430	426	30	277	797	633	1113	702	831	405
"NRIP2"	2782	9708	1301	210	716	585	114	96	561	138	655	121	420	290	107	28	156	22
"NRIP3"	3816	23475	0	0	0	0	0	0	24	0	0	0	140	168	221	287	210	215
"NRK"	8082	136062	0	0	0	0	0	0	0	0	0	0	0	0	0	0	0	0
"NRL"	2290	15024	891	72	483	408	53	19	537	199	127	57	2399	1406	2009	2062	2543	1636
"NRM"	1712	3234	85	112	48	37	40	72	60	205	49	152	371	393	286	335	123	371
"NRM29"	1734	3234	85	112	48	37	40	72	60	205	49	152	371	393	286	335	123	371
"NRN1"	2057	9400	0	0	0	0	0	0	0	0	0	0	0	0	0	0	0	0
"NRN1L"	635	1491	0	0	0	0	0	0	84	0	0	0	2	0	0	0	0	0
"NRP1"	5896	157415	37709	33857	20947	16762	18562	15295	17960	10423	17681	20016	15813	7608	14851	4965	7733	4163
"NRP2"	6678	115634	4664	29837	2598	2066	15960	13877	1342	11491	79	8870	903	1987	3093	5179	2006	1566
"NRSN1"	2412	21345	0	0	0	0	0	0	0	0	0	0	0	0	0	0	0	0
"NRSN2"	2389	8143	0	46	0	0	25	21	65	0	110	0	70	92	40	8	110	65
"NRTN"	1105	4518	0	0	0	0	0	0	23	20	0	0	0	0	0	0	0	0
"NRXN1"	9573	1114032	0	0	0	0	0	0	0	0	0	0	0	0	0	0	0	0
"NRXN2"	6622	117014	0	0	0	0	0	0	546	182	0	0	0	4	0	3	12	0
"NRXN3"	6145	1460667	0	0	0	0	0	0	0	0	0	0	0	0	0	0	0	0
"NR_003112"	658	658	0	0	0	0	0	0	9	0	0	0	37	38	0	0	0	0
"NR_024104"	1363	79324	2022	554	1112	910	288	266	991	454	75	668	345	430	294	205	374	155
"NR_027453"	3868	3868	0	0	0	0	0	0	0	17	0	0	3	3	0	6	4	7
"NS4ATP2"	6273	15097	292	0	182	110	0	0	226	0	150	0	1271	846	1209	612	1682	654
"NS5ATP1"	1974	137541	850	37	496	354	14	23	1012	84	0	23	782	900	1152	1063	1271	859
"NS5ATP2"	1517	26788	0	0	0	0	0	0	0	0	0	0	150	129	134	123	148	111
"NS5ATP3"	3136	42341	2458	2719	1392	1066	1529	1190	884	1585	325	2024	560	2405	622	707	1074	491
"NS5ATP4A"	1790	14092	875	458	582	293	279	179	339	282	681	580	5306	5791	3755	4495	7034	4253
"NS5ATP5"	834	17720	38	0	16	22	0	0	80	0	0	0	41	45	190	136	129	128
"NSA2"	1110	9633	0	23	0	0	14	9	10	0	0	0	127	819	688	600	533	501
"NSD1"	13005	166382	6691	2030	3814	2877	1076	954	3229	929	3975	1623	4054	4026	4397	2983	4938	2462
"NSDHL"	1639	38398	24	0	13	11	0	0	47	49	25	0	319	292	486	436	637	457
"NSF"	4095	133433	1674	878	928	746	453	425	1327	737	484	971	2951	3151	5037	4971	6097	4137
"NSFL1C"	3970	25606	1131	70	600	531	52	18	850	96	305	169	971	757	1247	938	834	847
"NSG1"	2280	32072	35	13	10	25	13	0	156	47	0	0	0	0	0	0	0	0
"NSL1"	13226	65645	1784	22	1019	765	6	16	1215	23	262	0	1108	1108	928	562	1209	761
"NSMAF"	3598	76340	6098	11357	3067	3031	8971	2386	2528	458	1364	2680	2307	20780	3055	2013	2798	1818
"NSMCE1"	1821	43800	198	1	100	98	1	0	252	102	0	26	415	368	286	381	755	592
"NSMCE2"	1220	275286	10106	9999	5723	4383	5696	4303	5413	5070	1487	6209	221	361	297	319	365	309
"NSMCE4A"	2189	18124	289	0	170	119	0	0	215	34	101	31	490	423	614	324	751	530
"NSUN2"	3570	22249	1611	2042	967	644	1067	975	816	1303	472	2404	1856	2622	1758	2362	2472	963
"NSUN3"	1441	63777	3350	783	1851	1499	405	378	1948	481	1031	340	636	713	590	374	408	372
"NSUN4"	6699	23184	1066	1800	648	418	914	886	600	1004	532	2457	593	1217	619	829	760	548
"NSUN5"	1701	5598	241	39	116	125	20	19	137	119	0	25	518	376	2591	1621	3238	406
"NSUN5B"	1848	6421	233	27	101	132	17	10	168	63	219	69	322	406	2177	1412	2664	254
"NSUN5C"	1761	6455	171	39	93	78	20	19	50	77	0	25	276	185	2247	1466	2825	1276
"NSUN6"	2437	106288	379	624	227	152	385	239	392	1664	25	1213	122	182	133	142	165	107
"NSUN7"	3708	60088	0	0	0	0	0	0	9	0	0	0	0	0	0	0	0	0
"NT5C"	1001	1555	148	0	30	118	0	0	25	11	84	44	632	224	365	262	461	452
"NT5C1A"	1113	12919	0	0	0	0	0	0	27	0	0	0	0	0	0	0	0	0
"NT5C1B"	2983	34849	24	0	11	13	0	0	11	12	0	0	265	179	291	124	380	145
"NT5C2"	5428	67446	9617	4357	5388	4229	2458	1899	4179	1975	3271	2843	3351	3371	3120	2483	3240	2164
"NT5C3"	1751	48667	592	23	230	362	23	0	571	21	0	21	169	162	194	212	262	252
"NT5C3L"	1792	11058	0	0	0	0	0	0	25	13	0	0	112	136	574	509	238	143
"NT5DC1"	3867	135923	1410	281	841	569	141	140	975	324	66	186	254	334	535	492	476	381
"NT5DC2"	2117	10638	2847	730	1218	1629	152	578	2034	215	0	38	4467	5012	2545	1987	4008	1522
"NT5DC3"	7228	68896	74	28	54	20	19	9	103	0	41	16	334	377	70	18	150	31
"NT5DC4"	1780	21391	10	0	0	10	0	0	103	27	62	82	74	117	45	36	62	22
"NT5E"	4064	46196	70	0	44	26	0	0	82	0	0	0	0	8	0	0	0	0
"NT5M"	1609	44297	0	0	0	0	0	0	128	8	0	0	27	12	0	0	8	0
"NTAN1"	1119	18118	757	46	475	282	13	33	338	20	95	30	561	430	1456	952	1827	814
"NTF3"	1335	63185	0	0	0	0	0	0	22	36	0	0	0	0	0	0	0	0
"NTF4"	994	2722	1	0	1	0	0	0	0	28	0	0	0	0	0	0	0	0
"NTF5"	2187	9717	3	0	2	1	0	0	123	61	0	0	0	0	0	0	0	0
"NTHL1"	1076	8053	8	0	5	3	0	0	63	27	0	0	116	120	116	102	192	129
"NTM"	3415	426005	0	0	0	0	0	0	68	25	0	0	0	0	0	0	0	0
"NTN1"	5960	222459	37	30	33	4	12	18	558	217	38	30	0	0	0	0	0	0
"NTN3"	1991	2647	114	0	84	30	0	0	24	11	63	0	0	0	0	0	0	0
"NTN4"	3624	132954	0	0	0	0	0	0	0	0	0	0	0	0	0	0	0	0
"NTN5"	2401	10524	0	0	0	0	0	0	100	33	0	0	0	0	0	0	0	0
"NTNG1"	4708	269660	0	0	0	0	0	0	0	0	0	0	0	0	0	0	0	0
"NTNG2"	3099	80888	1	0	0	1	0	0	348	197	0	0	0	0	0	0	0	0
"NTRK1"	2672	20973	0	0	0	0	0	0	495	110	0	0	5	4	7	11	3	0
"NTRK2"	8338	208219	0	0	0	0	0	0	8	0	0	0	0	0	0	0	0	0
"NTRK3"	3996	279067	0	0	0	0	0	0	209	33	0	0	0	0	0	0	0	0
"NTS"	1234	8690	0	0	0	0	0	0	0	0	0	0	0	0	0	0	0	0
"NTSR1"	4135	53935	1	0	1	0	0	0	354	159	0	0	0	0	0	0	0	0
"NTSR2"	1611	12026	0	0	0	0	0	0	0	0	0	0	0	0	0	0	0	0
"NUAK1"	6828	76688	0	0	0	0	0	0	0	10	0	0	0	0	0	0	0	0
"NUAK2"	3406	19692	38	0	17	21	0	0	110	87	0	15	187	129	251	125	226	52
"NUB1"	3871	18107	3012	18950	1645	1367	9989	8961	660	6947	291	12288	2140	8176	2525	5447	2931	2917
"NUBP1"	1243	25512	1218	330	715	503	166	164	577	289	707	532	1086	883	876	804	1439	781
"NUBP2"	1767	6169	110	17	68	42	11	6	149	29	89	0	472	338	646	488	791	483
"NUBPL"	3057	299828	98	6	65	33	0	6	168	87	0	0	74	69	42	36	54	12
"NUCB1"	2315	22958	676	200	343	333	103	97	657	191	766	100	5021	2524	5553	4879	8093	5590
"NUCB2"	1939	50672	6	17	6	0	1	16	0	0	0	0	227	267	236	236	149	139
"NUCKS1"	6460	37416	2998	1000	1687	1311	528	472	1267	305	1091	650	6091	6266	5912	4530	6886	4002
"NUDC"	1508	24665	164	11	73	91	0	11	386	161	0	89	464	517	1403	1212	1518	1231
"NUDCD1"	4055	93203	335	9	214	121	0	9	180	23	35	85	399	561	370	332	410	322
"NUDCD2"	951	6558	7	16	7	0	16	0	10	12	0	0	217	217	227	194	184	164
"NUDCD3"	4921	108420	3508	652	2000	1508	308	344	2324	566	1284	800	2956	2931	1262	987	1674	1058
"NUDT1"	791	8925	4024	2598	1442	2582	1354	1244	611	818	1450	2695	301	1619	161	137	245	205
"NUDT10"	1996	5288	0	0	0	0	0	0	16	0	0	0	0	0	0	0	0	0
"NUDT11"	4912	25323	1011	44	549	462	29	15	622	12	211	15	917	446	2485	975	2789	1303
"NUDT12"	3494	13935	0	0	0	0	0	0	0	0	0	0	127	197	130	45	28	4
"NUDT13"	2185	21372	1175	2126	631	544	1054	1072	561	1196	201	2017	174	183	177	139	218	87
"NUDT14"	869	8385	327	97	197	130	49	48	310	208	253	110	150	307	499	289	924	502
"NUDT15"	2025	9581	127	0	85	42	0	0	85	0	0	14	276	260	181	148	189	135
"NUDT16"	3448	4293	834	168	461	373	101	67	404	57	421	73	2635	2100	3369	1984	4643	2524
"NUDT16L1"	2045	2142	111	31	70	41	16	15	80	100	52	79	472	297	525	468	704	543
"NUDT16P"	2336	3249	131	0	69	62	0	0	200	0	49	0	1210	934	775	419	1027	480
"NUDT17"	1098	2943	48	3	30	18	0	3	69	44	0	0	179	144	217	183	314	140
"NUDT18"	2283	3074	110	0	35	75	0	0	66	0	0	0	397	49	71	15	97	44
"NUDT19"	2969	21836	675	129	369	306	99	30	458	216	96	308	1171	971	418	332	755	370
"NUDT2"	1064	14193	367	50	232	135	29	21	340	52	0	0	295	207	286	258	393	253
"NUDT21"	4413	22214	332	53	183	149	40	13	225	77	37	0	1794	1827	1658	1270	442	1193
"NUDT22"	1123	3751	454	57	275	179	19	38	381	54	216	22	816	240	602	454	1500	538
"NUDT3"	1354	104441	7573	3242	4308	3265	1914	1328	4401	1930	3330	3191	5474	253	245	1010	269	1047
"NUDT4"	4816	25323	1011	44	549	462	29	15	622	12	211	15	917	446	2485	975	2789	1303
"NUDT5"	1213	28571	509	49	222	287	32	17	320	8	53	34	1305	600	774	631	1468	722
"NUDT6"	1166	29956	0	0	0	0	0	0	14	0	0	0	107	69	87	46	42	59
"NUDT7"	1470	4282	23	0	11	12	0	0	57	0	0	0	179	165	135	77	190	109
"NUDT8"	811	1993	0	0	0	0	0	0	0	0	0	0	29	31	18	10	44	21
"NUDT9"	1708	35764	63	10	36	27	10	0	53	22	0	21	423	406	695	642	637	529
"NUDT9P1"	1078	1078	0	0	0	0	0	0	0	0	0	0	0	0	0	0	0	0
"NUF2"	2003	33832	0	0	0	0	0	0	0	0	0	0	6	6	0	4	6	0
"NUFIP1"	3497	50231	0	91	0	0	56	35	17	195	0	78	10	48	103	175	107	100
"NUFIP2"	10883	38313	7565	4173	4247	3318	2272	1901	3703	2164	5560	5145	5802	4401	7785	4228	7512	3264
"NUMA1"	7265	77664	5734	3483	2423	3311	1863	1620	2983	1473	4574	2563	7912	7087	5585	8480	14444	8436
"NUMA1 variant protein"	5479	9073	2198	1815	12	2186	689	1126	1897	1204	1099	2238	7123	6367	455	1164	7933	7347
"NUMB"	3657	183370	10868	31195	6117	4751	16927	14268	4391	15253	2605	35365	2640	2871	1171	1237	1374	2270
"NUMBL"	3567	24744	354	0	215	139	0	0	280	124	462	43	311	256	298	158	406	236
"NUP107"	3193	55239	526	584	307	219	311	273	262	245	60	405	796	1122	736	814	713	661
"NUP133"	4195	67045	650	64	341	309	31	33	354	74	18	115	844	963	1057	901	1153	795
"NUP153"	5803	91551	2424	1724	1338	1086	952	772	1186	1153	176	1831	1780	2042	1981	1628	2167	1265
"NUP155"	4390	79258	113	4	43	70	4	0	107	18	0	31	426	426	573	408	567	310
"NUP160"	5433	70388	960	185	512	448	111	74	799	324	454	318	1493	1398	1959	1602	1680	1066
"NUP188"	5733	59399	1713	2549	803	910	1424	1125	783	1779	482	3518	2989	4351	1940	3243	4677	3350
"NUP205"	6298	90829	981	363	550	431	178	185	503	210	351	212	1347	1469	1724	1553	2007	1241
"NUP210"	7231	104074	2865	432	1531	1334	282	150	2593	772	2078	905	1468	2188	1918	1862	2780	2969
"NUP210L"	5920	162424	47	16	26	21	1	15	24	30	1	76	0	0	0	0	0	0
"NUP214"	6636	108111	1715	585	897	818	288	297	1625	540	464	859	1473	1319	1575	1309	2023	1344
"NUP35"	1765	37326	29	0	19	10	0	0	94	9	0	55	83	86	124	156	150	95
"NUP37"	1212	44388	0	0	0	0	0	0	56	0	0	0	263	247	261	181	292	192
"NUP43"	3854	22231	322	100	132	190	56	44	193	44	88	55	325	985	733	475	800	428
"NUP50"	5386	24164	11100	457	5258	5842	214	243	964	260	2239	264	2057	1379	2526	1176	2773	1088
"NUP54"	2365	33839	394	227	201	193	119	108	294	398	27	315	660	915	688	701	714	626
"NUP62"	3418	22702	5541	9558	3082	2459	4825	4733	1710	1051	4199	11644	5317	10770	4815	8594	6152	6077
"NUP62CL"	1770	83014	0	0	0	0	0	0	0	0	0	0	0	0	0	0	0	0
"NUP85"	2330	30259	955	63	556	399	39	24	705	101	356	153	693	607	1033	751	1072	716
"NUP88"	2423	33578	1701	477	945	756	251	226	960	299	123	961	566	2829	2813	2530	3090	2366
"NUP93"	2758	114661	2714	1475	1449	1265	808	667	1518	1281	311	2328	1597	1647	1617	1414	2038	1384
"NUP98"	6875	122653	6285	19277	3605	2680	10279	8998	2496	9160	1784	23925	3681	5513	4440	4868	5566	3863
"NUPL1"	6476	34814	1818	3839	977	841	2077	1762	816	1632	160	2499	1627	4109	2084	3160	1992	1878
"NUPL2"	2532	6609	1346	503	771	575	260	243	550	217	457	147	1001	771	850	569	1116	542
"NUPR1"	915	1835	0	0	0	0	0	0	0	14	0	0	0	0	0	0	0	4
"NUS1"	4810	35269	1250	691	721	529	363	328	640	840	0	828	1027	1447	2666	3385	2416	2015
"NUSAP1"	2430	48323	5	0	5	0	0	0	0	0	0	0	131	181	159	107	193	116
"NUTF2"	890	24401	216	19	120	96	19	0	230	101	0	100	700	644	972	881	1231	862
"NVL"	2928	102837	619	68	374	245	45	23	462	67	50	59	365	368	495	343	524	310
"NWD1"	8423	97988	0	0	0	0	0	0	17	0	0	0	0	0	0	0	0	0
"NXF1"	4167	13368	3147	3421	1680	1467	1883	1538	935	1787	1721	2956	2733	4388	3445	4671	5011	3625
"NXF2"	3883	111355	0	0	0	0	0	0	0	0	0	0	0	0	0	0	0	0
"NXF2B"	3992	111355	0	0	0	0	0	0	0	0	0	0	0	0	0	0	0	0
"NXF3"	1913	17272	0	0	0	0	0	0	0	0	0	0	0	0	0	0	0	0
"NXF4"	3632	21730	0	0	0	0	0	0	0	0	0	0	0	0	0	0	0	0
"NXF5"	2081	25466	0	0	0	0	0	0	0	0	0	0	0	0	0	0	0	0
"NXN"	3011	180426	36	395	36	0	225	170	413	1537	0	195	0	2	0	42	0	0
"NXNL1"	908	5491	0	0	0	0	0	0	0	0	0	0	0	0	0	0	0	0
"NXNL2"	1463	40689	0	0	0	0	0	0	0	0	0	0	0	0	0	0	0	0
"NXPH1"	2923	319009	0	0	0	0	0	0	36	0	0	0	0	0	0	0	0	0
"NXPH2"	2560	111084	0	0	0	0	0	0	0	0	0	0	0	0	0	0	0	0
"NXPH3"	5552	7873	0	0	0	0	0	0	70	22	0	0	69	17	128	60	194	102
"NXPH4"	1805	9655	2	0	1	1	0	0	109	56	0	0	0	0	0	0	0	0
"NXT1"	1119	4037	0	0	0	0	0	0	23	0	0	0	163	179	230	226	233	192
"NXT2"	2697	8905	0	0	0	0	0	0	0	0	0	0	475	520	379	348	397	289
"NY-CO-1"	1810	36337	4120	2579	2335	1785	1341	1238	1549	1285	1595	2415	843	975	861	687	857	548
"NY-CO-7"	1694	2654	239	58	138	101	30	28	160	70	113	66	1830	1601	2100	1681	2489	1849
"NY-CO-8"	2135	244074	11700	7391	6596	5104	4217	3174	6124	3588	1903	3153	1024	1087	743	712	927	642
"NYX"	2631	28194	0	0	0	0	0	0	0	0	0	0	0	0	0	0	0	0
"Na+ channel"	3367	61360	0	0	0	0	0	0	0	0	0	0	0	2	0	0	0	0
"Nbla00301"	3276	11474	0	0	0	0	0	0	0	0	0	0	0	0	0	0	0	0
"Nbla00307"	2717	94883	496	41	294	202	32	9	881	66	0	16	1233	1409	1507	1247	1486	1080
"Nbla00360"	5880	64189	1859	2053	1025	834	1079	974	1022	1477	193	2195	1207	2257	1056	1826	1352	1324
"Nbla00487"	2848	17785	139	32	83	56	29	3	199	89	12	42	41	113	99	147	143	39
"Nbla00526"	3855	160521	7594	2575	4173	3421	1467	1108	3472	1601	3630	2707	723	726	846	590	815	483
"Nbla00537"	3042	24868	217	54	129	88	29	25	134	38	0	34	190	255	4505	4300	6772	3488
"Nbla00761"	3060	142101	0	0	0	0	0	0	0	0	0	0	0	0	0	0	0	0
"Nbla03267"	3933	58635	0	20	0	0	12	8	12	21	0	0	0	0	0	0	0	0
"Nbla03831"	1609	13949	12	0	12	0	0	0	15	0	0	0	98	105	88	59	104	62
"Nbla04300"	6196	181602	5627	1576	3263	2364	868	708	3841	1160	981	1087	982	1401	1056	990	1210	949
"Nbla10058"	1437	20568	251	135	113	138	73	62	227	96	55	127	1247	1773	2788	1977	2436	1871
"Nbla10143"	3032	56283	0	0	0	0	0	0	13	0	0	0	4	0	0	0	0	0
"Nbla10230/alpha-L-fucosidase"	1082	13973	28	0	11	17	0	0	4	0	0	0	231	114	474	451	451	279
"Nbla10300"	3450	40414	10857	9855	6731	4126	5287	4568	3473	3190	4369	5953	5155	7032	6135	5098	7733	4493
"Nbla10314"	4436	13003	8699	4284	4913	3786	2301	1983	4609	3364	3111	5476	678	581	936	680	968	442
"Nbla10317"	1599	9806	0	3	0	0	0	3	40	50	0	0	734	724	865	843	1115	773
"Nbla10383"	2951	127609	1303	330	763	540	191	139	993	468	102	470	100	144	330	268	394	154
"Nbla10535"	2289	12567	2205	857	1173	1032	484	373	503	558	1406	1548	2980	1401	1569	2025	3878	2270
"Nkx-2.5"	1043	2290	0	0	0	0	0	0	0	0	0	0	0	0	0	0	0	0
"Nucb2"	1170	34595	0	21	0	0	4	17	0	0	0	1	138	116	123	122	82	78
"Nup88"	1187	25262	2966	1505	1595	1371	823	682	1321	583	1403	1490	952	3359	2957	3134	3959	2875
"O1/O11 and JK2"	372	742	0	0	0	0	0	0	0	0	0	0	0	0	0	0	0	0
"OACT2"	1535	143135	568	14	353	215	6	8	1279	70	121	0	368	411	269	197	481	230
"OAF"	1865	18904	169	27	96	73	15	12	356	139	118	55	380	270	286	289	468	330
"OAS1"	1668	12974	86	0	58	28	0	0	400	67	0	0	375	334	2193	1068	1301	906
"OAS2"	3657	32231	357	3569	196	161	1891	1678	233	2605	0	501	846	2562	3358	1034	1427	1190
"OAS3"	6641	34805	275	295	232	43	166	129	349	799	109	173	505	792	3120	1109	1245	1164
"OASIS"	1831	5760	0	0	0	0	0	0	40	20	0	0	0	0	0	0	0	0
"OASL"	1826	18687	3608	18715	2074	1534	10068	8647	11	11436	11	10474	30	20181	152	10280	88	3499
"OAT"	3929	21649	0	0	0	0	0	0	16	0	0	0	1361	1459	873	867	1164	948
"OATL1"	3889	22924	65	31	36	29	17	14	77	42	0	0	469	432	522	386	653	479
"OATP"	7430	130838	0	0	0	0	0	0	0	0	0	0	0	0	0	0	0	0
"OATP-E"	2320	29417	0	0	0	0	0	0	268	198	0	0	63	55	126	330	60	139
"OATPRP4"	2867	160836	274538	0	251	274287	0	0	22	48	0	150	0	17	10	5	13	4
"OAZ1"	1174	3968	831	265	416	415	167	98	175	293	341	331	14678	16615	18020	18727	20195	14319
"OAZ2"	1921	15691	3012	1687	1838	1174	854	833	919	951	1703	2083	2801	2980	2780	3621	1428	2423
"OAZ3"	891	4676	21	0	21	0	0	0	63	14	0	0	333	468	274	285	335	224
"OBFC1"	6575	40727	70	10	27	43	0	10	132	8	0	15	406	363	287	202	435	199
"OBFC2A"	3854	10388	11117	40033	6119	4998	20611	19422	3493	18332	2712	20020	3837	28415	4986	13797	5043	6408
"OBFC2B"	1687	5403	0	0	0	0	0	0	32	18	0	0	178	184	165	176	161	173
"OBP2A"	695	3831	0	0	0	0	0	0	17	0	0	0	0	0	0	0	0	0
"OBP2B"	695	3963	0	0	0	0	0	0	37	0	0	0	0	0	0	0	0	0
"OBP2C"	760	3831	0	0	0	0	0	0	37	0	0	0	0	0	0	0	0	0
"OBPIIa"	744	3831	0	0	0	0	0	0	17	0	0	0	0	0	0	0	0	0
"OBPIIb"	802	3963	0	0	0	0	0	0	20	0	0	0	0	0	0	0	0	0
"OBSCN"	24135	170716	103	2	70	33	2	0	1148	505	0	36	67	108	80	41	555	328
"OBSL1"	5860	20547	0	0	0	0	0	0	158	135	0	0	0	0	0	0	10	0
"OC90"	1796	35162	0	0	0	0	0	0	0	0	0	0	0	1	0	0	0	0
"OCA2"	3160	344435	0	0	0	0	0	0	88	13	0	0	0	0	0	0	0	0
"OCEL1"	1096	2974	20	0	2	18	0	0	67	32	0	0	312	245	239	172	401	258
"OCIA"	1298	25438	1023	377	614	409	215	162	463	168	76	315	1616	1318	1415	1280	1902	961
"OCIAD1"	2303	30818	1110	430	642	468	242	188	511	179	76	315	2623	2501	2326	1961	3016	1846
"OCIAD2"	769	21410	0	0	0	0	0	0	0	0	0	0	3	15	11	7	15	8
"OCIM"	596	94829	0	0	0	0	0	0	117	12	0	0	0	0	0	0	0	0
"OCLM"	884	884	111	69	48	63	41	28	17	52	0	54	0	19	0	0	0	0
"OCLN"	2646	62013	0	0	0	0	0	0	0	0	0	0	8	22	17	14	40	5
"OCM"	699	5566	0	0	0	0	0	0	0	0	0	0	0	0	0	0	0	0
"OCM2"	589	5403	0	0	0	0	0	0	0	0	0	0	0	0	0	0	0	0
"OCRL"	5176	52278	246	67	145	101	34	33	170	47	127	33	620	781	834	783	999	669
"OCSP"	1888	6431	1	0	1	0	0	0	14	24	0	0	0	0	0	0	0	0
"OCT11"	3026	79704	0	0	0	0	0	0	9	11	0	0	0	1	0	0	0	0
"OCTM4"	1587	19047	74	15	46	28	15	0	216	69	12	58	2040	1644	1444	1293	837	747
"OCTN1"	1045	31980	529	71	313	216	38	33	516	72	0	0	97	63	66	27	85	24
"ODAM"	1298	8050	0	0	0	0	0	0	0	0	0	0	0	0	0	0	0	0
"ODC1"	2174	7400	44	0	33	11	0	0	27	82	9	0	1185	937	1201	857	820	625
"ODF1"	996	9399	0	0	0	0	0	0	0	0	0	0	0	0	0	0	0	0
"ODF2"	3730	44808	268	39	136	132	15	24	275	168	104	65	661	545	1117	961	1025	869
"ODF2L"	5731	47593	83	31	36	47	16	15	132	24	0	5	87	111	83	59	105	60
"ODF3"	3051	3463	0	0	0	0	0	0	36	9	0	0	0	0	0	0	0	0
"ODF3B"	977	2172	92	253	7	85	116	137	24	162	57	263	4601	77	99	79	112	15
"ODF3L1"	1197	3710	0	0	0	0	0	0	0	0	0	0	0	0	0	0	0	0
"ODF3L2"	1607	11638	0	0	0	0	0	0	31	52	0	0	0	0	0	0	0	0
"ODF4"	1152	6177	0	0	0	0	0	0	0	0	0	0	0	0	0	0	0	0
"ODZ1"	12924	587911	0	0	0	0	0	0	0	0	0	0	0	0	0	0	0	0
"ODZ2"	9673	979320	0	0	0	0	0	0	34	24	0	0	0	0	0	0	0	0
"ODZ3"	10875	479080	0	0	0	0	0	0	0	0	0	0	0	0	0	0	0	0
"ODZ4"	13581	787368	0	0	0	0	0	0	51	17	0	0	0	0	0	0	0	0
"OFCC1"	1042	164056	0	0	0	0	0	0	10	8	0	0	0	0	0	0	0	0
"OFD1"	4415	34649	339	72	232	107	41	31	135	32	138	9	350	276	372	290	531	289
"OGDH"	4274	102499	9542	9618	5350	4192	5144	4474	3692	3779	4904	10855	4705	4436	4437	4651	5819	4361
"OGDHL"	3784	27739	0	0	0	0	0	0	100	38	0	0	0	0	0	0	0	0
"OGFOD1"	3032	25984	45	0	15	30	0	0	128	28	14	34	776	594	526	490	714	356
"OGFOD2"	2723	5236	312	31	163	149	31	0	295	74	203	0	381	205	292	163	560	190
"OGFR"	4510	8115	1312	160	694	618	78	82	477	208	596	85	2603	1409	3236	1558	4594	2263
"OGFRL1"	2004	13755	10178	4849	5851	4327	2116	2733	5517	2992	153	1401	5214	7877	2349	3320	12753	5109
"OGG1"	2259	16726	1236	243	1014	222	128	115	689	175	1092	132	3431	2893	3744	3084	4539	2879
"OGG1 type 1e"	759	5635	246	0	246	0	0	0	91	35	0	43	1373	945	27	593	865	613
"OGN"	3072	20688	1213	1120	664	549	579	541	441	265	25	374	0	0	0	0	0	1
"OGT"	5476	42809	10327	13996	5508	4819	6953	7043	4684	6744	6720	12607	6618	9754	8436	10404	11130	6426
"OIP5"	1239	23353	22	0	11	11	0	0	10	0	0	0	19	11	2	0	5	0
"OIT3"	2370	39450	0	0	0	0	0	0	0	0	0	0	0	0	0	0	0	0
"OK/KNS-cl.4"	5359	113063	0	0	0	0	0	0	0	0	0	0	0	0	0	0	0	0
"OK/KNS-cl.6"	1551	2569	531	422	293	238	224	198	134	348	95	230	3871	3692	15589	15287	20261	16671
"OK/SW-cl.10"	1893	69649	1862	213	1068	794	107	106	1644	284	680	303	694	535	1083	796	1103	728
"OK/SW-cl.100"	1494	15023	1589	68	859	730	39	29	597	141	1642	290	4298	1390	4774	1025	5784	1392
"OK/SW-cl.103"	696	4823	256	308	162	94	153	155	196	231	53	373	270	545	6036	5805	7535	6498
"OK/SW-cl.108"	798	10867	0	0	0	0	0	0	0	0	0	0	0	0	0	0	0	0
"OK/SW-cl.110"	2472	22658	1671	389	973	698	187	202	945	304	865	430	7609	5752	12123	11729	13307	11476
"OK/SW-cl.16"	1328	1328	0	0	0	0	0	0	0	0	0	0	0	0	0	0	0	0
"OK/SW-cl.18"	5090	63328	916	0	528	388	0	0	849	19	0	22	574	580	535	597	550	446
"OK/SW-cl.20"	1792	38118	4506	6147	2739	1767	3456	2691	1636	3125	2587	8012	2705	4201	1814	2296	1613	1441
"OK/SW-cl.27"	914	5871	205	171	145	60	110	61	42	63	0	74	2409	1860	1185	1346	1727	1545
"OK/SW-cl.45"	2084	9779	1103	378	592	511	216	162	392	170	352	369	5407	4765	6208	5138	5652	3859
"OK/SW-cl.46"	951	2760	1155	2062	18	1137	17	2045	209	812	0	296	4825	4019	7982	8226	13561	8180
"OK/SW-cl.48"	1788	8376	1281	1227	864	417	733	494	390	580	480	910	9335	8897	7663	8808	11805	8806
"OK/SW-cl.5"	3085	27947	9002	9165	4998	4004	4904	4261	2719	3530	5519	7645	17328	20231	18363	19138	24728	18195
"OK/SW-cl.6"	3315	25627	1270	2730	706	564	1482	1248	759	1711	136	2676	2974	12418	9983	22009	10137	11961
"OK/SW-cl.69"	2270	26300	2974	729	1633	1341	390	339	1310	829	2924	1569	3103	2486	4740	4084	4627	3221
"OK/SW-cl.8"	1259	7200	168	357	99	69	185	172	40	132	0	221	4252	4951	5302	4099	5638	3047
"OK/SW-cl.81"	1021	4209	120	94	75	45	44	50	68	122	51	206	2855	3559	3839	4646	4717	4121
"OK/SW-cl.82"	580	7381	299	310	151	148	179	131	191	223	229	431	2574	2978	3991	4096	8011	4311
"OK/SW-cl.85"	2498	65318	1568	390	881	687	244	146	988	253	389	337	456	677	533	501	712	426
"OK/SW-cl.9"	972	14371	750	112	430	320	35	77	523	82	663	184	1056	816	778	726	1382	877
"OLA1"	4373	176191	8143	13627	4528	3615	7637	5990	3487	7113	1306	9979	520	1082	1255	1166	1752	1230
"OLAH"	1843	29958	0	0	0	0	0	0	0	0	0	0	0	0	0	0	0	0
"OLFM1"	2900	15547	0	0	0	0	0	0	239	57	0	0	0	0	0	0	3	0
"OLFM2"	1866	82677	80	3611	38	42	1930	1681	189	1671	0	2007	98	269	9	225	35	63
"OLFM3"	3530	194665	0	0	0	0	0	0	0	0	0	0	0	0	0	0	0	0
"OLFM4"	2818	23216	0	0	0	0	0	0	0	8	0	0	0	0	0	0	0	0
"OLFML1"	2706	25808	12	1	0	12	1	0	28	27	0	16	0	0	1	0	0	0
"OLFML2A"	6546	37722	0	0	0	0	0	0	47	68	0	0	0	0	0	0	0	0
"OLFML2B"	3169	40662	0	0	0	0	0	0	76	0	0	0	87	92	103	100	51	17
"OLFML3"	1970	2847	0	0	0	0	0	0	0	11	0	17	155	139	135	102	190	144
"OLIG1"	2279	2279	0	0	0	0	0	0	0	0	0	0	0	0	0	0	0	0
"OLIG2"	2490	3263	0	0	0	0	0	0	0	0	0	0	0	0	0	0	0	0
"OLIG3"	2197	2197	0	0	0	0	0	0	0	0	0	0	0	0	0	0	0	0
"OLR1"	2522	13893	0	0	0	0	0	0	0	26	0	21	63	89	218	794	106	421
"OLT-2"	902	11435	0	0	0	0	0	0	0	0	0	0	0	0	0	0	0	0
"OMA1"	1917	66056	36	0	17	19	0	0	139	11	48	0	162	284	207	232	194	155
"OMD"	2544	10310	778	438	470	308	255	183	209	166	38	73	0	0	0	0	0	0
"OMG"	1896	2713	393	161	229	164	88	73	153	70	112	167	64	40	56	1	68	21
"OMP"	492	492	0	0	0	0	0	0	38	0	0	0	1	0	0	0	0	0
"ONECUT1"	1927	32858	0	0	0	0	0	0	11	0	0	0	0	0	0	0	0	0
"ONECUT2"	16123	55614	0	0	0	0	0	0	10	0	0	0	0	0	0	0	0	0
"ONECUT3"	1486	21783	0	0	0	0	0	0	183	103	0	0	1	0	0	0	0	0
"OOEP"	1007	26536	0	0	0	0	0	0	0	0	0	0	0	0	0	0	0	0
"OPA1"	6523	104668	4597	2113	2563	2034	1142	971	2567	1373	601	1483	3073	3374	3028	2377	3246	2163
"OPA3"	5002	35712	1311	2540	756	555	1620	920	719	2568	343	9665	4903	9479	770	1123	931	962
"OPALIN"	3632	16117	1	0	1	0	0	0	0	0	0	0	0	0	0	0	0	0
"OPCML"	6419	1117528	0	0	0	0	0	0	144	73	0	0	0	0	0	0	0	0
"OPHN1"	7554	391113	96	43	50	46	43	0	76	57	0	0	1061	1208	61	50	84	24
"OPLAH"	4037	9419	250	97	136	114	37	60	163	107	96	105	634	626	405	403	847	516
"OPN1LW"	1238	14782	0	0	0	0	0	0	26	0	0	0	0	0	0	0	0	0
"OPN1MW"	2003	14268	0	0	0	0	0	0	0	0	0	0	6	10	0	0	0	0
"OPN1SW"	1101	3301	0	0	0	0	0	0	59	8	0	0	2847	2987	4149	107	90	55
"OPN3"	2635	47250	3423	9618	1899	1524	5234	4384	1725	9418	412	22028	2681	7636	1982	3044	2350	2023
"OPN4"	2414	11902	0	0	0	0	0	0	136	93	0	0	0	0	0	0	0	0
"OPN5"	3464	44318	0	0	0	0	0	0	0	0	0	0	0	0	0	0	0	0
"OPRD1"	1777	51556	0	0	0	0	0	0	12	0	0	0	0	0	0	0	0	0
"OPRK1"	5138	25920	0	0	0	0	0	0	0	0	0	0	0	0	0	0	0	0
"OPRL1"	3359	20505	350	0	137	213	0	0	687	164	724	151	390	259	364	228	779	338
"OPRM1"	2953	32954	17574	9327	9883	7691	5142	4185	9242	3621	7211	5532	6856	7123	4198	1919	6607	3246
"OPTC"	1452	14808	0	0	0	0	0	0	39	0	0	0	0	0	0	0	0	0
"OPTN"	3613	38196	118	740	50	68	452	288	37	482	0	913	463	683	788	969	746	702
"OR10A2"	913	913	0	0	0	0	0	0	0	0	0	0	0	0	0	0	0	0
"OR10A3"	945	945	0	0	0	0	0	0	0	0	0	0	0	0	0	0	0	0
"OR10A4"	948	948	0	0	0	0	0	0	0	0	0	0	0	0	0	0	0	0
"OR10A5"	955	955	0	0	0	0	0	0	0	0	0	0	0	0	0	0	0	0
"OR10A6"	945	945	0	0	0	0	0	0	0	0	0	0	0	0	0	0	0	0
"OR10A7"	951	951	0	0	0	0	0	0	0	0	0	0	0	0	0	0	0	0
"OR10AD1"	955	955	60	0	34	26	0	0	8	0	0	0	0	0	0	0	0	0
"OR10AG1"	906	906	0	0	0	0	0	0	0	0	0	0	0	0	0	0	0	0
"OR10C1"	939	939	0	0	0	0	0	0	0	0	0	0	0	0	0	0	0	0
"OR10G2"	933	933	0	0	0	0	0	0	0	0	0	0	0	0	0	0	0	0
"OR10G3"	942	942	0	0	0	0	0	0	0	0	0	0	0	0	0	0	0	0
"OR10G4"	935	935	0	0	0	0	0	0	0	0	0	0	0	0	0	0	0	0
"OR10G7"	937	937	0	0	0	0	0	0	0	0	0	0	0	0	0	0	0	0
"OR10G8"	937	937	0	0	0	0	0	0	0	0	0	0	0	0	0	0	0	0
"OR10G9"	935	935	0	0	0	0	0	0	0	0	0	0	0	0	0	0	0	0
"OR10H1"	1121	1121	0	0	0	0	0	0	14	0	0	0	0	0	0	0	0	0
"OR10H2"	1030	1030	0	0	0	0	0	0	0	0	0	0	0	0	0	0	0	0
"OR10H3"	950	950	0	0	0	0	0	0	0	0	0	0	0	0	0	0	0	0
"OR10H4"	951	951	0	0	0	0	0	0	0	0	0	0	0	0	0	0	0	0
"OR10H5"	948	948	0	0	0	0	0	0	12	0	0	0	0	0	0	0	0	0
"OR10J1"	963	963	0	0	0	0	0	0	0	0	0	0	0	0	0	0	0	0
"OR10J3"	989	989	0	0	0	0	0	0	0	0	0	0	0	0	0	0	0	0
"OR10J5"	929	929	0	0	0	0	0	0	0	0	0	0	0	0	0	0	0	0
"OR10K1"	941	941	0	0	0	0	0	0	0	0	0	0	0	0	0	0	0	0
"OR10K2"	938	938	0	0	0	0	0	0	0	0	0	0	1	0	0	0	0	0
"OR10P1"	942	942	0	0	0	0	0	0	0	0	0	0	0	1	0	0	0	0
"OR10Q1"	960	960	0	0	0	0	0	0	0	0	0	0	0	0	0	0	0	0
"OR10R2"	1008	1008	0	0	0	0	0	0	0	0	0	0	0	0	0	0	0	0
"OR10S1"	997	997	0	0	0	0	0	0	0	0	0	0	0	0	0	0	0	0
"OR10T2"	944	944	0	0	0	0	0	0	0	0	0	0	0	0	0	0	0	0
"OR10V1"	931	931	0	0	0	0	0	0	0	0	0	0	0	0	0	0	0	0
"OR10W1"	1470	1470	0	0	0	0	0	0	0	0	0	0	0	0	0	0	0	0
"OR10X1"	973	973	0	0	0	0	0	0	0	0	0	0	0	0	0	0	0	0
"OR10Z1"	942	942	0	0	0	0	0	0	0	0	0	0	0	0	0	0	0	0
"OR11A1"	2230	2230	0	0	0	0	0	0	0	0	0	0	0	0	0	0	0	0
"OR11G2"	1037	1037	0	0	0	0	0	0	0	0	0	0	0	0	0	0	0	0
"OR11H1"	980	980	0	0	0	0	0	0	0	0	0	0	0	0	0	0	0	0
"OR11H12"	980	980	0	0	0	0	0	0	0	0	0	0	0	0	0	0	0	0
"OR11H4"	975	975	0	0	0	0	0	0	0	0	0	0	0	0	0	0	0	0
"OR11H6"	993	993	0	0	0	0	0	0	0	0	0	0	0	0	0	0	0	0
"OR11L1"	970	970	0	0	0	0	0	0	0	0	0	0	0	0	0	0	0	0
"OR12D2"	1033	1033	0	0	0	0	0	0	0	0	0	0	0	0	0	0	0	0
"OR12D3"	1870	1870	0	0	0	0	0	0	0	0	0	0	0	0	0	0	0	0
"OR13A1"	2082	12956	0	0	0	0	0	0	0	0	0	0	0	0	0	0	0	0
"OR13C2"	957	957	0	0	0	0	0	0	0	0	0	0	0	0	0	0	0	0
"OR13C3"	1045	1045	0	0	0	0	0	0	0	0	0	0	0	0	0	0	0	0
"OR13C4"	956	956	0	0	0	0	0	0	0	0	0	0	0	0	0	0	0	0
"OR13C5"	956	956	0	0	0	0	0	0	0	0	0	0	0	0	0	0	0	0
"OR13C8"	963	963	0	0	0	0	0	0	0	0	0	0	0	0	0	0	0	0
"OR13C9"	957	957	0	0	0	0	0	0	0	0	0	0	0	0	0	0	0	0
"OR13D1"	1041	1041	0	0	0	0	0	0	0	0	0	0	0	0	0	0	0	0
"OR13F1"	959	959	0	0	0	0	0	0	0	0	0	0	0	0	0	0	0	0
"OR13G1"	925	925	0	0	0	0	0	0	0	0	0	0	0	0	0	0	0	0
"OR13H1"	927	927	0	0	0	0	0	0	0	0	0	0	0	0	0	0	0	0
"OR13J1"	939	939	0	0	0	0	0	0	0	0	0	0	0	0	0	0	0	0
"OR14A16"	931	931	0	0	0	0	0	0	0	0	0	0	0	0	0	0	0	0
"OR14C36"	938	938	0	0	0	0	0	0	0	0	0	0	0	0	0	0	0	0
"OR14I1"	937	937	0	0	0	0	0	0	0	0	0	0	0	0	0	0	0	0
"OR14J1"	966	966	0	0	0	0	0	0	0	0	0	0	0	0	0	0	0	0
"OR1A1"	929	929	0	0	0	0	0	0	0	0	0	0	0	0	0	0	0	0
"OR1A2"	931	931	0	0	0	0	0	0	0	0	0	0	0	0	0	0	0	0
"OR1B1"	957	957	0	0	0	0	0	0	0	0	0	0	0	0	0	0	0	0
"OR1C1"	944	944	0	0	0	0	0	0	0	0	0	0	0	0	0	0	0	0
"OR1D2"	939	939	0	0	0	0	0	0	0	0	0	0	0	0	0	0	0	0
"OR1D4"	993	993	0	0	0	0	0	0	0	0	0	0	0	0	0	0	0	0
"OR1E1"	946	946	0	0	0	0	0	0	0	0	0	0	0	0	0	0	0	0
"OR1E2"	972	972	0	0	0	0	0	0	0	0	0	0	0	0	0	0	0	0
"OR1F1"	939	939	0	0	0	0	0	0	0	0	0	0	0	0	0	0	0	0
"OR1F2"	984	984	0	0	0	0	0	0	0	0	0	0	0	0	0	0	0	0
"OR1G1"	943	943	0	0	0	0	0	0	0	0	0	0	0	0	0	0	0	0
"OR1I1"	1067	1067	0	0	0	0	0	0	0	0	0	0	0	0	0	0	0	0
"OR1J1"	969	969	0	0	0	0	0	0	0	0	0	0	0	0	0	0	0	0
"OR1J2"	4155	45538	0	0	0	0	0	0	0	2	0	0	0	0	0	0	0	0
"OR1J4"	942	942	0	0	0	0	0	0	0	0	0	0	0	0	0	0	0	0
"OR1K1"	951	951	0	0	0	0	0	0	0	0	0	0	0	0	0	0	0	0
"OR1L1"	1082	1082	0	0	0	0	0	0	0	0	0	0	0	0	0	0	0	0
"OR1L3"	975	975	0	0	0	0	0	0	0	0	0	0	0	0	0	0	0	0
"OR1L4"	937	937	0	0	0	0	0	0	0	0	0	0	0	0	0	0	0	0
"OR1L6"	1043	1043	0	0	0	0	0	0	0	0	0	0	0	0	0	0	0	0
"OR1L8"	931	931	0	0	0	0	0	0	0	0	0	0	0	0	0	0	0	0
"OR1M1"	942	942	0	0	0	0	0	0	0	0	0	0	0	0	0	0	0	0
"OR1N1"	937	937	0	0	0	0	0	0	0	0	0	0	0	0	0	0	0	0
"OR1N2"	993	993	0	0	0	0	0	0	0	0	0	0	0	0	0	0	0	0
"OR1Q1"	944	944	0	0	0	0	0	0	0	0	0	0	0	0	0	0	0	0
"OR1S1"	978	978	0	0	0	0	0	0	0	0	0	0	0	0	0	0	0	0
"OR1S2"	978	978	0	0	0	0	0	0	0	0	0	0	0	0	0	0	0	0
"OR2A1"	932	932	0	0	0	0	0	0	0	0	0	0	0	0	0	0	0	0
"OR2A12"	933	933	0	0	0	0	0	0	0	0	0	0	0	0	0	0	0	0
"OR2A14"	933	933	0	0	0	0	0	0	0	0	0	0	0	0	0	0	0	0
"OR2A2"	956	956	0	0	0	0	0	0	0	0	0	0	0	0	0	0	0	0
"OR2A25"	933	933	0	0	0	0	0	0	0	0	0	0	0	0	0	0	0	0
"OR2A4"	933	933	0	0	0	0	0	0	0	0	0	0	0	0	0	0	0	0
"OR2A42"	932	932	0	0	0	0	0	0	0	0	0	0	0	0	0	0	0	0
"OR2A5"	936	936	0	0	0	0	0	0	0	0	0	0	0	0	0	0	0	0
"OR2A7"	933	933	0	0	0	0	0	0	0	0	0	0	0	0	0	0	0	0
"OR2A9P"	1134	1134	0	0	0	0	0	0	0	0	0	0	0	0	0	0	0	0
"OR2AE1"	973	973	0	0	0	0	0	0	0	0	0	0	0	0	0	0	0	0
"OR2AG1"	952	952	0	0	0	0	0	0	0	0	0	0	0	0	0	0	0	0
"OR2AG2"	952	952	0	0	0	0	0	0	0	0	0	0	0	0	0	0	0	0
"OR2AK2"	1008	1008	0	0	0	0	0	0	0	0	0	0	0	0	0	0	0	0
"OR2AT4"	963	963	1	0	0	1	0	0	0	0	1	0	0	0	0	0	0	0
"OR2B11"	954	954	0	0	0	0	0	0	0	0	0	0	0	0	0	0	0	0
"OR2B2"	1074	1074	0	0	0	0	0	0	0	0	0	0	0	0	0	0	0	0
"OR2B3"	1107	1107	0	0	0	0	0	0	0	0	0	0	0	0	0	0	0	0
"OR2B6"	941	941	0	0	0	0	0	0	0	0	0	0	0	0	0	0	0	0
"OR2C1"	1037	1037	0	0	0	0	0	0	0	0	0	0	0	0	0	0	0	0
"OR2C3"	2743	3708	0	0	0	0	0	0	0	0	0	0	0	0	0	0	0	0
"OR2D2"	927	927	0	0	0	0	0	0	0	0	0	0	0	0	0	0	0	0
"OR2D3"	993	993	0	0	0	0	0	0	0	0	0	0	0	0	0	0	0	0
"OR2F1"	1090	1090	0	0	0	0	0	0	0	0	0	0	0	0	0	0	0	0
"OR2F2"	954	954	0	0	0	0	0	0	0	0	0	0	0	0	0	0	0	0
"OR2G2"	954	954	0	0	0	0	0	0	0	0	0	0	0	0	0	0	0	0
"OR2G3"	930	930	0	0	0	0	0	0	0	0	0	0	0	0	0	0	0	0
"OR2G6"	952	952	0	0	0	0	0	0	0	0	0	0	0	0	0	0	0	0
"OR2H1"	2997	5869	0	0	0	0	0	0	0	0	0	0	0	0	0	0	0	0
"OR2H2"	1064	1064	0	0	0	0	0	0	0	0	0	0	0	0	0	0	0	0
"OR2J2"	1041	1041	0	0	0	0	0	0	0	0	0	0	0	0	0	0	0	0
"OR2J3"	1796	62682	0	0	0	0	0	0	0	0	0	0	0	0	0	0	0	0
"OR2K2"	951	951	0	0	0	0	0	0	0	0	0	0	0	0	0	0	0	0
"OR2L13"	1886	163732	0	0	0	0	0	0	0	0	0	0	0	0	0	0	0	0
"OR2L2"	1134	1134	0	0	0	0	0	0	0	0	0	0	0	0	0	0	0	0
"OR2L3"	940	940	0	0	0	0	0	0	0	0	0	0	0	0	0	0	0	0
"OR2L5"	926	926	0	0	0	0	0	0	0	0	0	0	0	0	0	0	0	0
"OR2L8"	940	940	0	0	0	0	0	0	0	0	0	0	0	0	0	0	0	0
"OR2M2"	1043	1043	0	0	0	0	0	0	0	0	0	0	0	0	0	0	0	0
"OR2M3"	939	939	0	0	0	0	0	0	0	0	0	0	0	0	0	0	0	0
"OR2M4"	936	936	0	0	0	0	0	0	0	0	0	0	0	0	0	0	0	0
"OR2M5"	939	939	0	0	0	0	0	0	0	0	0	0	0	0	0	0	0	0
"OR2M7"	939	939	0	0	0	0	0	0	0	0	0	0	0	0	0	0	0	0
"OR2S2"	1047	1047	0	0	0	0	0	0	0	0	0	0	0	0	0	0	0	0
"OR2T1"	1110	1110	0	0	0	0	0	0	0	0	0	0	0	0	0	0	0	0
"OR2T10"	939	939	0	0	0	0	0	0	0	0	0	0	0	0	0	0	0	0
"OR2T11"	952	952	0	0	0	0	0	0	0	0	0	0	0	0	0	0	0	0
"OR2T12"	963	963	0	0	0	0	0	0	0	0	0	0	0	0	0	0	0	0
"OR2T2"	976	976	0	0	0	0	0	0	0	0	0	0	0	0	0	0	0	0
"OR2T27"	954	954	0	0	0	0	0	0	0	0	0	0	0	0	0	0	0	0
"OR2T29"	931	931	0	0	0	0	0	0	0	0	0	0	0	0	0	0	0	0
"OR2T3"	958	958	0	0	0	0	0	0	0	0	0	0	0	0	0	0	0	0
"OR2T33"	963	963	0	0	0	0	0	0	0	0	0	0	0	0	0	0	0	0
"OR2T34"	958	958	0	0	0	0	0	0	0	0	0	0	0	0	0	0	0	0
"OR2T35"	973	973	0	0	0	0	0	0	0	0	0	0	0	0	0	0	0	0
"OR2T4"	1048	1048	0	0	0	0	0	0	0	0	0	0	0	0	0	0	0	0
"OR2T5"	949	949	0	0	0	0	0	0	0	0	0	0	0	0	0	0	0	0
"OR2T6"	928	928	0	0	0	0	0	0	0	0	0	0	0	0	0	0	0	0
"OR2T8"	938	938	0	0	0	0	0	0	0	0	0	0	0	0	0	0	0	0
"OR2V2"	948	948	0	0	0	0	0	0	0	0	0	0	0	0	0	0	0	0
"OR2W1"	964	964	0	0	0	0	0	0	0	0	0	0	0	0	0	0	0	0
"OR2W3"	1526	28879	0	0	0	0	0	0	0	0	0	0	47	64	4	0	4	4
"OR2W5"	964	964	0	0	0	0	0	0	0	0	0	0	0	0	0	0	0	0
"OR2Y1"	937	937	0	0	0	0	0	0	0	0	0	0	0	0	0	0	0	0
"OR2Z1"	945	945	0	0	0	0	0	0	0	0	0	0	0	0	0	0	0	0
"OR3A1"	949	949	0	0	0	0	0	0	0	0	0	0	0	0	0	0	0	0
"OR3A2"	1085	1085	0	0	0	0	0	0	0	0	0	0	0	0	0	0	0	0
"OR3A3"	966	966	0	0	0	0	0	0	0	0	0	0	0	0	0	0	0	0
"OR3A4"	1203	1203	0	0	0	0	0	0	0	0	0	0	0	0	0	0	0	0
"OR4A15"	1035	1035	0	0	0	0	0	0	0	0	0	0	0	0	0	0	0	0
"OR4A16"	986	986	0	0	0	0	0	0	0	0	0	0	0	0	0	0	0	0
"OR4A47"	929	929	0	0	0	0	0	0	0	0	0	0	0	0	0	0	0	0
"OR4A5"	949	949	0	0	0	0	0	0	0	0	0	0	0	0	0	0	0	0
"OR4B1"	930	930	0	0	0	0	0	0	0	0	0	0	0	0	0	0	0	0
"OR4C11"	932	932	0	0	0	0	0	0	0	0	0	0	0	0	0	0	0	0
"OR4C12"	929	929	0	0	0	0	0	0	0	0	0	0	0	0	0	0	0	0
"OR4C13"	929	929	0	0	0	0	0	0	0	0	0	0	0	0	0	0	0	0
"OR4C15"	1112	1112	0	0	0	0	0	0	0	0	0	0	0	0	0	0	0	0
"OR4C16"	932	932	0	0	0	0	0	0	0	0	0	0	0	0	0	0	0	0
"OR4C3"	989	989	0	0	0	0	0	0	0	0	0	0	0	0	0	0	0	0
"OR4C45"	919	7099	0	0	0	0	0	0	0	0	0	0	0	0	0	0	0	0
"OR4C46"	929	929	0	0	0	0	0	0	0	0	0	0	0	0	0	0	0	0
"OR4C6"	1784	8416	0	0	0	0	0	0	0	0	0	0	0	0	0	0	0	0
"OR4D1"	932	932	0	0	0	0	0	0	0	0	0	0	0	0	0	0	0	0
"OR4D10"	937	937	0	0	0	0	0	0	0	0	0	0	0	0	0	0	0	0
"OR4D11"	937	937	0	0	0	0	0	0	0	0	0	0	0	0	0	0	0	0
"OR4D2"	924	924	0	0	0	0	0	0	0	0	0	0	0	0	0	0	0	0
"OR4D5"	958	958	0	0	0	0	0	0	0	0	0	0	0	0	0	0	0	0
"OR4D6"	945	945	0	0	0	0	0	0	0	0	0	0	0	0	0	0	0	0
"OR4D9"	944	944	0	0	0	0	0	0	0	0	0	0	0	0	0	0	0	0
"OR4E2"	941	941	0	0	0	0	0	0	0	0	0	0	0	0	0	0	0	0
"OR4F15"	938	938	0	0	0	0	0	0	0	0	0	0	0	0	0	0	0	0
"OR4F16"	938	938	0	0	0	0	0	0	0	0	0	0	0	0	0	0	0	0
"OR4F17"	919	919	0	0	0	0	0	0	0	0	0	0	0	0	0	0	0	0
"OR4F21"	938	938	0	0	0	0	0	0	0	0	0	0	0	0	0	0	0	0
"OR4F4"	919	919	0	0	0	0	0	0	0	0	0	0	0	0	0	0	0	0
"OR4F5"	919	919	0	0	0	0	0	0	0	0	0	0	0	0	0	0	0	0
"OR4F6"	938	938	0	0	0	0	0	0	0	0	0	0	0	0	0	0	0	0
"OR4K1"	937	937	0	0	0	0	0	0	0	0	0	0	0	0	0	0	0	0
"OR4K13"	914	914	0	0	0	0	0	0	0	0	0	0	0	0	0	0	0	0
"OR4K14"	933	933	0	0	0	0	0	0	0	0	0	0	0	0	0	0	0	0
"OR4K15"	1046	1046	0	0	0	0	0	0	0	0	0	0	0	0	0	0	0	0
"OR4K17"	1033	1033	0	0	0	0	0	0	0	0	0	0	0	0	0	0	0	0
"OR4K2"	946	946	0	0	0	0	0	0	0	0	0	0	0	0	0	0	0	0
"OR4K5"	971	971	0	0	0	0	0	0	0	0	0	0	0	0	0	0	0	0
"OR4L1"	940	940	0	0	0	0	0	0	0	0	0	0	0	0	0	0	0	0
"OR4M1"	942	942	0	0	0	0	0	0	0	0	0	0	0	0	0	0	0	0
"OR4M2"	942	942	0	0	0	0	0	0	0	0	0	0	0	0	0	0	0	0
"OR4N2"	933	933	0	0	0	0	0	0	0	0	0	0	0	0	0	0	0	0
"OR4N4"	2331	80633	0	0	0	0	0	0	0	0	0	0	0	0	0	0	0	0
"OR4N5"	927	927	0	0	0	0	0	0	0	0	0	0	0	0	0	0	0	0
"OR4P4"	939	939	0	0	0	0	0	0	0	0	0	0	0	0	0	0	0	0
"OR4Q3"	941	941	0	0	0	0	0	0	0	0	0	0	0	0	0	0	0	0
"OR4S1"	930	930	0	0	0	0	0	0	0	0	0	0	0	0	0	0	0	0
"OR4S2"	937	937	0	0	0	0	0	0	0	0	0	0	0	0	0	0	0	0
"OR4X1"	918	918	0	0	0	0	0	0	0	0	0	0	0	0	0	0	0	0
"OR4X2"	913	913	0	0	0	0	0	0	0	0	0	0	0	0	0	0	0	0
"OR51A2"	941	941	0	0	0	0	0	0	0	0	0	0	0	0	0	0	0	0
"OR51A4"	941	941	0	0	0	0	0	0	0	0	0	0	0	0	0	0	0	0
"OR51A7"	938	938	0	0	0	0	0	0	0	0	0	0	0	0	0	0	0	0
"OR51B2"	1056	1056	0	0	0	0	0	0	0	0	0	0	0	0	0	0	0	0
"OR51B4"	933	933	0	0	0	0	0	0	0	0	0	0	0	0	0	0	0	0
"OR51B5"	1031	162712	0	0	0	0	0	0	0	0	0	0	0	0	0	0	0	0
"OR51B6"	939	939	0	0	0	0	0	0	0	0	0	0	0	0	0	0	0	0
"OR51D1"	975	975	0	0	0	0	0	0	0	0	0	0	0	0	0	0	0	0
"OR51E1"	3104	11560	0	0	0	0	0	0	0	0	0	0	0	0	0	0	0	0
"OR51E2"	2787	17677	0	0	0	0	0	0	0	0	0	0	0	0	0	0	0	0
"OR51F1"	939	939	0	0	0	0	0	0	0	0	0	0	0	0	0	0	0	0
"OR51F2"	1028	1028	0	0	0	0	0	0	0	0	0	0	0	0	0	0	0	0
"OR51G1"	965	965	0	0	0	0	0	0	0	0	0	0	0	0	0	0	0	0
"OR51G2"	946	946	0	0	0	0	0	0	0	0	0	0	0	0	0	0	0	0
"OR51I1"	945	945	0	0	0	0	0	0	0	0	0	0	0	0	0	0	0	0
"OR51I2"	939	939	0	0	0	0	0	0	0	0	0	0	0	0	0	0	0	0
"OR51L1"	947	947	0	0	0	0	0	0	0	0	0	0	0	0	0	0	0	0
"OR51M1"	981	981	0	0	0	0	0	0	0	0	0	0	0	0	0	0	0	0
"OR51Q1"	954	954	0	0	0	0	0	0	0	0	0	0	0	0	0	0	0	0
"OR51S1"	972	972	0	0	0	0	0	0	0	0	0	0	0	0	0	0	0	0
"OR51T1"	1065	1065	0	0	0	0	0	0	0	0	0	0	0	0	0	0	0	0
"OR51V1"	966	966	0	0	0	0	0	0	0	0	0	0	0	0	0	0	0	0
"OR52A1"	938	938	0	0	0	0	0	0	0	0	0	0	0	0	0	0	0	0
"OR52A4"	916	916	0	0	0	0	0	0	0	0	0	0	0	0	0	0	0	0
"OR52A5"	951	951	0	0	0	0	0	0	0	0	0	0	0	0	0	0	0	0
"OR52B2"	972	972	0	0	0	0	0	0	0	0	0	0	0	0	0	0	0	0
"OR52B4"	944	944	0	0	0	0	0	0	0	0	0	0	0	0	0	0	0	0
"OR52B6"	1007	1007	0	0	0	0	0	0	0	0	0	0	0	0	0	0	0	0
"OR52D1"	957	957	0	0	0	0	0	0	0	0	0	0	0	0	0	0	0	0
"OR52E2"	978	978	0	0	0	0	0	0	0	0	0	0	0	0	0	0	0	0
"OR52E4"	938	938	0	0	0	0	0	0	0	0	0	0	0	0	0	0	0	0
"OR52E6"	941	941	0	0	0	0	0	0	0	0	0	0	0	0	0	0	0	0
"OR52E8"	953	953	0	0	0	0	0	0	0	0	0	0	0	0	0	0	0	0
"OR52H1"	963	963	0	0	0	0	0	0	0	0	0	0	0	0	0	0	0	0
"OR52I1"	975	975	0	0	0	0	0	0	0	0	0	0	0	0	0	0	0	0
"OR52I2"	1053	1053	0	0	0	0	0	0	0	0	0	0	0	0	0	0	0	0
"OR52J3"	928	928	0	0	0	0	0	0	0	0	0	0	0	0	0	0	0	0
"OR52K1"	946	946	0	0	0	0	0	0	0	0	0	0	0	0	0	0	0	0
"OR52K2"	946	946	0	0	0	0	0	0	0	0	0	0	0	0	0	0	0	0
"OR52L1"	1095	1095	0	0	0	0	0	0	0	0	0	0	0	0	0	0	0	0
"OR52M1"	954	954	0	0	0	0	0	0	0	0	0	0	0	0	0	0	0	0
"OR52N1"	963	963	0	0	0	0	0	0	0	0	0	0	0	0	0	0	0	0
"OR52N2"	966	966	0	0	0	0	0	0	0	0	0	0	0	0	0	0	0	0
"OR52N4"	1037	1037	0	0	0	0	0	0	0	0	0	0	0	0	0	0	0	0
"OR52N5"	975	975	0	0	0	0	0	0	0	0	0	0	0	0	0	0	0	0
"OR52R1"	1185	1185	0	0	0	0	0	0	0	0	0	0	0	0	0	0	0	0
"OR52W1"	962	962	0	0	0	0	0	0	0	0	0	0	0	0	0	0	0	0
"OR56A1"	957	957	0	0	0	0	0	0	0	0	0	0	0	0	0	0	0	0
"OR56A3"	947	947	0	0	0	0	0	0	0	0	0	0	0	0	0	0	0	0
"OR56A4"	1097	1097	0	0	0	0	0	0	0	0	0	0	0	0	0	0	0	0
"OR56A5"	941	941	0	0	0	0	0	0	0	0	0	0	0	0	0	0	0	0
"OR56B1"	1283	28918	357	243	189	168	131	112	194	128	229	24	1364	1516	2296	1543	1763	1456
"OR56B4"	959	959	0	0	0	0	0	0	0	0	0	0	0	0	0	0	0	0
"OR5A1"	949	949	0	0	0	0	0	0	0	0	0	0	0	0	0	0	0	0
"OR5A2"	974	974	0	0	0	0	0	0	0	0	0	0	0	0	0	0	0	0
"OR5AC2"	929	929	0	0	0	0	0	0	0	0	0	0	0	0	0	0	0	0
"OR5AK2"	929	929	0	0	0	0	0	0	0	0	0	0	0	0	0	0	0	0
"OR5AN1"	936	936	0	0	0	0	0	0	0	0	0	0	0	0	0	0	0	0
"OR5AP2"	952	952	0	0	0	0	0	0	0	0	0	0	0	0	0	0	0	0
"OR5AR1"	932	932	0	0	0	0	0	0	0	0	0	0	0	0	0	0	0	0
"OR5AS1"	974	974	0	0	0	0	0	0	0	0	0	0	0	0	0	0	0	0
"OR5AU1"	1089	1089	0	0	0	0	0	0	0	0	0	0	0	0	0	0	0	0
"OR5B12"	944	944	0	0	0	0	0	0	0	0	0	0	0	0	0	0	0	0
"OR5B17"	944	944	0	0	0	0	0	0	0	0	0	0	0	0	0	0	0	0
"OR5B2"	929	929	0	0	0	0	0	0	0	0	0	0	0	0	0	0	0	0
"OR5B21"	929	929	32	407	0	32	247	160	24	32	0	44	0	0	0	0	0	0
"OR5B3"	944	944	0	0	0	0	0	0	0	0	0	0	0	0	0	0	0	0
"OR5C1"	963	963	0	0	0	0	0	0	0	0	0	0	0	0	0	0	0	0
"OR5D13"	945	945	0	0	0	0	0	0	0	0	0	0	0	0	0	0	0	0
"OR5D14"	945	945	0	0	0	0	0	0	0	0	0	0	0	0	0	0	0	0
"OR5D16"	986	986	0	0	0	0	0	0	0	0	0	0	0	0	0	0	0	0
"OR5D18"	942	942	0	0	0	0	0	0	0	0	0	0	0	0	0	0	0	0
"OR5E1P"	521	521	0	0	0	0	0	0	0	0	0	0	0	0	0	0	0	0
"OR5F1"	945	945	0	0	0	0	0	0	0	0	0	0	0	0	0	0	0	0
"OR5H1"	941	941	0	0	0	0	0	0	0	0	0	0	0	0	0	0	0	0
"OR5H14"	934	934	0	0	0	0	0	0	0	0	0	0	0	0	0	0	0	0
"OR5H15"	941	941	0	0	0	0	0	0	0	0	0	0	0	0	0	0	0	0
"OR5H2"	946	946	0	0	0	0	0	0	0	0	0	0	0	0	0	0	0	0
"OR5H6"	979	979	0	0	0	0	0	0	0	0	0	0	0	0	0	0	0	0
"OR5I1"	945	945	0	0	0	0	0	0	0	0	0	0	0	0	0	0	0	0
"OR5J2"	938	938	0	0	0	0	0	0	0	0	0	0	0	0	0	0	0	0
"OR5K1"	952	952	0	0	0	0	0	0	0	0	0	0	0	0	0	0	0	0
"OR5K2"	951	951	0	0	0	0	0	0	0	0	0	0	0	0	0	0	0	0
"OR5K3"	966	966	0	0	0	0	0	0	0	0	0	0	0	0	0	0	0	0
"OR5K4"	965	965	0	0	0	0	0	0	0	0	0	0	0	0	0	0	0	0
"OR5L1"	937	937	0	0	0	0	0	0	0	0	0	0	0	0	0	0	0	0
"OR5L2"	937	937	0	0	0	0	0	0	0	0	0	0	0	0	0	0	0	0
"OR5M1"	949	949	0	0	0	0	0	0	0	0	0	0	0	0	0	0	0	0
"OR5M10"	949	949	0	0	0	0	0	0	0	0	0	0	0	0	0	0	0	0
"OR5M11"	918	918	0	0	0	0	0	0	0	0	0	0	0	0	0	0	0	0
"OR5M3"	923	923	0	0	0	0	0	0	0	0	0	0	0	0	0	0	0	0
"OR5M8"	937	937	0	0	0	0	0	0	0	0	0	0	0	0	0	0	0	0
"OR5M9"	932	932	0	0	0	0	0	0	0	0	0	0	0	0	0	0	0	0
"OR5P2"	970	970	0	0	0	0	0	0	0	0	0	0	0	0	0	0	0	0
"OR5P3"	936	936	0	0	0	0	0	0	0	0	0	0	0	0	0	0	0	0
"OR5R1"	974	974	0	0	0	0	0	0	0	0	0	0	0	0	0	0	0	0
"OR5T1"	982	982	0	0	0	0	0	0	0	0	0	0	0	0	0	0	0	0
"OR5T2"	1076	1076	0	0	0	0	0	0	0	0	0	0	0	0	0	0	0	0
"OR5T3"	1023	1023	0	0	0	0	0	0	0	0	0	0	0	0	0	0	0	0
"OR5V1"	1048	1048	0	0	0	0	0	0	0	0	0	0	0	0	0	0	0	0
"OR5W2"	932	932	0	0	0	0	0	0	0	0	0	0	0	0	0	0	0	0
"OR6A2"	1385	1385	0	0	0	0	0	0	0	0	0	0	0	0	0	0	0	0
"OR6B1"	937	937	0	0	0	0	0	0	0	0	0	0	0	0	0	0	0	0
"OR6B2"	1512	3949	0	0	0	0	0	0	0	0	0	0	0	0	0	0	0	0
"OR6B3"	996	996	0	0	0	0	0	0	0	0	0	0	0	0	0	0	0	0
"OR6C1"	939	939	0	0	0	0	0	0	0	0	0	0	0	0	0	0	0	0
"OR6C2"	940	940	0	0	0	0	0	0	0	0	0	0	0	0	0	0	0	0
"OR6C3"	936	936	0	0	0	0	0	0	0	0	0	0	0	0	0	0	0	0
"OR6C4"	929	929	0	0	0	0	0	0	0	0	0	0	0	0	0	0	0	0
"OR6C6"	944	944	0	0	0	0	0	0	0	0	0	0	0	0	0	0	0	0
"OR6C65"	938	938	0	0	0	0	0	0	0	0	0	0	0	0	0	0	0	0
"OR6C68"	953	953	0	0	0	0	0	0	0	0	0	0	0	0	0	0	0	0
"OR6C70"	938	938	0	0	0	0	0	0	0	0	0	0	0	0	0	0	0	0
"OR6C74"	939	939	0	0	0	0	0	0	0	0	0	0	0	0	0	0	0	0
"OR6C75"	939	939	0	0	0	0	0	0	0	0	0	0	0	0	0	0	0	0
"OR6C76"	939	939	0	0	0	0	0	0	0	0	0	0	0	0	0	0	0	0
"OR6F1"	928	928	0	0	0	0	0	0	0	0	0	0	0	0	0	0	0	0
"OR6K2"	976	976	0	0	0	0	0	0	0	0	0	0	0	0	0	0	0	0
"OR6K3"	995	995	0	0	0	0	0	0	0	0	0	0	0	0	0	0	0	0
"OR6K6"	1033	1033	0	0	0	0	0	0	0	0	0	0	0	0	0	0	0	0
"OR6M1"	942	942	0	0	0	0	0	0	0	0	0	0	0	0	0	0	0	0
"OR6N1"	939	939	0	0	0	0	0	0	0	0	0	0	0	0	0	0	0	0
"OR6N2"	954	954	0	0	0	0	0	0	8	0	0	0	0	0	0	0	0	0
"OR6P1"	954	954	0	0	0	0	0	0	0	0	0	0	0	0	0	0	0	0
"OR6Q1"	954	954	0	0	0	0	0	0	0	0	0	0	0	0	0	0	0	0
"OR6S1"	997	997	0	0	0	0	0	0	0	0	0	0	0	0	0	0	0	0
"OR6T1"	972	972	0	0	0	0	0	0	0	0	0	0	0	0	0	0	0	0
"OR6V1"	942	942	0	0	0	0	0	0	0	0	0	0	0	0	0	0	0	0
"OR6X1"	938	938	0	0	0	0	0	0	0	0	0	0	0	0	0	0	0	0
"OR6Y1"	977	977	0	0	0	0	0	0	0	0	0	0	0	0	0	0	0	0
"OR7A10"	931	931	0	0	0	0	0	0	0	0	0	0	0	0	0	0	0	0
"OR7A17"	929	929	0	0	0	0	0	0	0	0	0	0	0	0	0	0	0	0
"OR7A5"	2138	2138	0	0	0	0	0	0	0	0	0	0	0	0	0	0	0	0
"OR7C1"	962	962	0	0	0	0	0	0	0	0	0	0	0	0	0	0	0	0
"OR7C2"	960	960	0	0	0	0	0	0	0	0	0	0	0	0	0	0	0	0
"OR7D2"	3225	3225	0	0	0	0	0	0	0	0	0	0	0	0	0	0	0	0
"OR7D4"	940	940	0	0	0	0	0	0	0	0	0	0	0	0	0	0	0	0
"OR7E156P"	2651	5135	0	0	0	0	0	0	0	0	0	0	0	0	0	0	0	0
"OR7E24"	1021	1021	0	0	0	0	0	0	0	0	0	0	0	0	0	0	0	0
"OR7E37P"	666	666	0	0	0	0	0	0	0	0	0	0	0	0	0	0	0	0
"OR7E5P"	1837	7704	0	0	0	0	0	0	0	0	0	0	0	0	0	0	0	0
"OR7E91P"	1288	5855	0	0	0	0	0	0	0	0	0	0	0	0	0	0	0	0
"OR7G1"	1004	1167	0	0	0	0	0	0	0	0	0	0	0	0	0	0	0	0
"OR7G2"	1037	1037	0	0	0	0	0	0	0	0	0	0	0	0	0	0	0	0
"OR7G3"	939	939	0	0	0	0	0	0	0	0	0	0	0	0	0	0	0	0
"OR8A1"	981	981	0	0	0	0	0	0	0	0	0	0	0	0	0	0	0	0
"OR8B12"	932	932	0	0	0	0	0	0	0	0	0	0	0	0	0	0	0	0
"OR8B2"	942	942	0	0	0	0	0	0	0	0	0	0	0	0	0	0	0	0
"OR8B3"	941	941	0	0	0	0	0	0	0	0	0	0	0	0	0	0	0	0
"OR8B4"	929	929	0	0	0	0	0	0	0	0	0	0	0	0	0	0	0	0
"OR8B8"	936	936	0	0	0	0	0	0	0	0	0	0	0	0	0	0	0	0
"OR8D1"	927	927	0	0	0	0	0	0	0	0	0	0	0	0	0	0	0	0
"OR8D2"	936	936	0	0	0	0	0	0	0	0	0	0	0	0	0	0	0	0
"OR8D4"	944	944	0	0	0	0	0	0	0	0	0	0	0	0	0	0	0	0
"OR8G1"	1901	15341	0	0	0	0	0	0	0	0	0	0	3	2	0	0	0	0
"OR8G2"	914	914	0	0	0	0	0	0	0	0	0	0	0	0	0	0	0	0
"OR8H1"	935	935	0	0	0	0	0	0	0	0	0	0	0	0	0	0	0	0
"OR8H2"	938	938	0	0	0	0	0	0	0	0	0	0	0	0	0	0	0	0
"OR8H3"	940	940	0	0	0	0	0	0	0	0	0	0	0	0	0	0	0	0
"OR8I2"	933	933	0	0	0	0	0	0	0	0	0	0	0	0	0	0	0	0
"OR8J1"	950	950	0	0	0	0	0	0	0	0	0	0	0	0	0	0	0	0
"OR8J3"	947	947	0	0	0	0	0	0	0	0	0	0	0	0	0	0	0	0
"OR8K1"	959	959	0	0	0	0	0	0	0	0	0	0	0	0	0	0	0	0
"OR8K3"	938	938	0	0	0	0	0	0	0	0	0	0	0	0	0	0	0	0
"OR8K5"	924	924	0	0	0	0	0	0	0	0	0	0	0	0	0	0	0	0
"OR8S1"	1081	2472	0	0	0	0	0	0	0	0	0	0	0	0	0	0	0	0
"OR8U8"	985	365462	0	0	0	0	0	0	0	0	0	0	54	0	0	0	0	0
"OR9A2"	934	934	0	0	0	0	0	0	0	0	0	0	0	0	0	0	0	0
"OR9A4"	946	946	0	0	0	0	0	0	0	0	0	0	0	0	0	0	0	0
"OR9G4"	984	984	0	0	0	0	0	0	0	0	0	0	0	0	0	0	0	0
"OR9G9"	917	917	0	0	0	0	0	0	0	0	0	0	0	0	0	0	0	0
"OR9I1"	946	946	0	0	0	0	0	0	0	0	0	0	0	0	0	0	0	0
"OR9K2"	1008	1008	0	0	0	0	0	0	0	0	0	0	0	0	0	0	0	0
"OR9Q1"	2439	157685	0	0	0	0	0	0	9	0	0	0	0	0	0	0	0	0
"OR9Q2"	944	944	0	0	0	0	0	0	0	0	0	0	0	0	0	0	0	0
"ORAI1"	1499	15493	605	1815	353	252	1004	811	234	1386	73	5544	1138	2172	1007	2035	1444	2132
"ORAI2"	10773	23274	95	299	57	38	143	156	140	371	72	124	1149	1123	838	911	1113	853
"ORAI3"	2189	5855	390	0	222	168	0	0	301	47	202	0	787	339	935	306	1200	322
"ORAOV1"	2530	9833	718	236	376	342	107	129	366	221	131	261	434	383	367	262	572	257
"ORC1L"	3173	31631	0	16	0	0	8	8	19	32	0	0	49	14	64	8	83	25
"ORC2L"	3138	53517	353	0	196	157	0	0	278	33	11	35	378	463	336	201	266	131
"ORC3L"	2528	77325	141	17	101	40	17	0	247	52	0	52	129	217	359	329	452	248
"ORC4L"	2831	86588	1189	977	629	560	520	457	830	497	360	412	206	282	367	317	520	326
"ORC5L"	2073	81675	421	0	247	174	0	0	407	0	0	0	284	283	318	202	372	232
"ORC6L"	1995	5020	0	0	0	0	0	0	0	0	0	0	60	47	80	48	47	64
"ORCTL3"	1252	10590	0	0	0	0	0	0	0	20	0	0	0	0	0	0	0	0
"ORCTL4"	1946	12416	0	0	0	0	0	0	43	11	0	0	0	0	0	0	0	0
"ORF"	10252	260742	556	322	275	281	167	155	218	138	119	97	50	71	271	293	180	100
"ORF4"	1390	2985	203	33	119	84	33	0	99	127	90	339	395	463	495	458	551	586
"ORM1"	843	3456	68	0	40	28	0	0	75	51	0	0	0	0	0	0	0	0
"ORM2"	848	3467	67	0	39	28	0	0	38	33	0	0	0	0	0	0	0	0
"ORMDL1"	2751	13116	832	708	449	383	359	349	500	327	131	144	1613	1766	2381	1208	2375	1251
"ORMDL2"	1338	3155	64	88	52	12	42	46	80	83	53	46	966	1481	716	672	982	664
"ORMDL3"	3470	5800	76	16	37	39	8	8	82	31	0	11	462	462	157	103	172	440
"ORNT1"	3847	23050	30	0	16	14	0	0	31	0	0	0	254	232	242	134	284	175
"OS9"	2724	27454	3740	2044	1941	1799	1137	907	1080	869	1363	1574	8269	8451	10955	10891	13444	9468
"OSBP"	5097	41748	822	1510	431	391	852	658	471	1090	50	1507	1598	2396	2165	2162	2322	1712
"OSBP1"	1043	24070	643	1128	324	319	587	541	256	586	50	995	1522	2202	462	469	511	361
"OSBP2"	4354	213020	134	0	89	45	0	0	502	130	0	15	183	82	100	19	157	5
"OSBPL10"	7889	172322	0	0	0	0	0	0	22	21	0	33	4	3	15	7	12	8
"OSBPL11"	4645	66675	3157	20	1810	1347	16	4	1497	61	743	141	2638	2026	1364	1139	1443	768
"OSBPL1A"	7497	129120	7666	3073	4218	3448	1693	1380	4588	1729	1625	1463	1563	1507	1697	1524	1721	1184
"OSBPL2"	3985	57691	1358	376	760	598	197	179	1407	386	824	716	940	862	1127	923	1308	919
"OSBPL3"	6871	96077	24904	23528	14068	10836	12758	10770	10880	12382	9082	16560	1211	2873	2567	1730	3080	1151
"OSBPL5"	3909	78238	3749	552	2118	1631	265	287	2285	855	3528	1249	778	601	841	829	1369	954
"OSBPL6"	3871	201501	0	0	0	0	0	0	0	0	0	0	0	0	0	0	0	0
"OSBPL7"	4514	9636	18	0	6	12	0	0	173	59	0	9	50	25	107	11	237	112
"OSBPL8"	7346	208013	11607	5841	6557	5050	3226	2615	5460	2148	1762	1968	1511	1996	2161	4440	4712	2911
"OSBPL9"	3385	28842	2111	556	1276	835	291	265	1133	316	197	373	1221	2296	1677	1369	2009	1425
"OSCAR"	2141	6309	1378	787	750	628	463	324	321	404	1426	1354	2387	2420	1618	1467	2473	1785
"OSCP1"	1495	32546	115	0	86	29	0	0	141	21	0	0	0	0	5	0	10	0
"OSGEP"	1557	7983	496	128	261	235	54	74	205	57	276	64	756	485	738	462	966	395
"OSGEPL1"	2325	16540	145	14	88	57	14	0	224	0	0	0	239	215	181	101	218	109
"OSGIN1"	2399	17268	40	71	29	11	34	37	116	103	0	92	353	275	627	653	551	378
"OSGIN2"	4249	25333	732	718	420	312	388	330	390	275	80	370	1385	1472	1561	1233	1502	1046
"OSM"	1865	4021	0	47	0	0	0	47	82	119	0	170	73	507	88	1524	106	125
"OSMR"	4181	88268	13	0	13	0	0	0	0	0	0	0	0	0	0	0	0	0
"OSR1"	1896	7127	764	2871	455	309	1651	1220	354	2689	53	3175	224	314	248	340	232	159
"OSR2"	2123	7695	0	44	0	0	25	19	0	63	0	0	0	181	0	122	0	59
"OSRF"	5426	44394	129	161	85	44	114	47	201	297	0	210	492	503	479	412	535	328
"OSTC"	1084	17241	30	44	20	10	19	25	52	8	0	0	678	746	938	589	1148	546
"OSTCL"	1187	16506	0	0	0	0	0	0	32	0	1	0	0	0	0	0	0	0
"OSTF1"	1322	58717	6730	700	3877	2853	424	276	2673	310	1746	489	1417	1533	2893	2830	4086	2547
"OSTM1"	4471	33328	801	160	475	326	81	79	340	74	33	112	2717	579	3157	2961	2790	2218
"OSTN"	403	37588	0	0	0	0	0	0	0	0	0	0	0	0	0	0	0	0
"OSTalpha"	1462	16918	378	55	187	191	20	35	258	101	237	109	4941	5014	109	39	116	68
"OSTbeta"	651	7735	0	0	0	0	0	0	11	0	0	0	0	0	0	0	0	0
"OSZF"	3023	14484	312	138	150	162	44	94	201	78	0	54	573	601	603	448	570	317
"OTC"	1656	68968	0	0	0	0	0	0	0	0	0	0	0	0	0	0	0	0
"OTOA"	3637	82216	10	0	5	5	0	0	14	0	0	0	8	6	69	106	102	96
"OTOF"	7202	101496	0	0	0	0	0	0	362	200	0	0	0	5	0	0	0	0
"OTOG"	5014	60672	0	0	0	0	0	0	61	50	0	0	0	0	0	0	0	0
"OTOL1"	1436	7134	0	0	0	0	0	0	0	0	0	0	0	0	0	0	0	0
"OTOP1"	1875	38093	0	0	0	0	0	0	0	20	0	0	0	0	0	0	0	0
"OTOP2"	1787	9271	0	0	0	0	0	0	127	43	0	0	0	0	0	0	0	0
"OTOP3"	1946	13698	0	0	0	0	0	0	67	24	0	0	0	0	0	0	0	0
"OTOR"	1480	3807	0	0	0	0	0	0	0	0	0	0	0	0	0	0	0	0
"OTOS"	569	1628	0	0	0	0	0	0	0	0	0	0	0	0	0	0	0	0
"OTP"	2680	9986	0	0	0	0	0	0	0	0	0	0	0	0	0	0	0	0
"OTUB1"	2508	12569	493	309	248	245	153	156	277	197	106	307	1943	1776	2268	2005	2719	1618
"OTUB2"	3877	22552	215	117	137	78	65	52	152	294	0	221	57	24	34	5	21	8
"OTUD1"	3112	3112	210	1119	105	105	567	552	40	584	0	210	611	2547	661	758	727	764
"OTUD3"	6514	30543	965	145	546	419	73	72	536	98	286	97	342	151	390	174	502	71
"OTUD4"	7088	46031	2616	6580	1510	1106	3504	3076	1091	2977	633	4228	1993	4345	3158	4141	734	2420
"OTUD5"	2932	35590	1947	800	1085	862	432	368	972	460	1217	1428	1692	1524	1927	1705	2453	1744
"OTUD6A"	1690	1690	0	0	0	0	0	0	0	0	0	0	0	0	0	0	0	0
"OTUD6B"	3304	16900	1853	355	1093	760	193	162	606	190	216	209	591	989	731	758	866	543
"OTUD7A"	3156	387456	0	0	0	0	0	0	62	0	0	51	0	0	6	0	9	3
"OTUD7B"	6423	70455	0	0	0	0	0	0	38	0	0	0	58	78	6	0	32	6
"OTX1"	2285	6340	0	0	0	0	0	0	0	0	0	0	0	0	0	0	0	0
"OTX2"	2240	9672	0	0	0	0	0	0	0	0	0	0	0	0	0	0	0	0
"OVCA2"	1077	1449	128	1157	80	48	610	547	64	521	0	562	767	1794	915	1084	1168	1074
"OVCH1"	3448	70132	348	85	199	149	45	40	30	9	0	0	0	8	0	0	0	0
"OVCH2"	1709	15498	0	0	0	0	0	0	0	0	0	0	0	0	0	0	0	0
"OVCOV1"	2141	14888	2665	1385	1452	1213	747	638	935	643	2286	1508	1265	1140	1862	1314	2136	1248
"OVGP1"	2632	12754	15	0	15	0	0	0	0	0	0	0	0	0	19	10	24	7
"OVOL1"	2995	10156	0	0	0	0	0	0	0	56	0	1	0	27	22	0	19	31
"OVOL2"	1559	33727	0	0	0	0	0	0	0	15	0	0	0	0	0	0	0	0
"OVOS1"	4214	91405	8	0	6	2	0	0	0	1	0	0	0	0	0	0	0	0
"OXA1L"	1786	5039	1353	682	751	602	338	344	477	232	594	175	5293	3986	4961	2560	6268	2881
"OXCT1"	3574	140625	35	20	17	18	14	6	29	43	0	12	229	291	215	152	329	170
"OXCT2"	1825	1825	0	0	0	0	0	0	0	0	0	0	0	0	0	0	0	0
"OXER1"	1762	1762	83	0	62	21	0	0	43	48	0	50	0	0	233	185	259	0
"OXGR1"	2289	8633	0	0	0	0	0	0	0	0	0	0	0	0	0	0	0	0
"OXNAD1"	3929	40881	7986	8110	4445	3541	4464	3646	3137	3754	2455	4010	2122	2831	2437	2518	2866	2062
"OXR1"	4566	482446	507	63	305	202	45	18	937	66	0	16	1246	1429	1507	1247	1486	1080
"OXSM"	1529	4463	14	0	14	0	0	0	10	0	0	0	222	57	236	26	238	75
"OXSR1"	4540	89954	1548	4682	920	628	2709	1973	718	3483	53	4410	1300	2728	1467	2397	1535	1407
"OXT"	515	898	0	0	0	0	0	0	0	0	0	0	0	0	0	0	0	0
"OXTR"	4362	19205	0	0	0	0	0	0	19	9	0	0	0	47	0	0	0	0
"P/OKcl.13"	1017	16948	0	0	0	0	0	0	182	79	0	0	0	1	0	0	0	0
"P/OKcl.14"	647	1726	3301	4268	1719	1582	2278	1990	1106	1730	1136	3263	3164	525	4538	3193	6072	2348
"P/OKcl.19"	2406	30063	999	129	537	462	101	28	638	358	143	122	1009	756	1112	759	1126	872
"P/OKcl.4"	1390	6873	35	102	35	0	58	44	25	203	0	70	29	61	0	60	72	14
"P11"	2454	15824	186	0	103	83	0	0	374	31	62	0	27	29	30	20	33	21
"P140"	1318	7793	0	0	0	0	0	0	101	11	0	0	0	0	0	0	3	0
"P2RX1"	2872	20073	912	1232	508	404	675	557	647	1150	1346	3026	848	996	947	771	1281	722
"P2RX2"	1937	3571	2	0	1	1	0	0	0	0	0	0	0	0	0	0	0	0
"P2RX3"	1360	31601	0	0	0	0	0	0	119	87	0	0	1	0	0	0	0	0
"P2RX4"	2087	24245	3020	15146	1713	1307	8070	7076	464	5825	212	17301	741	4639	651	2482	809	1861
"P2RX5"	6182	33395	991	181	945	46	91	90	968	243	1049	349	6983	5850	4571	3696	6405	4275
"P2RX6"	2734	12840	0	0	0	0	0	0	55	44	0	0	0	1	0	0	0	0
"P2RX6P"	126	1859	0	0	0	0	0	0	18	0	0	0	0	0	0	0	0	0
"P2RX7"	3288	53180	5203	38683	2886	2317	20441	18242	665	13874	70	19179	1106	7172	457	3128	796	1246
"P2RY1"	3107	3107	465	0	228	237	0	0	188	21	0	13	557	348	1307	334	1052	368
"P2RY10"	1793	16610	0	0	0	0	0	0	0	0	0	0	116	223	211	231	103	45
"P2RY11"	1976	3867	1115	257	1111	4	143	114	257	114	818	220	7291	4102	5622	3078	6607	3488
"P2RY12"	1505	47170	0	0	0	0	0	0	0	0	0	0	25	12	3	17	28	0
"P2RY13"	2771	3243	0	0	0	0	0	0	0	0	0	0	0	0	118	106	54	0
"P2RY14"	2681	37095	0	0	0	0	0	0	294	0	0	0	181	173	188	95	344	194
"P2RY2"	2659	18051	11	0	11	0	0	0	24	12	0	0	42	25	30	0	49	0
"P2RY4"	1640	1640	0	0	0	0	0	0	0	0	0	0	0	0	0	0	0	0
"P2RY5"	1695	55135	5193	4391	2968	2225	2292	2099	2886	2785	453	2430	3012	1104	2120	369	2808	707
"P2RY6"	2639	28719	7150	847	3952	3198	453	394	2947	395	5782	41	2195	1232	1697	721	2802	1159
"P2RY8"	4236	74573	0	0	0	0	0	0	0	0	0	0	0	0	259	145	310	189
"P2X"	1362	11448	737	1076	403	334	553	523	387	814	1136	2364	467	625	501	327	552	192
"P38IP"	1896	13655	641	53	351	290	34	19	193	65	119	34	532	185	464	330	602	379
"P450-CYP21B"	2114	3338	0	0	0	0	0	0	17	0	0	0	0	0	0	0	0	0
"P4HA1"	2953	89752	3006	3790	1695	1311	2032	1758	1532	2208	708	4509	787	1067	967	1066	1615	790
"P4HA2"	2584	34631	141	0	82	59	0	0	191	0	18	0	423	331	592	440	760	532
"P4HA3"	2281	44998	0	0	0	0	0	0	0	0	0	0	0	0	0	0	0	0
"P4HB"	2589	17512	1654	723	877	777	338	385	599	591	1336	1577	12383	12176	15787	17706	18443	15439
"P4HTM"	2289	17240	408	34	249	159	28	6	384	69	89	103	220	259	312	230	492	244
"P53TG1"	710	20144	0	0	0	0	0	0	0	0	0	0	21	48	63	67	59	25
"P5CR2"	2033	37984	214	17	125	89	4	13	184	109	123	0	1304	909	1625	1073	1884	941
"P704P"	6727	36320	0	0	0	0	0	0	0	0	0	0	0	0	0	0	0	5
"P712P"	2567	4043	0	0	0	0	0	0	0	0	0	0	0	0	0	0	0	0
"P775P"	2010	34157	0	0	0	0	0	0	0	12	0	0	0	0	0	0	0	0
"PA2G4"	2638	9592	121	45	95	26	31	14	117	105	0	77	995	1182	1781	1648	1862	1513
"PA2G4P4"	2752	2752	110	14	59	51	0	14	68	0	0	0	374	367	158	156	206	181
"PAAF1"	1667	50748	45	0	33	12	0	0	56	0	0	0	198	198	127	197	134	174
"PABL"	1220	2317	0	0	0	0	0	0	0	0	0	0	0	0	0	0	0	0
"PABPC1"	2875	19173	7264	17828	3970	3294	9456	8372	2489	7979	3247	12320	24993	45400	38896	42722	49735	38564
"PABPC1L"	2144	29261	168	92	85	83	37	55	108	99	108	73	110	155	275	218	327	198
"PABPC1L2A"	2176	2176	0	0	0	0	0	0	0	0	0	0	0	0	0	0	0	0
"PABPC1L2B"	2200	2200	0	0	0	0	0	0	0	0	0	0	0	0	0	0	0	0
"PABPC3"	2428	2428	212	285	132	80	158	127	105	181	67	109	5598	5543	0	0	0	0
"PABPC4"	3220	16038	1305	2436	741	564	1359	1077	445	1023	345	1481	3294	3748	3849	3581	4084	3511
"PABPC4L"	4943	5414	0	0	0	0	0	0	0	0	0	0	0	0	0	0	0	0
"PABPC5"	3448	3987	0	0	0	0	0	0	0	0	0	0	0	0	0	0	0	0
"PABPCP2"	3934	3934	0	0	0	0	0	0	0	0	0	0	0	0	0	0	0	0
"PABPN1"	3180	5114	1714	688	962	752	384	304	670	321	752	574	1935	1963	3560	3263	4604	2861
"PABPNL1"	1173	3270	1	0	1	0	0	0	71	40	0	0	0	0	0	0	0	0
"PACAP"	846	2349	0	0	0	0	0	0	42	0	0	0	0	6	0	0	4	4
"PACE4C"	858	16426	0	0	0	0	0	0	28	3	0	0	0	0	13	5	0	0
"PACRG"	1626	588361	0	0	0	0	0	0	45	9	0	0	0	0	0	0	0	0
"PACRGL"	2162	27945	196	53	106	90	29	24	463	28	73	0	106	114	102	97	123	74
"PACS1"	4512	174391	15098	4922	8572	6526	2743	2179	6647	3226	10935	6647	2785	3126	3296	2679	4367	3366
"PACS2"	6390	83405	10379	2671	5625	4754	1336	1335	5074	1634	11485	3407	3461	2981	3903	2897	7063	3847
"PACSIN1"	4296	20351	0	0	0	0	0	0	174	102	0	0	0	0	0	0	0	0
"PACSIN2"	2118	76110	20899	7710	11551	9348	4173	3537	7841	4721	12871	8967	2619	2463	3157	2955	4684	1210
"PACSIN3"	2021	8344	0	0	0	0	0	0	15	50	0	0	1	0	0	3	0	0
"PACT"	1944	19818	1246	237	734	512	148	89	557	219	175	201	768	1428	962	654	1281	743
"PADI1"	3863	40882	0	0	0	0	0	0	104	89	0	0	0	0	0	0	0	0
"PADI2"	4378	52693	0	0	0	0	0	0	122	82	0	0	27	27	7	3	0	0
"PADI3"	3202	35134	0	0	0	0	0	0	134	29	0	0	0	0	0	0	0	0
"PADI4"	2281	55807	0	0	0	0	0	0	91	0	0	0	0	0	3	11	0	3
"PADI6"	2363	29456	0	0	0	0	0	0	110	80	0	0	0	0	0	0	0	0
"PAEP"	866	5020	0	0	0	0	0	0	32	0	0	0	0	0	0	0	0	0
"PAF1"	2144	5409	488	207	280	208	121	86	153	320	8	77	1420	1861	1381	1916	1884	1515
"PAFAH1B1"	5624	91987	8478	10187	4849	3629	5379	4808	3699	5246	5219	13129	3838	4084	3930	3014	4406	2844
"PAFAH1B2"	2507	2507	1786	230	922	864	122	108	872	122	543	360	2833	2175	2545	1265	2871	1621
"PAFAH1B3"	1104	5746	27	0	27	0	0	0	10	0	0	0	110	123	98	93	159	98
"PAFAH2"	3648	38390	124	0	88	36	0	0	199	17	31	0	108	438	615	492	695	459
"PAG1"	10750	144257	243	1166	178	65	688	478	670	1275	0	441	821	964	1110	1133	695	493
"PAGE1"	668	8542	0	0	0	0	0	0	0	0	0	0	0	0	0	0	0	0
"PAGE2"	485	3765	0	0	0	0	0	0	0	0	0	0	0	0	0	0	0	0
"PAGE2B"	496	3832	0	0	0	0	0	0	0	0	0	0	0	0	0	0	0	0
"PAGE3"	758	6430	0	0	0	0	0	0	0	0	0	0	0	0	0	0	0	0
"PAGE4"	498	4666	0	0	0	0	0	0	0	0	0	0	0	0	0	0	0	0
"PAGE5"	744	3751	0	0	0	0	0	0	0	0	0	0	0	0	0	0	0	0
"PAH"	2694	79279	0	0	0	0	0	0	0	0	0	0	0	0	0	0	0	0
"PAICS"	3393	25618	56	0	45	11	0	0	85	12	0	0	571	748	785	642	596	577
"PAIP1"	2804	30825	117	26	32	85	16	10	220	65	0	55	200	179	1056	870	900	806
"PAIP2"	2300	27279	507	72	278	229	61	11	236	107	206	462	2694	3103	2540	2361	2658	2364
"PAIP2B"	6304	44367	0	0	0	0	0	0	12	0	0	0	4	1	0	0	5	0
"PAK1"	3494	152049	14931	2221	8594	6337	1209	1012	6019	668	8672	1110	3182	4509	3070	2113	4391	2351
"PAK1B"	2188	37003	2439	1340	1347	1092	710	630	2798	396	3857	801	1538	3160	2336	1524	3277	1765
"PAK1IP1"	1503	14782	11	0	11	0	0	0	50	21	0	27	358	384	389	294	422	296
"PAK2"	6152	92790	12851	6830	7155	5696	3697	3133	4771	4095	5713	8899	8915	10065	10056	8335	11074	7445
"PAK3"	2772	124800	0	0	0	0	0	0	14	0	0	0	0	0	0	0	0	0
"PAK4"	3075	53628	365	55	159	206	22	33	640	576	0	580	216	209	251	276	301	258
"PAK6"	4225	38397	36	14	29	7	2	12	145	46	0	0	7	8	0	0	0	0
"PAK7"	4831	301652	0	0	0	0	0	0	19	0	0	0	0	0	0	0	0	0
"PALB2"	4071	38197	167	20	88	79	12	8	222	33	0	0	450	215	534	188	479	168
"PALLD"	5881	431392	19821	27438	11080	8741	14832	12606	11076	13251	11826	25563	10666	12106	16118	18556	16260	15145
"PALM"	2883	39379	0	0	0	0	0	0	177	107	0	0	1	0	0	0	0	0
"PALM2"	9485	171180	0	0	0	0	0	0	0	0	0	0	0	0	0	0	0	0
"PALM2-AKAP2"	7527	392214	605	4402	345	260	2342	2060	545	3860	0	2088	446	685	830	1658	908	648
"PALM3"	2266	5794	0	92	0	0	58	34	109	20	54	0	0	0	0	0	0	0
"PALMD"	2585	48667	0	0	0	0	0	0	0	0	0	0	0	0	0	0	0	0
"PAM"	3970	163891	8	0	8	0	0	0	60	20	0	0	281	263	1225	1351	638	867
"PAMR1"	3138	98472	0	0	0	0	0	0	9	0	0	0	0	0	0	0	0	0
"PAN2"	4683	16813	625	88	357	268	58	30	277	120	169	71	551	759	693	941	725	544
"PAN3"	5181	121062	25876	17682	14194	11682	9648	8034	11181	6969	11055	13300	2242	2882	2128	1848	2486	1559
"PANK1"	3374	62468	0	0	0	0	0	0	13	0	0	0	57	60	97	22	103	23
"PANK2"	2286	34761	8786	2030	4874	3912	1171	859	3862	1094	7310	3214	6094	5415	2630	1421	3206	1640
"PANK3"	3366	23960	3253	633	1882	1371	352	281	1406	288	263	295	274	6662	2218	1848	1850	1114
"PANK4"	2661	18062	676	427	366	310	288	139	464	515	562	474	624	415	711	669	989	522
"PANX1"	2771	53043	143	89	87	56	60	29	16	452	0	103	711	896	420	621	877	620
"PANX2"	3054	9565	43	0	16	27	0	0	171	43	216	0	317	234	287	223	657	398
"PANX3"	1601	8798	3	0	1	2	0	0	0	0	0	0	0	0	0	0	0	0
"PAO"	1462	12458	1568	312	846	722	171	141	646	232	2015	437	560	431	910	574	939	564
"PAOX"	1861	12458	1568	312	846	722	171	141	646	232	2015	437	560	431	910	574	939	564
"PAP2-a1"	1782	110190	1651	955	887	764	556	399	705	449	94	465	188	613	425	348	671	486
"PAP2D"	4019	114648	0	0	0	0	0	0	0	0	0	0	0	0	0	0	0	0
"PAPD4"	3538	74230	19301	24839	10842	8459	13506	11333	7071	10461	7970	10815	3830	5352	3833	3826	3885	2802
"PAPD5"	8123	82390	1673	227	975	698	127	100	1236	801	503	654	688	640	824	687	935	735
"PAPL"	2972	27183	0	0	0	0	0	0	16	12	0	0	0	0	0	0	0	0
"PAPLN"	5999	35023	647	187	433	214	114	73	426	317	223	152	233	183	161	154	311	106
"PAPOLA"	4529	64728	5760	4703	3313	2447	2523	2180	2879	2127	1803	3321	7660	9070	7517	6330	8144	4940
"PAPOLB"	4256	4256	0	0	0	0	0	0	12	0	0	0	216	262	0	0	0	0
"PAPOLG"	4265	42715	248	90	129	119	36	54	131	25	12	48	621	424	624	350	626	322
"PAPPA"	10991	248530	0	0	0	0	0	0	11	15	0	0	0	0	0	0	0	0
"PAPPA2"	6941	379663	0	0	0	0	0	0	8	0	0	0	0	0	0	0	0	0
"PAPPE"	7115	379663	0	0	0	0	0	0	8	0	0	0	0	0	0	0	0	0
"PAPSS"	1203	66774	852	27	479	373	11	16	612	10	30	0	411	579	937	841	949	705
"PAPSS1"	2553	106598	1791	147	1035	756	73	74	1141	69	73	0	966	1378	1867	1692	1602	1438
"PAPSS2"	3869	87986	14	0	14	0	0	0	10	0	0	0	218	183	710	708	357	373
"PAPST1"	1887	3446	539	797	293	246	410	387	88	523	286	1178	786	259	922	1976	1628	1816
"PAPST2"	2217	22494	256	109	127	129	78	31	307	74	54	102	422	420	597	365	556	274
"PAQR1"	1871	17524	611	139	338	273	90	49	405	95	210	199	4347	3566	4139	3392	4861	1993
"PAQR10"	1365	66970	0	0	0	0	0	0	96	41	0	0	0	0	0	0	0	0
"PAQR3"	3745	21490	6446	5946	3765	2681	3220	2726	4059	2648	2102	3826	4424	4987	6340	4590	6593	3741
"PAQR4"	2693	4143	207	0	70	137	0	0	192	29	194	0	921	503	1158	573	1600	674
"PAQR5"	5485	93236	0	0	0	0	0	0	57	0	0	0	0	0	8	7	0	0
"PAQR6"	2124	4638	40	0	17	23	0	0	51	47	0	0	4	2	0	10	3	3
"PAQR7"	3024	9770	0	0	0	0	0	0	15	18	0	0	54	13	71	0	121	22
"PAQR8"	4739	45650	1025	12	653	372	0	12	711	77	265	116	1066	703	638	234	1304	610
"PAQR9"	2104	2104	0	0	0	0	0	0	0	0	0	0	0	0	0	0	0	0
"PAR1"	2413	2413	0	0	0	0	0	0	0	0	0	0	0	0	0	0	0	0
"PAR4"	343	343	0	0	0	0	0	0	21	33	0	0	0	0	0	0	0	0
"PAR5"	3374	3374	540	138	318	222	66	72	555	45	0	16	20	20	0	0	0	0
"PARD3"	4095	703827	2	0	2	0	0	0	7	9	0	0	0	0	0	0	0	0
"PARD3B"	3848	1070023	0	0	0	0	0	0	19	0	0	0	0	0	0	0	0	0
"PARD6A"	1330	1547	0	0	0	0	0	0	24	12	0	0	23	14	0	0	5	3
"PARD6B"	4617	22198	0	0	0	0	0	0	0	10	0	0	0	0	0	0	0	0
"PARD6G"	3835	90280	16	0	16	0	0	0	247	80	0	0	0	36	0	0	0	0
"PARG"	4269	345006	1711	2978	903	808	1604	1374	1352	1956	136	3054	8203	13448	11669	23479	11856	13375
"PARK2"	4084	1380245	0	0	0	0	0	0	96	19	0	16	0	0	0	0	0	0
"PARK7"	1481	10302	141	172	51	90	94	78	154	135	24	174	1232	1397	1612	1584	2883	1360
"PARL"	1421	55521	4098	579	2197	1901	326	253	1974	217	1959	736	969	561	1296	1075	1810	1153
"PARM1"	5043	117027	9047	12324	5117	3930	6603	5721	2820	7818	897	16823	6154	8785	3276	3148	5220	3317
"PARN"	3101	194567	1709	515	1018	691	240	275	1372	883	262	704	1037	1254	1047	909	1362	912
"PARP1"	4007	47410	490	16	260	230	16	0	523	43	133	9	1837	1774	2507	2175	2700	1687
"PARP10"	3580	9245	817	212	445	372	94	118	284	181	475	345	857	938	2155	1164	1430	1333
"PARP11"	4501	64583	1510	626	844	666	380	246	1091	442	72	425	737	978	545	541	617	448
"PARP12"	3803	39974	6546	4092	2141	4405	2195	1897	4322	2167	7100	3282	1991	2490	3146	2699	3357	1395
"PARP14"	7724	50016	10416	35233	5793	4623	18912	16321	4313	16132	3990	13994	5096	11389	8102	6394	7703	4918
"PARP15"	2704	59089	8	0	4	4	0	0	8	16	0	68	41	28	10	29	145	26
"PARP16"	2540	28586	16	0	9	7	0	0	17	0	0	0	190	130	187	79	245	110
"PARP2"	2018	14291	130	0	88	42	0	0	110	6	0	0	276	121	240	135	276	156
"PARP3"	2369	6522	7	0	7	0	0	0	95	77	0	0	94	80	129	89	246	110
"PARP4"	5497	91875	14376	5938	7901	6475	3277	2661	5939	2482	7815	5366	10102	9937	7811	6606	10025	6369
"PARP6"	2648	30107	1268	537	757	511	285	252	562	412	542	647	1148	1323	1505	1174	1660	1171
"PARP8"	3041	176438	19664	10477	10923	8741	5742	4735	8882	4548	6220	5275	2171	2254	1967	1920	2187	1493
"PARP9"	6811	32576	1174	467	631	543	269	198	1046	326	564	132	2336	1942	2880	1100	2557	1267
"PARS2"	2347	7616	0	0	0	0	0	0	21	0	0	0	114	10	105	0	177	0
"PART1"	2499	59946	0	0	0	0	0	0	0	18	0	0	0	0	0	0	0	0
"PARVA"	3313	103212	0	0	0	0	0	0	0	0	0	0	0	0	0	0	0	0
"PARVB"	1799	169930	2848	3017	1647	1201	1685	1332	2230	3295	559	4260	1368	1304	1213	1236	1257	869
"PARVG"	3123	25414	3151	1104	1738	1413	573	531	1400	578	2776	1165	1516	1358	1980	1969	3229	2157
"PASD1"	3264	113204	0	0	0	0	0	0	0	0	0	0	0	0	0	0	0	0
"PASK"	5178	21134	280	39	152	128	19	20	469	105	0	44	171	217	253	179	377	160
"PAT2"	3442	32613	0	0	0	0	0	0	15	0	0	0	0	0	0	0	0	0
"PATE1"	1512	3556	0	0	0	0	0	0	0	0	0	0	0	0	0	0	0	0
"PATE2"	1639	2686	0	0	0	0	0	0	0	0	0	0	0	0	0	0	0	0
"PATE3"	1337	3489	0	0	0	0	0	0	0	0	0	0	0	0	0	0	0	0
"PATE4"	1988	6757	0	0	0	0	0	0	0	0	0	0	0	0	0	0	0	0
"PATL1"	4144	32319	1038	6342	593	445	3384	2958	431	3992	71	5680	1509	3386	2292	2041	1540	2619
"PATL2"	1966	11157	589	774	319	270	437	337	238	254	202	484	128	237	267	227	224	146
"PATZ1"	3816	20460	376	53	214	162	45	8	479	106	106	39	504	241	503	156	659	237
"PAWR"	1956	99045	0	0	0	0	0	0	0	0	0	0	0	0	0	0	0	0
"PAX1"	2843	10325	0	0	0	0	0	0	0	0	0	0	0	0	0	0	0	0
"PAX2"	4150	84231	0	2	0	0	0	2	105	37	0	0	0	0	0	0	0	0
"PAX3"	3350	99095	0	0	0	0	0	0	0	0	0	0	0	0	0	0	0	0
"PAX3/NCOA1 fusion"	3300	28917	275	359	164	111	185	174	229	123	39	125	754	702	732	671	872	604
"PAX4"	2267	5380	0	0	0	0	0	0	0	0	0	0	0	0	0	0	0	0
"PAX5"	3660	195947	5	5	5	0	3	2	394	171	0	0	0	30	4	3	0	0
"PAX6"	7312	25876	0	0	0	0	0	0	25	7	0	0	20	0	0	0	0	0
"PAX7"	6061	117861	0	0	0	0	0	0	368	124	0	0	0	0	0	0	0	0
"PAX8"	4066	62925	1019	270	584	435	156	114	692	371	223	335	1766	1506	506	348	1031	478
"PAX9"	3100	20229	0	0	0	0	0	0	0	10	0	0	0	0	0	0	0	0
"PAXIP1"	3732	59283	808	14	460	348	7	7	658	40	36	32	887	921	593	422	734	374
"PB1"	7652	134373	6440	4132	3541	2899	2288	1844	3305	2107	763	2256	2592	3621	2560	3547	3813	2309
"PBF"	2689	24228	6171	6120	3496	2675	3273	2847	3504	2408	8463	7922	7025	8009	2825	4886	2931	10173
"PBK"	2058	28434	0	0	0	0	0	0	19	0	0	0	0	0	0	0	0	0
"PBLD"	2600	50269	2094	1675	1244	850	915	760	46	907	148	1146	1311	1835	407	397	379	220
"PBOV1"	2500	2500	0	0	0	0	0	0	0	0	0	0	0	0	0	0	0	0
"PBRM1"	7823	134373	6726	4217	3680	3046	2311	1906	3511	2154	856	2389	2755	3737	2635	3651	3889	2352
"PBX1"	6692	292245	0	0	0	0	0	0	9	0	0	0	0	0	0	0	0	0
"PBX2"	3222	5455	1741	607	807	934	346	261	437	460	1206	1056	1874	2035	2693	2351	3817	2053
"PBX3"	2881	220038	24382	14762	13481	10901	8128	6634	12085	6352	10273	9209	968	1018	969	793	1286	818
"PBX4"	1444	56917	2	0	0	2	0	0	94	2	0	0	0	1	7	16	0	3
"PBXIP1"	3205	12008	506	65	260	246	26	39	342	86	92	0	1684	1713	2579	1220	3670	2015
"PC"	4215	109852	593	98	343	250	54	44	1234	321	612	71	1418	1086	2206	1767	3032	2075
"PC-1"	3949	136242	12	0	0	12	0	0	43	37	0	27	233	374	59	102	183	125
"PC-TP"	2363	26393	0	0	0	0	0	0	34	4	0	0	541	503	735	483	718	481
"PCA3"	3904	23113	0	0	0	0	0	0	0	0	0	0	0	0	0	0	0	0
"PCAN1"	2091	35776	0	0	0	0	0	0	0	0	0	0	0	0	0	0	0	0
"PCBD1"	1010	5276	102	47	54	48	20	27	89	64	39	112	890	958	1536	456	1453	1092
"PCBD2"	5624	64540	7768	3440	4364	3404	1917	1523	2890	1409	2079	2679	2014	950	705	2543	6870	116
"PCBP1"	1749	1749	361	232	193	168	127	105	0	84	0	64	9757	9784	10466	9972	12369	9289
"PCBP2"	3185	29061	5894	5402	3186	2708	2831	2571	2650	2477	3052	5334	7937	5821	13455	12320	16517	12490
"PCBP3"	2181	94292	0	13	0	0	13	0	625	267	0	8	4	6	0	0	20	0
"PCBP4"	2609	4180	0	0	0	0	0	0	99	63	0	0	16	8	21	3	32	9
"PCCA"	2515	441351	65	70	43	22	48	22	258	63	0	0	77	105	309	218	150	102
"PCCB"	6139	87572	714	99	437	277	73	26	286	64	60	32	1289	1144	992	926	1052	905
"PCCMT"	4926	14791	172	48	105	67	21	27	158	141	0	67	2642	2507	1998	1588	3477	2206
"PCCX2"	3041	15184	3447	2993	1827	1620	1427	1566	808	503	2380	498	1991	2648	1154	2504	1571	1866
"PCDH-beta6"	2602	2806	0	0	0	0	0	0	0	0	0	0	0	0	0	0	0	0
"PCDH-psi2"	3165	3165	0	0	0	0	0	0	0	0	0	0	0	0	0	0	0	0
"PCDH-psi3"	1973	1973	0	0	0	0	0	0	0	0	0	0	0	0	0	0	0	0
"PCDH1"	4760	25263	0	0	0	0	0	0	171	104	0	0	0	0	0	0	0	0
"PCDH10"	5370	42263	0	0	0	0	0	0	0	0	0	0	0	0	0	0	0	0
"PCDH11X"	9183	788569	66	38	31	35	38	0	0	0	0	0	2430	2781	2694	3045	2984	2767
"PCDH11Y"	9037	686129	0	0	0	0	0	0	0	0	0	0	0	0	479	0	143	486
"PCDH12"	5185	14098	16	0	16	0	0	0	50	35	0	10	3	1	0	1	3	1
"PCDH15"	9277	998518	0	0	0	0	0	0	19	0	0	0	0	0	0	0	0	0
"PCDH17"	8013	97278	0	0	0	0	0	0	0	0	0	0	0	0	0	0	0	0
"PCDH18"	5906	13555	0	0	0	0	0	0	0	0	0	0	0	0	0	0	0	0
"PCDH19"	9754	118623	0	0	0	0	0	0	0	0	0	0	0	0	0	0	0	0
"PCDH20"	6619	18260	0	0	0	0	0	0	0	0	0	0	0	0	0	0	0	0
"PCDH21"	5339	22604	0	0	0	0	0	0	58	0	0	0	0	0	0	0	0	0
"PCDH24"	4127	46406	12	0	0	12	0	0	427	212	0	0	0	1	0	0	0	0
"PCDH7"	8705	426386	0	0	0	0	0	0	0	0	0	0	0	0	0	0	0	0
"PCDH8"	4003	4665	0	0	0	0	0	0	7	0	0	0	0	0	0	0	0	0
"PCDH9"	6231	927503	0	0	0	0	0	0	0	0	0	0	0	0	0	0	0	0
"PCDHA1"	5264	226055	0	0	0	0	0	0	0	0	0	0	0	0	0	0	0	0
"PCDHA10"	5258	156297	0	0	0	0	0	0	0	0	0	0	0	0	0	0	0	0
"PCDHA11"	6119	144100	0	0	0	0	0	0	0	0	0	0	0	0	0	0	0	0
"PCDHA12"	5364	137000	0	0	0	0	0	0	0	0	0	0	0	0	0	0	0	0
"PCDHA13"	5264	130077	0	0	0	0	0	0	0	0	0	0	0	0	0	0	0	0
"PCDHA2"	5364	217487	0	0	0	0	0	0	0	0	0	0	0	0	0	0	0	0
"PCDHA3"	5264	211148	0	0	0	0	0	0	0	0	0	0	0	0	0	0	0	0
"PCDHA4"	5356	205259	0	0	0	0	0	0	0	0	0	0	0	0	0	0	0	0
"PCDHA5"	5222	190570	0	0	0	0	0	0	0	0	0	0	0	0	0	0	0	0
"PCDHA6"	5291	184281	0	0	0	0	0	0	0	0	0	0	0	0	0	0	0	0
"PCDHA7"	5225	177962	0	0	0	0	0	0	0	0	0	0	0	0	0	0	0	0
"PCDHA8"	5264	171024	0	0	0	0	0	0	0	0	0	0	0	0	0	0	0	0
"PCDHA9"	6389	6389	0	0	0	0	0	0	0	0	0	0	0	0	0	0	0	0
"PCDHAC1"	5479	85629	0	0	0	0	0	0	0	0	0	0	0	0	0	0	0	0
"PCDHAC2"	5675	45819	0	0	0	0	0	0	0	0	0	0	0	0	0	0	0	0
"PCDHB1"	2535	2535	0	0	0	0	0	0	0	0	0	0	0	0	0	0	0	0
"PCDHB10"	3264	3264	0	0	0	0	0	0	0	0	0	0	0	0	0	0	0	0
"PCDHB11"	3271	3271	0	0	0	0	0	0	0	0	0	0	0	0	0	0	0	0
"PCDHB12"	3407	3407	0	0	0	0	0	0	0	0	0	0	0	0	0	0	0	0
"PCDHB13"	3486	3486	0	0	0	0	0	0	0	0	0	0	0	0	0	0	0	0
"PCDHB14"	2782	2782	0	0	0	0	0	0	0	0	0	0	0	0	0	0	0	0
"PCDHB15"	2654	2654	0	0	0	0	0	0	0	0	0	0	0	0	0	0	0	0
"PCDHB16"	4817	4817	0	0	0	0	0	0	0	0	0	0	0	0	0	0	0	0
"PCDHB17"	2411	2411	0	0	0	0	0	0	0	0	0	0	0	0	0	0	0	0
"PCDHB2"	2727	2727	0	0	0	0	0	0	0	0	0	0	0	0	0	0	0	0
"PCDHB3"	3173	3173	0	0	0	0	0	0	0	0	0	0	0	0	0	0	0	0
"PCDHB4"	3622	3622	0	0	0	0	0	0	0	0	0	0	0	0	0	0	0	0
"PCDHB5"	2905	2905	0	0	0	0	0	0	0	0	0	0	0	0	0	0	0	0
"PCDHB6"	3029	3029	0	0	0	0	0	0	0	0	0	0	0	0	0	0	0	0
"PCDHB7"	3715	3715	0	0	0	0	0	0	0	0	0	0	0	0	0	0	0	0
"PCDHB8"	2591	2591	0	0	0	0	0	0	0	0	0	0	0	0	0	0	0	0
"PCDHB9"	4219	4220	0	0	0	0	0	0	0	0	0	0	0	0	0	0	0	0
"PCDHGA1"	4606	182296	91	0	55	36	0	0	124	55	0	0	8	10	38	0	24	22
"PCDHGA10"	4621	99805	91	0	55	36	0	0	124	55	0	0	8	10	38	0	24	22
"PCDHGA11"	4876	92011	91	0	55	36	0	0	114	44	0	0	8	10	38	0	24	22
"PCDHGA12"	4778	82390	91	0	55	36	0	0	114	44	0	0	8	10	38	0	24	22
"PCDHGA2"	4794	174194	91	0	55	36	0	0	124	55	0	0	8	10	38	0	24	22
"PCDHGA3"	4609	168947	91	0	55	36	0	0	124	55	0	0	8	10	38	0	24	22
"PCDHGA4"	4606	157780	91	0	55	36	0	0	124	55	0	0	8	10	38	0	24	22
"PCDHGA5"	4606	148650	91	0	55	36	0	0	124	55	0	0	8	10	38	0	24	22
"PCDHGA6"	4609	138897	91	0	55	36	0	0	124	55	0	0	8	10	38	0	24	22
"PCDHGA7"	4609	130081	91	0	55	36	0	0	124	55	0	0	8	10	38	0	24	22
"PCDHGA8"	5507	121065	91	0	55	36	0	0	124	55	0	0	8	10	38	0	24	22
"PCDHGA9"	4609	110028	91	0	55	36	0	0	124	55	0	0	8	10	38	0	24	22
"PCDHGB1"	4594	162720	91	0	55	36	0	0	124	55	0	0	8	10	38	0	24	22
"PCDHGB2"	4606	152845	91	0	55	36	0	0	124	55	0	0	8	10	38	0	24	22
"PCDHGB3"	4600	142586	91	0	55	36	0	0	124	55	0	0	8	10	38	0	24	22
"PCDHGB4"	4582	125096	91	0	55	36	0	0	124	55	0	0	8	10	38	0	24	22
"PCDHGB5"	4582	114853	91	0	55	36	0	0	124	55	0	0	8	10	38	0	24	22
"PCDHGB6"	4603	104778	91	0	55	36	0	0	124	55	0	0	8	10	38	0	24	22
"PCDHGB7"	4745	95266	91	0	55	36	0	0	124	55	0	0	8	10	38	0	24	22
"PCDHGC3"	4730	36979	91	0	55	36	0	0	90	44	0	0	8	10	38	0	24	22
"PCDHGC4"	4627	27807	91	0	55	36	0	0	90	30	0	0	8	10	38	0	24	22
"PCDHGC5"	4645	23740	91	0	55	36	0	0	79	18	0	0	8	10	38	0	24	22
"PCDHX"	170	170	0	0	0	0	0	0	0	0	0	0	0	0	0	0	0	0
"PCDHpsi-5"	4623	4623	0	0	0	0	0	0	0	0	0	0	0	0	0	0	0	0
"PCDP1"	2970	112191	0	0	0	0	0	0	0	0	0	0	0	0	0	0	0	0
"PCF11"	5926	28698	4706	5107	2622	2084	2791	2316	1555	2193	1377	3072	3032	3725	3720	2886	4120	2316
"PCGEM1"	1589	27052	0	0	0	0	0	0	0	0	0	0	0	0	0	0	0	0
"PCGF1"	1012	2323	40	0	6	34	0	0	66	0	0	15	238	110	212	130	249	251
"PCGF2"	2721	14289	13	2	13	0	2	0	128	74	0	0	236	178	213	139	264	0
"PCGF3"	6232	36754	5116	2100	2881	2235	1068	1032	2651	1688	3442	2699	1314	1674	2058	1904	2217	1574
"PCGF5"	7136	63653	1109	2236	612	497	1271	965	625	1226	0	529	1793	2722	1657	1382	1782	998
"PCGF6"	2360	48339	10	0	0	10	0	0	0	0	0	4	122	99	208	103	213	128
"PCH68"	4503	62280	0	0	0	0	0	0	0	0	0	0	0	0	0	0	0	0
"PCIA1"	4076	13769	116	156	42	74	118	38	86	118	0	308	563	523	718	726	996	748
"PCID2"	2044	31106	595	1822	329	266	1079	743	432	1863	18	2506	635	1427	577	1278	692	888
"PCIF1"	2712	13345	274	40	139	135	17	23	516	377	302	231	676	436	844	540	855	674
"PCK1"	2689	5372	0	0	0	0	0	0	0	0	0	0	0	0	0	0	0	0
"PCK2"	2601	9817	700	72	383	317	53	19	347	179	127	57	1905	1042	1886	1961	2504	1609
"PCLO"	20313	408878	0	0	0	0	0	0	0	0	0	0	0	0	0	0	0	0
"PCM1"	8820	107091	23298	5693	13136	10162	3092	2601	11471	1530	9973	2246	9557	8549	12430	10452	11316	7714
"PCMT1"	1898	61727	1126	688	669	457	419	269	478	467	310	1086	1530	1572	1255	1024	1415	1053
"PCMTD1"	4335	81596	8471	5698	4654	3817	3121	2577	3348	2908	1735	5024	2682	3630	2059	1862	2286	1330
"PCMTD2"	3917	20532	910	446	497	413	259	187	626	208	326	247	1154	1113	1143	742	1375	774
"PCNA"	1361	11670	0	0	0	0	0	0	15	16	0	0	683	763	742	799	718	786
"PCNAP1"	1053	1053	0	0	0	0	0	0	0	0	0	0	0	0	0	0	0	0
"PCNP"	2242	20239	1421	1000	877	544	562	438	574	530	172	1038	6687	7037	8596	8805	11760	8560
"PCNT"	10606	121647	2779	1413	1583	1196	782	631	2220	954	1506	979	1268	1587	1776	1582	2087	1336
"PCNX"	12955	207979	2853	2457	1653	1200	1235	1222	2600	2016	268	1544	1195	1490	1474	1452	1779	1143
"PCNXL2"	6851	311579	309	215	223	86	100	115	221	86	69	200	152	168	98	72	81	49
"PCNXL3"	6601	21129	1844	748	1027	817	369	379	1025	1026	1519	1818	1402	1398	1765	1841	2384	1751
"PCOLCE"	1632	5921	17	0	17	0	0	0	72	31	0	0	0	22	21	18	44	17
"PCOLCE2"	1918	71224	0	0	0	0	0	0	0	0	0	0	3	0	53	42	4	12
"PCOTH"	807	3215	6	0	0	6	0	0	0	0	0	0	34	8	27	16	28	24
"PCP2"	708	2063	0	0	0	0	0	0	47	18	0	0	3	4	100	0	119	8
"PCP4"	557	61975	0	0	0	0	0	0	24	31	0	0	0	0	0	0	0	0
"PCP4L1"	1426	26724	0	0	0	0	0	0	28	0	0	0	0	0	0	0	0	0
"PCSK1"	5068	42835	0	0	0	0	0	0	10	0	0	0	0	0	0	0	0	0
"PCSK1N"	975	4455	0	0	0	0	0	0	0	0	0	0	0	0	0	0	0	0
"PCSK2"	5115	21144	0	0	0	0	0	0	29	0	0	0	0	0	0	0	0	0
"PCSK4"	2676	8982	0	0	0	0	0	0	47	36	0	0	0	0	0	7	0	0
"PCSK5"	3371	302780	11917	41358	6567	5350	22476	18882	5922	13644	214	13508	659	666	922	705	773	580
"PCSK6"	4573	186055	0	0	0	0	0	0	331	79	0	0	7	4	21	5	6	5
"PCSK7"	3500	27024	2968	1670	1687	1281	908	762	1226	916	2785	2685	1657	2008	2427	1334	2304	1257
"PCSK9"	3648	25305	0	0	0	0	0	0	37	29	0	0	0	0	0	0	0	0
"PCTK1"	3274	11866	618	1367	347	271	695	672	184	652	0	814	926	1540	928	1612	1058	1239
"PCTK2"	4058	122185	4273	1457	2453	1820	892	565	2896	1260	1212	1910	734	972	1182	1068	921	932
"PCTK3"	3772	10360	0	0	0	0	0	0	140	66	0	0	40	34	27	67	106	113
"PCTP"	2279	26393	0	0	0	0	0	0	34	4	0	0	541	503	735	483	718	481
"PCYOX1"	5430	23476	65	0	36	29	0	0	66	20	0	0	1461	1351	1536	1439	1867	1201
"PCYOX1L"	4181	7607	818	141	446	372	77	64	510	108	655	100	699	622	1056	729	1588	844
"PCYT1A"	1588	49328	3933	2741	2153	1780	1345	1396	2458	1103	2206	3793	6108	6307	1609	1301	1862	1035
"PCYT1B"	5556	89252	0	0	0	0	0	0	0	0	0	0	0	0	0	0	0	0
"PCYT2"	2270	6961	113	36	79	34	22	14	177	79	52	0	231	212	357	293	486	360
"PD04912"	361	7411	37	10	7	30	10	0	27	0	0	17	560	635	782	601	882	648
"PD2"	1318	4559	199	207	120	79	121	86	119	320	8	77	993	1099	563	814	744	602
"PDAP1"	2388	13704	3987	922	2134	1853	472	450	1527	589	1858	1352	6990	6744	6987	6219	1578	6459
"PDC"	1210	17522	9	0	0	9	0	0	11	0	0	23	0	0	0	0	0	0
"PDCD1"	2116	9026	0	0	0	0	0	0	37	75	0	0	12	44	11	3	0	0
"PDCD10"	1445	50899	3210	1280	1812	1398	693	587	1657	867	353	1378	384	699	775	623	907	617
"PDCD11"	6452	49609	498	60	339	159	30	30	469	139	160	31	1236	1120	1337	1067	1811	1115
"PDCD1LG2"	2428	60738	667	221	395	272	114	107	692	408	80	249	1194	1963	843	770	1179	699
"PDCD2"	2049	2914	325	43	199	126	24	19	174	48	0	34	705	728	742	472	684	465
"PDCD2L"	1162	21769	0	0	0	0	0	0	0	0	1	2	15	33	38	12	49	29
"PDCD4"	3667	28169	1918	240	1145	773	121	119	1547	52	774	423	1009	537	2057	1442	2544	1615
"PDCD5"	564	6220	57	0	29	28	0	0	51	62	0	70	241	304	478	413	525	360
"PDCD6"	1194	5320	4510	1744	2456	2054	991	753	1968	1127	3480	2151	2043	1831	2106	1463	2987	1658
"PDCD6IP"	5972	71130	6652	3856	3651	3001	2135	1721	3476	1910	2388	2913	4705	3993	6533	4817	8582	5151
"PDCD7"	2855	16458	172	91	93	79	37	54	137	28	59	0	71	353	446	291	592	316
"PDCD9"	298	1313	22	0	13	9	0	0	11	0	25	0	83	66	122	50	105	70
"PDCL"	2747	10219	95	40	60	35	24	16	51	17	11	41	109	102	608	476	502	365
"PDCL2"	866	35688	0	0	0	0	0	0	0	0	0	0	0	0	0	0	0	0
"PDCL3"	1081	13785	0	0	0	0	0	0	0	0	0	0	212	74	598	506	595	424
"PDDC1"	4369	10265	914	203	491	423	118	85	516	227	957	496	983	508	758	463	965	546
"PDE10A"	8339	334807	0	0	0	0	0	0	17	0	0	0	0	0	0	0	0	0
"PDE10A2"	8449	249250	0	0	0	0	0	0	0	0	0	0	0	0	0	0	0	0
"PDE11A"	9296	449505	0	0	0	0	0	0	0	0	0	0	40	31	0	0	0	0
"PDE12"	3995	5788	347	210	207	140	100	110	126	81	49	84	1114	1253	1112	1001	1318	870
"PDE1A"	2433	380326	0	0	0	0	0	0	14	0	0	0	0	0	0	0	0	0
"PDE1B"	3190	29621	3908	576	694	3214	287	289	619	240	147	268	194	218	373	354	436	430
"PDE1B2"	2839	17784	712	416	340	372	181	235	363	228	145	211	175	217	353	346	422	423
"PDE1C"	3289	546311	0	0	0	0	0	0	11	8	0	0	0	0	0	0	0	0
"PDE2A"	4342	98310	41	134	12	29	76	58	748	809	122	602	0	0	6	0	16	3
"PDE3A"	4140	311686	0	0	0	0	0	0	0	0	0	0	0	0	0	0	0	0
"PDE3B"	6104	228335	2787	3686	1639	1148	2113	1573	2212	1106	27	781	695	617	1547	1513	1050	969
"PDE4A"	4794	48976	3953	1795	2168	1785	1005	790	1657	1795	4655	6398	2845	2206	2129	1602	2891	1658
"PDE4B"	4319	582070	0	18	0	0	15	3	0	37	0	0	50	180	5	136	11	75
"PDE4C"	6129	25440	0	0	0	0	0	0	342	138	0	0	4	2	0	0	0	0
"PDE4D"	8397	307081	204	147	140	64	82	65	649	129	22	125	17	10	0	3	4	0
"PDE4DIP"	8406	143596	3142	20158	1895	1247	11199	8959	2409	7851	372	8685	1773	2007	5811	11015	5738	6343
"PDE4DN2"	452	222597	0	0	0	0	0	0	19	0	0	0	0	0	0	0	0	0
"PDE5A"	7008	134431	660	204	345	315	126	78	928	192	12	46	282	163	29	29	99	35
"PDE6A"	5663	86838	970	49	559	411	20	29	339	30	166	0	82	94	0	1	0	0
"PDE6B"	3424	45319	4	4	0	4	4	0	208	188	0	0	22	14	8	20	22	3
"PDE6C"	2989	53084	18	0	18	0	0	0	0	0	0	0	0	0	0	0	0	0
"PDE6D"	1123	48829	1315	133	697	618	66	67	730	236	476	514	174	509	628	536	288	232
"PDE6G"	1027	6120	0	0	0	0	0	0	79	57	0	0	23	6	100	56	89	75
"PDE6H"	727	8821	0	0	0	0	0	0	0	16	0	0	0	0	0	5	0	0
"PDE7A"	3148	71417	5173	1986	3011	2162	1121	865	3552	934	1392	1724	1010	1150	1344	1159	1232	291
"PDE7B"	5506	157536	0	0	0	0	0	0	0	0	0	0	0	0	0	0	0	0
"PDE8A"	5215	76644	8102	5286	4509	3593	2941	2345	3801	4229	1123	4608	1067	1409	1772	1884	1600	1330
"PDE8B"	3572	216522	140	0	47	93	0	0	174	7	0	29	1126	55	24	0	22	8
"PDE9A"	2078	121756	0	888	0	0	498	390	368	633	0	1107	1	0	4	11	0	0
"PDF"	1160	1976	168	1	58	110	1	0	70	0	60	0	2479	1956	2	36	524	42
"PDGF"	877	877	0	0	0	0	0	0	0	14	0	0	0	0	0	0	0	0
"PDGFA"	2812	22584	0	0	0	0	0	0	152	188	0	10	70	73	157	172	145	114
"PDGFB"	3382	21272	4410	17343	2391	2019	8997	8346	416	10259	244	22619	1083	19741	788	14720	1025	8767
"PDGFC"	3075	209784	14001	24234	7807	6194	13096	11138	7773	10592	1102	12606	1224	1319	440	839	1135	781
"PDGFD"	3999	257114	0	0	0	0	0	0	0	0	0	14	0	0	0	0	0	0
"PDGFRA"	6596	69149	9785	3687	5626	4159	2019	1668	4969	1906	1328	2766	1375	1590	1199	1233	1553	1279
"PDGFRB"	5770	42021	29	0	16	13	0	0	226	184	3	0	24	6	0	0	0	0
"PDGFRL"	1564	65980	0	0	0	0	0	0	0	0	0	0	0	0	0	0	0	0
"PDHA1"	3473	17791	959	1162	516	443	600	562	284	441	372	1098	2050	2514	2165	2235	2634	2198
"PDHA2"	1387	1387	0	0	0	0	0	0	0	0	0	0	0	0	0	0	0	0
"PDHB"	1591	6212	840	56	655	185	45	11	947	30	0	0	5630	4975	1104	1834	1916	1972
"PDHX"	2998	79999	860	856	476	384	455	401	594	460	170	637	978	906	781	748	851	694
"PDIA2"	2798	6605	0	0	0	0	0	0	26	0	0	0	0	1	0	0	0	0
"PDIA3"	3242	26215	926	1284	524	402	737	547	293	778	98	1714	2796	874	8380	8687	8583	7093
"PDIA3P"	2100	2100	188	116	101	87	53	63	160	47	0	59	3947	4814	3667	3954	3842	3090
"PDIA4"	2962	25630	578	90	334	244	58	32	394	107	384	12	4270	3389	5898	4714	5275	4011
"PDIA5"	1692	94912	3	0	0	3	0	0	263	13	0	0	74	77	110	71	81	68
"PDIA6"	2718	54586	499	126	281	218	74	52	428	122	91	58	4856	4991	7178	6388	6005	4585
"PDIK1L"	4333	13758	91	0	57	34	0	0	155	20	0	0	799	120	652	2	656	132
"PDILT"	2139	45543	0	0	0	0	0	0	0	0	0	0	0	0	0	0	0	0
"PDK1"	4646	43083	1135	20	622	513	20	0	702	13	207	46	440	345	240	158	316	179
"PDK2"	2396	16323	15	0	9	6	0	0	186	40	0	0	244	212	210	192	371	238
"PDK3"	2160	74610	142	0	66	76	0	0	111	0	0	0	169	224	344	269	273	155
"PDK4"	3705	13112	0	0	0	0	0	0	0	0	0	0	0	0	22	3	8	0
"PDL1"	1334	12377	4767	5735	2473	2294	3075	2660	2113	3228	1483	4209	4894	15551	5071	10161	6917	10200
"PDL2"	2419	60738	667	221	395	272	114	107	692	408	80	249	1194	1963	843	770	1179	699
"PDLIM1"	1614	53154	5	0	5	0	0	0	0	0	0	0	4	15	4	6	26	19
"PDLIM2"	4621	17556	1221	93	730	491	61	32	525	248	1066	36	1339	543	863	510	1733	748
"PDLIM3"	2872	23447	0	0	0	0	0	0	15	0	0	0	0	0	0	0	0	0
"PDLIM4"	2623	15796	405	25	225	180	15	10	204	121	66	19	302	327	189	136	678	518
"PDLIM5"	6204	216340	6454	25878	3758	2696	13900	11978	2747	14403	175	22307	2228	2741	2101	2017	1921	1294
"PDLIM7"	2131	8549	1683	304	915	768	152	152	700	453	2699	1265	1735	1416	2431	1795	2484	1410
"PDNP3"	3119	110176	0	0	0	0	0	0	0	3	0	0	30	68	87	136	22	7
"PDP1"	4361	9121	264	37	144	120	18	19	156	21	0	21	1087	602	936	209	1409	391
"PDP2"	3832	7421	234	0	136	98	0	0	100	20	0	0	909	452	633	187	648	194
"PDPK1"	7689	65025	2840	831	1641	1199	406	425	1582	470	2138	988	3080	2891	6842	4539	7858	4125
"PDPN"	2816	34200	0	0	0	0	0	0	0	0	0	0	0	0	0	0	0	0
"PDPR"	8018	47657	2409	1203	1271	1138	666	537	1431	665	2221	1675	4105	3491	2414	1476	6111	3185
"PDRC2"	1861	25163	0	0	0	0	0	0	24	26	0	0	0	4	0	39	0	0
"PDRG1"	1377	7126	12	71	0	12	52	19	97	44	0	0	302	304	81	88	413	87
"PDS5A"	7208	155094	7387	3211	3979	3408	1720	1491	3567	1661	3025	4480	4128	4853	3991	3565	4854	2856
"PDS5B"	7502	191565	4412	1049	2545	1867	701	348	2745	753	1336	693	1520	1523	1401	983	1601	905
"PDSS1"	1628	49131	5980	27712	3426	2554	15773	11939	1950	14385	2639	52940	440	1082	2232	5188	2672	5682
"PDSS2"	3560	307020	6238	582	3575	2663	380	202	3874	590	1549	738	662	722	633	533	689	519
"PDX1"	2575	6285	0	0	0	0	0	0	0	0	0	0	0	0	0	0	0	0
"PDXDC1"	4032	62719	6385	3309	3707	2678	1833	1476	3481	2326	2526	3919	4769	4825	8638	8207	10694	6400
"PDXDC2"	4200	89643	1691	1054	833	858	576	478	1079	829	605	1373	358	417	1150	1077	1222	636
"PDXK"	7391	43211	12814	11413	8799	4015	6076	5337	5303	5307	17246	16039	12321	9510	12786	8991	15521	9531
"PDXP"	2007	8204	5	2	5	0	2	0	68	23	1	0	431	309	564	364	594	390
"PDYN"	2576	14051	0	0	0	0	0	0	9	0	0	0	0	0	0	0	0	0
"PDZD11"	1492	3589	0	0	0	0	0	0	0	0	0	0	229	235	363	325	453	305
"PDZD2"	11729	471522	231	13	117	114	0	13	441	149	60	0	0	13	4	10	0	0
"PDZD3"	2948	4693	0	0	0	0	0	0	48	25	0	0	0	0	0	0	0	0
"PDZD4"	4015	28382	0	0	0	0	0	0	127	80	0	0	4	1	0	0	0	0
"PDZD7"	2655	20084	1	0	0	1	0	0	260	150	0	0	20	13	12	7	29	17
"PDZD8"	3842	92333	3625	1506	1991	1634	847	659	1725	935	52	645	1005	1147	907	745	671	98
"PDZK1"	3507	18233	9	0	8	1	0	0	18	0	0	0	0	0	0	0	0	0
"PDZK1IP1"	897	6511	0	0	0	0	0	0	41	15	0	0	0	0	0	0	0	0
"PDZRN3"	4171	242422	0	0	0	0	0	0	0	0	0	0	0	0	0	0	0	0
"PDZRN4"	3421	136845	0	0	0	0	0	0	0	0	0	0	0	0	0	69	0	0
"PEA15"	2780	10037	2951	2063	1225	1726	1181	882	673	445	595	1858	15946	19185	13578	3861	21197	13115
"PEAR1"	4889	22705	0	0	0	0	0	0	164	82	0	0	0	0	4	0	0	0
"PEAS"	1882	7054	399	28	193	206	16	12	277	71	200	0	2426	2251	2599	1721	3446	2230
"PEBP1"	1495	9522	119	62	45	74	37	25	75	23	0	0	2460	1974	3847	3012	3680	2765
"PEBP4"	901	214658	0	3	0	0	3	0	485	290	0	0	0	0	0	0	0	0
"PECAM1"	1343	1343	317	36	156	161	36	0	279	39	97	49	5535	5054	3338	172	4295	3475
"PECI"	1494	19905	17	3	17	0	3	0	95	8	0	0	371	258	589	440	857	569
"PECR"	1875	43423	2573	26162	1330	1243	14081	12081	548	7715	681	14667	215	274	488	581	421	379
"PEF1"	1615	15008	670	840	368	302	424	416	363	577	59	857	973	1168	380	269	1396	362
"PEG10"	6616	13369	0	0	0	0	0	0	0	12	0	0	0	0	0	0	0	0
"PEG3"	8769	30651	0	0	0	0	0	0	0	0	0	0	0	0	0	0	0	0
"PEG3AS"	435	435	0	0	0	0	0	0	0	0	0	0	0	0	0	0	0	0
"PEG8/IGF2AS"	2074	8159	0	0	0	0	0	0	15	36	0	0	0	0	0	0	0	0
"PELI1"	7350	19697	10453	100946	5858	4595	54778	46168	707	48371	0	43164	657	17428	760	12874	689	2520
"PELI2"	5701	182939	2993	749	1774	1219	414	335	2696	990	469	559	422	439	519	563	519	422
"PELI3"	2751	10473	421	0	210	211	0	0	355	54	190	0	297	240	671	488	816	492
"PELO"	2921	14677	4	0	4	0	0	0	75	17	0	0	393	177	371	188	357	152
"PELP1"	3690	32954	1289	83	701	588	39	44	794	94	763	231	1286	1132	2256	1575	3498	1808
"PEMT"	1030	86117	1173	8	580	593	0	8	2115	451	567	55	417	262	231	222	548	459
"PEN11B"	3616	72199	0	0	0	0	0	0	384	184	0	0	0	0	0	0	0	0
"PENK"	1340	5771	0	0	0	0	0	0	0	0	0	0	0	0	0	0	0	0
"PEPD"	2017	134938	1419	812	747	672	428	384	2517	1774	622	1318	1458	839	2564	2232	1425	2008
"PER1"	4731	11966	133	241	75	58	121	120	327	380	54	928	593	1711	554	1430	532	1082
"PER2"	6364	44529	720	488	316	404	280	208	1011	452	107	289	972	829	1043	719	1062	648
"PER3"	6357	60524	1164	293	698	466	123	170	1198	375	82	167	1305	1389	1811	1309	1475	934
"PERP"	4305	19020	0	0	0	0	0	0	0	0	0	0	0	0	0	0	0	0
"PES1"	2757	30390	96	99	64	32	55	44	166	273	39	122	290	357	516	547	949	689
"PET112"	3735	5040	21	0	11	10	0	0	20	0	0	0	136	43	73	66	71	54
"PET112L"	2023	90146	156	0	79	77	0	0	395	43	0	0	450	369	483	413	550	370
"PEX1"	4440	41509	513	39	291	222	23	16	282	37	92	32	673	481	689	386	735	359
"PEX10"	2078	7769	98	0	44	54	0	0	247	121	101	32	2153	1733	2179	1875	2633	1811
"PEX11"	1044	7671	0	0	0	0	0	0	0	0	0	0	15	0	7	0	2	0
"PEX11A"	1161	7671	0	0	0	0	0	0	0	0	0	0	15	0	7	0	2	0
"PEX11B"	1614	7350	102	36	63	39	30	6	97	21	0	0	597	553	714	352	837	450
"PEX11G"	1067	12146	13	0	0	13	0	0	64	46	49	0	2	11	15	18	3	7
"PEX12"	2685	3843	0	0	0	0	0	0	0	0	0	0	63	5	74	7	97	12
"PEX13"	4518	34314	477	14	249	228	14	0	166	14	30	46	525	382	444	259	523	255
"PEX14"	1933	155812	908	213	460	448	117	96	1207	375	113	329	258	234	368	278	364	256
"PEX16"	1918	8455	435	47	265	170	27	20	168	184	289	343	260	216	367	407	421	394
"PEX19"	3677	8344	214	0	98	116	0	0	136	0	28	0	444	1685	2202	1804	2155	574
"PEX26"	2745	11522	568	354	342	226	173	181	231	377	172	969	968	996	728	616	800	535
"PEX3"	2782	39833	77	0	30	47	0	0	163	11	9	10	127	165	198	151	181	134
"PEX5"	3742	21798	22	0	10	12	0	0	16	11	0	0	331	243	436	268	486	287
"PEX5L"	3646	173960	0	0	0	0	0	0	0	0	0	0	0	0	0	0	0	0
"PEX6"	3513	15370	131	12	62	69	5	7	303	29	95	25	402	360	432	242	678	378
"PEX7"	1600	91371	61	45	30	31	29	16	266	9	0	0	163	90	178	139	140	128
"PF20"	2069	1126110	0	0	0	0	0	0	23	0	0	0	6	8	0	16	4	6
"PF4"	479	921	0	0	0	0	0	0	0	0	0	0	0	3	0	2	3	0
"PF4V1"	744	1187	0	0	0	0	0	0	0	0	0	0	0	0	0	0	0	0
"PFAAP1"	1785	43346	2822	859	1607	1215	487	372	1470	610	629	568	657	821	634	383	677	446
"PFAAP5"	918	94741	9656	9763	6030	3626	5763	4000	2798	1761	2708	2741	800	4561	1601	1381	2086	1163
"PFAS"	5412	21214	203	69	123	80	20	49	321	95	15	0	471	399	637	448	607	336
"PFDN1"	1328	58056	885	137	540	345	86	51	492	217	0	85	820	816	947	691	1092	832
"PFDN2"	645	17521	282	331	172	110	165	166	179	351	104	807	141	401	519	497	569	650
"PFDN4"	1349	11991	46	0	30	16	0	0	37	10	0	0	0	84	170	148	282	161
"PFDN5"	691	3999	544	433	326	218	231	202	245	261	240	418	3125	3432	4489	3894	4235	3380
"PFDN6"	599	1335	31	138	31	0	108	30	90	640	0	185	426	282	515	412	548	1455
"PFKFB1"	1747	60923	0	0	0	0	0	0	0	8	0	0	0	1	0	0	0	0
"PFKFB2"	7104	23117	55	0	14	41	0	0	30	4	0	10	315	363	520	314	668	314
"PFKFB3"	4586	32667	6742	5467	3729	3013	3005	2462	2406	4486	3501	8819	1279	2019	1234	2350	1537	1350
"PFKFB4"	3633	39103	917	6	581	336	4	2	1062	153	1508	67	219	425	462	765	481	822
"PFKL"	4055	8028	6407	2673	3404	3003	1269	1404	1705	1743	4932	4849	6554	6729	9351	9289	13065	8998
"PFKM"	3788	40183	2	0	0	2	0	0	48	45	14	0	134	134	141	175	120	130
"PFKP"	3299	23433	29696	17395	16263	13433	9314	8081	11583	10348	29401	16042	15940	15933	20308	17419	24013	15476
"PFN1"	1188	1817	1640	1171	871	769	578	593	540	931	871	1736	7470	23035	27168	36047	8223	29144
"PFN2"	2109	6052	281	39	161	120	22	17	108	59	0	0	0	0	0	0	0	0
"PFN3"	531	531	0	0	0	0	0	0	0	0	0	0	0	0	0	0	0	0
"PFN4"	780	7909	19	0	19	0	0	0	56	9	0	0	0	0	0	0	3	0
"PFTK1"	5100	614186	0	24	0	0	12	12	33	81	0	482	106	72	210	168	108	69
"PFTK2"	1801	54922	0	0	0	0	0	0	0	0	0	0	0	0	0	0	0	0
"PGA3"	1404	9367	0	0	0	0	0	0	0	0	0	0	2	2	0	0	0	0
"PGA4"	1403	9359	0	0	0	0	0	0	0	0	0	0	0	0	0	0	0	0
"PGA5"	1366	10246	0	0	0	0	0	0	0	0	0	0	0	0	0	0	0	0
"PGAM1"	1798	5765	213	17	98	115	0	17	192	91	0	143	1479	1372	7780	7005	7677	5523
"PGAM2"	836	2838	7913	4928	4381	3532	2508	2420	0	1855	5315	4035	4389	4912	4794	4162	6597	4438
"PGAM4"	1679	1679	0	0	0	0	0	0	0	0	0	0	0	0	0	0	0	0
"PGAM5"	1404	10481	266	604	135	131	383	221	96	270	48	560	701	528	512	304	573	333
"PGAP1"	11224	93727	21	34	4	17	10	24	0	44	0	24	48	111	9	0	0	0
"PGAP2"	2044	28533	621	143	328	293	113	30	326	186	106	208	181	314	237	186	346	222
"PGAP3"	2694	16936	47	0	33	14	0	0	314	132	0	34	265	217	403	335	461	353
"PGBD1"	3091	20963	7	0	7	0	0	0	10	0	0	0	16	0	21	0	32	5
"PGBD2"	2833	12904	155	0	81	74	0	0	152	25	0	0	348	137	400	104	443	180
"PGBD3"	3478	23902	2327	172	1246	1081	76	96	594	92	462	119	560	263	439	278	582	271
"PGBD4"	2318	2318	0	0	0	0	0	0	0	0	0	0	40	44	20	0	64	0
"PGBD5"	3452	55976	0	0	0	0	0	0	66	0	0	0	0	0	0	0	0	4
"PGC"	1363	10671	0	0	0	0	0	0	53	40	0	0	0	0	0	0	0	0
"PGC-1v"	6361	98057	0	0	0	0	0	0	0	0	0	0	0	0	0	0	0	0
"PGCP"	1903	498224	22741	16929	12913	9828	9439	7490	14309	10964	5835	15446	554	828	921	984	512	370
"PGD"	2064	21027	2501	566	1384	1117	254	312	945	183	1627	602	11254	7948	12711	11387	16134	10534
"PGDH3"	1182	23186	0	0	0	0	0	0	13	0	0	0	52	57	0	10	60	32
"PGF"	1735	13753	0	0	0	0	0	0	70	48	0	0	0	0	0	0	0	0
"PGGT1B"	2739	52043	1315	26	801	514	12	14	933	42	97	36	877	653	293	228	331	457
"PGK1"	2505	20465	1671	389	973	698	187	202	945	304	865	430	7609	5752	12123	11729	13307	11476
"PGK2"	1643	1643	0	0	0	0	0	0	0	0	0	0	0	0	0	0	0	0
"PGLS"	1037	9665	409	143	265	144	98	45	214	145	276	283	1367	647	873	769	1834	765
"PGLYRP1"	693	3884	0	13	0	0	0	13	77	35	0	0	0	0	0	0	0	0
"PGLYRP2"	2123	10219	0	0	0	0	0	0	0	0	0	0	3	1	0	0	0	0
"PGLYRP3"	1180	12858	0	0	0	0	0	0	0	0	0	0	0	0	0	0	0	0
"PGLYRP4"	1841	18426	0	0	0	0	0	0	0	0	0	0	0	0	0	0	0	0
"PGM1"	2553	37015	10	0	2	8	0	0	26	0	0	0	476	428	395	351	572	386
"PGM2"	3252	36279	583	83	318	265	57	26	504	349	193	182	2491	2739	2474	1873	2953	1903
"PGM2L1"	8515	68143	4	0	0	4	0	0	0	0	0	0	159	169	11	4	23	0
"PGM3"	2197	25005	299	22	219	80	0	22	311	57	48	0	630	437	602	431	581	361
"PGM5"	3348	174163	0	0	0	0	0	0	0	0	0	0	3	0	14	6	20	9
"PGM5P2"	1980	67611	265	0	166	99	0	0	57	7	0	0	51	32	280	75	207	92
"PGP"	3138	3221	0	149	0	0	91	58	0	109	483	77	1101	831	1394	908	1854	1077
"PGPEP1"	7211	29357	1215	48	699	516	27	21	649	114	1126	43	1787	943	1159	487	1591	762
"PGR"	13045	100191	0	0	0	0	0	0	0	0	0	0	0	0	0	0	0	0
"PGRMC1"	1918	8219	0	0	0	0	0	0	23	0	0	0	932	943	1009	834	1133	839
"PGRMC2"	1851	17652	24	18	24	0	0	18	72	23	0	43	117	131	160	121	164	106
"PGS1"	3162	21178	5445	1252	3003	2442	768	484	2474	1222	4872	2526	1349	627	1528	701	2163	876
"PGSF1"	941	3452	0	0	0	0	0	0	17	28	0	0	0	0	0	0	0	0
"PHACTR1"	4854	558524	89	156	70	19	82	74	329	266	0	48	64	72	71	197	131	127
"PHACTR2"	9645	153221	12028	7201	6641	5387	4141	3060	7250	5000	3333	5451	2125	2384	2928	2412	2716	1612
"PHACTR3"	2739	243163	0	0	0	0	0	0	368	84	0	0	0	0	0	0	0	0
"PHACTR4"	6341	130789	1246	377	719	527	196	181	1003	306	119	239	1053	983	818	544	1000	548
"PHAX"	1756	24449	34	0	16	18	0	0	40	34	0	0	1010	800	611	375	626	359
"PHB"	1833	10824	12	0	12	0	0	0	144	15	0	0	976	773	2020	1902	2567	1103
"PHB2"	1444	5401	1167	471	670	497	13	458	241	439	468	450	2283	2678	2401	1818	2721	1563
"PHC1"	5199	26744	947	797	518	429	436	361	444	417	0	516	33	8863	11099	9969	13424	10266
"PHC2"	4326	106994	3481	323	1831	1650	208	115	1916	354	892	612	1647	811	1570	827	2221	1078
"PHC3"	12687	94171	8932	3595	5040	3892	1888	1707	4024	1395	3041	2632	387	640	2354	1365	2220	1097
"PHEX"	2975	210307	0	0	0	0	0	0	0	0	0	0	0	0	0	0	0	0
"PHEX27HOM"	4384	9336	0	0	0	0	0	0	21	0	0	0	0	0	1	0	0	0
"PHF1"	2343	5458	272	263	151	121	135	128	187	201	47	180	512	748	532	742	612	620
"PHF10"	3909	9054	563	41	270	293	10	31	544	53	75	26	2360	2482	1062	823	1287	715
"PHF11"	1658	33317	602	95	389	213	42	53	553	196	154	161	963	596	1187	600	923	694
"PHF12"	4490	46239	3533	358	1940	1593	211	147	2022	296	2577	606	1206	493	1368	479	2110	632
"PHF13"	3673	10338	6	0	6	0	0	0	17	16	22	0	597	127	809	136	1022	138
"PHF14"	4276	129768	2644	1556	1451	1193	759	797	1949	742	116	393	424	517	473	366	583	414
"PHF15"	6635	57547	1020	1872	580	440	1005	867	859	2387	128	4535	1065	1715	1366	2851	1642	1869
"PHF16"	4942	148774	0	0	0	0	0	0	0	8	0	0	0	6	9	0	4	0
"PHF17"	5815	65221	721	60	412	309	43	17	638	119	104	58	738	538	895	342	758	326
"PHF19"	4302	21677	264	1511	114	150	812	699	314	913	44	1717	571	615	868	867	964	784
"PHF2"	5369	102960	3839	1106	2024	1815	546	560	2766	1939	1414	2175	1291	1202	1546	1169	1979	1116
"PHF20"	5907	178367	2194	1706	1194	1000	989	717	1225	1432	685	2913	1228	1122	1314	999	1499	836
"PHF20L1"	6282	73448	7202	3164	3910	3292	1747	1417	3785	1443	575	1611	2021	2460	1748	1450	2608	1407
"PHF21A"	7333	192116	10021	2053	5747	4274	1212	841	5267	1360	1502	1807	1349	1186	992	647	1342	787
"PHF21B"	3681	128538	0	0	0	0	0	0	593	240	0	0	0	0	0	0	0	0
"PHF23"	2041	4479	232	44	131	101	44	0	130	63	0	36	815	20	674	331	1400	276
"PHF3"	7487	78682	5691	878	3106	2585	481	397	2475	225	778	136	2380	2427	2817	1684	3134	1865
"PHF5A"	1068	8988	41	29	41	0	29	0	69	202	0	78	323	325	409	369	395	397
"PHF6"	4771	55481	359	86	205	154	32	54	210	79	0	33	999	1185	909	595	1133	580
"PHF7"	2286	13131	156	11	113	43	6	5	217	9	0	1	324	216	192	109	248	69
"PHF8"	6079	107495	1295	492	723	572	273	219	887	385	126	513	1126	697	1348	1261	1668	542
"PHGDH"	3203	24600	0	0	0	0	0	0	60	15	0	0	81	69	8	10	84	52
"PHIP"	12005	143876	14203	7910	8013	6190	4210	3700	6866	2953	2187	3228	3150	3937	3530	2537	3122	1855
"PHKA1"	6192	135366	0	0	0	0	0	0	0	0	0	0	0	0	5	0	0	0
"PHKA2"	5357	92065	1336	577	704	632	291	286	1121	625	820	480	791	1064	1251	1165	1464	1071
"PHKB"	5634	240225	6510	2370	3607	2903	1330	1040	5459	1823	1051	1102	2246	2528	2618	2286	3133	2131
"PHKG1"	1538	12016	127	0	69	58	0	0	150	57	0	0	1	0	3	10	6	5
"PHKG2"	1669	8762	575	143	333	242	100	43	315	157	206	281	309	691	920	596	1332	767
"PHLDA1"	5914	6330	491	481	262	229	292	189	137	174	0	80	1943	2501	2888	2319	2187	2896
"PHLDA2"	922	1149	0	0	0	0	0	0	0	23	0	0	58	151	204	0	45	339
"PHLDA3"	1517	3678	0	0	0	0	0	0	8	18	0	0	0	943	0	82	0	0
"PHLDB1"	5719	51530	312	7202	207	105	3946	3256	412	5908	0	8308	36	1370	37	2246	65	617
"PHLDB2"	6143	117337	0	0	0	0	0	0	0	0	0	0	0	7	0	0	0	0
"PHLDB3"	2504	29731	283	363	134	149	174	189	173	763	73	1720	67	392	82	256	148	236
"PHLPP1"	4815	264933	2595	11837	1482	1113	6556	5281	1193	4343	18	3829	400	389	396	304	474	292
"PHLPP2"	8454	70891	270	33	203	67	22	11	237	53	66	47	583	647	654	517	854	509
"PHOSPHO1"	2176	7398	1018	722	562	456	286	436	242	393	572	2686	530	905	580	981	972	1300
"PHOSPHO2"	1127	7243	0	0	0	0	0	0	0	0	0	0	0	0	13	0	0	0
"PHOX2A"	1701	5100	799	54	434	365	54	0	315	0	0	0	820	916	1183	1127	1506	1185
"PHOX2B"	3032	4889	0	0	0	0	0	0	0	0	0	0	0	0	0	0	0	0
"PHPT1"	1253	2234	363	46	149	214	22	24	137	102	201	66	637	414	1089	842	1223	655
"PHRF1"	5542	35739	4328	803	2424	1904	399	404	1943	959	3493	1490	1916	1492	2133	1470	3189	2004
"PHSECRG2"	2031	22872	53	0	15	38	0	0	200	18	0	0	1049	1097	747	580	852	574
"PHTF1"	3955	18012	375	34	224	151	24	10	232	15	0	28	268	412	483	394	492	336
"PHTF2"	5126	117373	3155	1046	1870	1285	528	518	2425	585	231	565	1912	2729	2621	2813	2668	1955
"PHYH"	1884	24617	0	17	0	0	17	0	60	19	0	0	504	327	500	520	562	464
"PHYH2"	1863	40890	134	0	100	34	0	0	162	8	0	0	263	258	507	430	338	406
"PHYHD1"	2150	21148	115	381	62	53	244	137	171	195	63	315	666	806	605	737	897	699
"PHYHIP"	3342	12636	0	0	0	0	0	0	121	43	0	0	0	0	0	0	0	0
"PHYHIPL"	3675	71186	0	0	0	0	0	0	0	0	0	0	0	0	0	0	0	0
"PI15"	7020	30243	0	0	0	0	0	0	0	0	0	0	0	0	0	0	0	0
"PI16"	2195	10404	0	0	0	0	0	0	30	0	0	0	0	1	0	0	0	0
"PI3"	556	1646	0	0	0	0	0	0	0	0	0	0	0	0	0	0	0	0
"PI4K2A"	4407	92087	3514	2027	2021	1493	1097	930	1559	906	1411	1777	3251	2539	6268	4023	5524	3678
"PI4K2B"	3611	45180	1916	1415	1071	845	821	594	1325	1110	605	1090	615	1023	582	1009	653	639
"PI4KA"	6775	151091	6122	2747	3516	2606	1434	1313	4087	2240	3254	3286	3013	3038	7677	7799	8494	6520
"PI4KAP2"	3883	13233	127	8	76	51	6	2	176	40	63	37	84	101	1422	1147	1663	1156
"PI4KB"	3793	35722	1879	2871	1057	822	1549	1322	1072	1579	782	3117	1559	2092	2089	2669	2717	2028
"PIAS1"	2292	133832	21506	16294	12074	9432	8856	7438	8678	7250	8003	11140	1092	2833	3092	1881	3501	1829
"PIAS2"	2373	105407	3395	757	1926	1469	444	313	2142	649	618	645	572	672	658	440	640	387
"PIAS3"	2916	10560	88	0	51	37	0	0	158	26	10	21	347	285	415	313	535	243
"PIAS4"	1746	30318	2948	1396	1635	1313	754	642	1483	1281	1521	1964	462	339	312	279	543	324
"PIB5PA"	2601	11775	0	0	0	0	0	0	95	0	0	0	22	31	4	0	38	18
"PIBF1"	3129	234361	858	72	534	324	37	35	905	80	68	223	243	257	261	200	337	231
"PICALM"	3868	111624	77053	80774	43128	33925	41205	39569	33697	32269	46470	62608	11151	12081	15871	16636	14883	11672
"PICALM variant protein"	1826	23787	19195	10862	10879	8316	2457	8405	16957	7783	8738	13617	3336	3982	4807	4333	4576	3393
"PICK1"	2219	18447	439	68	231	208	39	29	500	189	64	29	363	410	355	357	754	523
"PID1"	2825	247369	31763	0	0	31763	0	0	11	0	0	0	0	0	0	0	0	0
"PIF"	689	3775	0	0	0	0	0	0	0	0	0	0	0	0	0	0	0	0
"PIF1"	2693	10007	1	0	0	1	0	0	46	0	0	0	2	0	0	0	0	0
"PIG-T"	2260	10162	400	149	252	148	86	63	286	89	230	0	1578	1460	1977	1793	2250	1590
"PIG11"	3464	18710	1720	1540	951	769	799	741	760	1079	1294	2550	2031	2364	2038	2604	3071	2754
"PIG12"	1912	14730	0	0	0	0	0	0	68	40	0	0	0	0	0	0	0	0
"PIG32"	1729	45522	286	75	149	137	38	37	173	21	24	31	1835	2018	1778	1558	2177	1329
"PIG33"	3023	56167	0	0	0	0	0	0	0	8	0	0	0	0	0	0	0	0
"PIG35"	1192	15610	51	0	15	36	0	0	134	14	0	0	161	103	146	59	229	87
"PIG38"	1691	142610	0	0	0	0	0	0	0	0	0	0	0	0	0	0	0	0
"PIG45"	1286	1912	0	0	0	0	0	0	36	27	0	0	22	17	5	0	16	8
"PIG8"	2397	15278	30	0	0	30	0	0	17	45	0	73	686	540	950	715	1010	750
"PIGA"	3609	16082	11	0	0	11	0	0	24	0	0	40	180	325	270	232	244	192
"PIGB"	2208	36714	1793	168	952	841	100	68	1428	109	141	77	3563	3652	281	113	247	174
"PIGC"	1673	50958	128	0	49	79	0	0	229	1	0	17	492	460	480	333	610	356
"PIGF"	1139	35839	2164	5515	1408	756	2934	2581	1306	1276	372	2196	3035	4853	3994	4476	3765	3481
"PIGG"	3262	40332	2465	794	1357	1108	496	298	1413	556	1115	974	1010	913	1328	908	2068	889
"PIGH"	1442	10996	93	0	23	70	0	0	64	0	0	0	295	384	381	349	527	334
"PIGK"	4634	130465	51	0	46	5	0	0	67	0	0	0	439	580	4483	4341	6110	4548
"PIGL"	1474	100430	180	56	129	51	36	20	179	73	0	68	101	102	114	105	99	76
"PIGM"	4323	4323	10	0	10	0	0	0	12	0	0	0	182	101	130	41	136	28
"PIGN"	4902	142831	2726	447	1597	1129	234	213	1850	330	269	164	742	804	1041	1066	915	1000
"PIGO"	4076	7858	485	145	275	210	96	49	250	45	65	206	486	530	751	665	980	616
"PIGP"	915	7441	0	0	0	0	0	0	28	0	0	0	68	72	200	201	159	173
"PIGQ"	2977	17078	328	27	167	161	8	19	324	187	190	133	447	435	705	647	903	704
"PIGR"	4453	17944	0	0	0	0	0	0	0	12	0	0	0	0	0	0	0	0
"PIGS"	2885	18483	211	16	144	67	16	0	262	23	0	28	1805	1283	1506	1113	2077	1320
"PIGT"	2591	8073	400	149	252	148	86	63	286	89	230	0	1578	1460	1977	1793	2250	1590
"PIGU"	1974	116744	44	26	36	8	15	11	107	33	48	14	213	235	296	245	322	229
"PIGV"	2719	10202	33	15	33	0	15	0	106	103	0	16	285	233	290	263	393	207
"PIGW"	2257	3749	0	0	0	0	0	0	31	15	5	0	326	271	314	243	200	130
"PIGX"	3399	23334	181	0	68	113	0	0	63	18	16	21	508	576	350	376	443	341
"PIGY"	1355	2822	0	0	0	0	0	0	0	0	0	0	1379	1492	1818	1295	1869	1286
"PIGZ"	2703	22491	772	78	389	383	43	35	552	104	177	85	243	218	252	127	500	236
"PIH1D1"	1255	5567	354	65	223	131	36	29	163	92	69	15	874	537	651	696	1557	832
"PIH1D2"	1740	4436	0	0	0	0	0	0	0	0	0	0	641	630	496	381	604	388
"PIK3AP1"	4826	127210	10441	60880	5674	4767	32424	28456	2251	32873	988	40233	4204	6219	6563	10706	5155	4926
"PIK3C2A"	8317	83229	1201	846	721	480	461	385	1076	643	319	906	1322	1595	1501	1406	1471	962
"PIK3C2B"	7639	67717	20	4	4	16	0	4	101	32	0	3	119	92	55	26	152	76
"PIK3C2B variant protein"	2866	35679	12	4	4	8	0	4	85	32	0	0	24	16	29	8	38	24
"PIK3C2G"	4960	366415	0	0	0	0	0	0	0	0	0	0	0	0	0	0	0	0
"PIK3C3"	3647	56151	2916	1185	1733	1183	680	505	1887	1044	359	939	898	1252	1132	1000	1260	924
"PIK3CA"	3728	86186	3984	454	2236	1748	294	160	2476	260	458	241	1385	1805	1686	1268	1740	907
"PIK3CB"	3233	103954	2568	775	1438	1130	395	380	1641	417	351	649	1514	1865	1004	1052	1219	867
"PIK3CD"	5505	19010	10520	4300	5687	4833	2093	2207	3998	3378	9662	13196	6194	5714	4322	7365	10095	7220
"PIK3CG"	5383	41663	2093	241	1184	909	129	112	1135	55	306	0	2393	2044	2313	1468	2392	1349
"PIK3IP1"	2773	9134	103	0	77	26	0	0	168	47	8	37	472	59	476	151	182	249
"PIK3R1"	6969	86045	13839	1686	7707	6132	930	756	6928	831	5809	791	5237	3030	6195	2630	5823	3150
"PIK3R2"	5119	24913	1424	543	810	614	282	261	438	235	1018	486	26215	15584	58169	37253	34993	33558
"PIK3R3"	5684	92569	0	0	0	0	0	0	150	15	0	0	21	71	43	10	10	8
"PIK3R4"	5058	67919	315	47	165	150	13	34	345	119	14	15	821	912	875	870	960	855
"PIK3R5"	4509	86792	29983	61586	16744	13239	33897	27689	9127	38472	12838	52906	2299	5379	6620	6835	3765	3446
"PIK3R6"	3059	64941	1964	260	1050	914	135	125	1092	327	776	151	474	435	694	634	738	587
"PIKFYVE"	9942	92485	7497	2124	4043	3454	1195	929	4329	996	3191	1639	2931	3109	3592	2601	3537	2096
"PILRA"	1323	26656	1469	2355	841	628	1307	1048	557	1625	571	4435	774	1969	1632	3091	1462	2150
"PILRB"	3649	31716	4869	5708	2712	2157	3110	2598	1640	3296	1504	7297	1298	3008	2370	3885	3237	3040
"PIM1"	2713	5282	62	351	53	9	207	144	40	176	0	216	449	2398	884	3835	682	1566
"PIM2"	2191	5954	58	179	26	32	97	82	44	145	0	156	506	695	610	456	743	646
"PIM3"	2384	3578	1256	5559	740	516	2805	2754	303	4786	487	5219	2878	21672	3705	36610	4727	28442
"PIN1"	1673	14237	493	170	270	223	82	88	285	161	0	35	567	454	739	627	1188	627
"PIN1L"	997	997	0	0	0	0	0	0	0	0	0	0	0	0	0	0	0	0
"PIN4"	2607	83288	470	0	315	155	0	0	633	22	189	0	171	93	200	187	276	195
"PINK1"	2667	18057	263	17	144	119	0	17	269	57	0	9	4127	3200	1609	1427	2400	1491
"PINX1"	1054	74417	1213	182	718	495	127	55	799	480	243	390	94	102	94	100	105	93
"PION"	3280	105649	21629	28457	12070	9559	15201	13256	7741	8703	10304	23650	3144	6054	2546	3734	3044	1793
"PIP"	580	7662	0	0	0	0	0	0	0	0	0	0	0	0	0	0	0	0
"PIP4K2A"	3842	179738	32845	7869	18319	14526	4181	3688	15198	3579	18443	7055	5316	5681	5440	4637	6030	4141
"PIP4K2B"	5741	34215	870	293	480	390	179	114	571	188	516	309	1652	1448	1991	1221	2227	1227
"PIP4K2C"	3228	12270	138	3	83	55	3	0	113	3	0	0	729	796	958	636	1032	715
"PIP5K1A"	4243	4243	3779	2487	2057	1722	1431	1056	1472	1778	3012	5691	1540	2022	1315	1672	1774	1488
"PIP5K1B"	3316	266882	2843	1745	1597	1246	959	786	1817	935	603	1061	3284	3314	1367	752	1951	977
"PIP5K1C"	5065	70265	12082	12693	6392	5690	6632	6061	3538	9758	11069	28502	3986	4080	4207	1429	5864	4687
"PIP5K3"	3623	60164	5098	1292	2736	2362	725	567	3054	661	2634	1142	712	885	1181	950	998	511
"PIP5KL1"	1557	9269	0	0	0	0	0	0	115	51	30	37	6	3	1	21	56	5
"PIPOX"	2420	14320	28	0	18	10	0	0	119	17	0	0	309	289	300	226	472	295
"PIR"	1321	108540	180	0	111	69	0	0	77	20	0	0	260	273	259	297	193	106
"PIRT"	3467	15627	0	0	0	0	0	0	0	0	0	0	0	0	0	0	0	0
"PISD"	2688	12335	2299	576	1303	996	278	298	1274	485	2070	723	839	552	1524	869	1791	867
"PISRT1"	531	531	0	0	0	0	0	0	0	0	0	0	0	0	0	0	0	0
"PITPNA"	3646	44827	9060	10004	5030	4030	5456	4548	3535	5551	9444	15943	2072	3241	2258	3248	11201	2630
"PITPNB"	2938	67531	6902	16398	3886	3016	8767	7631	2795	8214	2580	15049	2193	1260	2474	3362	2559	2472
"PITPNC1"	2116	315723	3092	498	1790	1302	303	195	2199	695	382	1021	397	372	551	556	542	414
"PITPNM1"	4249	13605	762	154	349	413	84	70	369	226	233	124	2217	1926	2517	2182	3272	2476
"PITPNM2"	6826	167260	0	0	0	0	0	0	604	153	0	0	6	18	12	20	28	0
"PITPNM3"	9428	30476	0	0	0	0	0	0	375	169	0	13	11	2	78	132	0	14
"PITRM1"	4961	35889	2641	1176	1522	1119	700	476	874	868	552	645	5575	4749	3610	4680	4761	2194
"PITX1"	2385	6541	42	0	22	20	0	0	12	0	0	0	211	116	70	22	87	30
"PITX2"	3321	24537	0	0	0	0	0	0	14	11	0	0	0	0	0	0	0	0
"PITX3"	1392	11287	0	0	0	0	0	0	0	0	0	0	0	0	0	0	0	0
"PIWIL1"	3470	75829	1129	949	646	483	491	458	728	623	342	501	1367	2855	1665	2344	1918	1389
"PIWIL2"	4020	80506	0	0	0	0	0	0	0	0	0	0	0	0	0	0	0	0
"PIWIL3"	3709	55684	0	0	0	0	0	0	0	0	0	0	0	0	0	0	0	0
"PIWIL4"	3218	54114	230	41	130	100	22	19	238	106	12	33	183	194	216	193	250	190
"PJA1"	2733	4637	0	5	0	0	5	0	0	16	0	0	9	0	609	517	600	437
"PJA2"	4878	75266	2862	1578	1512	1350	850	728	1316	631	501	691	2370	6779	6247	5254	6593	4208
"PKCG"	2471	23990	0	0	0	0	0	0	86	31	0	0	0	0	0	0	0	0
"PKD1"	14184	47190	2148	384	1141	1007	164	220	1071	652	1482	649	1401	1498	2853	3062	3752	2520
"PKD1L1"	9058	173749	0	0	0	0	0	0	116	47	0	0	0	0	0	0	0	0
"PKD1L2"	7663	119493	0	0	0	0	0	0	132	14	0	0	0	0	0	0	0	0
"PKD1L3"	5223	70437	696	1352	521	175	811	541	442	673	3	1438	3411	5188	3487	0	4430	51
"PKD2"	5070	70110	6868	1835	3937	2931	1015	820	3696	711	2606	996	1805	1928	3057	2289	2843	1593
"PKD2L1"	3089	42342	1	0	1	0	0	0	10	0	0	0	0	1	0	0	0	0
"PKD2L2"	2332	51035	3186	814	1836	1350	392	422	1015	357	737	224	1899	2335	2186	1821	2040	1711
"PKDREJ"	7660	7660	0	0	0	0	0	0	0	0	0	0	0	0	0	0	0	0
"PKHD1"	16302	472280	0	0	0	0	0	0	0	0	0	0	0	0	0	0	0	0
"PKHD1L1"	14094	168795	2	0	0	2	0	0	0	0	0	0	12	10	0	0	0	0
"PKIA"	2187	87150	0	0	0	0	0	0	0	0	0	0	59	108	18	19	4	5
"PKIB"	1883	116142	298	15	177	121	15	0	205	86	0	11	3273	3478	878	611	2298	1366
"PKIG"	1438	87243	0	20	0	0	11	9	44	71	0	0	0	2	0	5	11	0
"PKLR"	3052	12141	2	0	0	2	0	0	0	24	0	0	0	0	0	0	0	0
"PKM2"	2685	32316	9965	9645	5514	4451	5163	4482	2826	4000	6399	9340	42535	40712	49831	48699	47832	41526
"PKMYT1"	2201	4735	34	0	0	34	0	0	78	33	0	0	840	503	1033	505	1306	600
"PKN1"	3101	38514	519	54	272	247	31	23	642	111	156	64	1550	1105	2900	2266	3449	2518
"PKN2"	6125	152017	7497	5343	4276	3221	2869	2474	4530	3925	1852	3939	1203	1547	1302	1085	1365	829
"PKN3"	3398	18398	4	0	2	2	0	0	160	72	0	9	711	550	4	0	7	3
"PKNOX1"	4987	59047	2167	1115	1310	857	556	559	1237	1197	1409	2180	622	653	583	507	711	488
"PKNOX2"	3741	268726	2	0	0	2	0	0	316	104	0	0	0	0	0	0	0	0
"PKP1"	5456	49537	0	0	0	0	0	0	157	49	0	0	0	0	0	0	0	0
"PKP2"	4451	106100	0	0	0	0	0	0	0	0	0	0	0	0	0	6	3	0
"PKP3"	2821	10692	0	0	0	0	0	0	64	52	0	0	0	1	0	0	0	0
"PKP4"	4610	224464	53	11	28	25	11	0	115	56	0	30	161	205	302	269	357	222
"PL-5283"	2500	13940	747	54	424	323	45	9	644	23	85	43	2239	2331	2171	1788	2210	1419
"PLA1A"	1762	31936	0	135	0	0	63	72	0	62	0	2	0	102	12	35	5	24
"PLA2"	2517	7569	0	0	0	0	0	0	8	0	0	0	0	0	0	0	0	0
"PLA2G10"	999	22121	0	0	0	0	0	0	13	15	0	0	0	0	5	0	0	0
"PLA2G12A"	5238	20098	0	0	0	0	0	0	76	0	0	0	198	201	103	64	180	95
"PLA2G12B"	1096	19574	0	0	0	0	0	0	0	0	0	0	0	0	0	0	0	0
"PLA2G15"	2727	15714	333	0	168	165	0	0	485	63	177	0	1595	697	2610	1278	2145	1296
"PLA2G16"	1389	39967	0	0	0	0	0	0	11	0	0	0	141	177	174	111	315	226
"PLA2G1B"	568	5679	0	0	0	0	0	0	11	0	0	0	0	0	0	0	0	0
"PLA2G2A"	1005	5009	0	0	0	0	0	0	0	0	0	0	0	0	0	0	0	0
"PLA2G2C"	456	11205	0	0	0	0	0	0	0	0	0	0	0	0	0	0	0	0
"PLA2G2D"	2625	7569	0	0	0	0	0	0	8	0	0	0	0	0	0	0	0	0
"PLA2G2E"	491	3312	0	0	0	0	0	0	0	0	0	0	0	0	0	0	0	0
"PLA2G2F"	2724	11058	0	0	0	0	0	0	87	0	0	0	0	0	0	0	0	0
"PLA2G3"	2581	5677	0	0	0	0	0	0	20	21	0	0	1	0	0	0	0	0
"PLA2G4A"	2938	160075	2356	6616	1461	895	3717	2899	1348	3836	0	849	720	1197	1042	943	1001	975
"PLA2G4B"	3206	11368	664	370	416	248	214	156	405	366	160	203	297	323	533	469	638	302
"PLA2G4C"	2583	63010	6	625	0	6	324	301	188	1259	339	2694	12	110	115	168	160	58
"PLA2G4D"	3603	26872	0	0	0	0	0	0	70	49	0	0	0	0	0	0	0	0
"PLA2G4E"	2539	26495	0	2	0	0	0	2	131	46	0	0	0	0	0	0	0	0
"PLA2G4F"	3416	15413	0	0	0	0	0	0	89	0	0	0	0	1	0	0	0	0
"PLA2G5"	2803	63723	0	0	0	0	0	0	12	22	0	0	42	19	192	146	167	198
"PLA2G6"	3240	70261	82	0	48	34	0	0	328	156	21	18	57	63	56	95	140	96
"PLA2G7"	1850	31099	6168	6192	3394	2774	3342	2850	2272	1291	4307	5767	4141	5402	7913	6137	4287	3837
"PLA2R1"	5186	116796	0	0	0	0	0	0	0	0	0	3	0	0	0	0	0	0
"PLAA"	4967	44101	666	1380	336	330	762	618	487	842	37	1050	912	1114	998	894	1269	883
"PLAC1"	1129	92642	0	0	0	0	0	0	0	0	0	0	0	0	0	0	0	0
"PLAC1L"	1634	7768	0	0	0	0	0	0	0	0	0	0	0	0	0	0	0	0
"PLAC2"	3694	9827	0	5	0	0	4	1	73	14	0	3	0	0	1	0	0	0
"PLAC4"	10009	10009	0	0	0	0	0	0	0	16	0	0	0	0	0	0	0	0
"PLAC8"	1435	19801	0	0	0	0	0	0	0	0	0	0	0	7	19	23	20	12
"PLAC8L1"	728	20071	0	0	0	0	0	0	0	8	0	0	0	0	0	0	0	0
"PLAC9"	677	12528	21097	487	11473	9624	270	217	4987	86	1056	293	14	122	303	83	534	173
"PLAG1"	7342	50392	0	0	0	0	0	0	86	0	0	0	15	0	0	0	0	0
"PLAGL1"	4749	68104	903	3155	523	380	1765	1390	592	2245	0	3404	384	841	1007	1540	524	312
"PLAGL2"	5659	15241	795	3688	446	349	1928	1760	221	1887	61	4209	800	4336	1061	4574	1326	3021
"PLAT"	3187	32960	26	1339	15	11	698	641	47	2336	0	2827	0	1818	0	1096	0	316
"PLAU"	2670	6396	1229	2871	668	561	1482	1389	416	821	714	1790	3803	11382	3692	11251	5776	15792
"PLAUR"	1750	19678	4400	16336	2425	1975	8644	7692	536	8156	674	18934	1822	15935	1567	14435	2124	10571
"PLB1"	5121	147633	7	4	3	4	4	0	93	38	0	0	54	43	66	58	110	73
"PLBD1"	1943	64196	614	32	355	259	10	22	601	38	139	31	2558	1959	2146	2129	2147	1618
"PLBD2"	2844	31089	5023	1019	2809	2214	548	471	1732	551	3511	1373	7973	1092	4074	3778	5523	3297
"PLCB1"	6854	752251	20389	23117	11457	8932	12609	10508	6957	7663	1800	12827	295	361	356	383	283	198
"PLCB2"	4708	20077	10368	3897	5012	5356	2083	1814	4179	1569	9077	2479	7790	8874	13872	10960	17094	14182
"PLCB3"	4394	17498	1018	101	487	531	43	58	649	332	658	183	1110	1027	1320	1031	2123	939
"PLCB4"	5657	411761	0	0	0	0	0	0	14	0	0	0	0	0	0	0	0	0
"PLCD1"	2978	17291	45	0	31	14	0	0	130	89	0	0	183	151	244	192	307	236
"PLCD3"	3472	20884	0	0	0	0	0	0	192	38	0	0	25	36	25	18	48	24
"PLCD4"	3104	29274	89	0	44	45	0	0	83	0	0	0	24	63	0	5	37	51
"PLCE1"	8022	334402	12	0	12	0	0	0	30	0	0	0	0	0	0	1	0	0
"PLCG1"	5237	38198	525	65	277	248	29	36	217	107	39	31	332	335	442	351	425	336
"PLCG1 variant protein"	1260	4399	51	0	41	10	0	0	61	41	0	0	76	92	125	85	109	69
"PLCG2"	4273	178970	25850	12413	14320	11530	6841	5572	10056	6492	15480	9870	5303	5593	5277	4146	5738	3523
"PLCH1"	6497	196436	0	0	0	0	0	0	0	0	0	0	0	0	0	0	0	0
"PLCH2"	5582	25348	71	22	41	30	6	16	249	279	0	0	1	1	0	6	0	5
"PLCL1"	6670	345182	440	228	205	235	115	113	2048	1106	108	811	145	158	212	254	144	76
"PLCL2"	4156	205647	15082	4192	8449	6633	2361	1831	8023	2428	5807	2173	1333	1223	1358	918	1368	849
"PLCXD1"	5309	21961	0	0	0	0	0	0	0	0	0	0	0	0	257	222	168	97
"PLCXD2"	7729	52337	0	0	0	0	0	0	17	18	0	0	0	8	0	0	0	1
"PLCXD3"	7742	203684	0	0	0	0	0	0	0	0	0	0	0	0	0	0	0	0
"PLCZ1"	2090	54804	0	0	0	0	0	0	0	0	0	0	0	0	0	0	0	0
"PLD1"	5847	209886	475	45	297	178	26	19	1261	81	77	82	300	340	627	543	772	474
"PLD2"	3496	16308	852	391	475	377	214	177	359	577	375	948	708	960	802	1274	1312	1027
"PLD3"	2417	30059	1309	408	766	543	237	171	618	289	480	182	6308	5630	12967	11264	10110	8497
"PLD4"	1983	8388	41	4	27	14	4	0	28	23	0	0	315	239	516	472	776	828
"PLD5"	2740	435728	0	0	0	0	0	0	0	0	0	0	0	0	0	0	0	0
"PLD6"	2563	5323	19	0	0	19	0	0	56	0	0	0	55	18	212	51	65	39
"PLDN"	4019	22121	9220	3807	5194	4026	2056	1751	3713	1135	6750	3333	19356	19685	10960	7436	13928	7509
"PLEC1"	15281	35725	17374	11837	7011	10363	6031	5806	4028	4103	13465	15102	24373	22477	25512	22660	34799	4883
"PLEK"	2860	32264	19086	140801	10612	8474	75614	65187	4407	69266	6665	124412	13881	109031	15030	118782	19392	67699
"PLEK2"	1469	25130	0	0	0	0	0	0	10	0	0	0	24	32	0	3	12	0
"PLEKHA1"	3995	46283	1889	1697	1107	782	898	799	1152	1205	245	1352	781	1278	759	808	1134	815
"PLEKHA2"	5651	72677	4829	974	2689	2140	571	403	2596	742	1638	1122	2614	2318	2158	1423	2155	1382
"PLEKHA3"	2475	24583	76	389	34	42	196	193	116	349	45	184	331	674	523	965	598	708
"PLEKHA4"	3102	31531	0	0	0	0	0	0	174	191	0	0	0	153	0	45	0	0
"PLEKHA5"	6597	243956	33271	23721	18839	14432	12764	10957	9911	5954	8472	10103	2082	3314	3678	2832	3173	1711
"PLEKHA6"	7421	141064	290	14	178	112	11	3	518	93	0	44	48	56	36	16	238	169
"PLEKHA7"	4826	226753	0	2	0	0	2	0	160	20	0	0	39	18	11	4	3	0
"PLEKHA8"	2682	101810	1347	34	738	609	34	0	870	23	312	68	654	640	731	513	934	483
"PLEKHA9"	1842	42944	14	0	0	14	0	0	29	0	0	0	131	147	109	54	122	77
"PLEKHB1"	2386	16641	15	13	15	0	0	13	94	0	0	0	0	0	1	0	0	0
"PLEKHB2"	4461	29618	3844	2474	2096	1748	1286	1188	1659	1468	1525	3277	12090	13058	14846	13531	14501	11108
"PLEKHF1"	1985	10012	0	18	0	0	8	10	16	0	0	0	16	0	8	0	75	14
"PLEKHF2"	2876	22875	3812	30212	2103	1709	16540	13672	834	14945	200	15487	1462	13176	1872	14757	2105	8709
"PLEKHG1"	7254	243802	0	0	0	0	0	0	50	10	0	16	8	0	4	0	3	0
"PLEKHG2"	7625	15306	117	187	99	18	95	92	146	354	0	386	231	346	296	547	327	353
"PLEKHG3"	4718	16751	32	0	32	0	0	0	293	58	0	0	292	192	9	17	137	6
"PLEKHG4"	6989	11991	53	3	26	27	0	3	70	71	6	19	110	90	186	137	185	142
"PLEKHG4B"	11533	49716	0	0	0	0	0	0	229	51	1	0	6	11	0	0	0	0
"PLEKHG5"	5243	53919	1411	394	779	632	201	193	805	310	927	304	811	755	1668	1688	1244	1233
"PLEKHG6"	3139	15849	913	247	672	241	121	126	544	146	699	356	0	0	0	0	0	0
"PLEKHG7"	3279	35605	283	310	139	144	215	95	106	67	0	0	0	0	0	0	0	0
"PLEKHH1"	6569	56249	14	0	0	14	0	0	97	62	0	0	225	294	0	0	4	0
"PLEKHH2"	6983	130688	0	0	0	0	0	0	0	0	0	0	0	0	0	0	0	0
"PLEKHH3"	4483	9115	2	0	2	0	0	0	0	0	0	0	9	0	0	9	0	0
"PLEKHJ1"	1844	3798	280	457	151	129	30	427	164	674	214	465	313	227	415	611	600	373
"PLEKHM1"	5310	54881	2355	955	1302	1053	504	451	1540	768	1380	1322	1448	1136	1854	1372	2818	918
"PLEKHM1P"	2932	52344	5018	2002	2100	2918	930	1072	2897	2214	4450	2564	1064	1221	1465	1334	944	1057
"PLEKHM2"	4140	50437	3963	5028	2188	1775	2719	2309	1696	3098	2322	7332	3482	3405	5271	6055	6484	5413
"PLEKHM3"	9815	204274	2340	5530	1370	970	2932	2598	1650	3322	499	6461	762	1023	929	839	1066	704
"PLEKHN1"	2569	8607	47	19	26	21	19	0	152	76	0	0	69	69	0	0	12	7
"PLEKHO1"	2328	4731	2264	2612	1244	1020	1405	1207	573	1218	1242	2338	5341	5193	4678	4140	6423	4507
"PLEKHO2"	3725	26119	8186	4262	4477	3709	2276	1986	2756	2478	7591	10164	9611	5574	11048	6886	14399	6941
"PLG"	2767	51073	0	0	0	0	0	0	0	0	0	0	0	0	0	0	0	0
"PLGLA"	702	5083	0	0	0	0	0	0	0	0	0	0	0	0	0	0	0	0
"PLGLB1"	3017	11388	0	0	0	0	0	0	0	0	0	0	0	0	98	11	66	10
"PLGLB2"	3016	11385	0	0	0	0	0	0	0	0	0	0	0	0	118	11	51	11
"PLIN1"	2973	15050	0	0	0	0	0	0	8	11	0	0	0	0	0	0	0	0
"PLIN2"	2073	11815	65	0	28	37	0	0	39	25	0	0	665	615	1065	2695	953	1966
"PLIN3"	2348	29436	726	239	398	328	133	106	496	262	313	753	1525	3610	3301	2941	4127	3273
"PLIN4"	6359	15526	41	0	22	19	0	0	208	19	10	0	128	78	283	62	264	179
"PLIN5"	2447	12664	0	0	0	0	0	0	48	30	0	0	0	0	0	0	0	0
"PLK1"	2179	11489	0	0	0	0	0	0	41	0	0	0	10	4	39	6	47	16
"PLK1S1"	2208	120634	79	0	43	36	0	0	62	19	12	0	202	184	191	143	156	136
"PLK2"	2797	6103	0	0	0	0	0	0	16	41	0	24	47	67	71	126	89	65
"PLK3"	2372	5632	472	2811	267	205	1454	1357	108	6221	161	19076	338	2974	626	9725	522	5490
"PLK4"	3828	18307	0	0	0	0	0	0	0	0	0	0	49	39	38	0	72	6
"PLK5P"	2119	10499	0	0	0	0	0	0	138	81	0	0	0	0	0	0	0	0
"PLLP"	1488	28564	0	0	0	0	0	0	60	49	0	0	0	2	0	0	0	0
"PLN"	1715	12146	1036	1277	549	487	687	590	430	520	59	723	0	0	0	0	0	0
"PLOD1"	3164	40849	1768	501	1043	725	321	180	843	494	873	324	2067	1911	3291	3154	3590	2704
"PLOD2"	4079	92056	0	0	0	0	0	0	0	0	0	0	0	3	0	0	0	0
"PLOD3"	2995	11754	620	103	353	267	68	35	369	136	501	51	1405	696	2044	1274	2992	1420
"PLP1"	3141	16108	0	0	0	0	0	0	0	0	0	0	0	0	0	0	0	0
"PLP2"	931	3164	110	0	57	53	0	0	45	4	0	0	1951	1878	1388	1187	1953	1343
"PLPL"	1388	1388	0	0	0	0	0	0	0	0	0	0	0	0	0	0	0	0
"PLRG1"	1797	13862	109	80	59	50	32	48	43	112	19	40	992	1359	944	936	1012	760
"PLS1"	3880	56766	2	0	0	2	0	0	0	0	0	0	0	5	0	4	0	0
"PLS3"	3556	89786	0	0	0	0	0	0	0	0	0	0	0	0	0	0	0	0
"PLSCR1"	2218	29662	13	7	13	0	0	7	42	126	0	0	105	315	243	346	92	121
"PLSCR2"	1274	62642	0	0	0	0	0	0	0	0	0	0	0	0	0	0	0	0
"PLSCR3"	2568	14365	71	6	47	24	6	0	74	28	37	0	589	792	933	721	777	905
"PLSCR4"	3440	58842	0	0	0	0	0	0	0	0	0	0	0	0	0	0	0	0
"PLSCR5"	2042	29662	0	0	0	0	0	0	0	0	0	0	0	0	0	0	0	0
"PLTP"	2275	13291	25	0	1	24	0	0	59	34	0	0	1023	858	2279	2306	2008	1849
"PLUNC"	1086	7314	0	0	0	0	0	0	0	0	0	0	0	0	0	0	0	0
"PLVAP"	2282	25875	0	1	0	0	0	1	166	21	0	0	1	0	46	62	4	15
"PLXDC1"	6831	88348	0	0	0	0	0	0	129	52	0	0	0	0	0	0	3	0
"PLXDC2"	2608	463745	101158	80403	56371	44787	43562	36841	43674	33124	46902	50621	9625	10071	5379	5090	4707	3271
"PLXNA1"	9025	48728	2278	8229	1198	1080	4180	4049	1033	5483	1217	16854	1466	2175	2401	5008	2862	2998
"PLXNA2"	11473	222077	0	0	0	0	0	0	155	111	0	0	3	14	26	58	19	20
"PLXNA3"	6778	15363	1314	464	634	680	245	219	1000	767	915	454	814	933	1577	1629	2474	1290
"PLXNA4"	13092	453233	0	0	0	0	0	0	191	56	0	0	0	0	0	0	0	0
"PLXNB1"	7348	25613	0	0	0	0	0	0	123	55	24	0	4	0	3	3	13	3
"PLXNB2"	6373	32596	7914	4073	4281	3633	2211	1862	2385	3421	7872	9729	11746	11023	15523	14007	17738	10378
"PLXNB3"	7553	16291	0	0	0	0	0	0	161	66	0	0	1	0	0	0	0	0
"PLXNC1"	5150	156727	52	1127	35	17	636	491	227	1445	0	1097	284	334	541	602	675	568
"PLXND1"	7013	51528	7257	3204	4095	3162	1717	1487	3232	3753	5744	7349	6545	6628	9830	8766	12957	9453
"PM20D1"	2161	22093	0	0	0	0	0	0	0	0	0	0	0	1	0	0	0	0
"PM20D2"	4714	19516	11	11	11	0	11	0	8	30	0	7	150	212	26	40	129	84
"PMAIP1"	2090	4348	1208	13190	636	572	7107	6083	29	5705	0	5580	176	46162	146	23874	123	12309
"PMCA2"	1745	117702	0	0	0	0	0	0	511	126	0	0	0	0	0	0	0	0
"PMCH"	758	1377	0	0	0	0	0	0	0	0	0	0	41	35	20	0	22	0
"PMCHL1"	1826	9911	0	0	0	0	0	0	0	0	0	0	0	0	0	0	0	0
"PMCHL2"	1845	10209	0	0	0	0	0	0	0	0	0	0	0	0	0	0	0	0
"PMEPA1"	4916	61579	1090	818	629	461	461	357	919	1068	0	382	383	496	42	51	315	147
"PMF1"	1085	27049	1772	1816	1246	526	1389	427	1412	3028	491	5600	592	524	610	428	410	496
"PMFBP1"	3967	53069	140	16	73	67	16	0	69	33	30	9	233	152	367	448	184	145
"PML"	5602	53141	1483	323	799	684	164	159	1019	1081	113	509	1339	1218	1764	921	2103	1127
"PMM1"	1291	12983	82	96	40	42	47	49	158	166	71	104	223	237	228	207	504	281
"PMM2"	2330	51525	3149	2544	1764	1385	1551	993	1288	1792	1181	3086	1069	1075	1072	1043	1505	1083
"PMP2"	3570	7157	0	0	0	0	0	0	0	0	0	0	0	0	0	0	0	0
"PMP22"	1833	35549	0	0	0	0	0	0	8	10	0	0	313	285	683	647	137	129
"PMP69"	2479	17051	758	5	433	325	0	5	380	63	569	102	443	335	961	456	848	407
"PMPCA"	3346	4868	274	129	167	107	49	80	231	377	20	618	816	715	1207	1333	1365	1228
"PMPCB"	3935	17261	355	341	174	181	160	181	242	168	92	132	883	1155	1296	1141	1613	1045
"PMS1"	3533	93545	1810	95	1062	748	75	20	902	140	206	36	1141	1141	1350	376	699	391
"PMS2"	2850	35868	26	0	22	4	0	0	40	0	0	19	240	173	289	154	366	184
"PMS2CL"	3342	43737	67	28	31	36	15	13	60	0	37	37	120	111	239	167	310	113
"PMS2L11"	1770	42937	1745	399	1004	741	223	176	999	405	2419	702	102	135	878	371	146	482
"PMS2L12"	1151	7587	0	0	0	0	0	0	0	0	0	0	0	0	176	238	93	111
"PMS2L13"	1525	15669	79	66	47	32	35	31	80	40	37	0	75	78	116	122	116	74
"PMS2L14"	1818	285854	0	0	0	0	0	0	0	0	0	0	0	0	1642	1389	1436	925
"PMS2L15"	1820	43581	0	0	0	0	0	0	0	0	0	0	0	1	872	712	383	230
"PMS2L3"	4617	16792	2571	584	1504	1067	313	271	1300	431	1386	653	1003	797	1287	678	1461	508
"PMS2L5"	1226	15438	0	0	0	0	0	0	37	0	0	0	19	7	3	0	0	3
"PMSCL1"	1321	10007	97	51	33	64	30	21	73	70	29	81	346	746	232	210	335	265
"PMVK"	1303	12277	0	12	0	0	0	12	153	31	0	0	393	408	831	764	686	690
"PNAS-108"	679	9667	0	3	0	0	3	0	0	0	0	0	0	5	3	0	5	0
"PNAS-112"	2528	24879	470	74	262	208	41	33	333	0	0	13	621	758	1018	840	940	739
"PNAS-116"	1248	24700	0	0	0	0	0	0	0	0	0	0	0	7	19	23	20	12
"PNAS-135"	2063	32099	1150	752	605	545	431	321	586	552	257	1537	226	214	1379	1203	1674	1179
"PNAS-2"	1411	16639	216	188	111	105	104	84	155	148	0	109	738	761	1629	1231	1734	1224
"PNCK"	1988	4628	0	0	0	0	0	0	28	17	0	0	0	0	0	0	0	0
"PNKD"	3123	76402	2967	3759	1549	1418	1991	1768	1094	2640	1261	4026	6072	7337	7869	9292	9219	7446
"PNKP"	2115	5798	1481	2236	1102	379	887	1349	429	8	474	462	954	524	1171	1073	1467	915
"PNLDC1"	1939	20436	0	2	0	0	1	1	17	0	0	0	24	44	0	0	0	0
"PNLIP"	1510	21940	0	0	0	0	0	0	0	0	0	0	0	0	0	0	0	0
"PNLIPRP1"	1499	18160	0	0	0	0	0	0	0	0	0	0	0	0	0	0	0	0
"PNLIPRP2"	1595	15962	0	0	0	0	0	0	0	0	0	0	0	0	0	0	0	0
"PNLIPRP3"	2318	50044	0	0	0	0	0	0	0	0	0	0	0	0	0	0	0	0
"PNMA1"	2644	2644	16	0	0	16	0	0	13	28	0	0	621	496	917	667	951	546
"PNMA2"	4849	9289	2	0	2	0	0	0	0	0	0	0	0	0	0	0	0	0
"PNMA3"	3753	4063	0	0	0	0	0	0	0	0	0	0	0	0	0	0	0	0
"PNMA5"	3366	67781	0	0	0	0	0	0	10	0	0	0	0	0	0	0	0	0
"PNMA6A"	2274	2601	0	0	0	0	0	0	0	0	0	0	0	0	0	0	0	0
"PNMAL1"	3698	5073	0	0	0	0	0	0	0	0	0	0	0	0	0	0	0	0
"PNMAL2"	4723	4723	0	0	0	0	0	0	13	0	0	0	0	0	0	0	0	0
"PNMT"	1160	2223	0	0	0	0	0	0	39	0	0	0	0	0	0	0	0	0
"PNN"	3614	8036	2227	1578	1186	1041	883	695	663	656	345	760	2344	2720	3076	2634	3608	2124
"PNO1"	1983	18086	687	397	364	323	227	170	180	280	0	260	375	498	384	429	373	388
"PNOC"	1506	23078	0	0	0	0	0	0	0	0	0	0	0	0	4	0	0	0
"PNPASE"	4526	59815	45	4	15	30	0	4	146	14	0	0	190	283	623	457	451	299
"PNPLA1"	2486	38137	0	0	0	0	0	0	26	10	0	0	0	2	12	20	0	6
"PNPLA2"	2081	6316	642	235	346	296	102	133	234	236	677	265	1392	1276	2251	1940	2026	1347
"PNPLA3"	2814	23831	44	41	26	18	20	21	166	26	2	19	218	185	347	240	304	219
"PNPLA4"	2854	28673	12	0	3	9	0	0	28	0	0	0	73	55	73	71	110	84
"PNPLA5"	2556	12300	0	0	0	0	0	0	31	46	0	0	0	0	0	0	0	0
"PNPLA6"	4561	27018	4966	1210	2741	2225	602	608	2093	613	4848	855	9203	7369	14851	12136	15666	11064
"PNPLA7"	5179	27677	364	66	168	196	43	23	1281	529	36	120	87	98	309	260	422	260
"PNPLA8"	3542	54569	613	777	377	236	509	268	389	541	40	484	1059	1830	910	1139	1058	714
"PNPO"	3471	7786	241	9	135	106	0	9	182	38	106	31	1146	988	874	546	1276	716
"PNPT1"	4607	59815	45	4	15	30	0	4	146	14	0	0	190	283	623	457	451	299
"PNRC1"	2309	3325	890	5396	489	401	2787	2609	189	2751	50	4656	2614	27506	2129	20316	2906	24624
"PNRC2"	2415	3648	491	977	274	217	520	457	278	444	45	527	2843	5620	4666	6969	4480	4984
"PODN"	3268	23290	0	0	0	0	0	0	31	30	0	0	0	0	0	0	0	0
"PODNL1"	3337	7289	3	0	0	3	0	0	184	23	0	0	80	76	50	76	162	82
"PODXL"	5991	56355	339	142	168	171	75	67	210	93	68	65	73	72	440	361	158	122
"PODXL2"	2179	43615	0	0	0	0	0	0	70	47	0	0	2	15	0	0	27	7
"POF1B"	3965	102355	0	0	0	0	0	0	0	0	0	0	0	0	0	0	0	0
"POFUT1"	5225	30772	79	37	36	43	21	16	162	97	37	228	746	696	893	655	824	586
"POFUT2"	4830	23969	289	95	155	134	54	41	179	249	55	185	209	219	308	298	417	267
"POGK"	3858	14987	2350	797	1353	997	419	378	990	498	578	661	3647	3087	4303	3031	4818	2828
"POGZ"	6636	56734	4125	4144	2355	1770	2169	1975	1682	1979	1009	3448	1989	2448	2397	1689	3164	1721
"POL3S"	2741	11531	145	0	89	56	0	0	377	78	88	0	986	916	1379	946	1500	400
"POLA1"	5482	303046	574	324	330	244	183	141	432	279	0	207	2234	2545	1707	1752	2384	1704
"POLA2"	2494	35657	590	108	394	196	55	53	474	185	211	188	693	662	561	439	821	551
"POLB"	1273	33285	140	66	90	50	31	35	210	120	0	43	185	180	178	143	227	151
"POLD1"	3495	19164	1949	499	1011	938	269	230	957	372	2224	415	2340	1999	2550	2072	3664	2179
"POLD2"	2169	8822	13	0	10	3	0	0	48	104	0	0	74	411	627	688	896	562
"POLD3"	3442	50138	345	32	163	182	16	16	244	12	0	0	556	357	631	331	657	377
"POLD4"	1771	1995	195	81	129	66	25	56	83	21	103	100	1577	956	356	1895	2631	1853
"POLDIP2"	2726	10945	187	84	121	66	50	34	100	141	24	0	634	592	712	616	794	678
"POLDIP3"	3494	31236	1834	1026	920	914	561	465	900	682	826	1316	3219	2343	2866	2438	3746	2434
"POLDS"	944	2013	195	81	129	66	25	56	83	21	103	100	1577	956	970	1895	2631	1853
"POLE"	7889	63599	700	192	355	345	118	74	917	537	335	223	706	589	784	719	1019	764
"POLE1"	8573	63599	700	192	355	345	118	74	917	537	335	223	706	589	784	719	1019	764
"POLE2"	1709	44659	70	0	14	56	0	0	84	0	0	0	35	4	8	0	9	0
"POLE3"	2403	3439	0	0	0	0	0	0	40	24	0	0	2206	2268	1833	1392	2292	1540
"POLE4"	699	11085	509	25	272	237	0	25	148	27	0	0	191	0	275	0	1056	856
"POLG"	4470	18491	2615	2305	1414	1201	1327	978	1002	874	1249	2337	2372	2747	3117	2906	3875	2378
"POLG2"	1585	19267	1555	825	833	722	445	380	679	196	230	468	583	416	273	155	311	77
"POLH"	8422	44383	304	0	199	105	0	0	271	39	68	280	376	1134	317	154	359	130
"POLI"	6222	28667	12	0	12	0	0	0	67	0	12	0	108	97	105	17	94	8
"POLK"	4556	52811	2996	481	1649	1347	227	254	2129	555	498	556	809	846	743	592	773	533
"POLL"	3073	9246	611	79	383	228	55	24	421	76	258	70	421	313	538	325	673	201
"POLM"	2629	10282	781	193	417	364	110	83	177	2018	604	80	4575	132	317	142	332	159
"POLN"	4368	129997	294	48	136	158	34	14	538	106	48	9	423	142	478	145	443	97
"POLQ"	8809	114581	0	0	0	0	0	0	0	0	0	0	0	0	0	7	10	0
"POLR1A"	6669	79827	873	242	488	385	127	115	672	223	296	245	1514	1394	1223	619	1430	657
"POLR1B"	5517	35237	168	19	65	103	12	7	126	45	0	11	628	460	645	283	686	316
"POLR1C"	1313	4455	367	34	174	193	34	0	210	175	44	26	1061	917	1028	935	1069	897
"POLR1D"	2251	45649	1291	317	831	460	183	134	839	257	0	27	1564	1452	1116	902	1941	1168
"POLR1E"	2239	17545	6	0	0	6	0	0	102	21	0	0	318	231	253	138	308	127
"POLR2A"	6609	30081	3943	2302	2240	1703	1220	1082	1404	1058	1974	1727	6942	5017	7074	5225	10119	5190
"POLR2B"	3952	52227	1750	814	1056	694	455	359	931	557	524	633	2011	1707	3441	2195	4024	1996
"POLR2C"	1813	9372	116	0	74	42	0	0	114	28	8	0	552	765	804	856	1092	681
"POLR2D"	2328	11890	329	85	177	152	48	37	72	43	0	97	87	108	435	816	489	659
"POLR2E"	2872	8813	2318	513	1250	1068	317	196	636	392	1817	997	4508	3635	5738	5104	8075	5478
"POLR2F"	2106	15646	26	4	26	0	4	0	391	140	0	24	247	251	313	318	359	321
"POLR2G"	1123	5176	201	0	89	112	0	0	126	36	12	9	1082	871	1195	908	1397	760
"POLR2H"	1735	6805	405	45	223	182	22	23	108	53	461	60	527	361	577	318	820	380
"POLR2I"	903	1596	0	0	0	0	0	0	63	43	0	0	152	107	236	113	196	219
"POLR2J"	980	5835	89	0	52	37	0	0	69	17	0	17	308	279	630	447	700	427
"POLR2J2"	1725	34712	653	309	421	232	167	142	903	505	1189	1163	437	423	5324	3218	9096	4901
"POLR2J3"	1689	34704	503	195	347	156	92	103	520	286	699	843	195	176	2172	1649	4731	2644
"POLR2J4"	6482	78256	1039	218	587	452	122	96	863	469	765	552	699	670	2017	1772	3909	1713
"POLR2K"	974	3392	15	0	15	0	0	0	0	45	0	0	455	777	357	392	398	344
"POLR2L"	877	2809	105	0	57	48	0	0	56	26	0	66	542	439	743	909	1159	854
"POLR3A"	5628	53355	146	0	106	40	0	0	158	7	112	0	340	346	743	327	865	416
"POLR3B"	4299	152540	105	2	72	33	0	2	191	72	0	31	313	273	270	202	323	203
"POLR3C"	1865	18280	588	424	307	281	189	235	359	451	374	536	843	937	877	871	933	560
"POLR3D"	1937	6062	158	99	79	79	60	39	155	146	0	20	416	687	401	558	408	320
"POLR3E"	4853	31673	708	364	364	344	217	147	600	561	35	368	650	583	625	612	911	559
"POLR3F"	2263	17253	130	16	83	47	16	0	102	47	0	0	308	257	217	166	281	164
"POLR3G"	3291	39688	0	0	0	0	0	0	11	0	0	0	0	0	0	0	0	0
"POLR3GL"	1173	14153	23	0	19	4	0	0	50	10	0	0	201	511	425	412	324	356
"POLR3H"	4479	18678	960	357	511	449	195	162	399	358	520	584	74	2552	3216	3025	4581	3186
"POLR3K"	799	6627	95	7	44	51	0	7	51	8	0	0	369	349	358	319	99	248
"POLRMT"	3821	16347	189	0	123	66	0	0	196	51	118	0	298	184	1048	694	1104	803
"POLS"	3874	42445	10053	20622	5573	4480	11117	9505	3546	9999	5909	15831	1212	3795	1659	3054	1841	1521
"POM121"	7027	72045	3645	1304	2029	1616	713	591	1794	892	2235	1872	1332	1204	3550	3068	4515	2513
"POM121-2"	1211	5202	588	78	314	274	69	9	457	173	203	336	177	196	434	428	475	299
"POM121-like 1"	2168	2168	0	0	0	0	0	0	16	0	0	0	0	0	0	0	0	0
"POM121C"	5877	69504	1005	194	581	424	124	70	797	297	203	543	777	822	3041	2729	3720	2169
"POM121L1"	1689	4998	0	0	0	0	0	0	0	0	0	0	0	0	0	0	0	0
"POM121L10P"	9553	13983	0	0	0	0	0	0	23	9	0	0	0	0	0	13	0	0
"POM121L12"	1270	1270	0	0	0	0	0	0	0	0	0	0	0	0	0	0	0	0
"POM121L1P"	4005	12986	0	0	0	0	0	0	25	0	0	0	0	0	5	0	6	0
"POM121L2"	3171	3171	0	0	0	0	0	0	0	0	0	0	0	0	0	0	0	0
"POM121L8P"	7710	15294	0	0	0	0	0	0	0	0	0	0	0	0	0	0	25	0
"POMC"	1299	7839	0	0	0	0	0	0	0	0	0	0	40	23	22	0	0	0
"POMGNT1"	2958	31625	61	0	38	23	0	0	137	31	0	0	422	464	614	566	646	466
"POMP"	1365	19852	794	361	434	360	202	159	471	282	354	431	1832	2196	2227	2414	2335	1992
"POMT1"	3339	20905	300	126	183	117	72	54	469	196	31	92	260	273	395	363	605	446
"POMT2"	5474	26209	35	29	9	26	10	19	232	74	28	22	294	276	278	241	461	245
"POMZP3"	1678	17318	693	352	336	357	168	184	311	160	48	142	185	175	174	339	461	191
"PON1"	1759	26215	0	0	0	0	0	0	0	0	0	0	0	0	0	0	0	0
"PON2"	1680	30211	3503	1118	1905	1598	576	542	1180	282	817	403	2934	1965	1615	1066	3229	1560
"PON3"	1687	98018	0	0	0	0	0	0	0	0	0	0	0	0	0	0	0	0
"POP1"	4760	42549	146	19	91	55	19	0	102	14	0	31	406	331	487	313	547	299
"POP2"	1313	23265	68	627	39	29	369	258	67	336	0	46	10	231	30	71	32	29
"POP3"	1385	18349	0	0	0	0	0	0	0	0	0	0	0	0	0	0	0	0
"POP4"	2601	10994	110	98	75	35	52	46	61	94	0	100	695	771	654	586	824	614
"POP5"	805	2354	104	0	44	60	0	0	49	41	0	85	332	161	345	291	410	196
"POP7"	933	1448	0	0	0	0	0	0	19	0	0	24	301	195	335	256	443	258
"POPDC2"	1732	18498	52	519	39	13	314	205	29	210	0	0	10	197	30	71	32	29
"POPDC3"	1844	22077	0	0	0	0	0	0	0	0	0	0	0	0	0	0	0	0
"POR"	2514	71754	763	108	480	283	69	39	867	577	323	527	1754	694	3260	3580	1942	1772
"PORCN"	2180	11833	0	0	0	0	0	0	46	8	0	0	50	79	92	83	105	57
"POSTN"	3402	36263	0	0	0	0	0	0	0	0	0	0	0	0	0	0	0	0
"POT1"	4221	107598	112	64	69	43	28	36	153	91	39	47	368	433	376	269	396	248
"POTEA"	1990	70745	0	0	0	0	0	0	0	0	0	0	0	0	0	0	0	0
"POTEB"	2034	31278	0	0	0	0	0	0	0	0	0	0	0	0	0	0	0	0
"POTEC"	2253	31863	0	0	0	0	0	0	0	0	0	0	0	0	0	0	0	0
"POTED"	1837	31410	0	0	0	0	0	0	0	0	0	0	0	0	0	0	0	0
"POTEE"	3455	46494	0	0	0	0	0	0	0	0	0	0	0	0	0	0	0	0
"POTEF"	4354	55689	0	0	0	0	0	0	0	14	0	0	0	0	0	0	0	0
"POTEG"	2194	31579	0	0	0	0	0	0	0	0	0	0	0	0	0	0	0	0
"POTEH"	2048	31607	0	0	0	0	0	0	0	0	0	0	0	0	0	0	0	0
"POU1F1"	1346	16956	0	0	0	0	0	0	0	0	0	0	0	0	0	0	0	0
"POU2AF1"	3034	27176	0	0	0	0	0	0	44	22	35	0	112	154	0	25	7	18
"POU2F1"	3074	195176	1762	291	1071	691	138	153	1698	464	0	517	54	454	150	134	99	66
"POU2F2"	4669	43959	562	44	331	231	18	26	493	525	218	1305	634	607	371	354	610	434
"POU2F3"	2978	79704	0	0	0	0	0	0	9	11	0	0	0	1	0	0	0	0
"POU3F1"	2929	2929	0	0	0	0	0	0	0	0	0	0	0	0	0	0	0	0
"POU3F2"	4087	4087	0	0	0	0	0	0	0	0	0	0	0	0	0	0	0	0
"POU3F3"	1503	1503	0	0	0	0	0	0	0	0	0	0	0	0	0	0	0	0
"POU3F4"	1508	1508	0	0	0	0	0	0	0	0	0	0	0	0	0	0	0	0
"POU4F1"	3814	4465	0	0	0	0	0	0	0	14	0	0	0	0	0	0	0	0
"POU4F2"	3142	3579	0	0	0	0	0	0	0	0	0	0	0	0	0	0	0	0
"POU4F3"	1184	1498	0	0	0	0	0	0	0	0	0	0	0	0	0	0	0	0
"POU5F1"	1405	6338	65	15	35	30	15	0	93	69	0	75	0	0	11	0	57	0
"POU5F1B"	1584	1584	0	0	0	0	0	0	0	0	0	0	0	0	0	0	0	0
"POU5F1P1"	382	382	0	0	0	0	0	0	0	0	0	0	0	0	0	0	0	0
"POU5F1P3"	382	382	14765	3550	8210	6555	1370	2180	5803	117	1414	269	4267	206	456	14	1356	188
"POU5F1P4"	382	382	65	15	35	30	15	0	23	34	0	75	0	0	0	0	0	0
"POU5F2"	1296	1296	133	66	55	78	31	35	55	77	0	54	0	0	0	0	0	0
"POU5FLC12"	382	382	14765	3550	8210	6555	1370	2180	5803	117	1414	269	4267	206	456	14	1356	188
"POU6F1"	5167	30759	52	0	0	52	0	0	77	25	0	0	0	12	0	6	0	0
"POU6F2"	2233	457984	0	0	0	0	0	0	20	25	0	0	0	0	0	0	0	0
"PP1164"	2324	14891	0	0	0	0	0	0	0	0	0	0	0	0	516	519	513	345
"PP14183"	3082	11109	2571	3339	1452	1119	1829	1510	876	2496	2603	5625	1354	1703	1772	2215	2146	1947
"PP14296"	2906	23748	0	0	0	0	0	0	246	102	0	0	0	0	0	0	0	0
"PP14571"	2019	7283	0	0	0	0	0	0	15	14	0	0	0	0	0	0	0	0
"PP18"	2072	15983	31	0	6	25	0	0	167	26	0	0	199	405	451	312	707	354
"PP187"	1984	92149	13	0	6	7	0	0	0	0	0	0	6	7	34	78	3	0
"PP199"	872	13235	830	549	442	388	270	279	453	340	275	1070	835	846	1134	890	1250	809
"PP2CE"	2977	200429	38037	38828	21373	16664	21119	17709	13210	16833	6123	18218	5694	6546	2410	1802	2821	1198
"PPA1"	1313	30606	11	151	0	11	94	57	57	236	0	142	183	210	588	570	624	595
"PPA2"	1729	104994	8207	2570	4632	3575	1405	1165	4071	957	2396	1967	2314	1943	1495	1197	1931	1404
"PPAN"	3214	9099	1611	304	1476	135	184	120	435	730	916	371	7431	4196	6203	3477	7379	3903
"PPAN-P2RY11"	3152	9099	1611	304	1476	135	184	120	435	730	916	371	7431	4196	6203	3477	7379	3903
"PPAP2A"	1629	110190	1651	955	887	764	556	399	705	449	94	465	188	613	425	348	671	486
"PPAP2B"	3300	84826	29747	26603	16440	13307	14223	12380	10794	12635	21770	36898	4412	7041	1663	1284	4146	1241
"PPAP2C"	1381	10125	0	0	0	0	0	0	45	0	0	0	0	0	0	0	0	0
"PPAPDC1A"	1861	124831	0	0	0	0	0	0	11	0	0	0	0	0	0	0	0	0
"PPAPDC1B"	2187	6008	139	96	49	90	57	39	129	74	58	145	580	609	723	712	762	475
"PPAPDC2"	2960	2960	0	0	0	0	0	0	0	0	0	0	220	146	254	62	284	116
"PPAPDC3"	2097	19570	0	0	0	0	0	0	104	9	0	0	0	0	0	0	0	0
"PPARA"	10351	92924	817	34	454	363	27	7	761	301	144	85	785	833	1159	893	1259	739
"PPARD"	3837	85620	17720	51566	9905	7815	27564	24002	4622	22947	7034	51570	2743	7003	2302	4620	3178	3406
"PPARG"	1926	145420	3019	5034	1706	1313	2771	2263	2861	3514	304	2652	390	328	1578	1978	880	1091
"PPARGC1A"	6330	98057	0	0	0	0	0	0	0	0	0	0	0	0	0	0	0	0
"PPARGC1B"	4814	117405	25567	5042	14139	11428	2624	2418	9979	3712	22083	8678	2735	2508	1160	958	1413	928
"PPAT"	3754	42316	43	0	43	0	0	0	89	0	0	0	202	155	341	177	318	136
"PPBP"	701	1144	0	0	0	0	0	0	0	0	0	0	0	1	0	0	6	5
"PPBPL1"	383	972	0	0	0	0	0	0	0	0	0	0	0	0	0	0	0	0
"PPBPL2"	1363	1363	0	0	0	0	0	0	0	0	0	0	0	0	0	0	0	0
"PPCDC"	2224	27141	1080	52	600	480	36	16	665	106	727	162	262	237	302	208	452	190
"PPCS"	1491	3914	531	136	299	232	96	40	219	52	286	34	1668	1358	1778	1061	2035	1082
"PPDPF"	780	1392	28	1	28	0	1	0	20	13	72	0	2158	1384	1957	1829	1909	2083
"PPEF-1"	2398	120256	0	0	0	0	0	0	0	0	0	0	0	0	0	0	0	0
"PPEF-2"	4274	42655	4	0	4	0	0	0	3	0	0	3	0	0	1	1	0	0
"PPEF1"	2889	136989	0	0	0	0	0	0	0	0	0	0	0	0	0	0	0	0
"PPEF2"	3428	42655	4	0	4	0	0	0	3	0	0	3	0	0	1	1	0	0
"PPFIA1"	5251	113679	4688	643	2652	2036	314	329	3149	596	2992	1289	1267	1379	2051	1797	2289	1588
"PPFIA2"	4082	499755	0	0	0	0	0	0	0	0	0	0	0	0	0	0	0	0
"PPFIA2 variant protein"	3929	496560	0	0	0	0	0	0	0	0	0	0	0	0	0	0	0	0
"PPFIA3"	4746	31617	13	0	13	0	0	0	228	126	12	0	18	16	32	6	14	22
"PPFIA4"	6379	44253	0	0	0	0	0	0	189	64	0	0	0	0	0	0	0	0
"PPFIBP1"	6123	171453	24832	9188	13701	11131	4962	4226	9703	2882	11496	10204	4393	5021	4531	3696	5067	3086
"PPFIBP2"	3820	76993	15566	17365	8687	6879	9317	8048	6346	13942	3049	23556	2140	2189	3003	2688	3763	2176
"PPHLN1"	4394	122477	4073	971	2250	1823	544	427	2614	956	637	1034	1857	2571	1290	1078	1895	1323
"PPIA"	2438	6476	721	761	399	322	408	353	264	334	464	811	6143	7162	19811	19930	21496	17732
"PPIAL4A"	784	784	0	0	0	0	0	0	0	0	0	0	0	0	0	0	0	0
"PPIAL4B"	784	784	0	0	0	0	0	0	0	0	0	0	0	0	0	0	0	0
"PPIAL4E"	784	784	0	0	0	0	0	0	0	0	0	0	0	0	0	0	0	0
"PPIAL4F"	784	784	0	0	0	0	0	0	0	0	0	0	0	0	0	0	0	0
"PPIAL4G"	737	737	0	0	0	0	0	0	0	0	0	0	0	0	0	0	0	0
"PPIB"	1345	3883	312	70	142	170	26	44	107	86	43	86	2775	2467	2909	3389	3781	1723
"PPIC"	1239	13347	0	0	0	0	0	0	0	0	0	0	83	66	58	51	139	95
"PPID"	1843	14274	187	219	145	42	107	112	138	113	18	99	790	1257	675	736	866	719
"PPIE"	4681	14850	127	29	56	71	10	19	233	28	40	0	560	548	600	448	799	455
"PPIF"	2201	7866	820	2270	464	356	1200	1070	239	868	264	2118	1888	4413	2078	4138	2231	3380
"PPIG"	2713	53399	2241	1100	1217	1024	620	480	1352	765	187	1235	1978	2123	2451	1469	2477	1474
"PPIH"	1210	9522	423	71	218	205	36	35	269	57	0	43	403	268	480	234	621	312
"PPIL1"	1740	20196	0	0	0	0	0	0	29	0	0	0	387	354	442	334	433	328
"PPIL2"	4121	31930	1713	739	1000	713	431	308	966	543	1267	834	1942	1717	2005	1393	2670	1551
"PPIL3"	1613	18321	988	43	580	408	22	21	437	15	136	0	1041	784	340	513	675	429
"PPIL4"	3318	30881	3731	939	2123	1608	537	402	1328	416	771	567	837	728	1144	892	1435	904
"PPIL5"	1970	15976	16	11	16	0	11	0	0	20	0	0	226	227	395	502	584	357
"PPIL6"	3687	50430	2	0	0	2	0	0	39	0	0	111	77	54	88	78	203	122
"PPL"	6260	54630	322	30	182	140	30	0	327	169	197	137	1	0	0	0	0	0
"PPM1A"	8208	49839	4359	3043	2426	1933	1748	1295	1768	1456	886	1737	2202	2255	2100	1561	2296	1443
"PPM1B"	3855	65743	7613	5278	4227	3386	2965	2313	3012	1975	2354	3340	2424	2892	2611	1961	2730	1922
"PPM1D"	3281	64484	1132	804	615	517	385	419	843	582	265	1151	580	503	868	707	924	546
"PPM1E"	6542	229302	0	0	0	0	0	0	21	0	0	0	0	6	1	3	9	2
"PPM1F"	5159	33426	3343	803	1385	1958	408	395	1988	529	3763	699	4599	4573	944	542	8003	4682
"PPM1G"	3834	28436	682	191	374	308	101	90	470	193	110	402	2375	1897	1874	2192	3811	1568
"PPM1H"	6210	290904	23	0	8	15	0	0	122	44	0	21	121	150	237	123	165	73
"PPM1J"	2489	5299	0	0	0	0	0	0	83	31	5	0	58	50	42	24	102	48
"PPM1K"	3729	24356	1393	7414	808	585	3997	3417	566	3761	61	2982	785	4779	516	1865	575	748
"PPM1L"	3056	314819	75300	71674	42198	33102	38926	32748	30080	26375	22335	34816	6106	6966	2806	2120	3282	1198
"PPM1M"	2399	4388	3212	918	1794	1418	480	438	1133	322	2806	912	8261	6714	9557	6321	12696	6047
"PPME1"	2466	83381	344	0	244	100	0	0	410	0	0	3	535	559	552	494	623	501
"PPOX"	2569	11622	308	3	197	111	0	3	318	103	81	0	876	700	947	808	1337	785
"PPP1CA"	1703	3425	815	187	521	294	38	149	548	468	496	188	2572	4761	6974	4548	8101	5167
"PPP1CB"	4993	51181	3943	3903	2236	1707	2124	1779	1755	1658	854	3386	5665	6528	4920	4638	5208	3856
"PPP1CC"	2490	23144	530	31	287	243	17	14	516	72	111	51	2789	2410	3403	2312	3537	1980
"PPP1R10"	4539	16840	2592	2162	1452	1140	628	1534	950	492	1202	2394	2510	2691	3054	2261	3705	1784
"PPP1R11"	1817	3177	152	119	97	55	42	77	116	46	0	47	1190	1465	1201	1277	1714	1258
"PPP1R12A"	5750	161636	20150	34216	11429	8721	18460	15756	7932	14946	4261	23518	3397	4509	3402	3448	3994	2531
"PPP1R12B"	11308	239863	2218	872	1311	907	492	380	2421	918	332	971	643	745	642	560	663	372
"PPP1R12C"	2944	26646	2619	845	1462	1157	429	416	909	741	2976	2291	991	1327	2471	2029	2389	2417
"PPP1R13B"	4976	113841	1099	500	619	480	228	272	407	169	99	453	441	285	243	148	466	254
"PPP1R13L"	3134	26716	0	0	0	0	0	0	79	49	0	0	0	0	0	3	6	0
"PPP1R14A"	720	5295	121	1	61	60	0	1	148	24	0	0	844	3	161	130	390	211
"PPP1R14B"	989	2462	25	0	11	14	0	0	0	28	0	0	0	2	757	366	568	339
"PPP1R14C"	2213	107340	0	0	0	0	0	0	51	10	0	0	0	0	0	0	0	0
"PPP1R14D"	876	13264	0	0	0	0	0	0	27	0	0	0	0	0	0	0	0	0
"PPP1R15A"	2385	3671	3691	21800	2115	1576	11544	10256	331	12652	218	15737	1475	1970	1650	81099	2278	74524
"PPP1R15B"	5275	8452	692	5112	386	306	2846	2266	434	2642	465	3306	2785	3	2920	14586	3065	4942
"PPP1R16A"	2728	12088	326	106	158	168	60	46	296	170	375	60	934	695	1216	790	2015	989
"PPP1R16B"	6261	117320	2873	1154	1625	1248	650	504	1572	705	739	4820	2050	2551	790	603	1882	1193
"PPP1R1A"	1841	9421	3	5	0	3	3	2	12	12	0	0	0	1	195	0	256	0
"PPP1R1B"	1879	9698	0	0	0	0	0	0	11	28	0	0	0	0	0	0	0	0
"PPP1R1C"	2019	144374	0	0	0	0	0	0	0	0	0	0	0	0	0	0	0	0
"PPP1R2"	3471	29003	1552	1777	877	675	1010	767	724	1086	266	1962	1495	2080	1772	1729	1915	1607
"PPP1R2P1"	3598	3598	0	0	0	0	0	0	0	0	0	0	0	0	0	0	0	0
"PPP1R2P3"	1992	1992	0	0	0	0	0	0	0	0	0	0	144	197	0	0	0	0
"PPP1R2P9"	869	869	0	0	0	0	0	0	0	0	0	0	0	0	0	0	0	0
"PPP1R3A"	4300	42202	0	0	0	0	0	0	0	0	0	0	0	0	0	0	0	0
"PPP1R3B"	5635	15312	981	102	583	398	58	44	730	43	104	15	3043	896	3160	845	5072	1880
"PPP1R3C"	2571	4659	0	0	0	0	0	0	0	0	0	0	0	0	0	0	0	0
"PPP1R3D"	3460	3460	0	0	0	0	0	0	28	0	0	0	549	214	531	136	655	172
"PPP1R3F"	2945	17762	483	172	299	184	89	83	228	91	0	78	141	102	95	103	211	103
"PPP1R3G"	1737	1737	0	0	0	0	0	0	0	0	0	0	26	12	0	0	55	0
"PPP1R7"	1303	32539	1481	188	782	699	100	88	1014	164	504	59	2941	2730	3009	2454	3764	2699
"PPP1R8"	2698	20892	173	49	115	58	34	15	88	83	0	53	964	441	919	598	1106	796
"PPP1R9A"	10537	388778	0	0	0	0	0	0	0	0	0	0	0	0	0	0	0	0
"PPP1R9B"	4038	16777	2036	609	1006	1030	328	281	733	458	1836	743	3856	3326	7772	4026	9719	5188
"PPP2CA"	2649	29803	2941	5347	1661	1280	2932	2415	1284	2597	723	5006	950	2007	1161	1875	1110	1664
"PPP2CB"	1976	27227	593	364	356	237	223	141	273	390	170	438	1056	790	1082	1114	1134	1038
"PPP2R1A"	2745	25326	2071	1405	1173	898	727	678	1008	1014	539	1897	3585	2199	4138	3194	4212	2993
"PPP2R1B"	5620	28566	406	97	213	193	59	38	431	155	270	67	1426	1413	1464	704	1910	792
"PPP2R2A"	2372	79613	9759	10018	5236	4523	5486	4532	5229	5337	2854	6791	2401	3314	2949	2922	3814	2532
"PPP2R2B"	2392	289091	201	0	143	58	0	0	570	73	0	17	64	98	39	22	102	89
"PPP2R2C"	4446	152022	0	0	0	0	0	0	781	273	0	0	1	1	0	0	0	0
"PPP2R2D"	1901	16518	2974	3133	1668	1306	1690	1443	1334	1419	1379	2627	917	1219	985	1306	1275	971
"PPP2R3A"	6757	182168	1348	818	743	605	464	354	799	446	0	211	216	276	231	173	176	44
"PPP2R3B"	2072	52657	0	0	0	0	0	0	0	0	0	0	0	0	61	66	94	57
"PPP2R3C"	1846	36842	1026	1342	550	476	728	614	591	807	278	967	1226	1540	753	893	895	658
"PPP2R4"	2835	37612	1021	40	597	424	13	27	1003	151	657	0	3066	2512	3918	2958	5287	3509
"PPP2R5A"	3140	76327	5179	644	2951	2228	402	242	2513	206	607	93	1509	1763	1686	1265	1905	1214
"PPP2R5B"	2722	9767	85	0	46	39	0	0	131	89	52	19	258	340	285	335	440	370
"PPP2R5C"	4497	166193	9379	3471	5344	4035	1845	1626	4723	1989	2483	3353	3496	4026	3607	3585	5734	3798
"PPP2R5D"	2965	27750	550	94	303	247	64	30	459	149	107	19	747	1449	751	1425	2151	1508
"PPP2R5E"	3380	168726	5132	1017	2817	2315	515	502	2875	708	1220	1005	810	1420	735	681	992	722
"PPP3CA"	4704	324043	21928	9378	12335	9593	5095	4283	11405	5617	4913	5168	1434	3448	2198	2148	2782	1935
"PPP3CB"	3163	59220	4352	2706	2374	1978	1524	1182	1709	1158	1551	2129	1013	1195	1098	881	1049	668
"PPP3CC"	2228	100041	6062	3786	3443	2619	2149	1637	3405	2235	1901	3759	579	696	460	581	673	509
"PPP3R1"	3017	73664	8525	5431	4844	3681	3021	2410	3574	2518	2201	4091	2696	3817	2587	588	2653	2141
"PPP3R2"	3386	3386	0	0	0	0	0	0	0	0	0	0	0	0	0	0	0	0
"PPP4C"	1449	9306	740	661	388	352	369	292	339	501	373	1041	2002	2060	2254	2450	3244	2107
"PPP4R1"	3986	67810	2715	146	1494	1221	79	67	1594	154	593	199	1494	1426	1284	1354	2143	1337
"PPP4R1L"	2505	15121	1691	734	918	773	438	296	1302	1169	318	1953	194	263	205	182	306	141
"PPP4R2"	1471	68894	3784	6977	2020	1764	3718	3259	1445	3719	723	4835	1485	1891	1463	1615	1535	1112
"PPP4R4"	3893	105425	0	0	0	0	0	0	0	0	0	0	0	0	0	0	0	0
"PPP5C"	2073	43811	659	62	372	287	41	21	753	97	344	89	717	543	793	729	1004	817
"PPP6C"	4357	43367	715	663	467	248	390	273	328	537	212	909	2121	1870	2126	2060	2482	1841
"PPPDE1"	4095	55982	1263	537	810	453	297	240	703	414	148	481	1230	1318	1145	947	1231	772
"PPPDE2"	751	19982	1661	3379	897	764	1999	1380	667	1146	906	4229	238	1457	480	572	603	367
"PPRC1"	5350	17303	1282	1715	729	553	949	766	526	1042	530	2105	1127	2032	1391	2778	1602	1763
"PPT1"	2583	24762	7040	531	4171	2869	293	238	1259	602	3327	1171	7499	11073	19746	4741	70339	31334
"PPT2"	4579	18135	288	11	188	100	11	0	168	71	100	20	2082	2519	2266	1617	4147	2220
"PPTC7"	3754	48829	1688	1284	1030	658	669	615	806	1365	180	2135	1432	2308	197	403	236	134
"PPWD1"	2142	24239	978	373	510	468	215	158	613	228	0	149	723	775	591	742	812	544
"PPY"	460	1662	0	0	0	0	0	0	0	0	0	0	0	0	0	0	0	0
"PPY2"	658	846	0	0	0	0	0	0	0	11	0	0	0	0	0	0	0	0
"PPYR1"	1958	4787	0	0	0	0	0	0	0	9	0	0	0	0	0	0	0	0
"PQBP1"	1184	4646	157	181	81	76	127	54	56	115	0	84	937	1031	900	1070	1245	998
"PQLC1"	2629	48607	8516	8714	4506	4010	4487	4227	3227	5724	7657	13545	527	756	987	1451	1693	866
"PQLC2"	2262	17055	758	122	402	356	70	52	402	165	297	56	559	380	572	354	819	505
"PQLC3"	1791	23458	1091	158	651	440	79	79	583	76	972	125	2330	2360	2082	1274	2472	1634
"PR"	12993	100191	0	0	0	0	0	0	0	0	0	0	0	0	0	0	0	0
"PRAC"	375	792	0	0	0	0	0	0	0	0	0	0	0	0	0	0	0	0
"PRAC2"	566	1579	0	0	0	0	0	0	0	0	0	0	0	0	0	0	0	0
"PRAF2"	1264	2844	0	0	0	0	0	0	29	21	0	0	62	59	74	64	77	79
"PRAGMIN"	4631	64000	24072	27236	13285	10787	14650	12586	8018	12891	14388	12962	3324	3512	3817	3560	5286	1742
"PRAJA1BETA"	2440	4760	0	5	0	0	5	0	0	16	0	0	588	574	609	517	600	437
"PRAM1"	2175	12556	1224	133	663	561	86	47	624	166	3231	645	1334	628	2110	1093	2236	1292
"PRAME"	2763	11574	0	0	0	0	0	0	0	0	0	0	0	0	0	0	0	0
"PRAMEF1"	1610	4679	0	0	0	0	0	0	0	0	0	0	0	0	0	0	0	0
"PRAMEF10"	1521	5368	0	0	0	0	0	0	0	0	0	0	0	0	0	0	0	0
"PRAMEF11"	1843	6798	0	0	0	0	0	0	0	0	0	0	0	0	0	0	0	0
"PRAMEF12"	1786	3064	0	0	0	0	0	0	0	0	0	0	0	0	0	0	0	0
"PRAMEF13"	2168	5244	0	0	0	0	0	0	0	0	0	0	0	0	0	0	0	0
"PRAMEF14"	2104	5244	0	0	0	0	0	0	0	0	0	0	0	0	0	0	0	0
"PRAMEF16"	1587	3005	0	0	0	0	0	0	0	0	0	0	0	0	0	0	0	0
"PRAMEF17"	1560	2978	0	0	0	0	0	0	0	0	0	0	0	0	0	0	0	0
"PRAMEF18"	2126	3518	0	0	0	0	0	0	0	0	0	0	0	0	0	0	0	0
"PRAMEF2"	1646	4825	0	0	0	0	0	0	0	0	0	0	0	0	0	0	0	0
"PRAMEF20"	1601	10879	0	0	0	0	0	0	0	0	0	0	0	0	0	0	0	0
"PRAMEF22"	2107	3498	0	0	0	0	0	0	0	0	0	0	0	0	0	0	0	0
"PRAMEF4"	1844	6994	0	0	0	0	0	0	0	0	0	0	0	0	0	0	0	0
"PRAMEF5"	1859	9239	0	0	0	0	0	0	0	0	0	0	0	0	0	0	0	0
"PRAMEF6"	1859	9240	0	0	0	0	0	0	0	0	0	0	0	0	0	0	0	0
"PRAMEF8"	1848	4121	0	0	0	0	0	0	0	0	0	0	0	0	0	0	0	0
"PRAMEF9"	1867	7017	0	0	0	0	0	0	0	0	0	0	0	0	0	0	0	0
"PRAP1"	782	5345	846	519	463	383	258	261	623	409	1694	367	70	73	74	90	96	59
"PRB1"	1175	3769	107	105	74	33	36	69	15	11	0	0	0	0	0	0	0	0
"PRB2"	1432	4026	111	0	64	47	0	0	16	14	0	0	0	0	0	0	0	0
"PRB3"	1095	3785	694	479	405	289	280	199	93	93	0	0	0	0	0	1	0	0
"PRB4"	918	3352	46503	36773	26059	20444	20104	16669	16075	10236	5986	9207	637	917	584	541	673	464
"PRC1"	3122	28532	113	11	57	56	3	8	109	0	0	0	67	61	6	11	34	11
"PRCC"	2125	33332	952	980	567	385	529	451	536	655	174	1076	1318	988	1069	984	1361	971
"PRCD"	2070	17792	0	0	0	0	0	0	112	68	0	0	5	0	20	19	29	50
"PRCP"	2215	76149	6278	377	3497	2781	207	170	2492	132	1128	210	4553	5022	3129	6026	8409	3832
"PRDM1"	5172	23621	3161	13683	1751	1410	7317	6366	531	6191	92	6326	1203	14289	444	3394	919	3142
"PRDM10"	6343	103130	876	237	500	376	133	104	700	156	176	331	542	524	615	486	693	393
"PRDM11"	2236	131340	78	0	48	30	0	0	510	176	14	0	26	24	15	12	12	23
"PRDM12"	2497	18405	0	0	0	0	0	0	11	24	0	0	0	0	0	0	0	0
"PRDM13"	3208	8806	0	0	0	0	0	0	15	0	0	0	0	0	0	0	0	0
"PRDM14"	2213	19539	0	0	0	0	0	0	0	0	0	0	0	1	0	0	0	0
"PRDM15"	6746	81206	275	362	170	105	174	188	480	1209	27	1312	356	401	421	467	487	390
"PRDM16"	8737	369441	0	0	0	0	0	0	2739	1346	0	0	0	0	0	0	0	0
"PRDM2"	7965	120224	15290	6897	8387	6903	3804	3093	6963	3573	8759	6215	2907	2654	3201	2163	4041	2003
"PRDM4"	4198	28272	424	57	288	136	35	22	358	21	62	0	810	524	558	713	1101	711
"PRDM5"	2495	228085	0	0	0	0	0	0	0	0	0	0	0	0	0	0	0	0
"PRDM6"	3034	98905	0	0	0	0	0	0	36	10	0	0	0	0	0	0	0	0
"PRDM7"	3230	19364	0	0	0	0	0	0	0	0	0	0	0	0	0	0	0	0
"PRDM8"	4105	19058	0	0	0	0	0	0	13	18	0	0	0	11	6	4	12	0
"PRDM9"	3700	20982	0	0	0	0	0	0	0	0	0	0	0	0	0	0	0	0
"PRDX1"	1239	10903	298	148	163	135	20	128	189	454	70	705	2898	3931	4640	6210	8525	8117
"PRDX2"	1467	2023	0	0	0	0	0	0	24	13	0	0	352	382	474	891	751	344
"PRDX3"	1597	11131	282	0	128	154	0	0	92	13	0	0	3879	3858	5116	4917	5656	4117
"PRDX4"	927	18870	6	0	3	3	0	0	0	0	0	0	464	444	582	496	530	381
"PRDX5"	889	3715	1	0	0	1	0	0	68	82	0	0	597	1897	1105	786	1011	799
"PRDX6"	1675	11462	403	962	253	150	564	398	323	663	201	909	3270	4500	4438	5710	4919	4552
"PRDXDD1P"	2152	2152	661	517	279	382	278	239	272	267	386	997	124	111	79	56	164	54
"PREB"	2175	3919	199	40	115	84	16	24	139	59	145	75	694	1098	1670	1382	1252	1139
"PRED16"	732	17913	0	0	0	0	0	0	0	0	0	0	0	0	0	0	0	0
"PRELID1"	1195	3116	65	137	29	36	96	41	68	140	0	132	636	1193	1514	1977	2148	1742
"PRELID2"	2347	76319	15	0	13	2	0	0	53	0	0	0	38	40	9	27	27	16
"PRELP"	5820	15596	0	0	0	0	0	0	28	0	0	0	0	0	0	0	0	0
"PREP"	2863	125464	2406	542	1422	984	323	219	1670	401	128	424	939	1125	1446	1293	1861	1277
"PREPL"	5226	42729	688	0	337	351	0	0	444	12	119	17	1332	1276	1322	1163	1462	915
"PRES"	2351	69001	0	0	0	0	0	0	19	0	0	0	0	0	0	0	0	0
"PREX1"	6673	203629	39602	11118	21651	17951	6138	4980	15405	6683	29978	12728	7196	7360	6766	6217	11712	5809
"PREX2"	5172	279296	0	0	0	0	0	0	0	25	0	27	0	0	0	0	0	0
"PRF1"	2536	5428	13	0	13	0	0	0	66	29	0	17	230	44	138	163	252	210
"PRG-3"	2462	296387	0	0	0	0	0	0	8	0	0	0	0	0	0	0	0	0
"PRG1"	494	494	0	0	0	0	0	0	0	0	0	0	0	0	0	0	0	0
"PRG2"	2364	9436	50	21	29	21	21	0	39	283	0	33	45	72	60	49	79	52
"PRG3"	874	4382	0	0	0	0	0	0	0	0	0	0	0	0	0	0	0	0
"PRG4"	5055	18283	50	29	28	22	13	16	42	7	0	10	127	159	65	80	122	65
"PRGP1"	1797	55625	0	0	0	0	0	0	27	0	0	11	2	0	0	3	2	4
"PRH1"	1215	290655	33785	25437	18911	14874	14028	11409	14201	8698	5789	8336	596	882	551	540	673	464
"PRH2"	4325	5611	1772	412	1111	661	234	178	316	228	59	111	0	0	0	0	0	1
"PRHOXNB"	524	10533	0	0	0	0	0	0	0	0	0	0	0	0	0	0	0	0
"PRIC285"	10022	16155	1484	1350	775	709	745	605	715	1548	1442	2534	1779	2563	2600	2399	2631	2437
"PRICKLE1"	4328	131433	0	0	0	0	0	0	9	0	0	0	37	0	0	0	6	3
"PRICKLE2"	8329	131606	0	0	0	0	0	0	23	0	0	0	0	0	0	0	0	0
"PRICKLE3"	1999	9442	194	0	109	85	0	0	82	26	0	0	1262	1211	242	148	370	128
"PRICKLE4"	2107	7065	37	0	21	16	0	0	34	22	0	18	492	387	694	592	894	602
"PRIM1"	1469	20778	0	0	0	0	0	0	0	0	0	0	64	52	81	42	87	60
"PRIM2"	2295	330955	1557	331	957	600	191	140	1847	635	166	231	216	197	100	100	112	79
"PRIMA1"	3827	70124	0	0	0	0	0	0	350	15	0	0	0	0	0	0	0	0
"PRINS"	2194	8923	0	0	0	0	0	0	0	0	0	0	0	0	0	0	0	0
"PRKAA1"	5139	38817	472	777	207	265	418	359	361	929	12	575	1031	1397	1007	1180	1184	724
"PRKAA2"	9360	70019	11	0	8	3	0	0	0	0	0	0	0	0	0	0	0	0
"PRKAB1"	2407	13669	351	239	207	144	111	128	427	226	106	313	647	461	773	300	982	374
"PRKAB2"	5429	17444	297	0	176	121	0	0	180	22	0	28	558	370	549	276	667	181
"PRKACA"	2681	26052	952	102	505	447	65	37	447	208	612	471	953	2131	1001	1074	1726	960
"PRKACB"	4581	73794	987	93	618	369	56	37	1247	85	459	264	2278	2174	3877	3557	3487	2388
"PRKACG"	1585	1585	0	0	0	0	0	0	0	0	0	0	0	0	0	0	0	0
"PRKAG1"	1850	16477	437	202	235	202	107	95	334	145	14	64	1233	1335	911	966	1270	899
"PRKAG2"	4751	39329	38648	32336	21549	17099	17395	14941	15211	15019	20764	34186	1787	2199	2239	2929	2134	1828
"PRKAG3"	2313	9408	0	0	0	0	0	0	68	18	0	0	0	0	0	0	0	0
"PRKAR1A"	4053	17948	5744	1341	3144	2600	810	531	3039	514	3584	986	14138	14071	21030	16805	19027	13529
"PRKAR1B"	1942	162748	192	842	121	71	468	374	1025	1022	0	859	568	967	528	860	638	875
"PRKAR2A"	2392	97179	1010	82	614	396	55	27	528	193	36	135	202	2717	1376	1330	1600	1009
"PRKAR2B"	3671	117079	0	1	0	0	1	0	69	8	0	0	258	288	197	129	609	302
"PRKCA"	8787	507938	6204	7699	3476	2728	4331	3368	5547	6820	485	2473	974	968	1401	1132	1580	1045
"PRKCB"	8029	384632	3618	1927	2035	1583	1135	792	3529	2445	1867	3863	1632	1592	2531	2613	1833	1470
"PRKCD"	2852	31510	10107	15906	5427	4680	8468	7438	2782	8391	7751	22677	4867	9419	6564	11219	8889	9301
"PRKCDBP"	1039	1566	0	0	0	0	0	0	9	0	0	0	134	99	78	38	72	29
"PRKCE"	5534	536087	35	154	21	14	111	43	528	1642	0	1924	0	0	16	29	10	5
"PRKCG"	3146	25436	0	0	0	0	0	0	86	31	0	0	0	0	0	0	0	0
"PRKCH"	3517	229182	653	590	343	310	321	269	183	87	0	408	159	244	95	115	170	108
"PRKCI"	4902	83552	158	0	76	82	0	0	81	18	0	10	484	534	589	463	705	469
"PRKCQ"	3385	88177	32	7	17	15	7	0	47	31	0	39	14	21	3	18	18	5
"PRKCSH"	2304	15216	507	180	306	201	92	88	309	158	318	139	2845	2480	2534	2375	3619	2281
"PRKCZ"	2342	134925	44	0	32	12	0	0	1000	473	2	8	44	45	5	4	101	16
"PRKD1"	3693	351212	0	0	0	0	0	0	0	0	0	0	0	0	0	0	0	0
"PRKD2"	3618	42812	372	214	178	194	88	126	346	319	304	753	312	349	429	394	628	379
"PRKD3"	5918	66576	5435	5312	3084	2351	2733	2579	2466	3345	478	6501	4450	5980	3930	3820	2612	3684
"PRKDC"	13592	187075	2703	1339	1487	1216	720	619	1605	916	837	884	3900	3645	5288	4742	5433	2629
"PRKG1"	3842	1304331	104	71	48	56	44	27	84	50	0	85	1330	1529	1318	1246	1733	1207
"PRKG2"	3388	126383	0	0	0	0	0	0	0	0	0	0	0	0	0	0	0	0
"PRKRA"	1912	19344	1246	237	734	512	148	89	557	219	175	201	768	1428	962	654	1281	743
"PRKRIP1"	2887	62790	2428	356	1339	1089	243	113	1090	215	1319	512	489	278	532	321	664	339
"PRKRIR"	6793	9615	758	390	462	296	235	155	416	289	0	320	1821	1792	2157	130	152	1561
"PRKWNK4"	1680	9225	0	0	0	0	0	0	47	33	0	0	0	0	0	0	0	0
"PRKX"	7223	107575	12473	9767	6864	5609	5178	4589	5071	6904	3356	10002	6397	6949	5824	4852	5780	4530
"PRL"	1360	10253	0	0	0	0	0	0	0	0	0	0	0	0	0	0	0	0
"PRLH"	265	602	0	0	0	0	0	0	0	0	0	0	0	0	0	0	0	0
"PRLHR"	1982	2246	0	0	0	0	0	0	0	0	0	0	0	0	0	0	0	0
"PRLR"	11798	174994	0	0	0	0	0	0	7	0	0	0	0	0	0	0	0	0
"PRM1"	410	500	0	0	0	0	0	0	0	0	0	0	0	0	0	0	0	0
"PRM2"	725	842	0	0	0	0	0	0	0	0	0	0	0	0	0	0	0	0
"PRM3"	310	310	0	0	0	0	0	0	17	0	0	0	0	0	0	0	0	0
"PRMT1"	1487	11210	177	139	108	69	67	72	225	221	18	206	498	558	1397	1554	1361	1318
"PRMT10"	2839	45746	378	30	196	182	13	17	289	7	0	13	190	168	288	135	326	174
"PRMT2"	2265	24530	4912	2266	2794	2118	1207	1059	2231	947	1959	1580	3046	2436	3143	2166	3797	1769
"PRMT3"	2747	121803	335	85	216	119	54	31	550	24	27	33	340	379	344	276	439	203
"PRMT5"	2487	8930	13	0	7	6	0	0	14	0	0	25	645	778	915	827	1007	814
"PRMT6"	2642	2642	0	0	0	0	0	0	0	0	0	0	599	397	709	243	733	340
"PRMT7"	2409	46219	556	8	315	241	0	8	470	93	196	64	274	241	319	213	346	214
"PRMT8"	2350	102713	0	0	0	0	0	0	65	33	0	0	0	0	0	0	0	0
"PRN"	1966	11228	338	29	172	166	13	16	347	155	185	117	532	360	502	347	700	365
"PRND"	3981	6551	0	1	0	0	1	0	0	0	0	0	0	0	0	0	0	0
"PRNP"	2741	15438	35	715	12	23	396	319	263	344	0	184	4513	4979	5780	5636	5884	4367
"PRNPIP"	1674	134198	1129	210	704	425	99	111	1903	463	414	437	305	336	380	401	436	348
"PRO0611"	570	570	562	278	368	194	163	115	163	329	6	236	0	1	0	0	3	0
"PRO0628"	1161	1161	1165	5234	1028	137	2550	2684	124	4512	189	3018	0	0	0	0	0	0
"PRO1768"	1260	1260	1322	426	781	541	238	188	320	264	39	424	0	0	0	0	0	0
"PROC"	1862	10801	0	0	0	0	0	0	64	19	0	0	141	88	13	0	68	39
"PROCA1"	1363	7572	289	13	154	135	13	0	227	253	85	275	174	72	60	16	285	73
"PROCR"	1541	6439	24	0	12	12	0	0	65	17	0	0	7	0	3	0	0	4
"PRODH"	2415	23773	0	0	0	0	0	0	172	56	0	0	0	0	0	0	0	0
"PRODH2"	1688	13311	0	0	0	0	0	0	0	0	0	0	0	0	0	0	0	0
"PROK1"	1373	6188	0	0	0	0	0	0	8	9	0	0	0	0	0	0	0	0
"PROK2"	1616	13552	0	0	0	0	0	0	0	0	0	0	60	44	0	0	0	0
"PROKR1"	1342	9914	0	0	0	0	0	0	0	0	0	0	0	0	0	0	0	0
"PROKR2"	1404	14693	0	0	0	0	0	0	0	0	0	0	0	0	0	0	0	0
"PROL1"	1042	12313	0	0	0	0	0	0	0	0	0	0	0	0	0	0	0	0
"PROL4"	1580	325765	35869	26054	20115	15754	14362	11692	15017	8877	5789	8404	647	914	566	552	702	484
"PROM1"	4284	115747	1	0	0	1	0	0	0	0	0	0	0	0	0	0	0	0
"PROM2"	4533	16854	0	0	0	0	0	0	155	72	0	0	0	0	0	0	0	0
"PROP1"	1467	4009	0	0	0	0	0	0	0	0	0	0	0	0	0	0	0	0
"PROS1"	3594	101054	0	14	0	0	6	8	0	0	0	0	119	115	34	54	155	75
"PROSC"	2576	17186	79	91	33	46	53	38	53	42	26	0	2072	2175	1629	1236	1686	1103
"PROTOR1"	1876	35480	82	0	45	37	0	0	302	128	0	31	56	42	85	82	102	113
"PROX1"	3074	47902	0	0	0	0	0	0	0	0	0	0	0	0	0	0	0	0
"PROX2"	1783	8704	164	17	80	84	12	5	83	0	0	0	201	100	222	1	196	3
"PROZ"	1560	13728	12	0	0	12	0	0	14	102	0	22	0	38	0	20	0	7
"PRP3"	2026	24686	557	143	244	313	100	43	320	145	207	521	571	637	867	601	967	672
"PRPF18"	1714	43930	1107	153	641	466	95	58	613	149	196	120	351	244	507	461	606	461
"PRPF19"	2355	16042	272	29	148	124	29	0	279	112	18	15	1594	1224	1640	1580	1773	1254
"PRPF3"	2478	31777	748	160	348	400	100	60	370	181	287	613	675	880	975	816	1120	908
"PRPF31"	2197	16362	127	46	28	99	28	18	181	116	45	0	349	418	841	544	1057	600
"PRPF38A"	2781	13774	228	260	92	136	153	107	138	251	0	137	814	1072	979	1020	1108	908
"PRPF38B"	3789	9490	2157	1659	1207	950	916	743	879	528	602	903	2520	2420	2651	1852	2555	1464
"PRPF39"	3537	31502	584	244	277	307	118	126	245	201	26	178	569	910	584	516	654	401
"PRPF4"	2747	17082	61	52	36	25	44	8	58	56	0	105	881	605	737	726	975	647
"PRPF40A"	7552	65868	3627	6115	2057	1570	3589	2526	2031	3782	710	7104	3797	4688	3903	3934	3780	2852
"PRPF40B"	3627	21048	1292	47046	536	756	25234	21812	215	36619	2142	78696	149	5304	2453	1813	282	2914
"PRPF4B"	7496	43649	2417	1399	1290	1127	737	662	1189	959	570	847	2868	3162	4268	3161	4215	2398
"PRPF6"	3120	52022	877	289	468	409	131	158	509	506	405	541	1252	1152	1905	1682	2534	1736
"PRPF8"	7337	34254	3128	1716	1789	1339	861	855	1218	1112	1194	1411	11382	12074	10210	8029	11928	6826
"PRPH"	1841	3573	0	0	0	0	0	0	0	11	0	0	0	0	0	0	0	0
"PRPH2"	3029	26026	20	0	0	20	0	0	81	9	40	0	0	0	0	0	0	0
"PRPS1"	2162	22603	154	26	84	70	26	0	65	14	0	18	1090	1330	2031	1534	1991	1601
"PRPS1L1"	1751	22603	154	26	84	70	26	0	65	14	0	18	1090	1330	2031	1534	1991	1601
"PRPS2"	2524	32851	247	0	120	127	0	0	164	0	0	8	1521	1167	1670	1600	1626	1331
"PRPSAP1"	2369	43364	57	0	27	30	0	0	122	19	0	0	525	359	426	470	728	460
"PRPSAP2"	1902	73090	448	50	283	165	31	19	439	50	57	54	513	473	588	538	675	510
"PRR10"	1771	3150	0	0	0	0	0	0	0	0	0	0	0	0	0	0	0	0
"PRR11"	1327	46056	14	0	14	0	0	0	83	0	22	0	712	811	220	179	233	102
"PRR12"	6956	34785	1184	73	603	581	46	27	656	127	1142	14	902	465	1145	316	1524	610
"PRR13"	1198	4995	622	301	330	292	140	161	206	165	536	416	3018	3181	4782	4199	5564	4169
"PRR14"	2199	5494	238	226	129	109	107	119	140	225	28	349	825	1019	1055	1353	1157	1276
"PRR15"	1680	3486	1	0	0	1	0	0	0	10	0	0	0	0	0	0	0	0
"PRR16"	1764	222945	31	0	23	8	0	0	0	0	0	0	0	14	0	0	7	0
"PRR18"	2705	2705	0	0	0	0	0	0	0	0	0	0	0	0	0	0	0	0
"PRR19"	1964	2048	0	0	0	0	0	0	34	52	0	0	46	39	25	27	50	39
"PRR20"	1850	3023	0	0	0	0	0	0	0	0	0	0	0	0	0	0	0	0
"PRR21"	1170	1170	0	0	0	0	0	0	0	0	0	0	0	0	0	0	0	0
"PRR22"	1641	1641	0	46	0	0	23	23	0	0	0	36	0	8	9	11	22	0
"PRR23A"	2307	2307	0	0	0	0	0	0	0	0	0	0	0	0	0	0	0	0
"PRR23B"	1897	1897	0	0	0	0	0	0	0	0	0	0	0	0	0	0	0	0
"PRR23C"	2792	2792	0	0	0	0	0	0	0	0	0	0	0	0	0	0	0	0
"PRR24"	839	839	0	0	0	0	0	0	0	13	0	32	63	71	91	108	115	80
"PRR25"	1211	8419	0	0	0	0	0	0	33	0	0	0	0	0	0	0	0	0
"PRR3"	2845	7426	123	0	11	112	0	0	152	25	0	19	307	163	243	91	278	132
"PRR4"	1708	234208	35869	26054	20115	15754	14362	11692	15017	8877	5789	8404	647	914	566	552	702	484
"PRR5"	2566	60875	82	0	45	37	0	0	445	227	0	31	56	42	85	82	102	113
"PRR5L"	3972	169030	286	331	152	134	172	159	123	62	23	325	67	87	75	66	131	59
"PRR7"	1480	9489	321	26	175	146	0	26	144	8	390	0	37	9	63	0	44	0
"PRRC1"	5535	34525	314	0	152	162	0	0	243	17	6	0	1617	1238	1839	1126	2074	1067
"PRRG1"	4588	108021	0	0	0	0	0	0	64	0	0	11	65	60	0	3	8	8
"PRRG2"	1636	9680	0	0	0	0	0	0	29	12	0	0	13	0	0	0	10	6
"PRRG3"	1598	3236	0	0	0	0	0	0	0	0	0	0	0	0	0	0	0	0
"PRRG4"	1970	24616	0	0	0	0	0	0	55	9	31	0	998	1245	184	321	619	140
"PRRT1"	2781	3562	0	0	0	0	0	0	24	0	0	0	0	0	0	0	0	0
"PRRT2"	3002	3639	0	0	0	0	0	0	129	24	0	0	0	0	0	0	0	0
"PRRT3"	3765	6854	110	0	35	75	0	0	166	0	0	0	88	228	344	102	91	81
"PRRT4"	3683	11357	0	0	0	0	0	0	10	22	0	0	0	0	0	0	0	0
"PRRX1"	4075	75229	0	0	0	0	0	0	0	0	0	0	0	0	0	0	0	0
"PRRX2"	1311	57031	0	0	0	0	0	0	405	213	0	0	70	62	28	5	95	30
"PRSS1"	1439	2542	0	0	0	0	0	0	0	0	0	0	0	0	0	0	0	0
"PRSS12"	3362	71507	0	0	0	0	0	0	0	12	0	0	1	4	0	0	0	0
"PRSS16"	2721	8743	0	0	0	0	0	0	26	0	0	0	0	0	0	0	0	0
"PRSS2"	406	1471	0	0	0	0	0	0	12	0	0	0	0	0	0	0	0	0
"PRSS21"	1167	4554	181	0	114	67	0	0	167	42	882	136	343	318	1170	936	868	484
"PRSS22"	1392	5445	0	0	0	0	0	0	44	51	0	0	0	0	0	0	0	0
"PRSS23"	3804	10782	0	0	0	0	0	0	0	8	0	0	14	50	7	0	0	0
"PRSS27"	2066	3144	1	15	1	0	14	1	114	47	0	1	1	2	0	0	0	0
"PRSS3"	1099	48715	25	12	13	12	12	0	10	0	0	0	19	16	10	0	30	13
"PRSS33"	1700	2756	13	0	2	11	0	0	38	43	0	0	4	0	9	4	10	0
"PRSS35"	2527	13147	0	0	0	0	0	0	0	0	0	0	0	0	0	0	0	0
"PRSS36"	2850	11166	173	7	75	98	7	0	154	99	82	17	314	259	298	331	853	433
"PRSS37"	1855	5201	0	0	0	0	0	0	0	0	0	0	0	0	0	0	0	0
"PRSS38"	1246	30753	0	0	0	0	0	0	0	0	0	0	0	0	0	0	0	0
"PRSS7"	3968	134538	0	0	0	0	0	0	0	0	0	0	0	0	0	0	0	0
"PRSS8"	1944	4397	96	0	36	60	0	0	89	36	0	0	0	0	0	0	0	0
"PRSSL1"	1058	9917	0	0	0	0	0	0	46	56	0	0	5	7	15	5	25	21
"PRTFDC1"	1935	103981	0	0	0	0	0	0	0	0	0	0	0	0	0	0	0	0
"PRTG"	11983	131431	0	0	0	0	0	0	0	0	0	0	0	0	0	0	0	0
"PRTN3"	1006	7192	0	0	0	0	0	0	0	29	0	0	0	1	4	15	3	17
"PRUNE"	2985	27218	0	0	0	0	0	0	40	0	0	0	387	377	408	155	525	261
"PRUNE2"	12603	294712	2558	720	1364	1194	386	334	703	232	0	30	114	226	0	0	16	0
"PRX"	5511	19601	0	0	0	0	0	0	157	27	0	0	92	21	5	4	124	5
"PRY"	1359	24253	0	0	0	0	0	0	0	0	0	0	0	0	0	0	0	0
"PS-PLA1"	1766	31936	0	135	0	0	63	72	0	62	0	2	0	102	12	35	5	24
"PSAP"	2835	35028	31044	99580	16874	14170	52825	46755	7131	414	14042	119044	113400	57532	161666	169620	144245	69748
"PSAPL1"	4680	4680	0	0	0	0	0	0	41	26	0	0	0	0	0	0	0	0
"PSAT1"	2195	32950	0	0	0	0	0	0	21	10	0	0	130	118	22	23	242	152
"PSCA"	1022	2269	0	0	0	0	0	0	23	36	0	0	0	0	0	2	6	0
"PSCD4"	2118	32895	24502	23111	13447	11055	12151	10960	4924	18409	15680	9075	8807	11732	8034	5060	11206	5834
"PSD"	4200	16527	317	2403	203	114	1458	945	132	2971	0	5936	21	3032	3	34	11	3
"PSD2"	4525	48644	0	0	0	0	0	0	254	109	0	0	0	0	0	0	0	0
"PSD3"	11702	486384	887	13840	549	338	7589	6251	1768	12272	8	8907	960	1041	767	710	1285	654
"PSD4"	5055	29118	2048	419	1142	906	240	179	854	455	1221	593	3094	2721	3471	2652	4696	2930
"PSEN1"	6347	86875	10251	28051	5730	4521	15050	13001	3442	12033	3505	27883	5118	8965	5217	7034	5730	5632
"PSEN2"	2311	25533	864	407	503	361	208	199	484	350	197	521	522	480	982	927	1223	969
"PSENEN"	669	1411	0	0	0	0	0	0	165	108	0	0	396	388	429	370	671	494
"PSF"	2059	3735	530	233	333	197	155	78	195	255	422	500	1767	1000	1824	5483	2930	1399
"PSG"	1109	18794	0	0	0	0	0	0	0	0	0	0	0	0	0	0	0	0
"PSG1"	2281	12515	0	0	0	0	0	0	0	12	0	0	0	0	0	0	0	0
"PSG11"	1829	12372	0	0	0	0	0	0	0	0	0	0	0	0	0	0	0	0
"PSG2"	1607	18454	0	0	0	0	0	0	0	0	0	0	0	0	0	0	0	0
"PSG3"	1950	214433	0	0	0	0	0	0	0	12	0	0	0	0	0	0	0	0
"PSG4"	2036	12936	0	0	0	0	0	0	13	0	0	0	0	0	0	0	0	0
"PSG5"	1925	18794	0	0	0	0	0	0	0	0	0	0	0	0	0	0	0	0
"PSG6"	1715	124393	0	0	0	0	0	0	0	0	0	0	0	0	0	0	0	0
"PSG7"	2040	13046	0	0	0	0	0	0	0	0	0	0	0	0	0	0	0	0
"PSG8"	2037	103032	0	0	0	0	0	0	0	0	0	0	0	0	0	0	0	0
"PSG9"	1711	16248	0	0	0	0	0	0	0	0	0	0	0	0	0	0	0	0
"PSGII"	2109	12372	0	0	0	0	0	0	0	0	0	0	0	0	0	0	0	0
"PSIMCT-1"	834	834	899	119	245	654	51	68	611	77	484	116	770	96	116	74	82	60
"PSIP1"	3391	46939	1569	126	625	944	70	56	1454	76	165	0	1388	589	730	585	1008	551
"PSKH1"	3483	36407	1169	164	625	544	110	54	803	483	581	391	1235	1095	427	1052	1589	1089
"PSKH2"	1159	21160	0	0	0	0	0	0	0	0	0	0	0	0	0	0	0	0
"PSMA1"	1573	15488	1083	1783	609	474	956	827	619	879	133	1260	2084	3331	2693	2930	2802	2971
"PSMA2"	1531	15343	339	152	196	143	97	55	108	121	179	138	1083	1130	1792	1698	2059	1694
"PSMA3"	938	27135	6256	6677	3561	2695	3569	3108	2480	2640	2402	1750	3493	4964	3497	3383	3771	2758
"PSMA4"	3059	8776	321	251	177	144	165	86	127	197	0	123	2273	2826	1964	1927	1600	974
"PSMA5"	977	24561	1311	773	767	544	400	373	694	399	519	1037	1192	1517	1537	1765	1731	1601
"PSMA6"	1018	25101	1132	4031	672	460	2173	1858	544	2675	91	5379	671	2132	1735	3204	1902	2067
"PSMA7"	1076	6685	619	338	339	280	190	148	222	199	211	231	2787	2341	3119	2377	3179	2085
"PSMA8"	1885	59506	0	0	0	0	0	0	0	0	0	0	50	67	64	81	39	0
"PSMB1"	2517	82312	860	954	440	420	519	435	519	477	206	848	2546	3043	1871	2078	2782	2029
"PSMB10"	4765	6126	922	248	489	433	136	112	428	287	270	357	1807	1489	1840	1656	2768	1417
"PSMB11"	1895	1895	0	0	0	0	0	0	9	0	0	0	0	0	0	0	0	0
"PSMB2"	5673	71732	514	519	353	161	308	211	433	625	39	464	1563	1640	1327	1266	1581	1029
"PSMB3"	759	11477	575	137	279	296	84	53	290	178	426	657	1669	1029	2291	2048	3069	1624
"PSMB4"	2091	2343	174	181	83	91	120	61	108	114	33	117	1593	1837	2616	2843	3391	2673
"PSMB5"	1382	9295	346	22	194	152	22	0	170	113	0	242	1351	1046	1481	792	1225	443
"PSMB6"	830	2333	9	0	0	9	0	0	29	14	0	0	728	1184	1247	1471	1529	1035
"PSMB7"	1377	59428	7393	5310	4052	3341	3123	2187	1304	3976	3860	7097	11239	11247	19229	16228	18637	12488
"PSMB8"	1587	4218	280	0	89	191	0	0	72	578	0	0	3797	9439	3179	1028	4497	1794
"PSMB9"	1089	4962	199	31	126	73	14	17	173	32	0	6	982	807	528	343	1784	871
"PSMC1"	1595	16072	485	335	292	193	188	147	322	290	199	479	269	350	2354	2431	2720	1784
"PSMC2"	1538	20568	251	135	113	138	73	62	227	96	55	127	1247	1773	2788	1977	2436	1871
"PSMC3"	1592	7706	84	44	40	44	25	19	214	129	0	5	658	896	1427	1559	1614	1322
"PSMC3IP"	1495	5420	462	0	197	265	0	0	141	15	48	0	1259	1354	1505	1141	1764	1200
"PSMC4"	1444	10280	260	167	149	111	86	81	77	117	17	251	1055	1284	1329	1449	1133	1278
"PSMC5"	2614	4578	570	138	262	308	67	71	175	158	207	157	2251	2043	2041	1961	2227	1152
"PSMC6"	2949	6499	697	404	403	294	202	202	354	253	0	419	530	669	1272	973	1433	930
"PSMD1"	3252	115866	4370	2595	2442	1928	1354	1241	2567	2164	825	2431	2030	2757	2920	2354	3157	2416
"PSMD10"	1551	7413	7	0	7	0	0	0	0	0	0	0	734	805	800	786	383	692
"PSMD11"	1653	36480	1602	2384	941	661	1245	1139	537	1216	272	2714	1117	1951	1450	2130	1756	1497
"PSMD12"	2093	26103	1026	441	593	433	296	145	564	427	0	617	1071	736	630	443	624	468
"PSMD13"	1774	16178	347	69	184	163	48	21	218	140	18	204	1335	1503	1987	1256	1979	986
"PSMD14"	1727	103442	1945	2203	1230	715	1250	953	1468	1035	148	1375	342	412	893	836	884	667
"PSMD2"	2943	9820	241	172	158	83	93	79	181	182	13	186	1935	1962	4143	5088	5467	3836
"PSMD3"	2159	17154	306	124	113	193	57	67	310	190	96	156	2168	1464	2194	2217	2250	2106
"PSMD4"	1348	12757	243	61	163	80	22	39	205	152	85	604	448	1079	1317	1647	1961	2110
"PSMD5"	3394	26874	301	381	147	154	185	196	276	215	44	163	1113	1167	938	677	1135	688
"PSMD6"	2059	12884	1465	662	867	598	374	288	509	356	107	375	1473	1167	1268	734	1611	712
"PSMD7"	1838	9505	1188	682	710	478	371	311	769	399	198	777	2340	2657	3031	2843	3458	2485
"PSMD8"	1587	7746	454	289	252	202	154	135	225	255	20	368	1799	1485	3089	3148	3810	3099
"PSMD9"	2414	29126	342	138	218	124	61	77	240	175	203	438	672	867	947	870	1141	825
"PSME1"	1179	2799	91	41	44	47	23	18	86	108	0	0	2912	2622	2710	2515	3122	2286
"PSME2"	963	3282	231	88	121	110	42	46	72	199	78	147	317	579	2050	1665	2281	2306
"PSME3"	3614	19334	365	498	199	166	288	210	259	339	172	555	2718	3487	2678	2901	3080	2512
"PSME4"	7146	106775	2812	3287	1584	1228	1881	1406	1710	2737	805	3917	1987	2651	2367	2689	2621	1808
"PSMF1"	3700	49186	2673	246	1473	1200	131	115	1371	249	529	185	1889	1770	1882	1665	1989	1763
"PSMG1"	1129	8052	14	0	14	0	0	0	12	0	5	0	258	254	321	271	288	223
"PSMG2"	1791	22596	218	41	118	100	31	10	232	90	46	70	728	611	1074	845	1305	902
"PSMG3"	1389	2661	23	0	19	4	0	0	40	0	0	0	433	258	461	241	245	380
"PSMG4"	942	9140	304	0	173	131	0	0	256	13	193	0	139	64	111	75	145	67
"PSORS1C1"	867	25216	0	0	0	0	0	0	127	27	0	0	0	0	0	0	0	0
"PSORS1C2"	1153	1817	0	0	0	0	0	0	12	0	0	0	0	0	0	0	0	0
"PSORS1C3"	596	4166	0	0	0	0	0	0	0	0	0	0	5	3	0	0	0	0
"PSPC1"	2350	108189	9494	7708	5242	4252	4228	3480	4341	3895	3083	6280	690	1127	964	1153	936	1002
"PSPH"	2172	40524	1645	781	938	707	457	324	1067	613	666	758	6834	7625	8839	8007	8918	7306
"PSPN"	472	556	0	0	0	0	0	0	0	20	0	0	0	0	0	0	0	0
"PSRC1"	1885	2864	0	0	0	0	0	0	13	0	0	0	51	3	16	0	90	0
"PSTK"	1729	10369	0	0	0	0	0	0	67	0	0	0	98	44	70	36	67	36
"PSTPIP1"	2090	42208	5201	734	2759	2442	424	310	2280	605	4643	808	1462	972	1864	1005	2596	1249
"PSTPIP2"	3038	88749	32351	94195	17995	14356	49907	44288	8400	45973	15239	98185	9766	13716	5014	11123	6826	7763
"PTA"	931	8827	0	0	0	0	0	0	0	7	0	0	27	12	45	7	34	34
"PTAFR"	2007	44585	4670	3246	2684	1986	1715	1531	2031	2408	3673	7805	10858	223	6592	4718	6376	4145
"PTAR1"	10058	50439	2655	1097	1456	1199	611	486	851	595	719	408	1640	1702	1898	1173	1915	847
"PTBLP"	3794	52345	3475	1580	1993	1482	794	786	1754	702	479	758	307	309	207	93	286	148
"PTBP1"	3296	14937	2822	2553	1522	1300	1308	1245	738	1255	2347	4045	5195	4843	6572	7859	7145	5801
"PTBP2"	3509	93426	3475	1580	1993	1482	794	786	1754	702	479	758	307	309	207	93	286	148
"PTCD1"	3142	47059	1846	470	973	873	259	211	1112	731	983	1076	3007	2524	3801	2967	4985	3325
"PTCD2"	2782	38981	21	0	6	15	0	0	93	12	60	0	73	54	121	64	149	53
"PTCD3"	6758	35977	1451	496	788	663	311	185	894	433	151	215	1287	1048	1470	1040	1851	953
"PTCH1"	8073	73983	2	0	2	0	0	0	79	25	0	0	4	0	0	0	12	11
"PTCH2"	3645	20530	0	6	0	0	4	2	108	1283	0	0	5	0	0	13	12	9
"PTCHD1"	5293	61934	0	0	0	0	0	0	0	0	0	0	0	0	0	0	0	0
"PTCHD2"	5234	58346	0	0	0	0	0	0	272	72	0	0	0	0	0	0	0	0
"PTCHD3"	2532	16182	0	0	0	0	0	0	0	0	0	0	0	0	0	0	0	0
"PTCRA"	1084	9848	0	11	0	0	11	0	18	38	0	0	51	19	123	132	187	121
"PTDSS1"	2517	72609	2369	275	1310	1059	144	131	1180	374	594	275	3305	3005	3506	3070	4649	3064
"PTDSS2"	2456	41108	155	3	86	69	3	0	436	118	68	22	232	227	290	294	391	277
"PTEN"	5555	105338	16214	14670	9177	7037	7946	6724	7048	7780	6016	9865	2885	3644	2945	2338	3853	2109
"PTENP1"	3913	3913	44	0	44	0	0	0	23	14	0	0	541	684	587	311	619	408
"PTER"	3799	76771	769	51	373	396	29	22	567	17	24	18	985	792	661	580	700	486
"PTF1A"	1333	1721	0	0	0	0	0	0	0	0	0	0	0	0	0	0	0	0
"PTGDR"	2943	9012	177	0	100	77	0	0	32	71	66	142	0	23	0	0	0	7
"PTGDS"	2028	6649	1	0	0	1	0	0	43	111	0	0	21	9	9	21	35	32
"PTGER1"	1423	2897	0	0	0	0	0	0	0	15	0	0	0	0	0	0	0	0
"PTGER2"	2478	14306	401	1950	236	165	1118	832	137	1800	52	1200	487	3079	735	3895	921	2076
"PTGER3"	7760	41955	53	153	33	20	100	53	5	214	0	0	446	711	6	33	36	4
"PTGER4"	3417	13805	2055	18624	1099	956	9996	8628	285	9804	0	13198	945	19849	1194	20746	1267	15624
"PTGES"	1789	14730	0	0	0	0	0	0	68	40	0	0	0	0	0	0	0	0
"PTGES2"	2074	7503	680	194	456	224	136	58	312	169	362	756	584	1096	783	1046	1782	1210
"PTGES3"	3211	24922	1434	766	824	610	376	390	696	586	1033	1822	4345	4326	1158	3978	4421	883
"PTGFR"	5434	49659	0	0	0	0	0	0	0	0	0	0	0	0	0	0	0	0
"PTGFRN"	6169	80285	354	19	216	138	19	0	334	35	37	0	1678	1453	2353	1735	2699	1773
"PTGIR"	2088	4630	23	79	0	23	50	29	0	288	0	606	38	454	143	810	86	386
"PTGIS"	5611	64296	0	0	0	0	0	0	13	9	0	0	0	0	0	0	0	0
"PTGR1"	2562	36884	129	0	78	51	0	0	100	8	0	0	395	393	316	305	625	451
"PTGR2"	2602	33547	7	0	7	0	0	0	0	0	0	0	324	309	272	256	251	218
"PTGS1"	5387	25174	11026	3337	6078	4948	1769	1568	4464	1368	10708	3551	14893	12569	23605	14829	21459	13129
"PTGS2"	4502	8616	0	965	0	0	530	435	0	319	0	13	0	5489	0	3117	7	713
"PTH"	816	3967	0	0	0	0	0	0	0	0	0	0	0	0	0	0	0	0
"PTH1R"	2270	21618	0	0	0	0	0	0	119	61	0	0	0	0	0	0	0	0
"PTH2"	461	1029	0	0	0	0	0	0	0	0	0	0	1	0	0	0	0	0
"PTH2R"	2825	134657	1	0	0	1	0	0	1	0	0	2	0	14	0	0	0	0
"PTHLH"	1876	9663	0	0	0	0	0	0	0	0	0	0	0	0	0	0	0	0
"PTHR2"	886	351083	0	0	0	0	0	0	0	0	0	0	0	0	0	0	0	0
"PTK2"	4524	342832	436	94	253	183	53	41	764	155	16	76	358	318	844	782	695	631
"PTK2B"	4751	147906	4735	8965	2698	2037	4821	4144	2017	4422	498	2632	1053	1493	1212	1760	1584	1065
"PTK6"	2515	8931	113	0	65	48	0	0	161	100	0	0	107	128	62	32	387	136
"PTK7"	4269	85430	2	0	0	2	0	0	175	30	0	0	2	0	0	0	0	0
"PTMA"	1501	3759	746	376	414	332	195	181	217	246	635	451	12206	12026	20877	13003	18253	19733
"PTMS"	1153	4577	329	0	180	149	0	0	111	19	110	75	2359	1919	1760	1419	2815	1792
"PTN"	1650	116456	0	0	0	0	0	0	0	0	0	0	0	0	0	0	0	0
"PTOP"	2650	2831	7	0	0	7	0	0	44	63	0	124	149	272	285	207	373	131
"PTOV1"	1896	9585	933	1643	843	90	706	937	591	621	252	542	638	84	1581	1491	1926	1448
"PTP4A1"	5087	11570	297	1007	184	113	547	460	165	461	0	205	2747	4208	3497	3840	3166	2551
"PTP4A2"	2164	30197	2520	4717	1445	1075	2574	2143	1054	1872	634	3985	4062	1883	2690	2604	2966	2397
"PTP4A3"	1337	9615	0	358	0	0	143	215	52	659	0	1159	20	149	0	350	24	140
"PTPDC1"	4525	79062	247	29	150	97	10	19	295	8	22	66	189	329	129	189	205	137
"PTPLA"	1436	14470	18	0	3	15	0	0	33	0	0	0	94	82	114	105	115	94
"PTPLAD1"	3217	47866	67	0	24	43	0	0	119	0	17	0	1350	1273	1279	1014	1432	1075
"PTPLAD2"	4163	28012	134	0	78	56	0	0	485	39	0	0	723	133	449	347	795	431
"PTPLB"	1194	90563	6354	1026	3607	2747	600	426	2619	277	1920	692	4810	5671	2202	295	3132	223
"PTPMT1"	2742	8032	425	123	243	182	72	51	215	49	200	69	976	929	0	1035	1582	0
"PTPN1"	3324	74195	10181	60209	5718	4463	33763	26446	2625	43062	1942	45139	2525	5887	3150	8431	3469	3657
"PTPN11"	6298	91182	827	581	523	304	368	213	532	739	0	1091	2311	2779	3255	2883	3395	2259
"PTPN12"	3243	102617	21197	53761	11963	9234	29187	24574	5747	24230	8771	56534	4199	8804	3679	6195	4114	3928
"PTPN13"	8623	220860	0	0	0	0	0	0	0	0	0	0	23	46	98	95	80	56
"PTPN14"	5251	23025	1	0	1	0	0	0	0	0	0	0	264	298	0	0	0	0
"PTPN18"	3683	19403	3682	1487	2144	1538	885	602	1792	859	3427	1967	4694	4212	4832	3626	6120	3479
"PTPN2"	2480	91088	13561	11372	7511	6050	6364	5008	5585	5671	6173	10606	2497	4111	2468	2085	3637	2298
"PTPN20A"	2975	69937	0	0	0	0	0	0	0	0	0	0	0	0	0	0	0	0
"PTPN20B"	2487	90882	0	0	0	0	0	0	0	0	0	0	0	0	0	0	0	0
"PTPN21"	6233	89002	0	0	0	0	0	0	9	0	0	0	6	0	0	0	0	0
"PTPN22"	3662	57937	114	14	83	31	14	0	100	0	0	18	321	438	435	388	372	327
"PTPN23"	5288	32442	1278	334	695	583	182	152	830	275	801	415	1484	1094	2073	1530	2623	1523
"PTPN3"	8786	75692	0	0	0	0	0	0	26	0	0	0	0	0	0	0	0	0
"PTPN4"	4228	95366	596	35	391	205	26	9	803	69	14	20	274	379	235	211	300	162
"PTPN5"	3147	63913	0	0	0	0	0	0	47	13	0	0	0	0	0	0	0	0
"PTPN6"	2512	10047	3097	1420	1690	1407	734	686	1140	838	2751	2225	9067	6937	9993	6185	11229	5519
"PTPN7"	3272	12978	1928	608	1087	841	310	298	800	255	1821	470	3207	2380	2384	3214	2742	3664
"PTPN9"	3950	112164	4696	414	2705	1991	212	202	1723	337	2649	498	1194	1213	1732	1226	1922	1255
"PTPRA"	4542	165174	7921	3659	4557	3364	2039	1620	3877	2211	2937	4380	2018	2022	3154	2538	4118	2662
"PTPRB"	11361	120587	0	0	0	0	0	0	0	0	0	0	0	0	0	0	0	0
"PTPRC"	5363	118410	36403	44858	20176	16227	24294	20564	15661	18492	12457	28583	18773	28129	18026	17804	18960	12821
"PTPRCAP"	909	2174	145	47	86	59	24	23	89	64	125	42	973	92	136	83	222	114
"PTPRD"	10118	2298260	13	0	13	0	0	0	10	0	0	0	0	0	0	0	0	0
"PTPRE"	5567	178839	70896	41113	39221	31675	21886	19227	27403	16659	56895	44516	32170	38246	35092	28658	40696	26788
"PTPRF"	7766	92797	1	0	0	1	0	0	512	190	0	0	4	0	0	0	0	0
"PTPRG"	6677	733331	0	0	0	0	0	0	32	7	0	0	560	600	965	954	1326	1079
"PTPRH"	3947	28260	2	0	0	2	0	0	11	7	0	0	3	0	0	0	0	0
"PTPRJ"	7873	190285	95245	180421	53122	42123	97026	83395	31216	101203	57052	199256	9577	10373	11642	8785	13801	8305
"PTPRK"	6236	551947	0	0	0	0	0	0	11	0	0	0	0	0	0	0	0	0
"PTPRM"	5632	839546	16	16	3	13	10	6	9	41	0	0	11	16	93	88	66	44
"PTPRN"	3653	19798	0	0	0	0	0	0	34	27	0	0	0	0	0	0	0	0
"PTPRN2"	4967	1002719	286	0	134	152	0	0	3699	1025	296	18	653	374	3267	2549	639	728
"PTPRO"	5180	274850	12022	1288	6679	5343	729	559	5676	272	4939	492	5851	4781	6618	3747	8724	4338
"PTPRQ"	7592	235844	0	0	0	0	0	0	0	0	0	0	0	0	0	0	0	0
"PTPRR"	3504	282724	0	0	0	0	0	0	0	0	0	0	0	0	0	0	0	0
"PTPRS"	7384	135296	72	11	28	44	0	11	607	311	0	0	0	0	0	0	0	0
"PTPRT"	12725	1117166	0	0	0	0	0	0	69	10	0	0	0	0	0	0	0	0
"PTPRU"	5624	90270	0	0	0	0	0	0	363	261	0	0	0	0	0	3	0	3
"PTPRV"	4117	21400	0	0	0	0	0	0	87	57	0	0	0	1	0	0	0	0
"PTPRZ1"	8187	188931	0	0	0	0	0	0	0	0	0	0	0	0	0	0	0	0
"PTRF"	3571	20808	0	0	0	0	0	0	17	0	0	0	196	160	240	180	148	154
"PTRH1"	2259	10926	0	0	0	0	0	0	57	110	0	0	60	63	82	103	109	67
"PTRH2"	799	10190	1593	651	732	861	377	274	534	400	277	542	75	666	25	28	72	335
"PTS"	1015	43591	473	329	331	142	196	133	261	249	88	382	150	326	105	158	116	113
"PTTG1"	776	6532	0	0	0	0	0	0	0	0	0	0	0	0	31	55	34	36
"PTTG1IP"	2742	24230	6171	6120	3496	2675	3273	2847	3504	2408	8463	7922	7025	8009	2825	4886	2931	10173
"PTTG2"	576	576	117	0	72	45	0	0	146	16	0	0	0	0	0	0	0	0
"PTTG3"	608	608	184	22	66	118	22	0	87	0	0	0	0	0	0	0	0	0
"PTX3"	1940	6838	97	1229	75	22	679	550	0	686	0	361	59	5106	86	5239	65	1376
"PUBC1"	1372	27118	138	59	98	40	36	23	85	54	9	18	514	474	434	374	498	293
"PUF60"	2076	6374	504	266	277	227	120	146	245	391	151	603	1536	2555	1987	2082	2545	1882
"PUM1"	5533	134412	9958	6853	5625	4333	3732	3121	4669	4088	4784	7657	2069	1900	2661	1832	2899	1777
"PUM2"	6233	102012	13347	8000	7418	5929	4358	3642	6520	3712	6511	4801	2210	4723	5550	3524	6613	3518
"PUNC"	1083	1326	0	0	0	0	0	0	23	20	0	0	0	0	0	0	0	0
"PURA"	2614	2614	326	39	197	129	39	0	384	14	74	17	963	787	898	251	1155	327
"PURB"	9068	9068	905	881	503	402	474	407	423	302	335	471	2954	4624	3545	4222	3433	2478
"PURG"	2692	37912	0	0	0	0	0	0	0	0	0	0	0	0	0	0	0	0
"PUS1"	2040	14615	382	102	208	174	76	26	198	204	108	217	423	441	465	444	550	410
"PUS10"	3826	77817	1811	80060	1152	659	43203	36857	254	4806	181	13431	71	27291	413	509	134	140
"PUS3"	1848	9738	89	0	56	33	0	0	31	36	0	8	414	353	268	260	528	276
"PUS7"	3496	65725	511	163	280	231	105	58	241	105	168	66	440	462	327	269	296	191
"PUS7L"	4369	30149	71	0	70	1	0	0	119	0	0	0	267	124	273	159	234	88
"PUSL1"	1936	2592	0	0	0	0	0	0	75	19	0	48	107	32	398	307	589	340
"PVALB"	576	18773	1	0	0	1	0	0	87	12	0	0	4	3	0	5	0	0
"PVR"	5909	22330	751	301	395	356	157	144	300	427	129	557	1013	1749	600	967	884	848
"PVRIG"	1597	2870	252	11	119	133	0	11	115	24	36	48	38	34	214	223	187	105
"PVRL1"	5479	67727	91	118	85	6	47	71	899	891	46	398	605	581	724	622	1202	828
"PVRL2"	2865	43094	3480	10015	1897	1583	5383	4632	825	6377	314	11018	1764	4635	2102	3696	2364	2613
"PVRL3"	1872	121360	0	0	0	0	0	0	0	0	0	0	3	0	0	0	0	0
"PVRL4"	3511	18606	0	0	0	0	0	0	95	38	2	0	0	0	8	4	0	0
"PWCR1"	1236	1236	10	0	0	10	0	0	0	0	0	0	0	0	0	0	0	0
"PWP1"	1868	26669	178	0	84	94	0	0	201	10	3	0	695	718	838	742	831	662
"PWP2"	3280	23856	256	30	112	144	9	21	405	134	109	80	511	425	727	544	934	585
"PWRN1"	1445	29622	0	0	0	0	0	0	0	0	0	0	0	0	0	0	0	0
"PWRN2"	5129	5129	0	0	0	0	0	0	0	0	0	0	0	0	0	0	0	0
"PWWP2A"	4012	43560	1560	1093	1003	557	598	495	831	727	372	1584	578	544	544	474	700	462
"PWWP2B"	2608	20651	1116	0	676	440	0	0	620	69	518	51	473	171	707	201	1257	308
"PX19"	1218	1218	0	0	0	0	0	0	0	0	0	0	232	251	0	0	0	0
"PXDN"	6843	112633	0	0	0	0	0	0	355	152	0	0	0	0	0	0	0	0
"PXDNL"	4823	489863	269	46	146	123	33	13	166	18	0	23	65	36	0	0	0	0
"PXK"	2150	92263	12519	2223	6996	5523	1171	1052	5617	786	6285	1351	6834	5886	4161	2385	4816	2390
"PXMP2"	1698	33282	277	604	135	142	383	221	231	293	48	560	743	561	526	329	630	362
"PXMP3"	4381	20030	398	0	241	157	0	0	412	0	52	0	868	927	809	773	986	642
"PXMP4"	5747	17587	41	0	13	28	0	0	94	29	0	0	273	118	129	52	161	69
"PXN"	5517	55315	6869	2334	3546	3323	1194	1140	2672	1109	7188	3661	6415	5651	5334	1760	7767	4521
"PXT1"	1456	10034	0	0	0	0	0	0	0	0	0	0	0	0	0	0	0	0
"PYCARD"	928	1444	77	14	42	35	0	14	33	18	0	0	1212	204	2215	1313	3241	1335
"PYCR1"	2066	4701	1	0	0	1	0	0	36	27	0	0	46	45	15	0	56	37
"PYCR2"	1699	4386	186	17	97	89	4	13	142	48	77	0	1304	909	1038	586	1884	458
"PYCRL"	2664	5683	13	0	5	8	0	0	56	69	0	0	107	63	115	77	126	89
"PYDC1"	529	1113	0	0	0	0	0	0	0	0	0	0	0	1	0	0	0	0
"PYDC2"	293	293	0	0	0	0	0	0	0	0	0	0	0	0	0	0	0	0
"PYGB"	4150	49943	5201	1014	2776	2425	540	474	2202	573	2414	583	3690	3147	3469	2442	4916	3196
"PYGL"	2869	39314	567	80	337	230	34	46	583	69	169	14	2246	1927	2933	2161	2479	1877
"PYGM"	3635	14327	9	0	9	0	0	0	69	71	0	0	1	1	0	12	4	4
"PYGO1"	1319	41918	0	0	0	0	0	0	0	0	0	0	0	0	0	0	0	0
"PYGO2"	3182	4757	171	21	88	83	0	21	109	0	0	58	877	420	1031	300	1374	442
"PYHIN1"	2089	45501	246	181	141	105	130	51	24	49	0	95	20	47	27	50	30	19
"PYM"	924	14088	670	94	367	303	70	24	313	135	417	210	20	50	51	69	69	41
"PYPAF6"	3789	51360	0	0	0	0	0	0	0	0	0	0	0	0	0	0	0	0
"PYROXD1"	4134	33644	946	295	545	401	169	126	462	132	10	81	1719	1642	1243	1024	1332	593
"PYROXD2"	2080	31657	520	20	57	463	20	0	230	275	72	0	143	97	144	98	253	109
"PYY"	1057	51730	0	0	0	0	0	0	35	13	0	0	0	0	0	0	0	0
"PYY2"	1070	1496	0	0	0	0	0	0	0	0	0	0	0	0	0	0	0	0
"PZP"	4645	59531	1372	755	758	614	405	350	353	341	2	713	6	18	19	10	6	129
"PZR"	4800	69970	521	0	263	258	0	0	512	16	0	0	1113	1091	971	757	1326	868
"Pax9"	1994	11813	0	0	0	0	0	0	0	0	0	0	0	0	0	0	0	0
"Per4"	1549	1549	0	0	0	0	0	0	0	0	0	0	0	0	0	0	0	0
"Pex14"	1136	103483	908	212	460	448	117	95	1147	341	113	329	88	79	128	103	110	71
"PleA 1"	12627	121351	10280	5133	5844	4436	2796	2337	4068	1902	2402	4400	2036	2383	1570	1428	2065	1262
"Pol mu"	2600	10282	781	193	417	364	110	83	177	2018	604	80	4575	132	317	142	332	159
"ProSAPiP1"	5250	5936	0	0	0	0	0	0	19	20	0	0	0	3	0	0	0	0
"QARS"	2453	8807	580	134	341	239	62	72	274	190	327	154	5008	4737	4245	3446	5979	3715
"QBRICK"	6202	173842	0	0	0	0	0	0	0	0	0	0	0	0	0	0	0	0
"QDPR"	1656	25839	105	0	67	38	0	0	43	0	0	0	176	174	444	394	395	300
"QKI"	7909	155496	46128	77288	25379	20749	41774	35514	20770	37591	16284	44485	9933	11932	11132	10035	10665	6696
"QM"	745	4361	523	803	18	505	429	374	386	608	535	766	968	5156	16967	17336	23013	16888
"QPCT"	1709	28713	741	1114	488	253	670	444	280	773	0	2209	3392	5609	3691	4258	4774	3379
"QPCTL"	2310	11501	35	27	19	16	16	11	104	42	26	0	167	112	186	149	224	126
"QPP"	698	1357	89	28	39	50	9	19	30	22	109	0	156	460	709	728	768	726
"QPRT"	1553	18870	5461	792	2824	2637	370	422	2154	289	7183	765	11283	9897	4961	3624	9408	4931
"QRFP"	411	411	0	0	0	0	0	0	0	12	0	0	0	0	0	0	0	0
"QRFPR"	2353	52386	0	0	0	0	0	0	0	0	0	0	0	16	0	0	0	0
"QRICH1"	3379	63760	1710	969	943	767	485	484	975	669	483	1790	2330	1404	2491	1837	3269	1359
"QRICH2"	5378	33633	4	10	4	0	3	7	242	63	0	22	8	0	5	0	8	0
"QRSL1"	4127	38851	242	0	150	92	0	0	297	37	0	34	483	451	526	301	519	399
"QSER1"	9280	87022	7829	2628	4399	3430	1504	1124	3584	1332	3409	2366	1889	2120	2058	1361	2442	1263
"QSK"	4228	26849	790	287	403	387	191	96	474	379	82	144	752	710	924	697	1189	661
"QSOX1"	3326	43201	22543	8265	12427	10116	4437	3828	7038	3033	15660	8442	22119	21453	27682	22672	33602	23765
"QSOX2"	4539	39507	65	9	32	33	4	5	436	222	51	14	251	268	296	246	400	195
"QTRT1"	1343	11932	58	17	35	23	9	8	87	7	24	1	232	239	291	283	353	206
"QTRTD1"	4003	31657	1363	1372	741	622	708	664	569	1056	268	1030	1183	1811	866	736	982	684
"R3HCC1"	1589	8181	46	7	17	29	4	3	89	16	0	14	383	294	302	221	430	295
"R3HDM1"	4707	138916	2142	215	1198	944	120	95	1662	234	135	309	773	1114	1007	968	1041	870
"R3HDM2"	4396	177242	11527	6429	6720	4807	3605	2824	4697	2935	6641	7391	1460	1574	1499	1168	1579	1057
"R3HDML"	1382	14251	0	0	0	0	0	0	34	0	0	0	0	0	0	0	0	0
"RAB10"	3790	103595	15842	18297	8776	7066	9835	8462	5933	9528	8733	19828	6514	8207	7246	6741	7601	5650
"RAB11A"	2397	19997	174	103	103	71	55	48	220	202	0	132	1786	2356	2351	2170	2825	2081
"RAB11B"	1631	14112	289	75	140	149	52	23	311	195	121	216	1183	1196	1188	1089	1675	1256
"RAB11FIP1"	7845	40535	5301	16026	2883	2418	8553	7473	1375	5720	1574	7058	3846	2045	2441	1921	4635	2176
"RAB11FIP2"	6125	41687	1757	413	1016	741	180	233	1092	230	61	121	827	755	1003	624	330	508
"RAB11FIP3"	4265	96814	1407	308	713	694	157	151	1133	535	762	628	548	542	714	581	833	487
"RAB11FIP4"	8640	146592	3079	133	1693	1386	90	43	1598	202	1533	84	1903	1302	2505	1243	2671	1509
"RAB11FIP5"	4346	39637	0	0	0	0	0	0	94	12	0	0	0	5	0	0	6	0
"RAB12"	5069	5069	6229	14491	3445	2784	7802	6689	1957	7638	2688	10381	1572	6050	1104	4332	1207	1645
"RAB13"	2210	4678	0	0	0	0	0	0	42	0	0	0	408	518	379	584	608	698
"RAB14"	4370	23951	3529	1506	2126	1403	806	700	1489	809	795	1486	5062	4700	4170	3108	4921	2958
"RAB15"	3644	26082	1220	107	770	450	47	60	547	79	576	73	146	106	800	494	287	936
"RAB17"	1972	16773	0	0	0	0	0	0	104	39	0	0	0	2	0	0	0	0
"RAB18"	2883	35850	1868	1006	1064	804	584	422	900	627	74	363	1969	2293	2250	1936	2380	1685
"RAB19"	956	22209	0	0	0	0	0	0	0	0	0	0	0	0	0	0	0	0
"RAB1A"	2648	43448	5703	6005	3422	2281	3341	2664	2595	2718	3214	6845	3885	4510	5661	5858	1792	4540
"RAB1B"	1959	8907	714	312	388	326	184	128	335	286	181	442	3139	2778	4283	4071	5762	4078
"RAB20"	1510	38659	169	2443	114	55	1306	1137	327	2146	43	3029	396	425	1018	53	679	856
"RAB21"	2633	32493	1956	7500	1048	908	4240	3260	925	3715	60	4714	1996	5008	1248	2579	1479	1887
"RAB22A"	8655	57791	2847	3399	1610	1237	1774	1625	1217	2100	613	3294	1591	1944	1571	1360	1830	1170
"RAB23"	3009	33489	0	0	0	0	0	0	0	0	0	0	69	21	22	10	48	9
"RAB24"	1679	2513	233	279	145	88	148	131	46	201	86	207	623	429	731	759	1188	1499
"RAB25"	1088	9329	0	0	0	0	0	0	23	12	0	0	0	0	0	0	0	0
"RAB26"	1672	5997	3	0	2	1	0	0	30	107	0	0	0	0	0	0	1	0
"RAB27A"	2820	66785	778	680	462	316	422	258	396	609	45	660	64	175	335	301	413	287
"RAB27B"	1337	61369	0	0	0	0	0	0	0	0	0	0	2	2	0	0	0	4
"RAB28"	1819	116644	1004	202	566	438	112	90	1052	196	52	52	278	374	255	226	356	241
"RAB2A"	1156	104072	7721	3858	4311	3410	2193	1665	3765	2278	1666	3715	1572	1662	1793	1652	1914	508
"RAB2B"	2935	17954	343	205	190	153	98	107	116	85	18	124	626	867	404	392	433	340
"RAB30"	1746	53129	12202	14072	6945	5257	7647	6425	4118	7787	3924	15876	2703	3775	1696	588	155	566
"RAB31"	4001	154327	44159	20395	24594	19565	10970	9425	17125	7673	27476	14980	21892	24864	17366	14600	21847	14767
"RAB32"	1206	11260	7	0	7	0	0	0	155	26	0	20	1421	855	315	1032	1364	935
"RAB33A"	2161	13072	520	0	300	220	0	0	201	38	0	88	864	672	1047	672	1455	656
"RAB33B"	3864	22104	0	0	0	0	0	0	59	0	0	0	226	194	225	73	234	71
"RAB34"	1779	3611	34	20	14	20	13	7	90	72	0	50	1233	1216	877	916	1053	931
"RAB35"	3015	21697	2908	1421	1592	1316	774	647	1132	765	2059	1910	3380	2901	1363	847	1496	3393
"RAB36"	3833	19020	0	0	0	0	0	0	98	72	0	0	0	0	0	0	0	0
"RAB37"	3273	76219	0	0	0	0	0	0	326	73	0	12	117	120	467	537	232	245
"RAB38"	1411	62170	387	223	215	172	135	88	511	175	0	26	43	255	211	172	71	179
"RAB39"	1782	34931	1499	858	825	674	439	419	556	468	275	1183	1172	1398	494	343	388	223
"RAB39B"	3484	6327	0	0	0	0	0	0	0	0	0	0	0	0	0	0	0	0
"RAB3A"	1506	7265	0	0	0	0	0	0	29	10	0	0	42	0	30	0	67	14
"RAB3B"	1552	71513	0	0	0	0	0	0	29	11	0	0	1	0	0	0	0	0
"RAB3C"	1013	268468	0	0	0	0	0	0	0	0	0	0	0	0	0	0	0	0
"RAB3D"	1883	15229	48	0	34	14	0	0	144	13	66	0	45	406	142	175	111	147
"RAB3GAP1"	4210	117693	8904	8586	5072	3832	4616	3970	4011	3687	2621	5672	2807	3527	2647	2340	3042	1894
"RAB3GAP2"	7384	124235	3410	1453	1889	1521	818	635	1724	1182	367	1268	4348	4886	3989	3378	5077	3543
"RAB3IL1"	2293	20225	3	0	3	0	0	0	158	24	0	0	5	3	51	26	69	42
"RAB3IP"	9645	83804	43	1214	17	26	682	532	33	447	0	551	90	227	51	51	60	65
"RAB40A"	1348	19737	0	0	0	0	0	0	0	0	0	0	0	0	0	0	0	0
"RAB40AL"	1029	1029	0	0	0	0	0	0	10	0	0	0	0	0	0	0	0	0
"RAB40B"	1764	41656	35	0	20	15	0	0	241	18	29	0	104	123	153	85	66	138
"RAB40C"	2614	39094	1001	139	532	469	47	92	1031	323	727	144	391	191	430	216	617	302
"RAB41"	1034	2784	0	0	0	0	0	0	0	0	0	0	0	0	0	1	1	0
"RAB42"	1113	2061	2	0	2	0	0	0	0	0	0	0	201	107	436	206	260	63
"RAB43"	4450	34203	2952	910	1677	1275	548	362	1639	616	2066	1402	520	352	3103	2138	4598	2773
"RAB4A"	1852	33640	725	77	425	300	37	40	573	142	0	126	800	647	786	582	879	608
"RAB4B"	1993	17897	1130	211	687	443	126	85	546	340	593	569	1380	1609	688	1322	1787	1217
"RAB5A"	2532	38088	5719	24519	3223	2496	13176	11343	1226	8112	695	14778	2194	7530	1876	3265	2341	2577
"RAB5B"	3290	20618	1512	1327	863	649	731	596	525	775	407	1513	4350	5101	3487	3191	5035	3178
"RAB5C"	1877	30026	1928	2904	1075	853	1514	1390	991	1855	934	5104	4073	2275	4584	6875	6017	4245
"RAB6A"	3596	69509	4038	600	2233	1805	382	218	1997	562	727	851	3408	3950	3926	3335	4824	3368
"RAB6B"	5566	71611	0	0	0	0	0	0	84	45	0	0	3	12	0	0	34	17
"RAB6C"	3078	3078	448	92	233	215	53	39	330	232	137	360	308	388	528	485	667	374
"RAB7A"	2238	88664	53257	30991	30619	22638	16608	14383	21087	11396	43606	22764	30440	32672	26876	21893	40025	25731
"RAB7L1"	3425	7497	150	50	61	89	34	16	152	8	0	122	841	994	938	632	774	672
"RAB8A"	2183	21955	2646	3947	1451	1195	2112	1835	943	2629	1135	4239	5487	7310	5221	5206	7065	5181
"RAB8B"	4881	78245	5245	13653	3082	2163	7401	6252	2255	6281	1377	8433	2287	3130	3133	2718	2912	1884
"RAB9-like"	997	55656	0	0	0	0	0	0	0	0	0	0	0	0	0	0	0	0
"RAB9A"	1082	20423	845	1687	485	360	943	744	258	513	0	722	587	1117	739	604	835	582
"RAB9B"	1052	7209	0	0	0	0	0	0	0	0	0	0	0	0	0	0	0	0
"RAB9P1"	625	625	0	0	0	0	0	0	0	0	0	0	0	0	0	0	0	0
"RABAC1"	811	2696	7	6	7	0	0	6	57	39	0	0	159	344	407	368	479	353
"RABEP1"	5419	103575	10411	5890	5889	4522	3301	2589	4818	2377	8474	6825	1612	4135	3627	3852	4591	3382
"RABEP2"	2292	20791	1487	582	833	654	335	247	469	333	1389	953	1243	990	908	728	1373	785
"RABEPK"	2463	21850	379	19	241	138	0	19	283	109	304	144	266	246	652	583	520	646
"RABGAP1"	5024	163860	17221	12033	9822	7399	6563	5470	8340	5522	5369	10497	2579	3249	2890	2304	3649	2213
"RABGAP1L"	2948	798694	16581	16098	9643	6938	9177	6921	10124	9894	2268	10334	954	901	740	647	840	557
"RABGEF1"	4670	71465	14725	11327	8178	6547	6178	5149	6980	5491	10036	10300	3701	2903	2991	1985	3761	1610
"RABGGTA"	2217	5999	276	49	149	127	23	26	185	86	67	10	557	776	869	852	1082	889
"RABGGTB"	1702	8880	2569	2257	1426	1143	1172	1085	985	1251	1103	1224	1491	1747	1971	1387	2017	1169
"RABIF"	2429	10177	58	0	12	46	0	0	184	54	0	45	15	11	529	297	717	339
"RABL2A"	2178	16159	132	8	105	27	8	0	247	0	56	42	218	158	436	232	713	334
"RABL2B"	2448	16169	85	0	37	48	0	0	101	16	0	0	299	298	432	342	714	362
"RABL3"	3889	55856	232	222	166	66	154	68	174	142	0	95	86	767	783	634	645	426
"RABL4"	6428	17861	430	22	253	177	22	0	415	35	119	116	385	255	530	255	594	191
"RABL5"	2463	8446	0	0	0	0	0	0	10	12	0	0	34	15	20	14	55	40
"RAC1"	2404	29473	4558	4916	2578	1980	2673	2243	1931	2393	2018	4872	6417	7033	7467	7169	10097	6844
"RAC2"	1473	18995	2309	582	1310	999	315	267	954	446	2234	1535	8574	6925	9506	7248	10327	6662
"RAC3"	1065	2549	0	0	0	0	0	0	28	20	0	0	0	0	10	6	11	6
"RACGAP1"	3345	36364	69	0	27	42	0	0	101	10	18	0	212	192	354	155	518	287
"RAD1"	4772	13018	460	416	204	256	226	190	250	219	0	211	665	986	504	522	1030	563
"RAD17"	3179	44096	19	0	0	19	0	0	9	0	0	0	322	340	600	498	779	500
"RAD18"	3058	83587	447	1448	245	202	795	653	324	1377	0	373	145	1198	265	129	149	199
"RAD21"	3763	28933	1180	1033	665	515	539	494	651	628	0	779	3986	4496	4236	3419	4872	3101
"RAD21L1"	1822	28383	0	0	0	0	0	0	0	0	0	0	0	0	0	0	0	0
"RAD23A"	1802	7803	590	241	302	288	136	105	293	261	411	324	2564	2814	2168	2083	2632	1881
"RAD23B"	4139	48927	5327	5175	2902	2425	2802	2373	2217	2347	1014	5150	4039	4679	5515	5228	5773	4315
"RAD26L"	4465	93223	1509	486	840	669	273	213	968	356	190	256	301	450	395	419	432	231
"RAD50"	5888	86965	1392	72	804	588	22	50	700	45	203	35	1711	1566	1638	1135	1844	1046
"RAD51"	2310	37029	0	0	0	0	0	0	8	0	0	0	0	0	6	0	12	4
"RAD51AP1"	2380	21264	0	0	0	0	0	0	0	9	0	0	0	0	56	16	16	47
"RAD51AP2"	3954	19697	0	0	0	0	0	0	0	0	0	0	0	0	0	58	97	0
"RAD51C"	2083	41729	0	0	0	0	0	0	10	0	0	0	115	137	130	122	249	169
"RAD51L1"	2524	776107	5266	3154	3223	2043	1761	1393	7406	5376	780	3253	55	90	43	61	52	29
"RAD51L3"	3911	112412	7180	12664	4100	3080	6955	5709	3223	5212	2282	13346	2110	2667	1241	1272	1599	1373
"RAD52"	2969	37610	1838	364	1053	785	221	143	1151	350	516	464	2551	55	168	101	298	96
"RAD54B"	3055	103123	0	0	0	0	0	0	0	0	0	0	4	0	6	22	11	9
"RAD54L"	3164	30780	52	8	29	23	0	8	189	83	0	78	0	759	0	0	0	2
"RAD54L2"	5196	33324	2117	461	1237	880	252	209	1206	299	759	569	485	505	604	600	716	500
"RAD9A"	2132	6461	283	8	197	86	5	3	168	89	61	19	108	2622	1668	1353	2207	1418
"RAD9B"	2893	29795	171	15	141	30	15	0	37	18	0	0	136	3109	128	13	182	17
"RADIL"	5738	86650	6	0	1	5	0	0	221	93	0	0	216	262	0	0	3	0
"RAE1"	1923	24265	535	286	292	243	163	123	409	398	165	184	637	569	742	660	774	520
"RAET1E"	2103	12685	0	0	0	0	0	0	0	0	0	0	0	0	0	0	0	0
"RAET1G"	1112	6202	0	0	0	0	0	0	15	8	0	0	0	0	0	0	0	0
"RAET1K"	1885	7125	0	0	0	0	0	0	76	53	0	0	0	0	0	0	0	0
"RAET1L"	805	5403	0	0	0	0	0	0	52	22	0	0	0	0	0	0	0	0
"RAF1"	3290	80600	5323	5200	2898	2425	2895	2305	1834	3386	2213	7997	3195	3904	3360	3456	4090	2936
"RAG1"	6580	11747	0	6	0	0	1	5	0	0	0	0	0	0	0	0	0	0
"RAG1AP1"	1348	3047	5272	2662	2958	2314	1459	1203	3593	2185	2325	2877	9871	10212	14619	14347	17061	12266
"RAG2"	2414	6319	0	0	0	0	0	0	0	0	0	0	4	6	6	7	5	6
"RAGE"	2365	76354	166	96	37	129	52	44	79	167	137	127	87	167	104	137	314	120
"RAI1"	7664	129978	10482	1899	5493	4989	1229	670	4962	2907	6624	4142	2614	801	2544	1836	3270	2177
"RAI14"	5357	148106	0	0	0	0	0	0	0	0	0	0	0	0	0	0	3	0
"RAI2"	2534	60812	0	0	0	0	0	0	33	9	0	0	0	0	0	0	0	0
"RALA"	2797	84555	2587	2157	1348	1239	1251	906	1510	1384	303	1659	892	1113	773	846	994	885
"RALB"	2327	41871	2134	222	1219	915	138	84	1344	371	602	523	2438	2368	2558	1900	2721	1895
"RALBP1"	4371	63100	191	0	98	93	0	0	310	24	10	34	1862	1452	2387	1963	2735	1785
"RALGAPA1"	7944	270875	1182	564	705	477	342	222	1010	654	64	514	360	610	913	857	914	634
"RALGAPA2"	6326	319856	913	1122	509	404	650	472	1010	762	124	515	377	950	394	394	471	247
"RALGAPB"	8664	106018	4339	2315	2432	1907	1330	985	2517	1684	1429	2243	2355	2642	2799	1915	3158	1734
"RALGDS"	4128	66195	6451	4518	3262	3189	2435	2083	3085	4255	6659	11470	2597	4633	5551	12528	5833	8206
"RALGPS1"	6355	308392	243	117	158	85	72	45	836	492	62	204	157	160	24	29	206	74
"RALGPS2"	5851	194937	87	144	60	27	61	83	207	89	0	142	611	839	248	284	240	97
"RALY"	1583	86335	13360	10835	7511	5849	5776	5059	5096	5303	6968	11759	2638	2743	2028	3535	3127	2289
"RALYL"	2907	738487	0	0	0	0	0	0	25	0	0	0	0	0	0	0	0	0
"RAMP1"	910	52568	10524	3561	5857	4667	1883	1678	6150	3019	8597	3927	1234	1146	6504	5892	7386	5159
"RAMP2"	802	1847	0	0	0	0	0	0	0	0	0	0	0	2	0	0	0	0
"RAMP3"	1347	26482	0	0	0	0	0	0	54	13	0	0	0	0	0	0	0	0
"RAN"	1366	4043	120	94	75	45	44	50	68	122	51	206	2855	3559	3839	4646	4717	4121
"RANBP1"	1344	8689	146	0	78	68	0	0	89	199	0	66	228	375	728	647	839	358
"RANBP10"	5774	83551	1310	227	790	520	130	97	861	506	254	420	548	534	227	473	833	510
"RANBP17"	4467	437998	0	0	0	0	0	0	19	8	4	0	5	11	0	0	0	0
"RANBP2"	11739	66331	3984	1984	2332	1652	1109	875	1797	956	862	943	6651	7002	8774	5591	8530	4802
"RANBP3"	3745	18321	5313	1526	2920	2393	812	714	3079	1505	4132	2796	1453	1130	1695	1141	2265	752
"RANBP3L"	2632	52908	0	45	0	0	14	31	0	29	0	0	0	95	0	12	0	0
"RANBP6"	4600	4600	214	36	118	96	25	11	135	31	0	0	1087	804	1152	492	1278	558
"RANBP9"	3126	90067	4357	443	2472	1885	223	220	2532	154	749	147	1689	1424	1632	1544	2146	1480
"RANGAP1"	4240	36904	851	1106	403	448	555	551	669	942	155	1896	737	2018	1212	1343	1645	1107
"RANGRF"	1143	1416	52	80	47	5	50	30	325	22	389	7	13	424	118	498	991	94
"RANK"	2180	60956	1653	0	953	700	0	0	1390	75	85	59	449	392	3609	2540	1519	1398
"RAP1A"	2118	49727	47926	37527	27066	20860	20537	16990	18432	15281	24418	29640	8983	10904	15271	13889	18533	12848
"RAP1B"	2109	49727	14870	26228	8190	6680	14259	11969	5375	11027	8392	21360	2089	3261	5453	6228	6690	5137
"RAP1GAP"	3521	73149	12921	2242	7054	5867	1264	978	3714	853	13289	2530	3033	3012	2157	1772	3256	2634
"RAP1GAP2"	6687	241304	4101	1039	2245	1856	618	421	3482	1915	2608	1438	726	888	1229	1184	1348	1038
"RAP1GDS1"	3774	182485	8169	1832	4573	3596	1048	784	4738	1085	1797	760	2165	2350	2164	1809	2702	1823
"RAP2A"	4359	33778	3900	227	2203	1697	142	85	2122	66	414	10	5266	5073	5178	3103	4787	2699
"RAP2B"	6234	6234	992	292	557	435	164	128	339	84	0	54	2842	1581	3485	1204	2977	1261
"RAP2C"	3977	16423	1217	6889	716	501	3764	3125	323	3010	174	4136	707	7678	2475	8765	1032	4555
"RAPGEF1"	6197	133073	129775	199410	71503	58272	106229	93181	34679	98666	85662	215476	16509	19582	10282	13656	9834	9455
"RAPGEF2"	6842	92303	12555	183321	7628	4927	99092	84229	3435	77480	1223	102901	2732	16627	4142	31962	4461	8333
"RAPGEF3"	6245	24436	13	12	8	5	0	12	467	290	0	0	94	63	115	171	204	109
"RAPGEF4"	4377	317095	0	0	0	0	0	0	20	0	0	0	0	0	0	0	0	0
"RAPGEF5"	6647	238626	0	0	0	0	0	0	9	0	0	0	0	0	0	0	0	0
"RAPGEF6"	6482	371154	17551	19314	9988	7563	10548	8766	8360	9030	3262	11109	2218	2195	2586	1892	2577	1503
"RAPGEFL1"	3742	17666	50	17	31	19	9	8	75	16	76	68	37	15	20	40	37	6
"RAPH1"	9611	101519	2069	1738	1172	897	999	739	1471	1029	397	1436	807	1014	1649	1485	1111	865
"RAPSN"	1672	11417	618	2	354	264	2	0	185	54	186	2	19	22	10	0	41	7
"RARA"	3413	15554	4398	250	2288	2110	164	86	1821	694	4588	1705	2239	1034	2281	806	3004	1457
"RARB"	3057	169588	309	12	125	184	12	0	286	63	0	0	0	0	0	0	0	0
"RARG"	2969	21684	63	126	32	31	62	64	184	236	0	197	332	948	229	786	373	749
"RARRES1"	1530	35378	662	1384	361	301	747	637	379	986	0	1840	1	321	30	2029	21	75
"RARRES2"	746	3357	0	0	0	0	0	0	12	14	0	0	0	0	0	0	0	0
"RARRES3"	768	9658	0	0	0	0	0	0	0	9	0	0	115	106	81	89	134	119
"RARS"	2151	32846	509	198	286	223	104	94	352	104	70	131	876	923	1203	780	1013	805
"RARS2"	2021	75589	1394	367	800	594	225	142	908	551	196	579	419	436	458	437	533	374
"RASA1"	4555	123583	43491	20132	24358	19133	10990	9142	23533	7461	23574	12317	5013	3533	5943	2735	5773	3055
"RASA2"	2629	125273	6801	2197	3928	2873	1148	1049	3187	1023	1553	1096	1249	1562	1088	874	1244	886
"RASA3"	4691	150902	4371	9612	2529	1842	5100	4512	2681	6662	2796	5762	912	892	931	501	1251	948
"RASA4"	6393	63146	361	127	265	96	56	71	540	278	619	351	412	388	4930	2728	7337	4579
"RASA4P"	2918	10091	70	3	23	47	2	1	48	34	0	33	13	54	623	424	580	468
"RASAL1"	3146	36705	7702	1929	4263	3439	972	957	1949	541	3415	964	1405	1348	697	551	1259	692
"RASAL2"	10895	385782	113451	87412	63159	50292	47510	39902	39930	24073	48093	37066	5751	5964	5857	4314	6845	3540
"RASAL3"	3308	12946	98	11	49	49	6	5	0	23	0	19	146	145	227	243	333	233
"RASD1"	1744	1954	0	0	0	0	0	0	20	0	0	0	0	0	0	0	0	0
"RASD2"	2973	12693	0	0	0	0	0	0	0	9	0	0	0	0	0	0	0	0
"RASEF"	2776	80728	0	0	0	0	0	0	0	0	0	0	0	0	0	0	0	0
"RASGEF1A"	3276	35205	0	0	0	0	0	0	438	169	4	0	19	3	3	11	58	11
"RASGEF1B"	6343	21015	3439	60806	1973	1466	32497	28309	112	24425	15	29990	180	8351	270	5460	191	6468
"RASGEF1C"	2416	37555	37	0	0	37	0	0	221	87	0	0	0	0	0	0	0	0
"RASGRF1"	6420	130926	0	0	0	0	0	0	382	91	0	0	4	10	13	35	23	19
"RASGRF2"	4137	265397	0	0	0	0	0	0	10	0	0	0	1	0	0	0	0	0
"RASGRP"	4282	31271	1964	1784	1044	920	889	895	735	1021	123	2456	218	865	191	442	274	279
"RASGRP1"	5041	76706	2241	4625	1191	1050	2533	2092	822	2373	123	6827	222	884	200	467	283	283
"RASGRP2"	2420	13973	48	12	21	27	5	7	183	80	20	42	75	97	111	109	235	139
"RASGRP3"	4798	88478	24774	10399	13863	10911	5769	4630	6976	2076	12639	7600	6120	6235	5039	3676	5308	3209
"RASGRP4"	3235	17249	380	15	229	151	3	12	284	159	169	85	963	880	698	482	646	610
"RASIP1"	3313	20129	0	0	0	0	0	0	40	21	0	0	0	1	0	0	0	0
"RASL10A"	1788	2827	20	0	20	0	0	0	10	17	0	0	30	33	47	59	60	46
"RASL10B"	3197	11862	0	0	0	0	0	0	25	13	0	0	0	0	0	0	0	0
"RASL11A"	1547	3365	0	0	0	0	0	0	0	0	0	0	40	269	149	495	65	202
"RASL11B"	1954	4502	0	0	0	0	0	0	15	0	0	0	0	0	0	0	0	0
"RASL12"	2583	14715	0	0	0	0	0	0	43	7	0	0	0	0	0	0	0	0
"RASSF1"	1967	11152	3616	966	2077	1539	470	496	1539	365	4833	1448	3458	1631	3873	1611	4696	1679
"RASSF10"	1850	1953	0	0	0	0	0	0	0	0	0	0	0	0	0	0	0	0
"RASSF2"	5483	43434	4844	5192	2298	2546	2713	2479	1458	3832	2527	10053	1597	1907	7431	7557	9713	6460
"RASSF3"	1340	84899	10389	3436	5854	4535	1937	1499	4661	2592	6854	4417	2305	2434	2153	2064	2067	1453
"RASSF4"	2504	34953	13018	12758	7110	5908	6769	5989	3916	9491	8373	19579	5863	8855	5750	10471	8944	8781
"RASSF5"	5639	81729	27453	159375	15316	12137	85090	74285	6250	86944	9307	168509	7410	26626	5775	27343	7499	15411
"RASSF6"	4334	47480	0	0	0	0	0	0	0	0	0	0	0	0	0	0	0	0
"RASSF7"	1780	3622	194	7	119	75	7	0	122	45	56	0	536	288	464	182	967	352
"RASSF8"	5637	20087	0	0	0	0	0	0	0	0	0	15	60	70	6	4	0	0
"RASSF9"	1798	31989	0	0	0	0	0	0	0	0	0	0	0	0	0	0	0	0
"RAVER1"	3603	17425	416	201	231	185	104	97	274	253	173	427	1409	986	1457	1048	1953	1120
"RAVER2"	4371	88136	63	1164	40	23	631	533	14	825	0	458	25	65	0	12	21	0
"RAX"	3198	6358	0	0	0	0	0	0	0	0	0	0	0	0	0	0	0	0
"RAX2"	2408	3125	3	0	3	0	0	0	15	2	0	0	0	0	0	0	0	0
"RB1"	4797	178143	11504	6960	6461	5043	3804	3156	5906	4148	1479	3759	6792	5914	5083	3215	6254	3061
"RB1CC1"	6690	92009	2545	351	1396	1149	183	168	1926	230	164	529	1683	2072	1750	1456	1627	1171
"RB3"	1258	19046	0	0	0	0	0	0	0	0	0	0	0	0	0	0	0	0
"RBAK"	6556	23568	2041	359	1123	918	200	159	1038	139	834	488	1298	686	1090	322	1170	390
"RBAP2"	5894	96598	38	10	28	10	10	0	421	152	51	0	92	63	197	178	216	185
"RBBP4"	7953	35063	2480	744	1314	1166	409	335	1229	472	1576	1254	3495	3350	4201	3203	4669	3162
"RBBP5"	3952	29439	433	722	233	200	396	326	337	500	131	701	356	526	755	683	962	568
"RBBP6"	6852	33275	2086	4554	1172	914	2518	2036	930	1986	454	2125	2165	4849	1980	3213	2216	2052
"RBBP7"	2029	25759	462	106	283	179	54	52	329	38	80	72	1279	1404	2058	1248	1927	1255
"RBBP8"	3286	93152	39	783	22	17	443	340	44	817	0	364	454	695	490	727	518	454
"RBBP9"	3860	10699	0	0	0	0	0	0	0	29	0	0	23	39	190	229	208	80
"RBCK1"	2772	22901	1243	365	688	555	228	137	544	397	927	546	1270	1381	1838	1444	2480	1446
"RBKS"	2324	108959	0	0	0	0	0	0	36	0	0	0	16	44	11	90	11	17
"RBL1"	4291	98233	102	0	50	52	0	0	120	6	0	10	364	183	365	269	363	170
"RBL2"	4907	57210	2085	401	1162	923	231	170	1125	137	457	73	3286	3974	3947	2984	4268	2581
"RBM10"	3409	41582	1303	876	705	598	482	394	679	912	543	1960	946	997	996	972	1307	988
"RBM11"	1980	12227	0	0	0	0	0	0	0	0	0	0	4	0	64	20	66	101
"RBM12"	6634	15962	3147	2102	1745	1402	1165	937	1193	1006	1266	1667	2278	3270	2449	3225	2628	2305
"RBM12B"	5102	9493	2745	749	1633	1112	455	294	1597	253	1320	472	1121	737	999	399	66	313
"RBM14"	5403	13339	5161	3863	2870	2291	2120	1743	1952	1946	5148	4190	1334	1158	1296	1309	1594	1372
"RBM14/RBM4 fusion"	1613	29889	10877	8269	6027	4850	4440	3829	4388	4116	9500	8443	2758	3124	2985	3400	3929	3170
"RBM15"	3434	7360	1939	730	1088	851	396	334	770	304	637	471	1049	1027	1026	795	1076	653
"RBM15B"	6605	6605	550	113	302	248	103	10	147	79	0	126	0	1	1	0	1	2050
"RBM16"	5022	100682	12222	8557	6972	5250	4629	3928	5318	3758	3797	7318	1639	1899	2153	1712	2224	1565
"RBM17"	3763	28113	1319	2006	762	557	1175	831	666	1247	46	1646	989	1566	1801	3076	1884	1466
"RBM18"	3200	25311	247	68	156	91	50	18	258	117	62	198	187	168	283	245	280	202
"RBM19"	4516	149635	1365	802	801	564	348	454	1557	1659	791	1152	788	738	1082	903	1180	872
"RBM20"	7247	195074	0	0	0	0	0	0	18	0	0	0	0	0	0	0	0	0
"RBM22"	2356	10318	384	319	196	188	143	176	166	253	38	425	1255	1627	588	1698	499	1213
"RBM23"	2617	18543	897	1707	502	395	934	773	319	669	322	1515	1943	863	840	628	694	469
"RBM24"	2512	12290	0	0	0	0	0	0	0	0	0	0	0	0	0	0	0	0
"RBM25"	4389	62855	5372	6245	2952	2420	3352	2893	2200	3303	1463	4508	3997	4623	5005	4046	5451	2623
"RBM26"	3722	85825	7246	1614	4053	3193	891	723	3625	579	1951	926	1033	1553	1375	1292	1475	1060
"RBM27"	6559	85621	1240	204	720	520	118	86	657	255	0	306	1209	912	1127	639	1313	649
"RBM28"	2828	33528	388	276	204	184	161	115	220	271	116	224	471	484	512	512	554	400
"RBM3"	1865	3970	739	1111	407	332	596	515	167	352	279	462	5391	6593	4000	4509	4534	3412
"RBM33"	10343	136978	12583	4402	6972	5611	2424	1978	6101	2719	4420	3972	2102	2030	2676	1514	3137	1638
"RBM34"	2064	30275	430	112	235	195	59	53	415	288	175	481	621	497	637	385	711	469
"RBM38"	2381	17923	2054	2926	1154	900	1568	1358	734	1720	892	6787	2140	3600	1786	4655	2601	4440
"RBM39"	4553	38628	11159	13914	6262	4897	7493	6421	4373	5280	6279	11804	5298	5636	7047	7005	6192	5810
"RBM4"	2326	7536	14516	9941	8046	6470	5330	4611	5705	4547	12619	10634	3237	3565	3248	3531	4224	3253
"RBM41"	2591	54386	1166	21	514	652	10	11	807	7	225	0	140	691	242	212	240	124
"RBM42"	1659	8608	127	0	74	53	0	0	139	106	62	142	663	799	496	479	626	440
"RBM43"	3917	13662	12	13	12	0	13	0	25	0	0	0	235	198	363	99	333	126
"RBM44"	4298	44064	13	0	2	11	0	0	18	2	0	0	18	23	19	5	0	0
"RBM45"	1792	17200	29	0	0	29	0	0	62	0	0	0	252	217	286	177	268	153
"RBM46"	3686	47539	0	0	0	0	0	0	0	0	0	0	0	0	0	0	0	0
"RBM47"	5386	206613	45592	57538	25551	20041	30998	26540	19191	29721	32455	53201	4841	5629	7216	7091	5968	4473
"RBM4B"	2340	12750	1447	703	839	608	348	355	713	315	345	392	584	451	727	568	948	487
"RBM5"	3122	30024	24766	18926	13975	10791	10302	8624	9915	8678	15362	19394	5806	7741	7778	6855	9501	5874
"RBM6"	3641	137091	17275	12220	9662	7613	6596	5624	6800	5443	10545	12306	2263	2999	3016	2751	3825	2584
"RBM7"	1922	8250	57	145	32	25	69	76	66	76	0	122	619	624	725	649	998	573
"RBM8A"	2793	3808	14	0	0	14	0	0	48	17	0	0	1095	1421	1862	1880	1824	1508
"RBM9"	6989	101848	0	0	0	0	0	0	33	9	0	0	166	162	0	0	0	0
"RBMS1"	4814	212495	10367	10343	5787	4580	5738	4605	5984	4903	1480	5899	1986	2772	3413	3449	2773	2364
"RBMS2"	8500	74373	8683	5109	4103	4580	2780	2329	3652	2198	6912	5325	267	218	2316	1407	4451	2219
"RBMS3"	2825	723678	0	0	0	0	0	0	12	0	0	0	0	0	0	0	0	0
"RBMX"	3901	8514	1562	1462	940	622	814	648	559	405	256	714	2715	3628	2999	3481	3755	2663
"RBMX2"	1533	11375	33	34	33	0	15	19	20	11	0	0	196	186	281	266	388	238
"RBMXL1"	5089	13505	901	1617	497	404	853	764	455	335	92	852	873	1995	887	1430	974	951
"RBMXL2"	2216	2216	0	0	0	0	0	0	0	0	0	0	0	0	0	0	0	0
"RBMXL3"	3470	3470	0	0	0	0	0	0	0	0	0	0	0	0	0	0	0	0
"RBMY1A1"	1785	14413	0	0	0	0	0	0	0	0	0	0	0	0	0	0	0	0
"RBMY1A3P"	431	5815	0	0	0	0	0	0	0	0	0	0	0	0	0	0	0	0
"RBMY1B"	1899	14418	0	0	0	0	0	0	0	0	0	0	0	0	0	0	0	0
"RBMY1D"	1897	14414	0	0	0	0	0	0	0	0	0	0	0	0	0	0	0	0
"RBMY1E"	1785	14415	0	0	0	0	0	0	0	0	0	0	0	0	0	0	0	0
"RBMY1F"	1895	109022	0	0	0	0	0	0	0	0	0	0	0	0	0	0	0	0
"RBMY1J"	1890	14405	0	0	0	0	0	0	0	0	0	0	0	0	0	0	0	0
"RBMY2EP"	539	6416	0	0	0	0	0	0	0	0	0	0	0	0	0	0	0	0
"RBMY2FP"	2044	7346	0	0	0	0	0	0	0	0	0	0	0	0	0	0	0	0
"RBMY3AP"	435	4434	0	0	0	0	0	0	0	0	0	0	0	0	0	0	0	0
"RBP1"	1489	13425	0	0	0	0	0	0	0	12	0	0	5	7	7	7	8	4
"RBP2"	691	23627	0	0	0	0	0	0	27	15	0	0	0	0	1	0	0	0
"RBP3"	4278	9504	0	0	0	0	0	0	10	0	0	0	0	0	0	0	0	0
"RBP4"	934	9401	52	0	52	0	0	0	51	0	0	0	0	0	3	0	0	0
"RBP5"	943	5187	0	0	0	0	0	0	0	20	0	0	0	0	0	0	0	0
"RBP56/CHN"	1281	34886	3760	2426	2090	1670	1285	1141	1525	801	2070	2261	3339	3880	3004	2657	2803	1892
"RBP7"	874	18824	0	0	0	0	0	0	0	0	0	0	4	0	0	3	10	3
"RBPJ"	2511	110832	42460	29632	23898	18562	15954	13678	23945	12969	29743	23554	11805	12030	19364	15532	16992	11041
"RBPJL"	2501	10973	0	0	0	0	0	0	0	0	0	0	0	0	0	0	0	0
"RBPMS"	3164	187792	1382	302	762	620	172	130	671	311	250	170	0	11	0	0	0	0
"RBPMS2"	1999	35674	0	0	0	0	0	0	148	50	0	0	0	0	0	0	0	0
"RBPSUHL"	2511	10973	0	0	0	0	0	0	0	0	0	0	0	0	0	0	0	0
"RBSP3"	4832	30053	16	0	16	0	0	0	110	0	0	0	272	271	273	247	590	299
"RBX1"	524	21283	1760	927	1004	756	486	441	687	361	820	1518	906	633	1193	1024	1640	1021
"RC3H1"	11013	61858	4378	1424	2486	1892	765	659	1676	807	1056	559	553	609	1654	1615	1736	1507
"RC3H2"	4012	55832	1873	323	1073	800	180	143	1067	252	570	521	576	2669	967	840	910	1414
"RC74"	2861	122520	594	69	316	278	34	35	727	162	46	129	383	546	520	437	839	552
"RCAN1"	2431	98598	5910	769	3225	2685	378	391	3263	538	1446	267	1756	5173	242	4384	260	1595
"RCAN2"	3322	105064	0	0	0	0	0	0	0	0	0	0	0	0	0	0	0	0
"RCAN3"	1702	33040	367	0	213	154	0	0	469	0	51	0	572	521	568	373	753	396
"RCAS1"	1113	20850	47	0	16	31	0	0	48	0	0	0	163	207	230	161	254	184
"RCBTB1"	4046	53639	737	91	365	372	50	41	440	99	88	14	1110	1148	1266	863	1950	1164
"RCBTB2"	3188	44217	10291	3169	5744	4547	1767	1402	4261	859	4873	1704	7927	6617	3927	1511	4532	1794
"RCC1"	2543	20864	172	6	103	69	0	6	96	64	40	17	458	435	529	463	612	604
"RCC2"	4104	32970	5286	7893	2920	2366	4296	3597	1705	4924	3935	9992	4857	6688	5379	12000	6464	8575
"RCCD1"	2774	8249	86	0	53	33	0	0	109	0	90	0	241	192	360	219	436	238
"RCE1"	1479	3122	193	51	118	75	21	30	107	87	0	82	425	387	499	383	677	429
"RCHY1"	4320	35275	1506	31	822	684	20	11	910	17	178	64	752	462	656	260	723	368
"RCL1"	2178	68232	22	32	15	7	9	23	89	45	15	47	169	120	243	193	182	145
"RCN1"	2610	9193	102	328	54	48	200	128	40	208	0	143	206	615	670	798	779	685
"RCN2"	2274	18640	28	0	15	13	0	0	53	0	0	0	436	480	440	395	507	331
"RCN3"	1860	16016	66	0	32	34	0	0	147	34	0	0	16	20	171	56	169	111
"RCOR1"	5530	137681	15801	6050	8866	6935	3352	2698	6562	3754	11482	7295	3120	3144	2651	1994	3039	2028
"RCOR2"	2605	5614	0	0	0	0	0	0	0	38	0	0	0	0	0	0	0	0
"RCOR3"	4482	57017	3502	486	2003	1499	237	249	1917	215	341	151	1113	797	1311	568	1488	626
"RCSD1"	2997	76013	5885	537	3318	2567	308	229	3362	348	3438	216	2725	2107	3604	2635	3619	1987
"RCVRN"	1178	7659	0	0	0	0	0	0	67	18	0	0	0	0	0	0	0	0
"RD3"	4269	16397	0	0	0	0	0	0	15	9	0	0	0	0	0	0	0	0
"RDBP"	1571	7001	161	4100	83	78	2220	1880	113	3093	12	1534	604	856	641	1021	850	629
"RDH10"	3535	30251	10	0	4	6	0	0	38	0	0	0	193	252	242	231	219	190
"RDH11"	2571	18991	342	30	183	159	17	13	221	31	19	0	1800	1626	2273	2031	2040	1662
"RDH12"	1886	32566	0	0	0	0	0	0	14	0	0	0	15	6	7	0	0	4
"RDH13"	2031	25224	539	96	290	249	33	63	463	216	543	436	378	251	205	113	373	177
"RDH14"	1600	5970	24	0	11	13	0	0	11	12	0	0	233	178	291	122	380	122
"RDH16"	1725	6202	0	0	0	0	0	0	9	11	0	0	0	0	2	3	0	0
"RDH5"	1466	2293	130	72	0	130	47	25	24	28	0	52	997	400	694	22	940	20
"RDH8"	1719	9030	0	0	0	0	0	0	10	0	0	0	0	1	0	0	0	0
"RDM1"	1170	12695	1	0	1	0	0	0	8	0	0	0	0	0	0	0	0	0
"RDX"	4502	67271	553	42603	323	230	6429	36174	452	4549	33	1033	833	1063	1322	1369	1255	886
"REA"	1038	3079	113	471	84	29	13	458	241	439	64	450	1643	2678	1534	1203	1687	1247
"REC8"	2349	8230	242	157	151	91	99	58	180	171	104	163	45	44	206	73	188	78
"RECK"	4615	64432	0	0	0	0	0	0	56	0	0	0	84	97	49	62	141	46
"RECQL"	3793	32760	1266	314	684	582	203	111	885	305	362	206	2536	1377	2478	1622	2861	1742
"RECQL4"	3823	6530	787	186	454	333	76	110	432	117	1678	98	73	187	273	116	215	256
"RECQL5"	3767	18326	356	8	139	217	8	0	772	279	30	115	299	235	306	349	528	396
"RECS1"	2295	18365	2358	3380	1250	1108	1766	1614	897	1846	1202	2954	1612	6915	1949	2708	8800	1845
"RED"	1962	48879	1	28	1	0	18	10	56	57	1	4	0	58	0	122	0	19
"REEP1"	3992	123657	0	0	0	0	0	0	27	0	0	0	0	0	0	0	1	0
"REEP2"	2181	7883	0	0	0	0	0	0	26	0	0	1	0	0	0	0	0	0
"REEP3"	2301	100850	548	162	306	242	76	86	595	77	50	75	1457	1713	979	857	1031	610
"REEP4"	1702	3917	298	13	187	111	13	0	129	73	372	22	1279	781	984	779	1903	644
"REEP5"	3490	45952	7512	1550	4177	3335	859	691	2788	645	3729	1800	3940	9041	8183	7128	12726	4625
"REEP6"	1377	6760	0	0	0	0	0	0	115	71	0	0	30	27	15	11	50	32
"REG1A"	1264	2486	0	0	0	0	0	0	0	0	0	0	0	0	0	0	0	0
"REG1B"	1231	2147	0	0	0	0	0	0	0	0	0	0	0	0	0	0	0	0
"REG1P"	2926	2926	0	0	0	0	0	0	0	0	0	0	0	0	0	0	0	0
"REG3A"	1007	2655	0	0	0	0	0	0	0	0	0	0	0	0	0	0	0	0
"REG3G"	947	2806	0	0	0	0	0	0	0	0	0	0	0	0	0	0	0	0
"REG4"	1523	17563	0	0	0	0	0	0	0	0	0	0	0	0	0	0	0	0
"REL"	2603	41428	6408	79207	3965	2443	42675	36532	1346	22534	784	38944	1671	30652	828	7472	560	2053
"RELA"	3270	9373	1272	2209	704	568	1142	1067	631	1648	254	3350	816	1499	1023	7937	1353	2954
"RELB"	2273	36742	4137	13077	2335	1802	6984	6093	497	6345	1026	22306	940	5343	948	3324	1399	2171
"RELL1"	3624	75744	1676	915	947	729	498	417	1746	931	515	514	478	326	500	248	618	337
"RELL2"	2589	4115	610	19	333	277	12	7	126	65	394	43	225	500	362	482	698	359
"RELN"	11631	517732	0	0	0	0	0	0	22	0	0	0	0	0	0	0	0	0
"RELT"	3513	20807	16446	6198	9293	7153	3247	2951	3770	3776	12508	11402	2534	2764	3187	3517	4337	2713
"REM1"	1660	9604	0	0	0	0	0	0	16	0	0	0	0	0	0	0	0	0
"REM2"	1864	4459	0	0	0	0	0	0	29	23	0	0	12	0	33	0	10	8
"REN"	1475	11523	0	0	0	0	0	0	46	12	0	0	1	0	0	0	0	0
"RENBP"	1481	9511	777	163	459	318	125	38	267	29	429	51	591	555	1332	1116	1366	1071
"REP15"	1140	1140	178	108	121	57	67	41	77	31	75	86	36	44	65	34	0	0
"REPIN1"	3296	5256	447	164	278	169	89	75	205	198	589	392	1945	1437	2282	2353	3423	2632
"REPS1"	3570	83779	4377	532	2528	1849	317	215	2393	107	592	360	645	585	840	673	889	821
"REPS2"	7971	206591	180	26	107	73	19	7	462	98	39	84	490	608	345	347	596	272
"RER1"	3210	13662	2071	964	1201	870	589	375	777	553	1162	1110	3124	3190	3818	3129	4543	3051
"RERE"	8216	465235	22751	7086	12798	9953	3793	3293	12532	4842	10773	6485	3365	2878	2061	2521	5656	3036
"RERG"	2221	113588	0	0	0	0	0	0	0	0	0	0	0	0	0	0	0	0
"RERGL"	1139	9312	0	0	0	0	0	0	0	0	0	0	0	0	0	0	0	0
"RES4-22D"	4937	107144	6389	4483	3581	2808	2350	2133	2854	2148	3015	4748	997	987	836	826	1145	717
"RESP18"	870	3770	0	0	0	0	0	0	27	0	0	0	0	0	0	0	0	0
"REST"	3666	24299	1355	259	775	580	112	147	669	141	457	53	2601	1849	2510	1009	2749	411
"RET"	5633	53280	0	0	0	0	0	0	339	64	0	0	0	0	0	0	0	0
"RETN"	482	1370	0	0	0	0	0	0	24	0	0	0	0	0	6	3	4	5
"RETNLB"	576	1646	0	0	0	0	0	0	0	0	0	0	0	0	0	0	0	0
"RETSAT"	3321	12744	90	5	63	27	0	5	104	81	0	0	563	536	802	595	907	508
"REV1"	4756	89543	3026	1164	1749	1277	717	447	2023	922	535	932	1210	776	1435	1140	1369	1017
"REV3L"	10997	184685	2080	2421	1237	843	1460	961	1411	1717	272	201	588	824	808	741	781	472
"REXO1"	4596	33208	2012	917	1053	959	456	461	1127	1234	1190	2396	862	718	1009	870	1518	922
"REXO1L1"	8444	32166	0	0	0	0	0	0	12	17	0	0	0	0	0	0	0	0
"REXO2"	1165	10892	9	0	9	0	0	0	41	0	0	0	217	193	204	142	230	138
"REXO4"	2366	11978	117	1	63	54	0	1	240	59	0	39	372	161	682	483	585	547
"RFC1"	4911	78921	215	35	84	131	19	16	174	6	16	0	766	724	1018	593	1034	625
"RFC2"	1724	22906	6775	3721	3745	3030	1932	1789	3740	2743	7610	4070	14906	13537	17512	16118	22724	16016
"RFC3"	2400	19438	3	0	3	0	0	0	61	3	0	0	123	135	108	117	106	56
"RFC4"	1459	16802	11	4	0	11	4	0	43	3892	0	2707	6182	116	158	96	149	112
"RFC5"	2479	15532	202	157	124	78	126	31	237	380	26	127	3975	4810	177	83	233	118
"RFESD"	2805	10267	0	0	0	0	0	0	0	0	0	0	0	0	5	3	0	6
"RFFL"	4197	60417	7023	12615	3989	3034	6924	5691	3069	5203	2282	13327	1917	2498	1053	1156	1331	1239
"RFK"	2816	9013	2	0	0	2	0	0	0	0	0	0	723	750	815	606	825	531
"RFNG"	1835	3873	99	30	23	76	30	0	56	34	0	0	423	321	274	418	805	437
"RFPL1"	1497	3873	0	0	0	0	0	0	0	0	0	0	25	0	0	0	0	0
"RFPL2"	2415	13044	0	0	0	0	0	0	9	0	0	0	0	0	0	0	0	0
"RFPL3"	1489	3295	0	0	0	0	0	0	17	0	0	0	6	0	0	0	0	0
"RFPL4A"	909	4034	0	0	0	0	0	0	0	0	0	0	0	0	0	0	0	3
"RFPL4B"	1903	3968	0	0	0	0	0	0	0	0	0	0	0	0	0	0	0	0
"RFT1"	5109	41969	311	18	165	146	0	18	369	40	64	26	353	212	525	401	588	424
"RFTN1"	3011	197871	28379	81182	15901	12478	43752	37430	7870	48750	5218	53917	1546	1837	2179	2326	4362	2999
"RFTN2"	3121	105058	28	0	11	17	0	0	33	8	38	0	0	0	0	0	0	0
"RFWD2"	2794	262405	33462	23574	18365	15097	12764	10810	14998	8812	10636	16281	1250	1380	1790	1606	1915	1587
"RFWD3"	5087	45483	886	299	549	337	174	125	546	397	89	804	1254	913	991	642	1075	558
"RFX1"	4397	44793	564	5	299	265	5	0	514	89	289	215	416	223	475	259	670	351
"RFX2"	4129	117490	118	507	68	50	255	252	695	1528	0	1946	65	49	95	38	123	30
"RFX3"	3291	278948	6943	1711	3840	3103	976	735	4188	1040	1369	999	254	335	162	135	248	79
"RFX4"	3691	161632	0	0	0	0	0	0	22	0	0	0	0	0	0	0	0	0
"RFX5"	3629	6655	385	1442	177	208	759	683	175	760	587	204	3948	5826	3877	4581	4110	3432
"RFX6"	3508	54934	0	0	0	0	0	0	0	0	0	0	0	0	0	0	0	0
"RFX7"	7203	152753	2902	300	1586	1316	190	110	2838	289	263	11	1284	1323	1111	872	995	689
"RFX8"	1921	77344	0	10	0	0	10	0	0	16	0	0	0	0	0	0	0	0
"RFXANK"	1447	9671	5	0	0	5	0	0	143	67	0	0	481	315	367	346	560	307
"RFXAP"	2828	10403	4032	107	2337	1695	34	73	1502	26	1481	27	536	487	393	179	585	291
"RG9MTD1"	1612	4377	53	37	28	25	15	22	38	53	0	38	706	933	628	654	699	681
"RG9MTD2"	3712	16953	4	7	0	4	7	0	18	0	0	0	140	184	102	62	81	52
"RG9MTD3"	2413	25168	506	60	258	248	39	21	330	56	0	72	668	211	291	81	343	88
"RGAG1"	5429	37278	0	0	0	0	0	0	0	0	0	0	0	0	0	0	0	0
"RGAG4"	4790	4790	70	0	31	39	0	0	58	13	0	0	972	836	1159	866	1396	1007
"RGL1"	5131	292459	18041	14229	10006	8035	7732	6497	8372	7264	2181	9508	7610	11805	7028	7325	7690	4405
"RGL2"	2928	7304	1801	1472	847	954	994	478	514	6177	1382	2385	1515	938	1942	2576	3387	2970
"RGL3"	2580	25288	0	0	0	0	0	0	39	18	31	0	7	1	115	86	109	73
"RGL4"	3070	8399	684	641	665	19	304	337	634	26	1291	521	216	1	736	491	8	4
"RGMA"	3460	30274	0	0	0	0	0	0	85	90	0	0	0	0	0	0	0	0
"RGMB"	4583	27199	0	0	0	0	0	0	12	0	0	0	13	0	0	0	0	0
"RGN"	2243	14939	0	0	0	0	0	0	0	0	0	0	0	0	0	0	0	0
"RGNEF"	8415	170893	0	0	0	0	0	0	11	0	0	0	0	3	5	0	4	0
"RGP1"	1325	3588	171	8	50	121	8	0	151	61	42	24	128	1217	1129	941	1366	827
"RGPD1"	6793	69838	0	18	0	0	18	0	0	0	0	0	0	0	2500	1727	3132	1550
"RGPD2"	6716	96364	0	0	0	0	0	0	0	0	0	0	0	0	1106	706	1241	371
"RGPD3"	5896	63667	0	0	0	0	0	0	0	0	0	0	0	0	387	191	337	281
"RGPD4"	8088	55097	0	0	0	0	0	0	0	0	0	0	0	0	597	259	557	256
"RGPD5"	7638	63749	78	28	55	23	15	13	206	0	0	0	14	26	1963	1432	2873	1864
"RGPD6"	8344	64455	78	28	55	23	15	13	206	0	0	0	14	26	2001	1458	2873	1865
"RGR"	1482	14137	0	0	0	0	0	0	0	0	0	0	0	0	0	0	0	0
"RGS"	3242	104574	0	0	0	0	0	0	0	0	0	0	3	3	0	0	0	0
"RGS1"	1408	4304	0	346	0	0	188	158	0	190	0	115	123	877	183	1093	266	1304
"RGS10"	908	42884	8440	10134	4567	3873	5391	4743	2418	4473	5240	10908	1333	2123	1384	1338	1936	1192
"RGS11"	2393	7606	0	0	0	0	0	0	58	0	0	0	0	0	0	0	0	0
"RGS12"	6256	118031	3190	1008	1739	1451	542	466	1707	1022	1334	913	781	535	1466	1059	1289	1021
"RGS13"	1502	24107	0	0	0	0	0	0	0	0	0	0	0	0	0	0	0	0
"RGS14"	2420	14756	1878	155	1011	867	96	59	804	150	1167	0	2983	1784	2204	1085	3968	1366
"RGS16"	2436	5791	0	0	0	0	0	0	0	0	0	0	0	12	0	28	0	35
"RGS17"	1462	120350	0	0	0	0	0	0	0	10	0	0	0	0	0	0	0	3
"RGS18"	2148	27353	208	0	148	60	0	0	306	0	0	0	1307	968	1543	1033	1417	753
"RGS19"	1603	6646	745	55	345	400	34	21	377	81	470	62	692	214	741	246	1160	339
"RGS2"	1354	3239	135	586	98	37	310	276	55	201	0	57	668	832	785	539	856	262
"RGS20"	2108	107495	0	0	0	0	0	0	13	10	0	0	0	0	0	0	0	0
"RGS21"	1796	50292	0	0	0	0	0	0	0	0	0	0	0	0	0	0	0	0
"RGS22"	4212	145070	0	0	0	0	0	0	0	0	0	0	0	0	0	0	0	0
"RGS3"	4616	153008	122	83	75	47	72	11	448	225	48	36	814	435	744	275	1026	500
"RGS4"	3485	8197	0	0	0	0	0	0	0	0	0	0	0	0	0	0	0	0
"RGS5"	5832	60776	0	0	0	0	0	0	0	0	0	0	2	2	0	0	0	0
"RGS6"	6076	634083	0	0	0	0	0	0	102	20	0	0	0	0	0	0	0	0
"RGS7"	2458	581663	0	0	0	0	0	0	0	16	0	0	0	0	0	0	0	0
"RGS7BP"	3820	105669	0	0	0	0	0	0	0	0	0	0	0	0	0	0	0	0
"RGS8"	919	26277	0	0	0	0	0	0	0	0	0	0	0	0	0	0	0	0
"RGS9"	2452	90272	7	0	4	3	0	0	76	27	0	0	0	3	0	0	0	0
"RGS9BP"	2895	2895	0	0	0	0	0	0	0	0	0	0	0	0	0	0	0	0
"RGSL1"	3780	110476	0	0	0	0	0	0	0	0	0	0	3	3	0	0	0	0
"RHAG"	1935	31696	0	0	0	0	0	0	0	0	0	0	0	0	0	0	0	0
"RHBDD1"	2508	160820	3594	2027	1999	1595	1106	921	2762	1866	81	1362	986	1152	877	784	1054	698
"RHBDD2"	1883	9929	476	12	284	192	12	0	450	82	525	55	1344	670	2116	1812	1966	1379
"RHBDD3"	1745	8072	68	0	63	5	0	0	85	57	54	0	272	219	337	175	347	219
"RHBDF1"	3009	14572	50	21	24	26	18	3	212	256	19	91	96	120	224	287	243	195
"RHBDF2"	3623	30535	1154	519	608	546	303	216	594	796	984	1289	226	338	503	843	294	429
"RHBDL1"	1588	2563	1	0	0	1	0	0	55	40	0	0	0	2	0	5	6	0
"RHBDL2"	1861	43708	676	77	375	301	16	61	466	14	0	47	8	1	1	0	0	0
"RHBDL3"	4670	58487	0	0	0	0	0	0	249	80	0	12	123	71	92	17	112	73
"RHBG"	2032	16008	0	0	0	0	0	0	53	0	0	0	0	0	0	0	0	0
"RHCE"	1884	67944	25	17	0	25	17	0	110	0	0	0	2684	3531	2965	2912	3743	2616
"RHCG"	1948	25163	0	0	0	0	0	0	24	26	0	0	0	4	0	39	0	0
"RHD"	2938	57956	77	0	64	13	0	0	0	0	0	0	0	0	410	425	0	0
"RHEB"	2083	53914	7374	21561	4118	3256	11654	9907	2357	8837	2206	16079	1098	2426	2362	2951	2305	2391
"RHEBL1"	1253	5309	1	18	0	1	18	0	11	53	0	0	12	147	13	19	4	13
"RHO"	2772	6706	0	0	0	0	0	0	102	79	0	0	0	68	0	46	5	35
"RHOA"	1924	52947	4034	5017	2230	1804	2800	2217	1526	2620	2225	6895	1456	5905	4115	3986	4550	3774
"RHOB"	2367	2367	176	155	100	76	90	65	53	190	0	176	664	3181	631	2218	1042	946
"RHOBTB1"	4581	74835	0	0	0	0	0	0	30	0	0	0	95	85	410	318	179	101
"RHOBTB2"	5459	20620	644	2264	532	112	1213	1051	183	1425	0	449	2716	8588	888	981	940	964
"RHOBTB3"	5576	65221	14	0	14	0	0	0	85	10	10	11	96	162	320	266	60	93
"RHOC"	2487	6278	251	113	130	121	90	23	288	138	43	319	1418	2018	1043	2147	1137	2155
"RHOD"	1137	15200	0	0	0	0	0	0	80	0	0	0	0	0	0	0	0	0
"RHOF"	2438	15934	1719	7679	940	779	3994	3685	188	4426	526	13657	1957	10308	1036	8293	2321	8149
"RHOG"	1321	14007	2038	2301	1062	976	1322	979	733	1439	1424	3566	25	4730	4389	5623	197	4913
"RHOH"	2002	47756	0	28	0	0	11	17	0	8	0	82	76	90	89	149	63	49
"RHOJ"	1910	87416	0	0	0	0	0	0	0	0	0	0	0	0	0	0	0	0
"RHOQ"	4545	41960	10727	19137	5951	4776	10231	8906	3618	7137	7229	16549	3042	5539	4429	5040	3832	3712
"RHOT1"	3424	67285	2445	273	1506	939	157	116	1809	169	1222	206	1193	1178	1350	1005	1430	1007
"RHOT2"	2575	6039	865	341	459	406	224	117	334	308	512	550	1434	1418	1915	1667	2643	1793
"RHOU"	4323	11542	56	59	31	25	35	24	101	175	15	92	704	839	724	1596	980	400
"RHOV"	1706	2075	1	0	0	1	0	0	30	0	0	0	0	0	0	0	0	0
"RHOXF1"	758	6824	0	0	0	0	0	0	0	0	0	0	0	0	0	0	0	0
"RHOXF2"	1311	5478	0	0	0	0	0	0	0	0	0	0	0	0	0	0	0	0
"RHOXF2B"	1311	5478	0	0	0	0	0	0	0	0	0	0	1	0	0	0	0	0
"RHPN1"	3729	15366	1393	307	724	669	151	156	676	361	1530	440	725	638	1420	1176	2159	1226
"RHPN2"	3545	86327	0	0	0	0	0	0	18	0	0	0	0	0	0	0	0	0
"RIBC1"	1954	6939	0	1	0	0	0	1	61	0	0	0	0	2	0	0	0	11
"RIBC2"	1399	18721	0	0	0	0	0	0	0	0	0	0	0	1	0	0	0	0
"RIC3"	5902	62995	0	0	0	0	0	0	0	0	0	0	0	6	0	0	0	0
"RIC8A"	2707	6580	419	37	197	222	8	29	283	174	151	73	2483	2072	2713	1404	3509	2225
"RIC8B"	5965	67058	541	52	301	240	27	25	557	79	42	0	192	198	212	111	328	155
"RICH2"	4329	202132	0	0	0	0	0	0	68	13	0	0	295	16	0	0	20	0
"RICS"	10132	227139	30	0	17	13	0	0	36	23	0	0	139	178	58	66	96	7
"RICTOR"	9644	136481	9922	7965	5517	4405	4332	3633	4453	2988	1751	2601	1742	2170	1920	1469	1910	1130
"RIE2 sid2705"	3761	43266	2109	1735	1175	934	920	815	858	1023	432	2257	2131	3326	3296	3299	4415	2954
"RIF1"	8542	65816	2186	7239	1125	1061	4075	3164	1332	3452	278	4641	1911	4371	2048	3093	1968	1533
"RILP"	1797	3947	75	276	39	36	154	122	271	97	477	194	1098	303	638	533	810	644
"RILPL1"	2720	62358	843	98	451	392	37	61	824	180	272	0	226	131	140	131	233	118
"RILPL2"	1439	21330	68	1213	15	53	644	569	32	990	0	1782	265	459	186	1311	560	788
"RIMBP2"	6393	121783	0	0	0	0	0	0	472	75	0	0	0	0	0	0	0	0
"RIMBP3"	5785	5785	0	0	0	0	0	0	0	0	0	0	93	0	442	0	682	0
"RIMBP3B"	5785	5785	0	0	0	0	0	0	0	0	0	0	19	0	427	0	633	0
"RIMBP3C"	5786	5786	0	0	0	0	0	0	0	0	0	0	0	0	414	0	613	0
"RIMKLA"	10574	43434	0	0	0	0	0	0	0	0	0	0	0	0	0	0	0	0
"RIMKLB"	5837	79271	0	0	0	0	0	0	0	13	0	0	19	48	35	37	37	6
"RIMS1"	7281	515859	0	0	0	0	0	0	0	0	0	0	0	0	0	0	0	0
"RIMS2"	5776	372808	3	0	0	3	0	0	11	0	0	0	0	3	0	0	0	0
"RIMS3"	7237	44974	39	0	28	11	0	0	193	11	0	0	339	294	301	61	498	207
"RIMS4"	5143	58463	0	0	0	0	0	0	54	0	0	0	0	0	0	0	0	0
"RIN1"	2744	4089	5	0	0	5	0	0	39	48	0	0	213	115	141	38	276	114
"RIN2"	4255	112892	3279	19243	1890	1389	10385	8858	945	6957	22	4509	1539	3274	2013	2366	1324	1235
"RIN3"	3855	175209	28566	14534	15836	12730	7697	6837	11136	8549	22900	15376	4158	2344	4365	2606	5995	3139
"RING1"	1744	4214	282	193	147	135	101	92	103	144	108	202	734	816	705	813	859	810
"RINL"	3045	10422	0	0	0	0	0	0	41	43	0	0	39	42	18	15	9	7
"RINT1"	2991	35594	91	5	62	29	0	5	113	78	120	22	483	456	505	353	444	275
"RIOK1"	2492	28208	103	0	56	47	0	0	81	59	0	43	339	464	317	309	354	318
"RIOK2"	3972	22435	47	36	34	13	16	20	95	26	42	0	635	450	651	310	696	383
"RIOK3"	4044	30312	1037	784	583	454	441	343	569	389	351	610	2696	3066	2640	2358	2936	1897
"RIP"	2547	10026	686	426	385	301	255	171	336	327	408	486	1839	1961	1145	393	1432	1043
"RIP3"	1968	4016	188	33	141	47	33	0	224	68	188	7	590	414	815	515	1111	455
"RIPK1"	4385	51299	4021	20881	2212	1809	11233	9648	1089	8197	392	7324	1537	4588	1563	2716	1651	1437
"RIPK2"	2595	33318	1097	13496	674	423	7424	6072	148	5113	21	6075	540	5878	846	4022	745	2447
"RIPK3"	2076	3045	188	33	141	47	33	0	224	68	188	7	590	414	815	515	1111	455
"RIPK4"	3880	27722	0	0	0	0	0	0	30	11	0	0	0	0	0	0	0	0
"RIPPLY1"	1035	3115	0	0	0	0	0	0	0	0	0	0	0	0	0	0	0	0
"RIPPLY2"	666	4249	0	0	0	0	0	0	0	0	0	0	0	0	0	0	0	0
"RIT1"	3431	13578	1081	1003	612	469	573	430	484	522	882	1391	2666	2558	2878	2275	3069	1802
"RIT2"	1162	372466	0	0	0	0	0	0	0	9	0	0	0	0	0	0	0	0
"RLBP1"	1760	11825	158	0	89	69	0	0	121	10	0	0	0	0	0	0	0	0
"RLBP1L1"	3496	213679	0	0	0	0	0	0	45	0	0	0	0	970	0	0	0	0
"RLBP1L2"	2016	67483	0	0	0	0	0	0	0	0	0	0	0	0	0	0	0	0
"RLF"	6257	79553	3164	4399	1743	1421	2367	2032	1605	2651	775	4238	1093	1742	1026	1146	1266	868
"RLIM"	10632	31650	2967	5438	1678	1289	2924	2514	1272	2359	581	3274	2912	4845	3600	2954	2744	1971
"RLN1"	969	4906	0	0	0	0	0	0	0	0	0	0	0	0	0	0	0	0
"RLN2"	892	4714	0	0	0	0	0	0	0	0	0	0	0	0	0	0	0	0
"RLN3"	454	2768	0	0	0	0	0	0	31	18	0	0	0	0	0	0	0	0
"RLTPR"	4515	12442	0	0	0	0	0	0	23	60	0	19	7	5	6	10	23	12
"RMI1"	3569	23347	572	41	337	235	27	14	151	18	43	31	1126	644	761	237	897	400
"RMND1"	1923	47329	1685	261	951	734	144	117	665	49	524	39	346	279	246	141	251	153
"RMND5A"	6192	57752	4242	11474	2269	1973	6278	5196	2312	5065	1403	9615	1930	2248	4626	3653	4913	2931
"RMND5B"	2739	7139	880	179	549	331	92	87	608	107	587	306	965	744	827	591	1190	448
"RMRP"	266	266	0	0	0	0	0	0	0	0	0	0	0	0	0	0	0	0
"RNASE1"	904	1522	0	0	0	0	0	0	0	0	0	0	696	704	556	534	1217	605
"RNASE10"	1174	5620	0	0	0	0	0	0	0	0	0	0	0	0	0	0	0	0
"RNASE11"	1919	5100	0	0	0	0	0	0	0	0	0	0	0	0	0	0	0	0
"RNASE12"	742	742	0	0	0	0	0	0	0	0	0	0	0	0	0	0	0	0
"RNASE13"	1608	1966	0	0	0	0	0	0	0	0	0	0	0	0	0	0	0	0
"RNASE2"	737	966	0	0	0	0	0	0	0	1	0	0	18	12	27	21	3	4
"RNASE3"	717	946	0	0	0	0	0	0	0	0	0	0	0	0	0	0	0	0
"RNASE4"	1933	16423	0	0	0	0	0	0	13	0	0	0	37	64	23	0	78	7
"RNASE6"	1061	1416	241	0	146	95	0	0	59	0	24	0	4091	4577	4049	3529	4507	2230
"RNASE6PL"	760	69789	2576	120	1422	1154	65	55	1588	214	2300	59	2231	1255	3885	3418	4149	2300
"RNASE7"	1498	2007	0	1	0	0	1	0	0	0	0	0	0	0	0	0	0	0
"RNASE8"	464	464	0	0	0	0	0	0	0	0	0	0	0	0	0	0	0	0
"RNASE9"	1251	4839	0	0	0	0	0	0	0	0	0	0	0	0	0	0	0	0
"RNASEH1"	1641	13249	87	114	40	47	88	26	176	196	76	158	107	932	349	394	349	228
"RNASEH2A"	1503	7058	0	0	0	0	0	0	65	41	0	0	145	134	147	137	164	123
"RNASEH2B"	1599	60704	447	48	259	188	33	15	1187	168	96	172	504	437	418	339	504	330
"RNASEH2C"	2787	3265	347	260	191	156	150	110	165	137	237	120	927	789	1136	993	1516	879
"RNASEK"	1097	2401	497	496	250	247	255	241	124	303	92	210	23	4492	4853	5367	6584	4998
"RNASEL"	4242	15621	106	8	54	52	0	8	94	0	0	13	1819	1558	1584	942	1571	827
"RNASEN"	5456	131682	892	35	537	355	25	10	796	110	89	136	879	925	953	796	1060	746
"RNASET2"	2449	23818	2435	47	1350	1085	30	17	1456	39	2300	59	2229	1229	3885	3417	4149	2300
"RND1"	1652	8721	12	132	0	12	64	68	60	289	0	0	22	1211	0	123	0	56
"RND2"	4156	6801	0	0	0	0	0	0	19	8	0	0	0	0	0	0	0	0
"RND3"	2773	19465	0	0	0	0	0	0	0	0	0	0	0	0	0	0	0	0
"RNF10"	3863	43266	2109	1735	1175	934	920	815	858	1023	432	2257	2131	3326	3296	3299	4415	2954
"RNF103"	4567	11306	4637	2390	2870	1767	1336	1054	2335	940	1797	1832	1049	1454	2565	2403	2669	1934
"RNF11"	3075	37174	530	1088	290	240	579	509	517	861	76	2127	1291	1916	1334	1375	1516	1280
"RNF111"	5576	109388	7074	2585	3936	3138	1398	1187	3205	1480	1507	2910	1618	1494	1868	1302	2108	1241
"RNF112"	3208	6066	0	0	0	0	0	0	73	25	0	0	1	0	1	0	0	0
"RNF113A"	1296	1296	0	0	0	0	0	0	8	0	0	0	2013	1856	1591	1165	1929	1242
"RNF113B"	1379	1483	0	0	0	0	0	0	0	0	0	0	0	0	0	0	0	0
"RNF114"	2471	17508	2510	1218	1451	1059	655	563	939	652	2239	1180	3596	3404	3276	2251	4001	2326
"RNF115"	1682	77740	3395	3408	1892	1503	1939	1469	1492	2543	685	3430	1229	1494	617	571	749	391
"RNF121"	2713	68875	2774	2699	1383	1391	1550	1149	2191	2034	334	4017	531	1070	476	563	744	478
"RNF122"	1874	19372	0	30	0	0	0	30	42	108	0	0	53	101	85	65	116	92
"RNF123"	4293	31973	1550	292	826	724	127	165	1017	353	1191	442	1362	1263	1722	1680	2354	1674
"RNF125"	5894	54711	683	137	420	263	99	38	279	22	106	142	1039	1110	538	408	695	462
"RNF126"	1649	15699	405	0	240	165	0	0	360	133	357	55	482	16	435	262	638	558
"RNF126P1"	1318	1318	0	0	0	0	0	0	14	0	0	0	0	4	0	0	16	11
"RNF128"	2845	70352	0	0	0	0	0	0	0	0	0	0	0	0	0	0	0	0
"RNF13"	2973	149450	27300	19315	15319	11981	10473	8842	11534	4891	10489	9459	4402	5011	6106	5322	6480	5030
"RNF130"	1856	116637	19503	5567	10907	8596	2950	2617	9989	1647	8874	2632	6531	2579	5059	8688	5105	5753
"RNF133"	1444	1444	0	0	0	0	0	0	0	0	0	0	0	0	0	0	0	0
"RNF135"	2222	28971	1723	149	963	760	74	75	978	237	1179	107	1674	968	1142	627	1108	604
"RNF138"	3558	39688	1044	120	614	430	74	46	679	48	116	128	787	624	874	535	940	463
"RNF138P1"	5702	5702	59	68	59	0	36	32	60	58	0	20	69	71	0	0	0	0
"RNF139"	3313	13852	74	136	51	23	98	38	60	110	80	63	1426	1291	1331	917	1400	837
"RNF14"	3122	20132	503	59	279	224	19	40	323	99	154	90	1146	1177	1372	1026	1612	1009
"RNF141"	4090	29551	83	37	27	56	37	0	124	0	14	0	725	169	685	623	364	487
"RNF144A"	5746	126786	0	0	0	0	0	0	70	0	0	20	0	15	0	3	3	0
"RNF144B"	4774	81256	17545	89741	9846	7699	48498	41243	4133	47683	3412	75242	2381	17383	2074	16259	2134	6533
"RNF145"	3575	52095	6218	12088	3471	2747	6461	5627	2581	6966	960	8624	1768	5569	2573	6099	3080	3789
"RNF146"	2145	21484	2415	780	1202	1213	430	350	1166	293	603	384	1610	257	1934	771	2180	860
"RNF148"	1303	1303	0	0	0	0	0	0	0	0	0	0	0	0	0	0	0	0
"RNF149"	2459	32601	7090	18434	3913	3177	9908	8526	2180	6669	2714	3486	2271	4349	1530	2178	1973	1317
"RNF150"	4668	267893	0	0	0	0	0	0	11	0	0	0	0	0	0	0	0	0
"RNF151"	800	2103	0	0	0	0	0	0	12	0	0	0	0	2	0	0	0	0
"RNF152"	1807	78002	0	0	0	0	0	0	13	9	0	0	0	0	0	0	0	0
"RNF157"	4909	97857	1	0	0	1	0	0	36	0	0	0	1	0	0	0	0	12
"RNF160"	7786	64813	817	137	475	342	49	88	622	222	118	132	1258	1581	1397	1102	987	839
"RNF165"	5310	134012	0	0	0	0	0	0	486	150	0	0	0	0	0	0	0	0
"RNF166"	1853	9892	4450	1514	2390	2060	806	708	1826	839	8010	2651	2924	2365	4763	2524	6313	1657
"RNF167"	1795	4841	1935	918	977	958	221	697	625	1038	223	1800	1311	1199	1243	1126	2031	1502
"RNF168"	2321	31955	658	56	350	308	30	26	447	70	63	0	222	80	299	198	260	211
"RNF169"	7828	93546	8898	1503	4860	4038	875	628	3584	920	2322	1105	2131	1542	1983	877	2430	545
"RNF17"	5141	115757	0	0	0	0	0	0	0	2	0	0	0	0	0	0	0	0
"RNF170"	4123	43428	1443	8	806	637	0	8	894	30	600	86	1176	984	1048	603	1135	636
"RNF175"	3434	47154	0	521	0	0	241	280	0	243	0	399	2017	9881	108	331	81	268
"RNF180"	4950	207025	0	0	0	0	0	0	0	0	0	0	0	0	0	0	0	0
"RNF181"	721	1996	17	0	17	0	0	0	117	28	0	0	562	378	1455	1139	1658	691
"RNF182"	3304	55032	0	0	0	0	0	0	0	0	0	0	0	0	0	0	0	0
"RNF183"	2193	6178	0	0	0	0	0	0	11	0	0	0	0	0	0	0	0	0
"RNF185"	3218	46868	1205	762	751	454	467	295	654	500	220	711	1041	996	1580	1240	1848	1166
"RNF186"	1250	1250	0	0	0	0	0	0	0	0	0	0	0	0	0	0	0	0
"RNF187"	3136	8822	208	15	110	98	0	15	143	62	0	21	2066	1468	2719	2104	3214	2268
"RNF19A"	4349	53041	10749	50588	6105	4644	27213	23375	3896	30671	3580	26035	2595	10010	1481	5957	4167	4712
"RNF19B"	2610	28236	9842	42297	6199	3643	23776	18521	2411	17	5995	69689	3858	10915	2343	16041	2636	9912
"RNF2"	3558	57191	1354	283	819	535	120	163	842	320	166	256	619	476	693	612	799	497
"RNF20"	3959	29494	335	62	191	144	17	45	229	97	25	0	1436	1401	1568	1206	1887	1070
"RNF207"	3981	15164	148	392	74	74	227	165	155	623	57	1502	2429	2505	27	478	822	521
"RNF208"	1070	1070	0	0	0	0	0	0	14	0	0	0	0	0	0	0	0	0
"RNF212"	2636	42315	1	0	1	0	0	0	147	40	0	0	0	0	0	0	0	0
"RNF213"	12889	56354	16697	11224	9206	7491	6095	5129	8054	5464	9849	7039	9999	12467	17199	12672	19716	11261
"RNF214"	2708	52952	189	22	118	71	22	0	250	30	48	4	1172	1139	3935	3132	3630	2726
"RNF215"	1927	8499	75	0	43	32	0	0	71	53	0	0	111	57	128	138	252	155
"RNF216"	5792	161616	7913	4647	4639	3274	2549	2098	4297	5910	3484	3730	1776	1398	1747	1451	2419	1500
"RNF216L"	2436	24184	1186	198	638	548	100	98	559	107	560	342	446	247	514	282	623	352
"RNF217"	1789	100145	2645	110	1454	1191	61	49	1826	36	304	31	435	446	343	192	375	201
"RNF219"	3628	46281	301	40	146	155	28	12	307	10	24	33	552	428	639	261	689	348
"RNF220"	3025	246438	1246	270	701	545	178	92	908	317	613	320	1925	1053	2369	1345	3032	1567
"RNF222"	3069	7123	0	0	0	0	0	0	19	0	0	0	0	0	0	0	0	0
"RNF24"	3364	83987	12901	5335	7429	5472	2734	2601	4399	2293	4663	4558	4938	4320	120	1602	966	575
"RNF25"	1923	8195	6	10	4	2	5	5	65	22	0	0	186	105	215	58	305	118
"RNF26"	2786	2786	0	0	0	0	0	0	96	27	0	0	763	502	824	566	1018	631
"RNF31"	4254	13890	2332	813	1260	1072	509	304	1098	721	1791	972	2776	1691	4062	1898	4567	2067
"RNF32"	2266	16561	248	165	124	124	111	54	208	168	0	39	120	158	61	123	87	33
"RNF34"	2082	24255	3185	1911	1744	1441	734	1177	1299	713	1662	1163	2303	2095	1038	1864	1228	1671
"RNF38"	5266	64521	4250	1111	2374	1876	648	463	1791	680	882	1350	2361	1969	1989	1194	2609	1405
"RNF39"	2174	5587	19	42	19	0	0	42	0	17	0	0	1107	1385	1038	1114	1479	1111
"RNF3A"	3781	62081	5116	2100	2881	2235	1068	1032	2651	1656	2962	2699	1269	1660	2058	1904	2217	1574
"RNF4"	3484	46400	5008	730	2786	2222	424	306	2059	856	4290	2236	2747	1937	2931	1599	3901	2106
"RNF40"	4277	12897	849	473	481	368	263	210	356	354	150	534	2379	2213	2555	2201	2863	2008
"RNF41"	3419	17420	354	23	203	151	13	10	307	52	27	56	1295	279	909	218	1084	724
"RNF43"	5581	63856	81	18	28	53	0	18	105	92	0	0	140	485	0	276	131	0
"RNF44"	4164	10723	1127	378	495	632	241	137	655	246	1624	647	2336	2111	3011	1702	4040	529
"RNF5"	1140	2407	32	0	0	32	0	0	35	0	0	0	1254	879	1332	1133	1907	1321
"RNF6"	3588	9604	534	141	302	232	91	50	449	137	122	65	2041	2128	2422	1718	2556	1558
"RNF7"	1601	8193	329	104	197	132	40	64	206	67	94	123	877	802	1130	784	1527	844
"RNF8"	5744	40767	204	8	137	67	8	0	166	0	0	0	332	225	289	138	482	230
"RNFT1"	2024	12395	995	439	600	395	236	203	342	178	313	432	1360	765	1375	1337	827	403
"RNFT2"	2908	115340	0	0	0	0	0	0	8	0	0	0	0	0	0	0	0	0
"RNGTT"	4479	353361	4125	2065	2389	1736	1088	977	2568	1860	279	1754	787	823	739	613	779	191
"RNH1"	2982	9060	3306	1485	1827	1479	778	707	1016	824	3139	2465	14549	11701	14798	8132	21144	12833
"RNLS"	2421	299223	0	0	0	0	0	0	0	0	0	15	10	22	15	19	36	9
"RNMT"	6215	37852	1892	987	1094	798	597	390	1057	391	553	585	2677	2545	2717	1551	2855	1438
"RNMTL1"	1804	10229	15	17	15	0	10	7	73	117	0	69	233	253	199	268	337	274
"RNPC3"	3287	43401	1579	864	892	687	530	334	1069	437	226	463	754	568	878	487	1134	532
"RNPEP"	2423	23510	2060	421	1192	868	166	255	879	210	718	148	4626	2960	3449	2172	6216	3457
"RNPEPL1"	3306	10039	881	137	471	410	62	75	546	189	1365	160	3797	2839	4996	2994	6850	3326
"RNPS1"	2316	14485	1000	1006	537	463	564	442	440	653	331	1210	1658	1947	932	2103	1483	1824
"RNU11"	136	136	26	0	26	0	0	0	0	318	0	0	0	0	0	0	0	0
"RNU12"	545	545	0	0	0	0	0	0	0	0	0	0	0	0	0	0	0	0
"RNU4ATAC"	131	131	15	54	0	15	27	27	27	27	0	0	0	0	0	0	0	0
"RNU5E"	67	245258	535	196	316	219	124	72	582	155	46	108	838	814	703	511	877	525
"RNU6ATAC"	126	126	0	0	0	0	0	0	166	0	0	0	0	0	0	0	0	0
"RNY4"	35	35	0	0	0	0	0	0	0	0	0	0	0	0	0	0	0	0
"RNY5"	48	380	0	0	0	0	0	0	0	0	0	0	0	0	0	0	0	0
"ROBLD3"	989	4090	66	0	37	29	0	0	73	23	0	0	994	434	1219	668	1956	987
"ROBO1"	7541	422223	0	0	0	0	0	0	0	0	0	0	49	97	0	0	0	0
"ROBO2"	6458	607369	0	0	0	0	0	0	0	9	0	0	0	0	0	0	0	0
"ROBO3"	4596	16081	52	0	31	21	0	0	170	102	0	0	293	314	320	247	593	417
"ROBO4"	3854	13718	3	0	0	3	0	0	62	13	0	0	48	18	12	7	28	7
"ROC1"	3281	13578	1081	1003	612	469	573	430	484	522	882	1391	2666	2558	2878	2275	3069	1802
"ROC2"	1866	8193	329	104	197	132	40	64	206	67	94	123	877	802	1130	784	1527	844
"ROCK1"	6679	162109	9976	7024	5774	4202	3850	3174	5354	6465	1919	6792	3447	4770	5165	4989	5565	3669
"ROCK2"	6434	162935	3912	363	2216	1696	232	131	2338	344	394	380	1167	1710	1241	1234	1153	665
"ROD1"	7290	114593	7377	3857	4222	3155	2225	1632	3056	1843	1283	2619	1088	8568	4244	4799	4429	4424
"ROGDI"	2691	5195	1188	276	702	486	157	119	520	178	1458	312	3224	2238	3387	1595	3861	2377
"ROM1"	1879	2379	0	0	0	0	0	0	58	44	0	0	0	19	7	10	31	0
"ROMO1"	463	1671	36	7	19	17	7	0	1	12	0	0	176	117	339	247	330	340
"ROPN1"	1108	22320	0	0	0	0	0	0	0	0	0	0	0	0	0	0	0	0
"ROPN1B"	1455	8809	0	0	0	0	0	0	0	0	0	0	0	0	0	0	0	0
"ROPN1L"	1047	23130	0	0	0	0	0	0	11	0	0	0	0	0	0	0	0	0
"ROR1"	3391	405019	39	327	8	31	193	134	103	161	0	480	275	346	84	142	60	56
"ROR2"	4100	227562	0	0	0	0	0	0	400	54	0	0	0	0	0	0	0	0
"RORA"	11008	139246	125	83	57	68	48	35	261	77	56	173	71	174	23	16	32	3
"RORB"	3612	189865	0	0	0	0	0	0	0	0	0	0	0	0	0	0	0	0
"RORBP70"	1942	58363	0	0	0	0	0	0	0	0	0	0	0	0	0	0	0	0
"RORC"	3282	25802	0	0	0	0	0	0	138	76	0	0	0	0	0	0	0	0
"ROS1"	7411	137490	0	0	0	0	0	0	0	0	0	0	0	0	0	0	0	0
"RP"	594	795	0	0	0	0	0	0	0	0	0	0	0	0	109	103	131	104
"RP1"	7104	14769	0	0	0	0	0	0	0	0	0	0	0	0	0	0	0	0
"RP1-177G6.2"	1401	5074	0	0	0	0	0	0	9	0	0	0	0	0	0	0	0	0
"RP1-20N2.5"	2751	7415	307	18	182	125	6	12	155	15	0	0	2002	1655	1427	790	948	729
"RP1-57A13.2"	1576	58589	1139	466	668	471	242	224	873	427	300	727	582	744	654	584	966	574
"RP11-155N3.2"	4549	53094	0	0	0	0	0	0	8	0	0	0	71	91	398	349	534	370
"RP11-190J1.9"	708	26726	1175	395	678	497	234	161	545	218	523	877	168	202	189	187	163	131
"RP11-206L10.16-001"	1317	1317	3	1	1	2	0	1	3	23	0	0	0	1	0	0	2	0
"RP11-311P8.3"	2202	30473	186	51	87	99	18	33	242	39	45	0	325	386	396	404	405	253
"RP11-369J21.6"	2107	13539	0	0	0	0	0	0	11	0	0	0	482	520	525	418	544	372
"RP11-383C5.6"	1384	14848	217	0	124	93	0	0	186	44	23	0	324	228	357	216	400	212
"RP11-419L10.1"	3178	37987	2837	2340	1691	1146	1292	1048	1711	1328	722	1700	75	151	163	165	308	167
"RP11-426E5.2"	4553	28712	7	0	3	4	0	0	17	0	14	0	66	60	128	43	105	17
"RP11-45B20.2"	894	6405	0	0	0	0	0	0	0	0	0	0	3	0	0	0	0	3
"RP11-472K8.2-001"	4838	8121	1082	93	607	475	35	58	961	402	262	145	1101	652	524	323	1204	542
"RP11-529I10.4"	804	21322	176	0	96	80	0	0	260	34	0	31	44	59	77	45	87	49
"RP11-99L11.2"	1712	32252	0	0	0	0	0	0	0	0	0	0	0	0	0	0	0	0
"RP1L1"	7979	48757	0	0	0	0	0	0	106	56	0	0	0	0	0	0	0	0
"RP2"	3832	45444	884	5197	533	351	2869	2328	407	1964	40	2063	1976	3301	1808	2239	1792	1428
"RP3-337H4.3"	1654	5139	154	127	92	62	85	42	134	116	52	128	1247	1027	1965	1150	2206	1037
"RP3-365I19.1-001"	1037	178731	12350	9068	6695	5655	5119	3949	7188	5963	4758	9490	290	316	686	812	986	490
"RP3-474I12.8-001"	724	3112	0	0	0	0	0	0	18	23	0	0	0	0	0	0	0	0
"RP3-483K16.1"	797	55054	5882	25120	3226	2656	13851	11269	2062	20517	981	21781	496	226	155	278	219	203
"RP4-662A9.2"	3520	32847	0	0	0	0	0	0	10	0	0	0	0	0	0	0	0	0
"RP4-695O20__B.10"	2281	25643	8686	1047	4767	3919	519	528	3926	1280	7301	2221	43	40	48	44	57	46
"RP4-697K14.11"	1829	4100	364	383	162	202	176	207	132	797	390	627	297	217	329	389	365	293
"RP5-1022P6.2"	6668	41604	9454	8411	5238	4216	4452	3959	4481	3897	5479	8012	2648	4159	2737	3276	3254	2326
"RP5-1049G16.1"	1650	96518	18366	6527	9739	8627	3542	2985	7571	4276	9992	8838	950	1755	2904	2390	1822	983
"RP5-860F19.6-001"	1639	1766	0	0	0	0	0	0	0	0	0	0	0	0	0	0	0	0
"RP9"	1124	14592	29	0	29	0	0	0	84	0	0	0	150	36	229	36	264	119
"RP9P"	3351	21046	624	0	383	241	0	0	613	0	116	14	80	21	147	12	43	17
"RPA1"	4362	69577	400	17	240	160	11	6	280	25	86	5	1990	2197	2271	2730	3299	2444
"RPA2"	1880	23189	203	11	118	85	11	0	297	77	62	46	662	711	502	695	1876	659
"RPA3"	1600	81663	2371	1150	1344	1027	661	489	1276	617	348	566	121	172	241	217	290	178
"RPA4"	1436	1436	12	22	0	12	22	0	0	0	0	0	0	0	0	0	0	0
"RPAIN"	2660	10026	686	426	385	301	255	171	336	327	408	486	1839	1961	1145	393	1432	1043
"RPAP1"	4694	27089	99	4	55	44	4	0	266	59	15	24	479	372	577	467	769	439
"RPAP2"	3188	89212	958	156	533	425	54	102	998	110	41	139	343	391	289	205	317	215
"RPAP3"	3703	44130	858	58	423	435	42	16	601	0	183	70	982	947	1093	747	1116	726
"RPE"	2507	18939	7361	654	4150	3211	369	285	3158	192	1956	263	253	1111	1791	1003	1951	1119
"RPE65"	2622	21137	0	0	0	0	0	0	0	0	0	0	0	0	0	0	0	0
"RPEL"	1634	216527	0	0	0	0	0	0	0	0	0	0	0	0	0	0	0	0
"RPF1"	1983	19114	636	142	406	230	69	73	655	94	133	125	1989	1393	689	483	628	449
"RPF2"	958	43504	68	102	46	22	66	36	85	269	0	339	262	396	326	363	369	290
"RPGR"	4733	43088	57	18	52	5	0	18	159	12	0	30	157	248	142	163	179	121
"RPGRIP1"	3968	63324	53	119	29	24	62	57	59	117	0	407	1129	212	22	1242	49	102
"RPGRIP1L"	6204	103950	0	0	0	0	0	0	0	0	0	0	2	0	3	0	0	0
"RPH3A"	5198	30732	0	0	0	0	0	0	38	1	0	0	0	0	0	0	0	0
"RPH3AL"	2593	140284	2	0	0	2	0	0	837	304	0	10	0	0	3	9	6	4
"RPIA"	1842	59277	134	0	52	82	0	0	196	21	16	16	383	408	578	651	521	395
"RPK118"	412	10283	205	1440	127	78	831	609	106	778	23	714	23	18	33	42	20	24
"RPL10"	2325	4111	525	803	20	505	429	374	386	640	535	766	969	5157	16984	17344	23019	16897
"RPL10A"	943	1984	234	202	125	109	111	91	112	144	80	179	3183	4544	4032	5081	6947	5315
"RPL10L"	808	808	0	0	0	0	0	0	0	0	0	0	0	0	0	0	0	0
"RPL11"	1978	3769	454	384	240	214	203	181	215	204	28	298	6251	8028	8114	10650	12890	9661
"RPL12"	759	3621	289	531	232	57	49	482	318	127	24	194	1676	1743	6261	5501	8754	6464
"RPL13"	1276	2719	1155	2062	18	1137	17	2045	209	812	0	296	4825	4019	7982	8226	13561	8180
"RPL13A"	1132	4699	7181	11141	4032	3149	5492	5649	1995	7952	978	2377	4125	3579	11150	10325	15660	9687
"RPL13AP20"	660	660	0	0	0	0	0	0	0	0	0	0	0	0	0	0	0	0
"RPL13AP3"	1473	1473	0	0	0	0	0	0	0	0	0	0	0	0	0	0	0	0
"RPL13AP6"	654	654	124	0	55	69	0	0	74	54	50	307	0	0	0	0	0	0
"RPL13P5"	623	623	53	0	34	19	0	0	59	0	0	0	196	170	173	148	197	46
"RPL13a"	1122	4699	7181	11141	4032	3149	5492	5649	1995	7952	978	2377	4125	3579	11150	10325	15660	9687
"RPL14"	922	5030	23	44	23	0	18	26	0	34	0	16	1511	0	2891	4648	3775	4800
"RPL14P1"	693	693	0	0	0	0	0	0	0	0	0	0	3455	3720	2212	2442	3026	2409
"RPL15"	2498	6548	134	168	79	55	74	94	141	154	0	0	8551	9241	11536	13711	15025	13100
"RPL17"	1466	9926	874	1412	507	367	749	663	161	251	31	83	2174	2326	6678	6171	9155	6429
"RPL18"	1078	3196	140	57	84	56	25	32	214	171	115	189	1818	1809	5027	4440	7336	4871
"RPL18A"	627	3399	1005	1537	550	455	807	730	251	1049	459	827	16	351	4791	6233	6857	4419
"RPL19"	1073	4387	30	27	30	0	27	0	84	41	0	46	2311	6272	9742	9551	12603	9556
"RPL19P12"	1135	1135	0	0	0	0	0	0	22	0	0	0	0	0	0	0	0	0
"RPL21"	570	5010	627	1752	323	304	943	809	224	801	84	967	132	543	5369	6017	5917	5464
"RPL22"	2088	14600	523	1306	292	231	684	622	175	1033	0	1495	2105	2740	4330	4988	5324	4043
"RPL22L1"	1964	5380	18	45	18	0	32	13	18	15	0	57	309	435	207	235	318	219
"RPL23"	606	3362	333	364	173	160	162	202	69	191	0	374	3785	4461	6463	8156	9563	6322
"RPL23A"	1768	2935	554	925	273	281	586	339	153	242	275	382	1123	1067	2765	1191	1330	2864
"RPL23AP53"	5825	23973	48	46	18	30	27	19	68	40	0	0	108	167	42	36	76	6
"RPL23AP64"	632	632	451	100	163	288	52	48	188	65	243	581	156	220	26	0	40	0
"RPL23AP7"	1486	15901	5	0	5	0	0	0	0	0	0	0	62	44	216	148	213	128
"RPL23AP82"	976	32100	85	0	37	48	0	0	101	16	0	0	334	310	590	436	785	433
"RPL23P8"	524	524	0	0	0	0	0	0	0	0	0	0	0	0	0	14	0	0
"RPL24"	568	5631	155	218	86	69	115	103	89	242	0	361	1303	3049	3285	3684	4372	4079
"RPL26"	586	5733	339	225	182	157	105	120	175	203	0	372	1880	5843	5896	5276	7126	6991
"RPL26L1"	712	10335	0	0	0	0	0	0	32	0	0	0	29	0	242	241	147	283
"RPL27"	680	4436	92	0	17	75	0	0	28	54	0	104	2921	3152	5632	5953	7906	5775
"RPL27A"	4883	7425	1110	1081	596	514	617	464	420	887	276	607	2057	2596	11075	5844	14871	10571
"RPL28"	5609	5739	347	217	189	158	135	82	238	207	77	286	3906	3364	6152	5899	8455	6090
"RPL29"	698	2315	108	41	55	53	19	22	40	67	0	72	3577	3175	312	13	5490	4139
"RPL29P2"	648	648	0	0	0	0	0	0	0	0	0	0	0	1	0	0	0	0
"RPL3"	2116	7505	1984	2312	1038	946	1259	1053	333	911	74	756	5456	7856	14514	17767	18302	12412
"RPL30"	1129	20696	537	631	367	170	550	81	280	422	212	461	5751	6084	6885	7245	9354	7077
"RPL31"	2330	3678	1459	697	767	692	401	296	762	473	857	1207	1005	2014	5535	4851	6824	5552
"RPL31P11"	1547	1547	0	0	0	0	0	0	0	0	0	0	0	0	0	0	0	0
"RPL32"	1772	5506	1069	1461	617	452	784	677	311	916	48	1146	1654	4925	5989	7819	8075	6257
"RPL32P3"	2840	8286	1977	782	1107	870	418	364	856	497	1076	583	635	440	919	377	1199	279
"RPL34"	991	9890	260	360	147	113	189	171	109	180	86	475	1916	2096	3217	3660	4873	3835
"RPL35"	464	4084	84	29	52	32	0	29	118	61	0	111	95	873	2697	1507	3661	2631
"RPL35A"	521	5626	123	192	74	49	73	119	34	95	73	303	1758	4221	3283	2240	3061	3580
"RPL36"	538	1332	148	220	68	80	129	91	54	249	85	156	1429	1449	3349	2889	3678	2031
"RPL36A"	2294	2894	108	48	79	29	24	24	69	43	67	0	166	191	2388	2443	3390	2779
"RPL36AL"	524	1944	28	14	28	0	0	14	42	0	0	30	0	2820	2835	3035	438	2862
"RPL37"	1574	3959	228	221	153	75	142	79	141	132	120	199	599	647	4339	4237	5190	6326
"RPL37A"	1728	2668	158	63	114	44	35	28	169	127	76	50	2967	3224	6149	6336	7993	4482
"RPL38"	2458	2629	396	2221	185	211	1176	1045	231	830	42	1810	1599	2522	2485	3783	3415	3858
"RPL39"	404	5139	22	0	22	0	0	0	16	12	0	11	0	28	3022	5399	3748	5162
"RPL39L"	706	18524	3	0	0	3	0	0	17	0	0	0	34	55	21	24	36	31
"RPL3L"	1538	10100	0	0	0	0	0	0	51	0	0	0	0	0	0	0	0	0
"RPL4"	1882	25218	1395	3217	746	649	1744	1473	268	1844	0	1646	11100	97	14849	18738	19838	17826
"RPL41"	586	1243	92	0	65	27	0	0	56	53	0	0	643	800	14516	14539	20351	15053
"RPL5"	2070	9565	1785	2475	1014	771	1323	1152	618	956	567	1186	7484	8679	6766	7860	9441	8216
"RPL6"	1218	2147	201	123	137	64	44	79	93	85	0	85	2060	2248	8502	6075	10928	8194
"RPL7"	1019	3103	64	59	40	24	26	33	33	43	0	36	359	462	6624	8518	6948	8113
"RPL7A"	898	3213	1549	1137	882	667	617	520	150	396	89	206	2568	0	10862	11322	16148	12262
"RPL7L1"	1580	8999	140	65	60	80	52	13	162	61	91	124	2596	2567	2394	2071	2526	1397
"RPL8"	1008	1308	306	293	186	120	135	158	127	163	0	138	5497	5888	12533	12525	17989	9954
"RPL9"	1050	3139	256	308	162	94	153	155	196	231	53	373	270	545	6036	5805	7535	6498
"RPLP0"	1265	4506	437	182	213	224	118	64	143	152	0	311	6014	9323	18295	17986	20769	15368
"RPLP0L2"	3530	24415	5	0	0	5	0	0	81	43	0	0	0	3	0	0	0	0
"RPLP1"	516	2727	83	116	43	40	70	46	19	14	69	72	7325	1775	14944	16429	13970	11374
"RPLP2"	498	2942	516	0	281	235	0	0	124	344	0	110	1456	2480	5481	6345	6902	4200
"RPML2"	2101	18181	116	0	69	47	0	0	183	35	0	0	664	459	583	419	710	553
"RPN1"	2351	30908	2478	436	1395	1083	231	205	919	301	502	279	3793	3020	4261	4215	3848	3335
"RPN2"	2522	62569	1147	775	595	552	471	304	835	787	241	1001	3624	3062	6240	6588	6496	4278
"RPP14"	3505	13949	406	114	240	166	75	39	270	70	273	295	1332	739	874	409	921	419
"RPP21"	596	1698	5	34	5	0	16	18	24	0	0	0	111	92	125	120	195	106
"RPP25"	2334	2334	0	0	0	0	0	0	10	0	0	0	451	195	445	174	694	297
"RPP30"	4521	36840	399	21	246	153	4	17	278	0	0	2	556	540	417	277	425	316
"RPP38"	1658	7075	140	16	98	42	0	16	41	9	0	0	388	222	400	187	488	209
"RPP40"	1166	8992	0	0	0	0	0	0	0	0	0	0	43	31	48	29	35	23
"RPPH1"	342	342	0	0	0	0	0	0	611	0	0	0	0	0	0	0	0	0
"RPRD1A"	4332	77581	5574	354	3136	2438	228	126	3014	167	2042	238	1605	1524	1127	785	1531	935
"RPRD1B"	3877	58818	2774	984	1464	1310	490	494	1318	752	915	984	787	845	949	818	1108	672
"RPRD2"	7827	112051	3036	403	1578	1458	203	200	1137	194	710	424	2061	1530	1692	1016	2283	1319
"RPRM"	1472	1472	0	0	0	0	0	0	0	0	0	0	0	0	0	0	0	0
"RPRML"	1093	1093	0	0	0	0	0	0	0	0	0	0	0	0	0	0	0	0
"RPS10"	774	8561	72	130	32	40	68	62	151	147	47	429	472	615	3928	3710	5147	3867
"RPS10P7"	688	688	105	0	72	33	0	0	44	0	121	38	306	261	69	51	100	62
"RPS11"	614	3312	528	771	249	279	390	381	186	317	191	435	6427	6462	14574	15670	19890	15126
"RPS12"	508	2996	153	266	31	122	147	119	156	236	0	265	1749	1799	6553	7056	8000	6377
"RPS13"	534	3282	496	758	274	222	463	295	89	517	0	392	2099	2663	5341	5946	7054	6014
"RPS14"	789	5527	269	39	157	112	23	16	265	132	0	266	5518	5802	7387	7419	12574	6428
"RPS15"	614	2058	83	17	40	43	17	0	86	83	0	152	1422	1261	2462	2277	3154	2722
"RPS15A"	548	7381	299	310	151	148	179	131	191	223	229	431	2574	2978	3991	4096	8011	4311
"RPS15AP10"	907	907	739	59	264	475	34	25	0	16	0	67	43	0	35	0	0	0
"RPS16"	687	2771	254	234	150	104	136	98	147	208	98	295	3607	3551	5047	4454	5298	4832
"RPS17"	490	3706	0	0	0	0	0	0	0	0	0	0	0	0	4096	8342	4751	4833
"RPS18"	707	4431	493	248	234	259	139	109	125	225	81	342	5463	5994	10330	10437	14199	10311
"RPS19"	853	11496	1256	1883	707	549	1056	827	369	1025	715	2969	2475	3839	5607	8490	8953	7641
"RPS19BP1"	930	3763	299	111	161	138	50	61	123	58	65	125	1100	144	1491	905	639	1194
"RPS2"	1113	2754	531	422	293	238	224	198	134	348	95	230	3871	3692	15589	15287	22760	16671
"RPS20"	1019	6403	171	533	17	154	289	244	60	233	0	66	1828	3757	5210	6477	6923	6116
"RPS21"	885	1456	101	20	59	42	0	20	36	35	0	0	298	366	102	132	3018	159
"RPS23"	3316	5096	107	59	62	45	11	48	39	35	0	0	4066	2120	6325	7299	9234	7362
"RPS24"	2919	21462	656	286	387	269	187	99	276	236	328	502	6671	7349	10704	13966	14319	6023
"RPS25"	497	2637	214	231	135	79	111	120	199	155	62	143	2589	3077	7159	7258	9437	7354
"RPS26"	684	2321	33	72	12	21	35	37	46	40	0	0	66	122	2729	2742	3489	2759
"RPS26P11"	552	552	0	0	0	0	0	0	0	0	0	0	0	0	0	0	0	0
"RPS27"	356	1395	70	125	31	39	63	62	28	26	0	96	68	99	2059	1610	3045	2856
"RPS27A"	739	3115	69	151	34	35	93	58	24	84	0	184	1845	2482	5134	5682	6423	5048
"RPS27L"	1439	3942	112	105	62	50	58	47	89	19	0	22	1002	106	1525	988	1259	686
"RPS28"	384	896	19	0	0	19	0	0	84	84	0	0	152	165	2678	2651	3359	2533
"RPS29"	714	9043	277	337	140	137	174	163	144	188	236	447	1126	1240	4088	5145	5638	4417
"RPS2P32"	1024	1024	0	0	0	0	0	0	0	0	0	26	0	0	0	0	0	0
"RPS3"	1880	4426	1257	3033	1066	191	1619	1414	1212	4513	1258	2017	4344	7135	8012	9303	9327	7947
"RPS3A"	1744	4605	211	135	110	101	80	55	118	101	61	216	1392	1519	8033	8174	16658	7855
"RPS4X"	1712	3492	165	71	81	84	51	20	108	27	109	44	3045	3308	6520	7743	9849	11329
"RPS4Y1"	998	25470	1561	1653	873	688	914	739	410	571	0	0	2323	2639	3437	3702	0	0
"RPS4Y2"	893	24964	0	0	0	0	0	0	0	0	0	0	0	0	0	0	0	0
"RPS5"	1522	7516	33	0	33	0	0	0	29	33	0	219	17	1896	3423	3685	4023	2273
"RPS6"	1385	3963	483	318	276	207	199	119	240	209	50	192	10472	13108	9991	12295	14362	12256
"RPS6KA1"	3221	45273	7186	5326	3923	3263	2863	2463	2627	3419	7493	7081	11033	9157	14086	14006	16562	12094
"RPS6KA2"	5838	217874	1503	2769	777	726	1627	1142	3665	2474	188	1219	587	529	1072	1112	1099	1033
"RPS6KA3"	8159	117495	4263	3023	2259	2004	1628	1395	2348	2342	683	3682	3998	4768	4009	3593	5015	3298
"RPS6KA4"	3153	13063	611	75	334	277	40	35	307	45	779	36	1750	1064	2170	1512	2798	1654
"RPS6KA5"	3892	189828	0	2	0	0	0	2	63	0	0	0	22	46	54	59	42	29
"RPS6KA6"	2793	123933	0	0	0	0	0	0	0	0	0	0	0	0	0	0	0	0
"RPS6KB1"	5461	57343	847	322	525	322	233	89	605	319	219	911	958	1071	927	832	1105	727
"RPS6KB2"	1925	6945	410	76	209	201	28	48	201	169	321	155	665	615	784	652	1094	632
"RPS6KC1"	4229	222221	5309	7558	3041	2268	4306	3252	3536	5714	565	3613	709	1015	949	859	820	673
"RPS6KL1"	3070	16843	0	0	0	0	0	0	39	71	0	0	0	0	0	0	3	0
"RPS7"	2586	3129	84	281	22	62	131	150	83	120	65	210	891	1137	5368	4717	7436	4777
"RPS8"	710	3167	3051	1700	1652	1399	924	776	302	1113	775	411	10117	10141	13377	13562	17996	13569
"RPS9"	1602	6471	1474	1571	811	663	852	719	563	816	1331	1907	5288	6044	7090	8371	8036	8218
"RPSA"	1381	65103	1615	1740	915	700	945	795	407	1014	203	563	4711	5041	6373	6273	7811	4283
"RPSAP52"	1143	68953	0	0	0	0	0	0	0	0	0	0	0	0	0	0	0	0
"RPTN"	3572	5635	0	0	0	0	0	0	0	0	0	0	0	0	0	0	0	0
"RPTOR"	6890	421550	4428	1697	2536	1892	954	743	5639	3250	1508	2860	953	897	1160	1232	1484	1053
"RPUSD1"	2153	2998	88	0	38	50	0	0	70	57	0	0	410	188	535	259	719	371
"RPUSD2"	1842	5126	0	0	0	0	0	0	0	0	0	0	107	16	122	0	162	7
"RPUSD3"	2497	4119	209	6	143	66	5	1	180	111	59	62	412	230	345	235	229	251
"RPUSD4"	2548	9599	231	467	157	74	225	242	197	143	81	236	528	402	375	551	574	450
"RQCD1"	1049	24884	1099	1248	653	446	644	604	596	990	781	1524	1366	1921	1491	1338	1550	1117
"RRAD"	1481	3859	0	0	0	0	0	0	0	0	0	0	0	0	0	5	0	6
"RRAGA"	1649	1649	39	0	0	39	0	0	16	14	0	0	1507	1527	1390	1211	1610	1162
"RRAGB"	2217	41098	468	86	319	149	58	28	352	15	0	8	320	329	303	199	314	200
"RRAGC"	2173	35153	1185	212	640	545	95	117	898	101	704	173	2243	2061	1334	943	1488	986
"RRAGD"	4931	47660	65	5	32	33	0	5	75	0	0	0	707	632	1521	1455	1273	936
"RRAS"	989	4850	11	0	0	11	0	0	49	57	0	0	384	371	274	217	662	202
"RRAS2"	2350	81264	0	0	0	0	0	0	0	0	0	0	2	0	3	0	0	9
"RRBP1"	3818	68607	4841	6369	2709	2132	3495	2874	2063	3480	2122	3552	3194	3146	4999	4285	4785	3937
"RREB1"	8123	143506	34464	8861	19028	15436	4612	4249	14287	3665	21520	6181	3729	3265	3969	2443	4257	2431
"RRH"	1561	16711	0	0	0	0	0	0	0	0	0	0	0	0	0	0	0	0
"RRM1"	3296	44183	3	0	3	0	0	0	149	16	0	0	717	689	856	664	790	645
"RRM2"	3406	8815	0	0	0	0	0	0	0	0	0	0	0	0	0	0	4	4
"RRM2B"	4938	34616	918	236	549	369	137	99	547	72	194	82	2008	1999	2021	1445	2114	1094
"RRN3"	3762	34279	340	819	212	128	476	343	159	667	17	1022	745	1673	1317	2220	1451	1442
"RRP1"	1838	11173	598	307	365	233	200	107	441	369	483	527	613	544	891	907	1091	789
"RRP12"	4459	44670	20	7	15	5	2	5	328	86	21	63	559	484	726	669	879	615
"RRP15"	7774	52696	31	8	20	11	8	0	63	45	0	0	305	369	268	237	233	184
"RRP1B"	5101	36528	3527	702	1916	1611	367	335	1698	434	2222	961	11708	8088	10710	4971	13028	6011
"RRP7A"	1752	4348	184	142	131	53	71	71	317	251	82	374	157	305	557	1075	1062	712
"RRP7B"	2321	8751	177	29	101	76	17	12	283	156	80	198	64	80	323	396	752	444
"RRP8"	1679	3659	192	66	99	93	28	38	213	109	31	190	235	201	350	505	314	147
"RRP9"	1558	8478	17	0	4	13	0	0	141	61	0	0	182	94	221	187	263	189
"RRS1"	1705	1705	283	78	158	125	40	38	95	34	96	30	1317	781	1658	684	2028	857
"RS1"	3030	32415	0	0	0	0	0	0	10	0	0	0	0	0	0	0	0	0
"RSAD1"	2508	7148	242	17	151	91	17	0	107	13	0	0	580	445	783	484	1089	578
"RSAD2"	3518	20569	0	0	0	0	0	0	53	0	0	0	16	0	171	0	65	3
"RSBN1"	6718	50617	734	91	443	291	43	48	510	73	0	25	918	469	872	252	1038	330
"RSBN1L"	3228	83379	4355	290	2560	1795	123	167	1778	261	1197	434	1231	718	927	399	940	460
"RSC1A1"	1854	1854	382	18	201	181	0	18	367	9	65	0	721	752	1328	800	1072	551
"RSF1"	5329	37305	5597	2185	3263	2334	1213	972	3498	1534	754	2776	1532	1509	1283	1379	1103	991
"RSHL1"	2461	19610	0	0	0	0	0	0	32	59	2	0	0	0	0	0	0	0
"RSL1D1"	5144	17389	190	498	119	71	218	280	102	397	0	468	3143	4217	2567	2831	3292	2850
"RSL24D1"	1470	15712	265	207	143	122	116	91	155	95	0	66	1133	1224	375	305	498	374
"RSPH1"	1373	23804	0	0	0	0	0	0	26	12	0	0	0	1	0	0	0	0
"RSPH10B"	3242	44539	0	0	0	0	0	0	0	0	0	0	0	0	0	0	0	0
"RSPH10B2"	3242	44658	0	0	0	0	0	0	0	0	0	0	0	0	0	0	0	0
"RSPH3"	2198	18564	732	19	507	225	10	9	377	4	187	22	283	210	339	139	339	132
"RSPH4A"	2846	16508	10	0	10	0	0	0	0	0	0	0	0	0	0	0	0	0
"RSPH9"	920	25936	83	0	33	50	0	0	187	41	30	16	1	0	0	0	0	0
"RSPO1"	2993	23542	0	0	0	0	0	0	52	15	0	0	0	0	0	0	0	0
"RSPO2"	3154	184370	0	0	0	0	0	0	0	0	0	0	0	0	0	0	0	0
"RSPO3"	2144	78136	0	0	0	0	0	0	0	0	0	0	0	0	0	0	0	0
"RSPO4"	2709	43808	0	0	0	0	0	0	96	17	0	0	0	0	0	0	0	0
"RSPRY1"	2672	52697	649	712	354	295	409	303	588	783	51	1349	933	1148	979	906	1040	738
"RSRC1"	1636	434684	14374	9880	8254	6120	5630	4250	7670	5544	569	4438	811	794	657	627	652	486
"RSRC2"	2362	22274	2690	4338	1572	1118	2425	1913	1034	1584	748	3324	906	2672	1692	1723	1825	1588
"RSU1"	3918	226765	15127	6170	8545	6582	3271	2899	6230	3157	2792	3564	4224	4895	4368	3822	5985	3879
"RTBDN"	2071	9939	0	0	0	0	0	0	47	0	0	0	0	0	0	0	0	0
"RTCD1"	2633	26611	762	48	411	351	39	9	515	50	44	42	607	576	742	814	907	680
"RTDR1"	1258	82649	0	0	0	0	0	0	449	203	0	0	0	0	0	0	0	0
"RTEL1"	5614	38899	5477	2453	2878	2599	1212	1241	2161	1999	5823	4654	918	1136	1787	1891	2760	1530
"RTF1"	5038	66460	275	121	169	106	82	39	239	102	52	145	1443	1195	1385	955	1635	1000
"RTKN"	2633	14723	160	0	86	74	0	0	227	20	25	0	243	133	298	156	302	235
"RTKN2"	6650	75512	11	0	11	0	0	0	141	0	0	0	0	0	0	0	0	0
"RTL1"	4194	4194	0	0	0	0	0	0	9	0	0	0	0	0	0	0	0	0
"RTN1"	3318	274865	11306	13085	6412	4894	7281	5804	6277	10002	1164	11072	936	1480	914	767	1488	912
"RTN2"	2294	11764	0	0	0	0	0	0	17	65	0	19	208	228	187	253	333	205
"RTN3"	4979	78437	4526	690	2554	1972	374	316	2344	235	2024	578	4945	5239	5106	5075	5761	4926
"RTN4"	4849	78407	13762	10280	7226	6536	5557	4723	5603	6246	6508	9583	8114	9607	10561	5365	9633	10477
"RTN4IP1"	2643	58470	52	0	35	17	0	0	113	14	0	22	121	108	223	160	2083	170
"RTN4R"	1975	2269	12	0	12	0	0	0	394	265	14	0	102	52	465	275	361	287
"RTN4RL1"	3164	90207	0	0	0	0	0	0	369	237	0	0	0	0	0	0	0	0
"RTN4RL2"	1265	16046	0	0	0	0	0	0	88	59	0	0	60	59	46	24	84	0
"RTP1"	2217	3979	0	0	0	0	0	0	0	0	0	0	0	0	0	0	0	0
"RTP2"	1348	4300	0	0	0	0	0	0	0	0	0	0	1	0	0	0	0	0
"RTP3"	819	2956	0	0	0	0	0	0	0	0	0	0	0	0	0	0	0	0
"RTP4"	1011	3201	0	0	0	0	0	0	0	13	0	0	136	224	163	72	158	93
"RTTN"	7142	201921	5	4	0	5	0	4	68	36	17	11	34	119	105	180	118	85
"RTVP1"	871	17989	2649	1899	1368	1281	1036	863	766	854	309	1287	5865	7573	7580	5922	6741	4995
"RUFY1"	2644	59450	1824	761	1036	788	420	341	1119	609	520	715	1685	1535	2422	1985	2610	1654
"RUFY2"	4519	63671	819	634	420	399	309	325	496	186	274	283	1418	1736	1634	1603	1961	1451
"RUFY3"	4435	86641	5139	4037	2899	2240	2214	1823	2655	2462	2237	4932	1333	1627	1558	1544	1649	971
"RUFY4"	3141	55154	10823	3468	5932	4891	1861	1607	3358	1043	3351	887	19991	14384	15362	6510	24883	9288
"RUNDC1"	3833	13127	201	34	119	82	16	18	123	11	157	40	639	231	691	175	854	257
"RUNDC2A"	3704	21369	5996	1164	3316	2680	504	660	3273	1094	4585	1819	271	366	549	494	710	369
"RUNDC2B"	5139	78477	928	839	473	455	462	377	688	484	921	2009	4	16	312	124	352	203
"RUNDC3A"	2057	10112	1	0	1	0	0	0	81	48	0	0	1	8	0	0	0	0
"RUNDC3B"	4112	203885	585	29	330	255	19	10	139	0	0	0	0	0	0	0	0	0
"RUNX1"	7279	100890	78509	59121	43642	34867	31608	27513	33847	18608	49273	33657	5471	4545	5164	2628	5252	2855
"RUNX1T1"	3651	136556	0	0	0	0	0	0	0	0	0	0	0	0	0	0	0	0
"RUNX2"	5707	128906	1780	127	1041	739	48	79	2787	370	244	194	671	677	588	371	645	358
"RUNX3"	4345	65500	2727	1263	1534	1193	758	505	1028	1056	514	1574	1485	1421	1180	852	1975	1051
"RUSC1"	3495	10271	804	63	246	558	55	8	471	162	0	108	429	442	437	315	659	454
"RUSC2"	5647	23267	805	0	432	373	0	0	860	47	288	13	490	486	930	693	885	765
"RUVBL1"	2137	89132	1142	661	607	535	333	328	440	475	442	491	7413	7402	8372	7284	9817	6827
"RUVBL2"	1688	22365	31	0	16	15	0	0	140	48	0	0	387	286	432	417	526	405
"RWDD1"	1314	21851	35	0	13	22	0	0	66	0	0	0	470	455	557	513	734	541
"RWDD2A"	1416	3224	0	0	0	0	0	0	21	0	0	0	82	31	68	37	82	57
"RWDD2B"	1807	13605	31	0	22	9	0	0	11	0	0	0	572	378	221	104	290	234
"RWDD3"	1318	13064	330	0	213	117	0	0	262	0	135	12	478	290	382	142	368	158
"RWDD4A"	2597	19544	0	0	0	0	0	0	78	1	0	0	125	127	523	392	533	397
"RXFP1"	2514	130217	0	0	0	0	0	0	0	0	0	0	0	1	0	0	0	0
"RXFP2"	2820	63331	0	0	0	0	0	0	0	0	0	0	0	0	0	0	0	0
"RXFP3"	1853	1853	0	0	0	0	0	0	0	0	0	0	0	0	0	0	0	0
"RXFP4"	1146	1146	404	524	230	174	341	183	137	338	271	660	0	0	0	0	0	0
"RXRA"	6001	34005	29275	7308	16336	12939	3708	3600	10064	6788	38355	17525	7807	6240	8772	6155	11844	6675
"RXRB"	2897	7069	666	101	357	309	57	44	239	102	156	221	1742	766	1573	796	1838	1052
"RXRG"	1851	44081	0	0	0	0	0	0	13	8	0	0	0	0	0	0	0	0
"RYBP"	4446	72025	11683	29386	6532	5151	15902	13484	4546	12761	4285	19667	2235	4992	2426	4246	2472	305
"RYK"	2954	93610	6710	973	3741	2969	594	379	3356	343	1123	526	1338	1519	980	693	1275	815
"RYR1"	15496	153865	2	0	0	2	0	0	504	204	0	0	246	130	204	248	291	220
"RYR2"	16470	791588	0	0	0	0	0	0	26	0	0	0	0	0	0	0	0	0
"RYR3"	15662	555127	78	0	50	28	0	0	52	0	0	0	0	24	15	10	15	0
"RabGAPLP"	2787	39700	5174	4473	2804	2370	1354	3119	616	12285	3001	23562	4020	262	4119	1013	6361	5552
"Rabex5"	4574	129410	7182	8548	3939	3243	4608	3940	3697	4402	4749	7776	1389	1774	853	1238	1061	793
"Rh50"	1812	31696	0	0	0	0	0	0	0	0	0	0	0	0	0	0	0	0
"Rpp14"	3406	13949	406	114	240	166	75	39	270	70	273	295	1332	739	874	409	921	419
"Rpp29"	2376	10994	110	98	75	35	52	46	61	94	0	100	695	771	654	586	824	614
"S100A1"	783	3642	9	15	9	0	0	15	44	17	0	0	31	38	13	4	59	13
"S100A10"	1057	11329	739	1700	440	299	894	806	293	1285	250	1789	4552	6400	1764	1825	3034	1169
"S100A11"	596	4530	449	1609	282	167	868	741	148	703	0	920	8572	10612	9843	14380	13638	9533
"S100A12"	469	1893	0	0	0	0	0	0	0	0	0	0	0	0	0	0	0	0
"S100A13"	897	15290	119	109	72	47	44	65	197	35	16	0	301	119	62	43	233	22
"S100A14"	1044	2058	0	0	0	0	0	0	0	0	0	0	0	0	0	0	0	0
"S100A16"	1091	2116	0	0	0	0	0	0	72	24	0	0	12	0	0	4	24	8
"S100A2"	963	4721	0	0	0	0	0	0	13	12	0	0	0	7	9	0	0	4
"S100A3"	741	1927	0	0	0	0	0	0	22	23	0	0	2	11	2	0	6	0
"S100A4"	567	2188	313	131	183	130	76	55	0	38	42	0	20552	13031	14594	4275	7169	5340
"S100A5"	713	4619	0	0	0	0	0	0	35	0	0	0	22	24	7	3	41	32
"S100A6"	686	1643	159	13	90	69	0	13	31	37	47	27	14064	15640	15488	4695	24955	17194
"S100A7"	442	2919	0	0	0	0	0	0	18	0	0	0	0	0	0	0	0	0
"S100A7A"	4282	6703	0	0	0	0	0	0	0	0	0	0	0	0	0	0	0	0
"S100A7L2"	482	3033	0	0	0	0	0	0	0	0	0	0	0	0	0	0	0	0
"S100A8"	410	1042	0	0	0	0	0	0	0	0	0	0	0	18	42	28	29	25
"S100A9"	579	3174	0	0	0	0	0	0	16	0	0	0	61	64	276	345	189	235
"S100B"	1233	6506	0	0	0	0	0	0	0	0	0	0	262	265	146	94	102	52
"S100G"	456	4512	0	0	0	0	0	0	0	0	0	0	0	0	0	1	0	0
"S100P"	511	3332	0	0	0	0	0	0	35	0	0	0	0	0	0	0	0	0
"S100PBP"	4347	41434	1582	295	904	678	158	137	1064	125	368	121	516	500	453	212	687	336
"S100Z"	1151	71231	0	0	0	0	0	0	0	0	0	0	0	0	0	0	0	0
"S11"	1854	16178	347	69	184	163	48	21	218	140	18	204	1335	1503	1987	1256	1979	986
"S1PR1"	3052	4773	3	0	0	3	0	0	0	0	0	20	172	184	384	216	238	144
"S1PR2"	3586	9841	346	17	211	135	0	17	161	48	149	38	1292	377	1022	250	1244	396
"S1PR3"	4207	13564	0	0	0	0	0	0	39	0	0	0	266	134	152	3	330	165
"S1PR4"	1565	1565	234	10	140	94	0	10	157	57	430	67	1025	457	1144	541	1430	708
"S1PR5"	2193	4986	0	0	0	0	0	0	0	14	0	0	91	47	13	30	58	19
"SAA1"	720	3756	0	0	0	0	0	0	0	0	0	0	0	0	0	0	0	0
"SAA2"	1198	9594	0	0	0	0	0	0	0	0	0	0	0	0	0	0	0	0
"SAA3"	644	3661	0	0	0	0	0	0	0	0	0	0	0	0	0	0	0	0
"SAA4"	638	5453	0	0	0	0	0	0	0	0	0	0	0	0	0	0	0	0
"SAAL1"	1548	25749	28	28	19	9	20	8	38	0	0	0	288	249	230	156	242	149
"SAC3D1"	1568	3925	8	0	0	8	0	0	18	0	0	0	229	123	199	75	271	136
"SACM1L"	3768	56148	3653	381	2048	1605	206	175	1725	104	524	85	2201	1937	1878	1339	2378	1284
"SACS"	15649	104878	1620	738	885	735	447	291	617	208	42	194	1756	1830	2113	1135	1930	852
"SAE1"	2701	79814	1537	642	793	744	321	321	802	635	699	1013	1321	1365	1781	1596	2174	1657
"SAFB"	3014	45326	5098	4607	2787	2311	2516	2091	2263	2636	3261	6290	1173	1978	2972	2647	3917	2461
"SAFB2"	3338	35929	3807	2805	2102	1705	1563	1242	1447	1631	2385	2497	1316	1363	2748	2372	3461	2147
"SAG"	1921	39394	1	0	0	1	0	0	21	22	0	0	0	0	0	0	0	0
"SAGE1"	3763	19369	0	0	0	0	0	0	0	0	0	0	0	0	0	0	0	0
"SAKI"	1452	5642	401	425	313	88	171	254	166	295	0	479	770	132	816	1093	1335	176
"SALF"	5750	18301	0	0	0	0	0	0	0	0	0	0	0	0	0	0	0	0
"SALL1"	5256	14624	0	0	0	0	0	0	24	0	0	0	0	0	0	0	0	0
"SALL2"	4912	16105	0	0	0	0	0	0	27	0	0	0	0	0	0	0	0	0
"SALL3"	4775	17918	0	0	0	0	0	0	0	0	0	0	0	0	0	0	0	0
"SALL4"	3486	18465	0	0	0	0	0	0	14	0	0	0	0	0	0	0	0	0
"SAMD1"	1304	2004	282	85	110	172	68	17	55	47	79	75	231	113	416	358	630	387
"SAMD10"	2186	5531	99	0	44	55	0	0	89	33	0	0	83	80	95	3	138	40
"SAMD11"	2568	18842	32	0	0	32	0	0	131	132	0	0	4	336	296	267	0	0
"SAMD12"	8874	432491	6528	2298	3718	2810	1269	1029	5287	2014	2491	1195	36	47	284	72	144	65
"SAMD13"	1765	6121	0	0	0	0	0	0	0	0	0	0	0	0	4	3	0	5
"SAMD14"	1869	17133	0	0	0	0	0	0	52	140	0	0	3	1	0	0	0	0
"SAMD3"	2388	221109	688	464	368	320	267	197	115	35	19	168	32	70	23	20	59	21
"SAMD4A"	6538	225398	323	237	226	97	175	62	573	511	37	35	34	40	312	267	141	96
"SAMD4B"	4504	42429	2656	2749	1478	1178	1441	1308	1242	2163	1121	3878	893	1838	1144	2171	1724	1289
"SAMD5"	6091	61096	0	0	0	0	0	0	0	0	0	0	0	0	0	0	0	0
"SAMD7"	2269	27466	0	0	0	0	0	0	9	0	0	0	0	0	0	0	0	0
"SAMD8"	1514	65216	1721	960	904	817	509	451	795	1074	479	2359	952	1139	471	407	504	304
"SAMD9"	6838	18492	657	251	381	276	168	83	538	193	0	30	1506	1667	2557	891	1737	884
"SAMD9L"	7138	18314	6218	2438	3413	2805	1311	1127	3368	692	2331	450	5194	514	7798	3211	7464	3481
"SAMHD1"	2717	59533	12625	1359	6880	5745	842	517	5412	429	10814	260	21364	4128	12593	9607	12352	7435
"SAMM50"	2378	21938	383	41	205	178	20	21	303	0	13	0	602	580	930	757	973	840
"SAMSN1"	2194	98176	7809	11103	4400	3409	5854	5249	4784	6592	2973	8673	1684	3327	3118	4857	3023	2823
"SAP130"	4194	86080	556	84	266	290	51	33	522	75	173	83	703	668	871	669	1096	718
"SAP18"	2304	8572	65	56	34	31	56	0	37	134	87	86	1505	2032	2223	1990	2378	1906
"SAP25"	969	1588	195	218	62	133	124	94	71	257	245	324	27	0	79	46	98	14
"SAP30"	1112	6591	24	0	15	9	0	0	0	0	0	0	128	0	137	90	143	106
"SAP30BP"	2529	40741	1658	4066	989	669	2204	1862	784	2205	218	3758	870	1393	964	1474	1261	1154
"SAP30L"	6228	15097	292	0	182	110	0	0	226	0	150	0	1271	846	1209	612	1682	654
"SAPS1"	3686	17594	2061	383	1121	940	116	267	927	434	1396	687	3193	3025	3009	3334	3601	2435
"SAPS2"	4186	73067	8304	3638	4764	3540	1969	1669	3397	2603	6048	7569	1538	1529	2259	2188	3428	2295
"SAPS3"	5146	154615	18053	19870	10021	8032	10625	9245	8136	9830	9757	20113	3062	3872	3457	3261	3445	2461
"SAR1A"	3073	20320	1366	2968	783	583	1599	1369	573	1611	270	1671	3282	4638	1163	1271	1203	1088
"SAR1B"	1372	26409	140	0	82	58	0	0	84	36	0	25	1197	1172	426	383	334	323
"SARDH"	3414	76393	18	7	9	9	0	7	471	355	0	9	94	56	210	243	345	327
"SARM1"	7007	29080	11	0	0	11	0	0	70	33	0	0	127	77	245	184	321	176
"SARNP"	2264	25195	3956	3449	2259	1697	1909	1540	1486	2697	1682	5439	124	266	525	513	683	619
"SARS"	1982	24247	594	106	314	280	68	38	420	188	107	157	1665	1536	1803	1170	1766	1908
"SARS2"	2127	34593	262	88	115	147	64	24	375	101	191	41	761	747	834	750	1040	875
"SART-2"	1372	172656	14270	12493	7800	6470	6803	5690	6288	9760	4365	7505	4377	4219	3791	2403	4964	2570
"SART1"	3620	18448	831	169	465	366	91	78	323	216	205	285	1802	1380	1932	1458	2721	1478
"SART3"	6618	19784	1758	969	958	800	539	430	847	829	391	983	1018	1034	1277	1367	1649	941
"SAS"	1491	3243	18	26	0	18	26	0	46	47	47	0	999	1748	976	1024	1160	893
"SASH1"	7729	209457	74	631	50	24	396	235	431	3425	0	688	267	343	372	327	595	287
"SASH3"	2699	15284	3338	503	1860	1478	240	263	1254	350	2570	505	7775	6137	11775	7445	13861	8777
"SASS6"	3912	49409	141	227	51	90	118	109	87	311	18	53	161	114	126	15	135	24
"SAT1"	1179	3052	1863	4371	1072	791	2358	2013	350	1259	503	1816	4096	6843	5543	12918	5617	8846
"SAT2"	969	1640	53	26	27	26	20	6	14	12	0	0	532	151	883	437	888	692
"SATB1"	5531	77565	305	70	176	129	45	25	419	81	62	19	334	346	1020	621	394	826
"SATB2"	5740	188597	82	29	51	31	20	9	210	2	54	7	229	304	117	133	189	112
"SATL1"	2198	16683	0	0	0	0	0	0	0	0	0	0	573	620	171	140	193	145
"SAV1"	3036	34665	212	5415	97	115	2825	2590	95	1570	0	2854	590	2937	353	1657	534	972
"SBC2"	7731	111625	2434	1167	1370	1064	665	502	1646	663	1300	1200	1844	1994	2221	2203	1863	1398
"SBDS"	1610	7900	23	87	0	23	63	24	50	95	0	110	445	784	414	791	861	443
"SBDSP"	1786	7898	89	80	64	25	37	43	96	93	23	142	245	370	386	408	348	341
"SBF1"	8056	30033	2135	723	1223	912	428	295	1048	653	258	1250	2591	2272	2822	3156	4258	2673
"SBF1P1"	6124	6124	0	0	0	0	0	0	0	0	0	0	28	35	0	0	0	0
"SBF2"	7479	515542	13318	7607	7731	5587	4297	3310	9982	6927	2804	7624	1819	2339	3410	3150	4223	3042
"SBK1"	4988	31324	4	0	0	4	0	0	96	31	0	0	0	0	0	0	5	0
"SBK2"	1049	6562	0	0	0	0	0	0	0	0	0	0	0	0	0	0	0	0
"SBNO1"	4212	54534	1555	960	936	619	642	318	931	613	641	1674	2458	2351	2050	1785	2110	1229
"SBNO2"	4956	66650	6930	3263	3705	3225	1776	1487	2661	2785	7552	7953	3846	3602	3972	2945	6179	3658
"SBP1"	4379	4379	112	0	67	45	0	0	136	74	0	0	171	129	155	142	212	135
"SBSN"	1947	4943	0	0	0	0	0	0	74	46	0	0	0	0	0	0	0	0
"SC2"	1240	36411	412	6	226	186	6	0	445	38	260	0	486	474	1003	1099	1274	1158
"SC4MOL"	2144	15408	261	373	156	105	197	176	159	233	0	335	1715	2644	960	776	1233	940
"SC5DL"	7022	20542	191	259	104	87	155	104	94	137	0	158	1216	1647	890	613	1084	630
"SC65"	2793	10651	0	0	0	0	0	0	26	0	0	0	3	5	0	0	0	0
"SCA7"	980	48368	2288	250	1213	1075	140	110	1322	232	222	129	19	62	33	30	27	20
"SCA8"	1477	32542	0	0	0	0	0	0	0	0	0	0	0	0	0	0	0	0
"SCAD-SRL"	1256	36469	616	24	341	275	24	0	636	31	415	116	985	1019	888	780	1273	725
"SCAF1"	4323	16525	627	244	335	292	154	90	373	351	108	605	1197	926	1299	1086	1817	1185
"SCAI"	12188	200911	848	62	491	357	22	40	500	26	79	40	308	351	148	42	252	31
"SCAMP1"	6251	120224	658	100	422	236	66	34	591	13	42	5	1249	1401	1014	852	1136	891
"SCAMP2"	2476	10389	2653	1081	1523	1130	690	391	1144	659	2616	2063	4592	4115	4764	1872	2905	4203
"SCAMP3"	1599	6426	145	12	45	100	6	6	230	42	9	36	1065	1107	1137	1052	1460	691
"SCAMP4"	2532	20640	779	172	427	352	103	69	461	284	483	206	1462	1211	1575	1215	2078	1160
"SCAMP5"	3473	25937	0	0	0	0	0	0	35	22	0	0	0	0	0	0	0	0
"SCAND1"	1729	5844	14	0	0	14	0	0	36	23	0	0	778	20	57	767	1111	718
"SCAND2"	4514	11005	798	151	404	394	98	53	403	40	377	124	1123	691	310	76	480	159
"SCAND3"	4880	15706	0	0	0	0	0	0	0	0	0	0	0	0	0	0	0	0
"SCAP"	4278	62263	1415	167	711	704	67	100	779	147	374	99	879	840	1204	819	1878	1103
"SCAPER"	5465	525696	292	69	162	130	35	34	241	115	0	156	199	278	230	229	286	192
"SCAPIN1"	1429	11699	0	0	0	0	0	0	0	0	0	0	0	0	0	0	0	0
"SCARA3"	3637	38962	0	0	0	0	0	0	0	0	0	0	0	0	0	0	0	0
"SCARA5"	3635	122447	0	0	0	0	0	0	184	43	0	0	0	0	0	0	0	0
"SCARB1"	2874	86346	10326	1998	5568	4758	1116	882	5245	1139	2097	560	5502	5126	2171	1488	4861	2446
"SCARB2"	4760	55143	190	143	114	76	72	71	567	283	0	0	1834	1708	5046	4842	2199	2190
"SCARF1"	3454	11891	1781	2605	944	837	1611	994	620	865	1633	1627	1756	765	1613	3003	1960	2640
"SCARF2"	3519	13273	0	0	0	0	0	0	56	75	0	35	0	15	5	4	58	20
"SCARNA1"	167	167	0	0	0	0	0	0	20	18	0	0	0	0	0	0	0	0
"SCARNA10"	331	331	2245	1599	1237	1008	0	1599	220	0	0	744	0	0	0	0	0	0
"SCARNA11"	138	138	0	0	0	0	0	0	0	78	0	0	0	0	0	0	0	0
"SCARNA12"	270	270	0	444	0	0	0	444	147	344	0	429	0	1475	0	0	0	0
"SCARNA13"	1958	1958	0	0	0	0	0	0	0	197	0	0	43	92	0	28	48	85
"SCARNA14"	138	138	0	0	0	0	0	0	0	0	0	0	0	0	0	0	0	0
"SCARNA15"	127	127	0	0	0	0	0	0	0	0	0	0	26	0	32	0	0	0
"SCARNA16"	187	187	35	0	0	35	0	0	52	70	0	0	22	26	28	33	20	14
"SCARNA17"	422	422	0	0	0	0	0	0	56	0	0	0	0	0	0	0	0	0
"SCARNA18"	133	133	0	0	0	0	0	0	18	23	0	0	0	0	0	0	0	0
"SCARNA2"	421	421	3902	0	2059	1843	0	0	0	1064	0	0	0	0	0	0	0	0
"SCARNA20"	131	131	107	77	62	45	0	77	0	45	0	0	0	0	0	0	0	0
"SCARNA21"	139	139	0	0	0	0	0	0	2	135	0	0	0	0	0	0	0	0
"SCARNA22"	125	125	0	0	0	0	0	0	23	0	0	0	0	0	0	0	0	0
"SCARNA23"	131	131	0	0	0	0	0	0	0	0	0	0	0	0	0	0	0	0
"SCARNA27"	127	127	0	0	0	0	0	0	25	0	0	0	18	9	20	0	22	0
"SCARNA3"	145	145	639	885	521	118	423	462	973	714	0	862	0	0	0	0	0	0
"SCARNA4"	130	130	118	0	118	0	0	0	81	0	0	158	0	0	0	0	0	0
"SCARNA5"	279	279	1391	1804	777	614	984	820	98	220	0	0	0	0	0	0	0	0
"SCARNA6"	267	267	468	0	261	207	0	0	79	0	0	0	10	0	0	0	0	0
"SCARNA7"	329	329	1731	1992	936	795	1067	925	178	577	0	0	0	0	0	0	0	0
"SCARNA8"	132	132	0	0	0	0	0	0	0	0	0	0	0	0	0	0	0	0
"SCARNA9"	353	353	546	0	312	234	0	0	86	107	0	138	24	0	0	6	0	0
"SCARNA9L"	348	348	0	0	0	0	0	0	0	44	0	99	0	0	0	0	0	0
"SCCA1"	1279	2075	0	0	0	0	0	0	0	0	0	0	0	0	0	0	0	0
"SCCPDH"	2484	44061	4	0	0	4	0	0	41	0	0	0	383	377	570	613	533	525
"SCCRO"	3038	37769	2357	1639	1366	991	955	684	922	1068	495	1587	1747	1853	449	400	435	262
"SCD"	5473	17817	769	370	412	357	195	175	366	212	0	21	11929	11400	9581	7422	11224	7432
"SCD5"	3108	169322	0	0	0	0	0	0	20	12	0	0	0	26	27	20	11	43
"SCDR10"	748	4557	0	0	0	0	0	0	123	105	0	0	0	0	7	0	6	4
"SCEL"	3257	109589	0	0	0	0	0	0	8	0	0	0	0	0	0	0	0	0
"SCFD1"	2181	113499	5018	1716	2874	2144	949	767	3051	1171	674	821	1358	1372	1415	1106	1631	1141
"SCFD2"	3182	493092	7762	5392	4401	3361	3114	2278	5266	3614	692	3087	316	190	422	447	428	416
"SCG2"	2476	5463	0	0	0	0	0	0	0	0	0	0	0	0	0	0	0	0
"SCG3"	3321	39674	0	0	0	0	0	0	0	53	0	0	0	0	0	0	0	0
"SCG5"	1250	55430	0	0	0	0	0	0	10	0	0	0	0	0	1	0	3	0
"SCGB1A1"	427	4145	14	0	14	0	0	0	33	0	26	0	42	2	40	0	35	20
"SCGB1C1"	434	1495	0	0	0	0	0	0	47	42	0	0	0	0	0	0	0	0
"SCGB1D1"	432	3301	0	0	0	0	0	0	0	0	0	0	0	0	0	0	0	0
"SCGB1D2"	440	2557	0	0	0	0	0	0	0	0	0	0	0	0	0	0	0	0
"SCGB1D4"	437	2784	0	0	0	0	0	0	0	0	0	0	0	0	0	0	0	0
"SCGB2A1"	524	5273	0	0	0	0	0	0	0	0	0	0	0	0	0	0	0	0
"SCGB2A2"	504	2999	0	0	0	0	0	0	8	0	0	0	0	0	0	0	0	0
"SCGB3A1"	468	1383	0	0	0	0	0	0	0	0	0	0	0	0	0	0	0	0
"SCGB3A2"	518	3481	0	0	0	0	0	0	0	0	0	0	0	0	0	0	0	0
"SCGBL"	429	1145	0	0	0	0	0	0	0	0	0	0	0	0	0	0	0	0
"SCGN"	1488	49579	0	0	0	0	0	0	33	0	0	0	0	0	0	0	0	0
"SCHIP1"	3922	130572	0	0	0	0	0	0	22	0	0	0	18	19	10	3	21	18
"SCIDA"	547	11796	346	28	187	159	14	14	210	94	139	45	50	78	171	72	122	80
"SCIN"	3259	83024	0	0	0	0	0	0	0	0	0	0	7	20	30	31	20	21
"SCLT1"	3684	88377	4554	3508	2673	1881	1916	1592	2861	2435	748	2205	369	418	338	314	385	232
"SCLY"	4261	33533	6315	375	3581	2734	207	168	3715	262	2571	330	1957	1864	3393	2573	3840	2709
"SCMH1"	3359	134231	195	11	128	67	11	0	110	22	0	25	70	57	17	35	79	79
"SCML1"	2915	17514	908	1534	542	366	838	696	233	468	0	403	509	894	272	351	329	319
"SCML2"	4213	115413	0	0	0	0	0	0	11	0	0	0	0	0	0	0	0	0
"SCML4"	4543	122158	0	0	0	0	0	0	0	0	0	21	0	0	0	0	0	3
"SCN10A"	5900	96665	0	0	0	0	0	0	0	0	0	0	0	0	0	0	0	0
"SCN11A"	6526	104794	0	0	0	0	0	0	0	8	0	0	0	0	0	0	0	0
"SCN12A"	1574	14016	0	0	0	0	0	0	0	0	0	0	0	0	0	0	0	0
"SCN1A"	8125	84480	0	0	0	0	0	0	0	0	0	0	0	0	0	0	0	0
"SCN1B"	1511	9820	3	1500	3	0	781	719	4	1058	0	653	6	352	8	397	10	117
"SCN2A"	8885	98479	0	0	0	0	0	0	0	0	0	0	0	0	0	0	0	0
"SCN2B"	4926	13820	0	0	0	0	0	0	21	0	0	0	0	0	0	0	0	0
"SCN3A"	9151	116547	3	0	0	3	0	0	65	36	0	0	4	0	0	0	0	0
"SCN3B"	6072	25422	0	0	0	0	0	0	0	0	0	0	0	0	0	0	0	0
"SCN4A"	7829	34366	0	0	0	0	0	0	304	51	0	0	0	0	0	0	0	0
"SCN4B"	4582	19538	2	1	2	0	0	1	119	42	0	0	2	2	0	0	0	0
"SCN5A"	8532	101612	3	0	0	3	0	0	282	55	0	0	4	3	0	0	0	0
"SCN7A"	5752	81941	0	0	0	0	0	0	0	0	0	0	21	5	0	0	0	0
"SCN8A"	7232	217279	0	0	0	0	0	0	9	0	0	0	0	0	0	0	0	0
"SCN9A"	9780	180795	6721	3289	3687	3034	1802	1487	2207	699	610	1380	2196	3353	595	512	1186	457
"SCNM1"	1009	1869	75	0	43	32	0	0	156	14	32	0	886	683	691	625	1146	581
"SCNN1A"	3491	28381	3	0	0	3	0	0	78	82	0	0	0	1	0	0	0	0
"SCNN1B"	2609	79030	0	0	0	0	0	0	142	13	0	0	0	0	0	0	0	0
"SCNN1D"	3072	11595	0	0	0	0	0	0	141	109	0	0	6	0	20	9	25	15
"SCNN1G"	3512	34162	0	0	0	0	0	0	0	0	0	0	0	0	0	0	0	0
"SCO1"	1758	17236	250	15	160	90	0	15	186	87	0	76	138	558	416	322	455	299
"SCO2"	1020	2036	482	2046	3	479	1103	943	298	3396	527	6712	701	8538	1238	5728	1184	2221
"SCOC"	2003	39097	25	0	9	16	0	0	68	0	0	0	993	997	860	719	1012	829
"SCP2"	5431	124336	923	52	553	370	46	6	578	89	27	0	2468	2825	3180	3005	3488	2450
"SCPEP1"	1956	28661	631	253	348	283	140	113	384	97	183	41	2020	2348	3192	3219	3537	3000
"SCRG1"	905	11319	129	0	95	34	0	0	148	0	0	0	0	0	3	0	0	0
"SCRIB"	5255	24461	402	73	224	178	25	48	484	311	502	71	874	863	906	814	1075	661
"SCRN1"	5309	49169	1523	177	777	746	105	72	1115	148	47	80	1720	2026	1226	864	3316	1676
"SCRN2"	1839	3652	45	0	20	25	0	0	48	39	11	0	192	149	229	147	293	150
"SCRN3"	2475	33262	375	0	238	137	0	0	393	10	0	0	380	383	439	323	419	308
"SCRT1"	3554	5491	0	0	0	0	0	0	0	43	0	0	1	0	0	0	0	0
"SCRT2"	3578	14584	7683	1316	4635	3048	733	583	1339	313	6198	1176	12	0	0	0	0	0
"SCS-betaA"	1522	52389	341	131	172	169	56	75	251	0	37	46	360	302	753	645	694	619
"SCT"	518	862	0	2	0	0	2	0	19	0	0	0	0	0	0	0	0	0
"SCTR"	1834	84609	0	0	0	0	0	0	41	7	0	0	0	0	0	0	0	0
"SCUBE1"	3850	140127	0	0	0	0	0	0	1267	586	0	0	0	0	0	0	0	0
"SCUBE2"	3759	71222	0	0	0	0	0	0	11	11	0	6	0	0	0	0	0	0
"SCUBE3"	5137	36421	104	0	7	97	0	0	424	106	70	0	0	0	0	0	0	0
"SCXB"	608	1530	1	0	1	0	0	0	0	0	0	0	0	1	0	21	0	11
"SCYA16"	1731	4989	0	0	0	0	0	0	11	8	0	0	0	0	0	0	0	0
"SCYL1"	2667	13636	328	67	166	162	40	27	302	301	33	417	1272	1273	1466	1223	1593	1219
"SCYL2"	3820	72365	1921	2280	1114	807	1223	1057	1182	1775	567	2260	2429	2955	3059	2978	3366	2347
"SCYL3"	3491	41274	678	110	384	294	66	44	450	0	136	36	355	236	394	186	411	194
"SDAD1"	3114	41046	211	260	100	111	145	115	139	228	0	102	311	231	918	682	1006	817
"SDC1"	3299	24638	0	0	0	0	0	0	117	45	0	0	0	0	11	0	5	23
"SDC2"	3490	118157	33238	20129	18474	14764	10848	9281	14166	6029	24159	23488	11225	12978	11625	11912	12804	11412
"SDC3"	6396	9276	159	0	113	46	0	0	852	214	73	0	1964	1502	3060	2212	3560	2003
"SDC4"	2615	23135	7266	76626	4005	3261	41057	35569	126	36354	0	75040	812	64266	1401	23796	1197	15017
"SDCBP"	3685	29692	5408	17701	2628	2780	9631	8070	1332	814	1655	8247	3070	24902	25364	11623	6188	20534
"SDCBP2"	1479	19217	269	105	137	132	45	60	146	74	171	39	29	29	26	18	40	29
"SDCCAG1"	4153	69008	7931	4832	4374	3557	2690	2142	3894	2471	3096	4873	7224	6930	13229	13206	13329	12714
"SDCCAG10"	2933	77761	343	85	169	174	47	38	550	86	74	89	354	284	382	354	331	284
"SDCCAG3"	2388	8681	150	0	86	64	0	0	157	36	12	30	443	260	517	415	838	456
"SDCCAG8"	2621	244074	11700	7391	6596	5104	4217	3174	6124	3588	1903	3153	1024	1087	743	712	927	642
"SDF2"	1077	13327	484	363	253	231	185	178	349	454	63	997	914	1035	929	922	1167	802
"SDF2L1"	876	2047	0	0	0	0	0	0	15	27	0	0	329	326	573	690	561	451
"SDF4"	3542	4444	1574	3393	821	753	1776	1617	471	1780	1103	4966	2190	4646	4899	4571	4121	5349
"SDHA"	2402	38458	2136	702	1109	1027	335	367	1367	472	817	628	1708	1896	2309	1927	3254	1972
"SDHAF1"	1114	1114	12	0	0	12	0	0	27	21	0	0	263	116	256	98	388	159
"SDHAF2"	1211	16632	1457	370	722	735	164	206	857	370	1004	1113	942	970	748	692	942	777
"SDHALP1"	2508	30360	3018	1700	1663	1355	917	783	1671	1085	1355	1739	401	418	1833	1425	2273	778
"SDHALP2"	2316	30825	3682	2182	2110	1572	1278	904	5088	1463	2447	2772	830	885	1803	1489	2406	971
"SDHB"	1151	35440	1002	78	553	449	53	25	511	134	549	121	1869	1496	2792	2159	2762	1692
"SDHC"	2856	50369	710	23	315	395	23	0	287	130	110	248	1446	1403	3516	3251	3834	2800
"SDHD"	1368	8948	961	767	576	385	429	338	421	365	486	922	3430	4279	4394	4228	5072	3697
"SDK1"	10439	967551	25	22	17	8	12	10	767	251	0	9	3	5	42	20	35	27
"SDK2"	10766	309705	0	0	0	0	0	0	1279	403	0	0	0	0	0	0	0	0
"SDPR"	3218	12942	0	0	0	0	0	0	0	0	0	0	241	232	65	0	111	19
"SDR16C5"	3192	20673	0	0	0	0	0	0	0	0	0	0	0	0	0	0	0	0
"SDR16C6"	978	22299	0	0	0	0	0	0	0	0	0	0	0	0	0	0	0	0
"SDR39U1"	1928	2963	1046	1028	1021	25	642	386	13	474	852	978	4335	3964	4991	3239	7188	3814
"SDR42E1"	2777	13843	0	0	0	0	0	0	26	0	0	0	0	0	0	0	0	0
"SDR9C7"	944	10428	0	0	0	0	0	0	13	0	0	0	0	0	0	0	0	0
"SDS"	1611	11442	252	1	143	109	0	1	188	30	75	33	39	28	125	95	30	25
"SDSL"	1402	15866	0	0	0	0	0	0	38	0	0	0	116	71	227	251	193	178
"SEBOX"	922	3792	27	11	16	11	3	8	31	18	42	0	0	1	1	0	0	0
"SEC11A"	1389	46901	3772	388	2044	1728	223	165	1861	204	2588	755	1731	1468	2508	2270	2146	2773
"SEC11B"	1526	46901	3772	388	2044	1728	223	165	1861	204	2588	755	1731	1468	2508	2270	2146	2773
"SEC11C"	1176	16565	99	17	71	28	10	7	124	11	0	0	384	456	499	476	496	353
"SEC11L3"	1082	13470	99	17	71	28	10	7	112	11	0	0	182	261	325	309	324	232
"SEC13"	2385	13045	1677	1217	983	694	654	563	739	846	989	1408	1027	1345	1613	1556	1123	1099
"SEC14L1"	5559	76176	7492	3793	4259	3233	2095	1698	3840	2751	3089	4144	3577	3759	5535	4219	6416	3792
"SEC14L2"	4278	28346	609	60	391	218	32	28	593	148	213	129	418	529	495	575	710	483
"SEC14L3"	2315	12819	0	0	0	0	0	0	0	11	0	0	0	0	0	0	0	0
"SEC14L4"	2587	16800	0	0	0	0	0	0	10	0	0	0	0	0	0	0	0	0
"SEC14L5"	6472	60840	4700	2266	2683	2017	1233	1033	2278	933	5320	2020	1475	751	907	394	1529	564
"SEC16A"	9073	42960	2678	2598	1464	1214	1449	1149	1803	2114	1450	4670	4047	4577	4402	3200	6478	4099
"SEC16B"	6354	109655	433	84	228	205	66	18	495	35	10	50	625	588	565	302	621	281
"SEC22A"	4237	65813	389	80	181	208	54	26	735	236	96	98	187	193	201	165	247	146
"SEC22B"	1824	20517	1359	2597	667	692	1446	1151	718	1252	163	2447	2193	3449	2059	3117	1878	1927
"SEC22C"	1628	33955	620	172	344	276	117	55	607	107	33	82	1626	1698	981	1301	1261	735
"SEC23A"	3861	71316	306	19	200	106	19	0	256	28	31	66	1142	1244	1875	1683	1969	1299
"SEC23B"	3451	53864	1300	636	759	541	397	239	721	807	232	604	2922	3232	3694	3364	3894	2852
"SEC23IP"	4262	49024	943	521	522	421	271	250	526	446	130	354	1456	1922	1988	1694	2273	1448
"SEC24A"	6409	79123	295	264	163	132	128	136	257	439	73	1026	1069	1402	1358	1466	1567	1054
"SEC24B"	4760	106645	4011	2796	2205	1806	1534	1262	2001	1667	620	2105	1242	1248	1735	1069	1907	1092
"SEC24C"	4552	27787	1870	1141	994	876	636	505	707	720	501	927	3244	3635	4478	3954	5096	3539
"SEC24D"	4088	113349	3480	991	1958	1522	525	466	1848	679	349	474	3010	3071	3259	2373	2893	2101
"SEC31A"	4491	81887	3708	2243	2098	1610	1164	1079	2193	1403	1284	1826	4149	4479	4987	3764	4494	2849
"SEC31B"	5093	33194	1087	302	588	499	167	135	824	243	613	250	1417	1281	1904	1546	2502	1630
"SEC34"	1002	21641	396	163	256	140	108	55	197	134	0	268	150	136	158	153	157	88
"SEC61A1"	3647	19315	1314	1157	720	594	595	562	520	669	483	956	7937	7838	9279	8342	11079	7641
"SEC61A2"	3251	18925	1796	1241	946	850	645	596	937	746	486	990	8934	8476	9766	8592	11811	8017
"SEC61B"	565	8332	345	620	216	129	338	282	111	279	0	295	956	787	1445	1239	1818	1522
"SEC61G"	469	7000	27	0	16	11	0	0	18	13	0	0	425	531	581	574	583	494
"SEC62"	6547	31581	1162	398	674	488	187	211	473	283	141	232	2891	3396	2627	2392	2885	1905
"SEC63"	6519	90522	2729	1443	1598	1131	812	631	1730	1015	765	879	1867	2105	2167	1853	2335	1620
"SECISBP2"	3585	40797	3102	2982	1699	1403	1572	1410	1766	1334	1217	2118	1301	1703	1488	1301	1523	1086
"SECISBP2L"	6932	57665	1086	1619	634	452	871	748	567	894	72	1451	560	661	834	889	754	931
"SECTM1"	2286	13022	21	5	9	12	5	0	203	94	0	0	619	701	476	384	853	500
"SEEK1"	865	25242	0	0	0	0	0	0	80	0	0	0	0	0	0	0	0	0
"SEH1L"	3512	39552	772	338	484	288	173	165	402	311	89	794	1071	1337	1287	1208	1253	1079
"SEL-OB"	2227	38585	0	0	0	0	0	0	0	0	0	0	0	0	0	0	0	0
"SEL1L"	6599	60967	3563	2797	2010	1553	1478	1319	1554	1372	677	2292	843	1276	6530	1951	6755	1006
"SEL1L2"	2370	141212	0	0	0	0	0	0	0	0	0	0	0	0	0	0	0	0
"SEL1L3"	4572	115562	44	20	20	24	17	3	201	111	0	49	439	379	1503	1604	984	943
"SELE"	3888	11440	0	0	0	0	0	0	0	0	0	0	0	0	0	0	0	0
"SELENBP1"	2124	8385	0	0	0	0	0	0	57	12	0	0	0	3	27	22	11	3
"SELI"	8137	49807	1504	1165	855	649	680	485	804	1014	196	1609	733	1139	830	890	855	567
"SELK"	820	6764	34	1161	20	14	599	562	16	628	0	585	479	309	443	814	392	670
"SELL"	2441	21029	0	0	0	0	0	0	0	0	0	0	225	300	160	319	129	104
"SELM"	1054	15292	0	0	0	0	0	0	54	14	0	0	29	8	4	12	43	23
"SELO"	2321	16638	1943	503	1120	823	288	215	851	383	1875	959	1319	970	1315	780	1538	688
"SELP"	3186	41289	0	0	0	0	0	0	0	0	0	0	0	0	0	0	0	0
"SELPLG"	2535	11990	632	125	344	288	84	41	394	88	370	7	126	8421	200	114	13864	7218
"SELS"	1297	6488	153	139	70	83	84	55	58	43	0	234	743	1007	872	1047	1022	835
"SELT"	3492	27168	2820	1064	1524	1296	540	524	1126	1094	372	1308	3758	4336	5581	5507	5581	4128
"SELV"	1708	5575	0	0	0	0	0	0	0	0	0	0	0	0	0	0	0	0
"SEMA 3B"	3170	8266	4	0	4	0	0	0	69	100	0	0	4	8	0	0	3	3
"SEMA3A"	5670	236554	0	0	0	0	0	0	0	0	0	0	0	0	4	0	0	0
"SEMA3B"	3066	8266	4	0	4	0	0	0	69	100	0	0	4	8	0	0	3	3
"SEMA3C"	5191	176814	10112	10232	5595	4517	5484	4748	6223	4196	875	3268	1854	2805	3415	3215	2764	674
"SEMA3D"	6406	158183	0	0	0	0	0	0	0	0	0	0	0	0	0	0	0	0
"SEMA3E"	6491	285104	0	0	0	0	0	0	0	0	0	0	0	0	0	0	0	0
"SEMA3F"	3560	30057	5	0	5	0	0	0	275	155	0	0	0	0	0	0	0	0
"SEMA3G"	4716	11777	18	1	12	6	0	1	176	49	0	0	27	21	249	154	127	124
"SEMA4A"	3293	24206	661	1095	371	290	553	542	389	947	167	2462	1671	2434	1581	1914	1959	1232
"SEMA4B"	3827	44740	48	0	16	32	0	0	271	81	34	0	235	87	311	95	367	123
"SEMA4C"	3794	7195	0	0	0	0	0	0	53	34	0	0	0	50	17	104	11	41
"SEMA4D"	4646	102461	1452	263	751	701	118	145	1991	606	822	494	1025	1122	1038	695	1515	934
"SEMA4F"	4287	27794	0	0	0	0	0	0	0	0	0	0	13	0	7	4	9	8
"SEMA4G"	4671	16094	11	0	11	0	0	0	106	13	0	0	67	69	47	30	28	7
"SEMA5A"	11831	511097	0	0	0	0	0	0	0	0	0	0	0	0	0	0	0	0
"SEMA5B"	4730	118535	0	0	0	0	0	0	149	71	0	0	0	0	0	0	0	0
"SEMA6A"	6930	131301	1582	1036	933	649	610	426	789	469	0	134	26	43	70	72	39	13
"SEMA6B"	3959	17173	0	0	0	0	0	0	91	10	0	0	0	0	0	0	4	8
"SEMA6C"	4004	14941	0	0	0	0	0	0	36	38	0	0	0	3	0	0	0	0
"SEMA6D"	6117	55735	0	0	0	0	0	0	25	7	0	0	0	0	0	0	0	0
"SEMA7A"	3389	24670	2588	2902	1432	1156	1542	1360	1064	2065	1879	5245	1159	1916	1851	2056	2207	2549
"SEMG1"	1666	2778	0	0	0	0	0	0	0	0	0	0	0	0	0	0	0	0
"SEMG2"	2020	17462	0	0	0	0	0	0	0	0	0	0	0	0	0	0	0	0
"SENP1"	5080	63019	163	150	101	62	89	61	115	276	44	87	201	421	466	403	471	339
"SENP2"	3209	44854	209	394	141	68	202	192	229	105	0	250	402	630	515	575	647	515
"SENP3"	2494	9968	512	63	270	242	37	26	376	222	208	297	949	783	968	775	1359	694
"SENP5"	6315	66857	4892	5039	2668	2224	2794	2245	1833	2838	1347	4460	1795	2337	1700	1642	1965	1244
"SENP6"	6665	116373	11182	7620	6250	4932	4202	3418	5091	3610	4102	5267	3437	3833	2732	2063	3316	2274
"SENP7"	4955	188967	1640	451	946	694	251	200	1294	468	104	422	620	885	689	633	619	359
"SENP8"	1440	22551	0	0	0	0	0	0	0	10	0	0	67	48	57	20	45	10
"SEP15"	1841	51979	1679	371	946	733	210	161	833	321	233	230	4342	4343	5173	4181	5344	4197
"SEPHS1"	4109	4109	485	152	291	194	95	57	404	57	218	61	821	998	342	480	1282	350
"SEPHS2"	2265	2267	170	99	94	76	60	39	79	72	67	0	4855	3172	6019	3748	6344	3589
"SEPN1"	4341	18048	637	54	339	298	23	31	487	160	426	143	2578	2430	3335	2810	3878	3069
"SEPP1"	4211	12043	0	0	0	0	0	0	0	0	0	0	164	189	87	438	102	35
"SEPSECS"	5793	40578	714	552	379	335	365	187	492	188	93	352	772	852	888	654	905	575
"SEPT1"	1601	4716	54	1	35	19	0	1	41	15	0	0	67	71	50	67	123	70
"SEPT10"	4195	31972	807	254	500	307	178	76	469	97	151	206	643	585	444	465	729	428
"SEPT11"	5564	88874	9639	11016	5372	4267	5944	5072	3822	5724	2140	6614	3661	789	4171	3800	4425	3166
"SEPT12"	1495	10725	0	0	0	0	0	0	30	41	0	0	1	1	0	0	0	0
"SEPT13"	3080	45229	185	22	145	40	10	12	383	20	0	0	139	94	193	97	209	79
"SEPT14"	3795	69247	0	0	0	0	0	0	0	0	0	0	0	0	0	0	0	0
"SEPT2"	3682	38160	6115	3772	3372	2743	2001	1771	2512	2073	3375	4645	12424	14679	11681	11343	13372	8485
"SEPT3"	4664	21294	0	0	0	0	0	0	57	26	0	0	16	15	92	71	62	25
"SEPT4"	1916	11797	0	0	0	0	0	0	36	9	0	0	0	0	0	0	0	0
"SEPT5"	4683	7556	0	0	0	0	0	0	21	36	0	0	4	0	4	5	12	14
"SEPT6"	4705	76424	3062	612	1740	1322	298	314	1041	431	1365	519	2742	1878	1694	1264	3093	1606
"SEPT7"	2526	104290	8937	2458	5033	3904	1414	1044	4009	1174	1884	1317	3405	3467	4655	3572	5295	3784
"SEPT8"	4354	21372	123	0	44	79	0	0	240	53	95	26	362	544	647	443	1073	527
"SEPT9"	4466	181081	53724	28827	29641	24083	15265	13562	18135	19639	52873	35408	14521	13608	13153	11503	17232	11756
"SEPW1"	880	6099	155	0	76	79	0	0	159	94	0	75	254	271	460	400	683	390
"SEPX1"	1368	5061	106	4	55	51	4	0	118	37	0	0	893	571	197	891	247	994
"SERAC1"	5176	56657	238	0	131	107	0	0	187	7	37	0	340	275	294	143	342	159
"SERBP1"	6770	22630	1333	1298	761	572	703	595	673	650	129	905	4536	5093	6739	6565	7740	4779
"SERF1"	1798	17860	0	0	0	0	0	0	0	0	0	0	0	0	52	121	72	92
"SERF1A"	712	7458	0	0	0	0	0	0	0	0	0	0	0	0	52	82	72	63
"SERF1B"	1915	17869	0	0	0	0	0	0	0	0	0	0	0	0	52	121	72	92
"SERF2"	2899	4114	1146	823	629	517	426	397	517	516	1100	808	11017	10835	16396	15907	18694	14364
"SERGEF"	1501	225040	4032	591	2273	1759	341	250	3113	1121	442	822	260	255	279	239	425	276
"SERHL"	2063	20464	665	313	408	257	189	124	778	568	228	646	906	1082	1486	1319	2930	1825
"SERHL2"	1592	17984	177	29	101	76	17	12	225	71	48	76	37	75	141	48	158	110
"SERINC1"	3138	28461	1620	1207	837	783	677	530	914	491	160	521	9700	11259	7865	7349	7075	6158
"SERINC2"	2209	20257	32	0	11	21	0	0	102	120	0	0	295	233	636	549	639	533
"SERINC3"	2730	22827	1571	593	936	635	343	250	590	186	357	401	5015	5762	5151	3875	5490	3700
"SERINC4"	1501	5092	1102	1063	740	362	558	505	629	572	994	433	11017	10865	12471	12026	14446	63
"SERINC5"	1673	144398	12724	13246	7358	5366	7192	6054	4554	4356	4010	4751	2539	3120	3789	3608	3791	3390
"SERP1"	3996	61236	1478	1325	867	611	728	597	803	1029	130	903	9951	9897	9391	8842	9646	6605
"SERP2"	786	23873	0	0	0	0	0	0	9	7	0	0	0	0	0	0	0	0
"SERPINA1"	3538	13946	136	1887	84	52	971	916	14	1229	0	1329	650	3361	593	3190	861	1696
"SERPINA10"	2456	9711	0	0	0	0	0	0	0	12	0	0	0	0	0	0	0	0
"SERPINA11"	1476	10323	0	0	0	0	0	0	0	0	0	0	0	0	0	0	0	0
"SERPINA12"	2066	30562	0	0	0	0	0	0	32	0	0	0	0	0	0	0	0	0
"SERPINA13"	1722	6270	0	0	0	0	0	0	16	0	0	0	0	0	0	0	0	0
"SERPINA3"	2663	11663	0	0	0	0	0	0	36	0	0	0	0	0	0	0	0	0
"SERPINA4"	1983	8464	0	0	0	0	0	0	12	0	0	0	0	0	0	0	0	0
"SERPINA5"	2318	11728	0	0	0	0	0	0	0	10	0	0	0	0	0	0	0	0
"SERPINA6"	1645	19104	0	0	0	0	0	0	0	0	0	0	0	0	0	0	0	0
"SERPINA7"	1781	4089	0	0	0	0	0	0	0	0	0	0	0	0	0	0	0	0
"SERPINA9"	1844	13612	0	0	0	0	0	0	23	0	0	0	0	0	0	0	0	0
"SERPINB1"	1430	8347	1086	1685	604	482	897	788	516	818	274	891	4468	275	3175	1901	1868	1680
"SERPINB10"	1290	27282	0	0	0	0	0	0	0	0	0	0	0	0	0	0	0	0
"SERPINB11"	1843	21037	0	0	0	0	0	0	0	0	0	0	0	0	0	0	0	0
"SERPINB12"	1283	10851	0	0	0	0	0	0	0	0	0	0	0	0	0	0	0	0
"SERPINB13"	3398	11900	0	0	0	0	0	0	0	0	0	0	0	0	0	0	0	0
"SERPINB2"	2171	16183	0	0	0	0	0	0	0	0	0	0	0	0	0	10	0	0
"SERPINB3"	1783	6766	0	0	0	0	0	0	0	0	0	0	0	0	0	0	0	0
"SERPINB4"	1725	7009	0	0	0	0	0	0	0	0	0	0	0	0	0	0	0	0
"SERPINB5"	2639	28175	0	0	0	0	0	0	0	0	0	0	0	0	0	0	0	0
"SERPINB6"	3608	10011	1991	1240	1030	961	656	584	1220	991	1404	2071	2024	2734	2855	1835	3574	2434
"SERPINB7"	2242	29993	0	0	0	0	0	0	0	0	0	0	0	0	0	0	0	0
"SERPINB8"	3396	19346	637	2556	391	246	1395	1161	536	1255	39	2364	1482	4643	1666	4214	1637	2309
"SERPINB9"	4150	16041	400	4162	236	164	2234	1928	42	2297	0	3840	583	8484	588	7603	536	3258
"SERPINC1"	1605	13575	0	0	0	0	0	0	0	0	0	0	0	0	0	0	0	0
"SERPIND1"	2245	8496	429	160	249	180	108	52	316	212	0	209	0	0	0	0	1	0
"SERPINE1"	3185	12165	265	2668	160	105	1372	1296	29	2277	0	3051	615	15120	413	9276	425	6447
"SERPINE2"	2684	56432	0	0	0	0	0	0	0	8	0	0	0	10	0	3	3	0
"SERPINE3"	1448	21073	1046	1994	645	401	1184	810	371	652	37	620	451	635	0	6	3	1
"SERPINF1"	1549	15610	51	0	15	36	0	0	134	14	0	0	161	103	146	59	229	87
"SERPINF2"	2294	12431	72	19	45	27	17	2	241	109	62	5	151	100	158	84	287	118
"SERPING1"	1989	17301	0	0	0	0	0	0	0	0	0	0	18	1	26	6	13	20
"SERPINH1"	3413	10431	6	0	6	0	0	0	28	0	0	0	233	205	309	229	371	227
"SERPINI1"	1918	89847	1	0	0	1	0	0	25	0	0	0	7	0	13	5	0	5
"SERPINI2"	1502	31894	0	0	0	0	0	0	0	0	0	0	0	0	0	0	0	0
"SERTAD1"	1204	3523	53	26	36	17	0	26	43	60	0	95	138	133	191	1214	116	118
"SERTAD2"	5549	22292	748	128	440	308	59	69	572	286	110	450	2019	1679	2105	1371	2232	17
"SERTAD3"	1519	1758	264	189	168	96	106	83	79	114	56	114	1171	821	1189	765	1708	837
"SERTAD4"	2010	10245	0	0	0	0	0	0	0	0	0	0	0	0	0	0	0	0
"SESN1"	2767	107632	1684	464	895	789	250	214	1342	363	50	577	427	377	609	383	548	456
"SESN2"	3494	22997	135	9	79	56	9	0	159	42	0	18	321	348	538	425	743	449
"SESN3"	1997	58115	2614	7121	1567	1047	3928	3193	1809	6161	145	8495	259	4913	368	3333	3490	276
"SESTD1"	10464	162931	6992	29565	4103	2889	16072	13493	3181	16826	975	27821	920	1538	1027	2366	949	577
"SET"	2926	7167	607	222	336	271	95	127	241	91	52	329	4514	5854	5723	4527	6121	4744
"SETBP1"	9903	387612	8717	6593	4939	3778	3553	3040	5816	5109	2855	6526	307	331	426	263	457	174
"SETD1A"	6466	27368	487	116	242	245	48	68	499	156	270	242	1003	721	1029	617	1496	646
"SETD1B"	8219	27933	1583	493	904	679	246	247	611	626	844	964	1278	1054	1626	1474	2068	1237
"SETD2"	8687	147569	9284	2698	5306	3978	1445	1253	4208	1549	3342	3302	2886	3201	2780	2176	3724	2089
"SETD3"	2900	83144	12716	4921	7064	5652	2623	2298	5069	2141	7232	5162	3212	3165	3350	3125	4149	1446
"SETD4"	4281	25721	379	0	244	135	0	0	389	13	60	67	1947	1536	2549	1737	2836	1734
"SETD5"	6848	80435	9631	11643	5390	4241	6323	5320	3796	5327	3792	9316	2366	3180	2772	2919	3476	2031
"SETD6"	2986	5049	496	264	306	190	159	105	0	63	28	304	1175	1277	1091	805	1412	855
"SETD7"	7019	50386	874	48	539	335	37	11	781	10	182	0	2954	2815	3130	2264	3524	1796
"SETD8"	2757	25196	776	256	440	336	130	126	403	281	307	438	642	560	1200	902	1277	787
"SETDB1"	4468	38407	1264	381	706	558	197	184	842	186	573	195	1549	1138	1714	1081	2500	995
"SETDB2"	6234	50711	2008	369	1136	872	196	173	1085	76	388	122	1170	746	1117	542	886	618
"SETMAR"	2176	13653	1707	1733	985	722	915	818	578	691	223	786	466	687	126	152	142	135
"SETX"	11041	93546	11896	5326	6690	5206	2967	2359	5340	2343	5398	4668	7945	7735	5274	3530	5546	2441
"SEZ6"	4229	51136	969	169	515	454	127	42	1060	471	183	162	0	2	0	0	0	0
"SEZ6L"	3421	210956	0	0	0	0	0	0	64	0	0	0	8	5	20	14	24	35
"SEZ6L2"	3568	28100	0	0	0	0	0	0	99	37	0	0	0	1	0	0	0	0
"SF1"	3522	14165	4023	3902	2184	1839	2196	1706	1749	1757	2706	3603	5095	4435	4742	4012	7496	5976
"SF3A1"	5134	24936	901	758	512	389	388	370	496	682	243	779	2298	3186	3165	2984	4003	2746
"SF3A2"	1658	11863	357	68	216	141	28	40	334	182	40	482	574	396	694	586	979	533
"SF3A3"	2851	33109	921	52	596	325	28	24	436	90	106	74	836	867	1687	1207	1903	1193
"SF3B1"	4315	43073	3294	3875	1920	1374	2087	1788	1804	2136	1126	2109	7504	10223	9387	9282	10775	5581
"SF3B14"	774	8861	77	0	27	50	0	0	84	14	0	0	105	595	618	546	742	454
"SF3B2"	2916	16568	526	424	267	259	199	225	311	375	52	202	2785	2252	3428	3121	4198	2911
"SF3B3"	9745	53881	1846	1584	1053	793	810	774	965	1260	943	2136	2459	2790	2834	2559	3411	2260
"SF3B4"	2089	5027	0	25	0	0	25	0	68	90	0	50	1188	1053	666	787	812	635
"SF3B5"	738	738	0	0	0	0	0	0	15	11	0	0	883	878	1151	1116	1390	1084
"SF4"	2284	43986	545	33	266	279	29	4	421	141	191	0	278	149	662	450	758	472
"SFI1"	4284	122274	2673	1124	1603	1070	580	544	1181	419	1284	603	875	903	1524	966	2060	1080
"SFMBT1"	3716	140655	3152	447	1743	1409	234	213	1493	279	204	432	968	810	403	349	393	292
"SFMBT2"	4384	249203	7523	7468	4336	3187	4128	3340	4239	6287	1960	8338	702	2491	329	2736	965	1725
"SFN"	1316	1316	0	0	0	0	0	0	0	10	0	0	0	0	0	0	0	0
"SFPQ"	3081	9542	9508	12054	5260	4248	6488	5566	3942	5303	4916	8924	7520	13699	10041	14553	9853	9896
"SFRP1"	4457	47503	0	0	0	0	0	0	77	47	0	0	0	0	0	0	0	0
"SFRP2"	1993	8488	0	0	0	0	0	0	0	0	0	0	0	0	0	0	0	0
"SFRP4"	2978	10991	0	0	0	0	0	0	0	0	0	0	0	0	0	0	0	0
"SFRP5"	1884	5248	0	0	0	0	0	0	0	13	0	0	0	0	0	0	0	0
"SFRS1"	5644	6427	3102	2073	1571	1531	1117	956	1425	875	948	784	5618	7032	5784	5494	6547	4694
"SFRS10"	4160	23566	6948	12442	3861	3087	6701	5741	2925	6317	3565	9867	3141	6943	3906	5831	4044	4567
"SFRS11"	4022	21724	5467	6746	3051	2416	3680	3066	2970	3339	2105	3926	4502	6573	5737	6064	6175	3522
"SFRS12"	4216	36051	5019	3442	2773	2246	1830	1612	2149	1450	1038	1796	2325	2867	2500	1784	2588	1289
"SFRS12IP1"	6856	50518	189	10	129	60	0	10	211	25	0	11	705	751	613	322	659	402
"SFRS13A"	2934	11239	2184	3362	1301	883	1885	1477	1055	1597	892	2517	516	4359	2185	2649	2031	1737
"SFRS13B"	3603	22123	0	15	0	0	15	0	24	126	0	76	0	49	0	0	0	0
"SFRS14"	5556	41658	4095	2244	2256	1839	1225	1019	1823	790	3105	1944	2552	2782	3812	3336	5475	3052
"SFRS15"	4289	61120	3868	2183	2212	1656	1252	931	2204	1421	505	2142	660	853	824	1126	803	889
"SFRS16"	2786	31433	2491	999	1383	1108	587	412	1141	888	1856	1812	819	812	1079	921	1663	933
"SFRS17A"	3282	10925	0	0	0	0	0	0	0	0	0	0	0	0	2431	2322	3128	1941
"SFRS18"	3231	25366	3879	3399	1922	1957	1838	1561	1284	1427	1451	1967	1307	2189	4169	2932	4689	1985
"SFRS2"	2882	3215	431	0	0	431	0	0	0	649	599	720	4672	6529	5503	7348	6044	5823
"SFRS2B"	4332	4333	76	0	56	20	0	0	0	0	0	0	981	826	839	562	1039	553
"SFRS2IP"	7609	71487	9819	3972	5464	4355	2164	1808	4547	1832	2729	2452	7313	7762	6617	4702	8052	4108
"SFRS3"	3606	10155	1280	2557	801	479	1422	1135	678	1021	657	1924	3817	5702	4276	5254	5086	5170
"SFRS4"	2535	34388	5092	6821	2712	2380	3813	3008	2066	3314	2603	6443	2720	3812	2771	2930	3087	2163
"SFRS5"	3487	5892	4046	10649	2357	1689	5828	4821	1491	4160	2264	10025	6287	14118	8059	13221	8662	10654
"SFRS6"	4019	5740	1817	2192	1038	779	1198	994	638	883	554	1031	3736	5807	5070	5741	4736	4511
"SFRS7"	2495	7895	1482	1476	826	656	823	653	695	864	478	1071	2706	2344	2662	3416	2907	3192
"SFRS8"	5754	67232	3778	2945	2156	1622	1679	1266	2116	2148	1267	3404	730	713	1008	705	1104	710
"SFRS9"	1166	8088	1322	552	735	587	306	246	643	353	767	725	3005	3030	2179	2538	2370	1915
"SFT2D1"	696	22474	2569	3038	1424	1145	1614	1424	1039	1617	570	2813	1595	2097	1201	2146	1543	1180
"SFT2D2"	863	16834	19534	10522	10513	9021	5657	4865	6403	4280	7111	4082	9570	10014	1597	950	1678	702
"SFT2D3"	2810	2810	94	143	52	42	81	62	88	55	0	59	795	21	375	199	414	237
"SFTA2"	456	826	0	0	0	0	0	0	0	0	0	0	0	0	0	0	0	0
"SFTA3"	1488	40496	0	0	0	0	0	0	0	0	0	0	0	0	0	0	0	0
"SFTPA1"	1317	4487	0	0	0	0	0	0	0	0	0	0	0	0	0	0	0	0
"SFTPA1B"	977	3258	0	0	0	0	0	0	0	0	0	0	0	0	0	0	0	0
"SFTPA2"	2206	4556	0	0	0	0	0	0	0	0	0	0	0	0	0	0	0	0
"SFTPA2B"	312	1097	0	0	0	0	0	0	0	0	0	0	0	0	0	0	0	0
"SFTPB"	2782	10935	0	0	0	0	0	0	90	0	0	0	0	0	0	0	0	0
"SFTPC"	1504	5757	0	0	0	0	0	0	0	17	0	0	0	0	0	0	0	0
"SFTPD"	1289	11365	0	0	0	0	0	0	14	0	0	0	2	6	0	0	11	0
"SFXN"	2429	24650	36	0	26	10	0	0	60	5	0	0	66	49	87	78	72	6
"SFXN1"	3002	50109	10	0	10	0	0	0	52	0	0	0	542	406	424	346	362	233
"SFXN2"	2574	24650	36	0	26	10	0	0	60	5	0	0	66	49	87	78	72	6
"SFXN3"	3101	10003	1003	327	498	505	196	131	635	229	691	197	2913	2703	3002	1917	3795	2277
"SFXN4"	1409	24453	172	2	105	67	0	2	108	9	111	81	324	183	331	342	303	272
"SFXN5"	4153	129801	4626	871	2646	1980	438	433	3091	972	1537	1076	1029	997	1145	1089	1468	977
"SGCA"	1442	9928	1	0	0	1	0	0	93	44	0	0	0	0	0	0	0	0
"SGCB"	4285	17626	0	11	0	0	2	9	10	0	0	0	1036	1155	485	488	736	401
"SGCD"	9796	441031	0	0	0	0	0	0	14	0	0	0	0	0	0	0	0	0
"SGCE"	1905	67900	0	0	0	0	0	0	7	0	0	0	0	0	0	0	0	0
"SGCG"	1815	144246	0	0	0	0	0	0	0	0	0	0	0	0	0	0	0	0
"SGCZ"	2185	1148420	0	0	0	0	0	0	12	0	0	0	0	0	0	0	0	0
"SGEF"	5196	136469	69	0	50	19	0	0	67	13	0	19	29	30	0	4	0	0
"SGIP1"	4718	210944	0	0	0	0	0	0	0	0	0	0	0	0	0	0	0	0
"SGK1"	3214	148813	1494	4759	837	657	2500	2259	551	101	432	1648	3445	4874	5694	8760	4345	8192
"SGK196"	1620	29668	690	88	417	273	44	44	433	45	134	0	1374	860	149	52	138	29
"SGK2"	2131	19537	14	0	2	12	0	0	291	7	0	0	32	2	9	11	73	3
"SGK269"	11582	176864	432	564	262	170	401	163	487	577	19	369	940	1070	1049	955	1138	531
"SGK3"	4516	194406	15531	3444	8674	6857	1944	1500	7311	1390	6836	2235	3026	3390	1989	1448	2183	1203
"SGK493"	2506	10507	0	0	0	0	0	0	11	29	0	0	0	0	0	0	0	0
"SGMS1"	3763	318393	5781	5473	3385	2396	2999	2474	4362	3420	308	2956	620	684	801	755	892	725
"SGMS2"	6234	21782	395	10885	224	171	5868	5017	49	4428	0	3404	733	1594	315	610	550	528
"SGN3"	1733	34452	330	110	182	148	52	58	173	86	46	71	1075	1061	1121	1227	1567	1019
"SGOL1"	2392	25534	201	0	90	111	0	0	113	14	0	0	5	5	0	1	0	0
"SGOL2"	4551	57955	0	0	0	0	0	0	11	9	0	0	151	171	165	105	155	121
"SGPL1"	5782	65228	11300	14101	6479	4821	7619	6482	3671	5980	4045	12704	10103	13936	9094	8467	9623	7090
"SGPP1"	3309	43821	2375	214	1282	1093	149	65	921	93	280	241	33	1795	1734	1232	1612	1141
"SGPP2"	1348	134296	4603	73829	2652	1951	39640	34189	0	25309	0	48206	14	1081	6	561	16	47
"SGSH"	5645	11120	1305	831	286	1019	492	339	1172	394	366	659	258	248	1941	3834	4734	2866
"SGSM1"	7251	83388	0	0	0	0	0	0	115	53	0	0	0	0	0	0	0	0
"SGSM2"	4890	43543	2834	1360	1455	1379	784	576	1465	917	2271	1686	1560	1819	2447	2178	3384	2362
"SGSM3"	3222	39700	5174	4473	2804	2370	1354	3119	616	12285	3001	23562	4020	262	4119	1013	6361	5552
"SGTA"	2327	28644	1074	875	646	428	448	427	667	762	839	1876	1684	1366	2022	1792	2166	1555
"SGTB"	5462	56186	491	1896	276	215	1106	790	157	2286	5	647	1245	427	746	1033	810	594
"SH2B1"	4874	10221	1492	470	813	679	247	223	484	261	1153	678	810	622	1482	845	2043	826
"SH2B2"	1900	33774	1021	141	516	505	89	52	557	230	554	253	246	160	301	119	322	161
"SH2B3"	5413	45676	16676	18438	9223	7453	9841	8597	4604	11806	13631	25785	7197	11349	8027	11057	9366	6952
"SH2D1A"	2503	26862	0	0	0	0	0	0	0	0	0	0	35	49	6	8	8	3
"SH2D1B"	2539	16874	0	0	0	0	0	0	0	0	0	0	71	111	10	6	80	43
"SH2D2A"	1683	10607	24	0	24	0	0	0	71	39	0	0	10	3	0	10	0	18
"SH2D3A"	2364	15350	0	0	0	0	0	0	29	16	0	0	0	1	0	0	0	1
"SH2D3C"	3165	40453	1695	11	925	770	11	0	898	190	1401	65	510	220	473	130	1082	304
"SH2D4A"	2868	82109	0	0	0	0	0	0	0	0	0	0	0	0	0	0	0	0
"SH2D4B"	3990	108660	1	0	1	0	0	0	0	0	0	13	9	14	0	0	0	0
"SH2D5"	3844	12910	0	0	0	0	0	0	16	17	0	0	0	1	0	0	0	0
"SH2D6"	1996	18098	0	0	0	0	0	0	35	14	0	0	0	0	0	0	0	0
"SH2D7"	1898	11468	9	0	2	7	0	0	0	1	0	0	0	0	0	0	0	0
"SH3BGR"	1227	63648	0	0	0	0	0	0	0	0	0	0	39	30	37	33	44	32
"SH3BGRL"	2367	96741	13718	3475	7807	5911	1861	1614	5811	1238	3999	862	11764	12224	9146	9354	11286	10301
"SH3BGRL2"	4650	72371	0	0	0	0	0	0	0	0	0	0	0	2	16	12	5	3
"SH3BGRL3"	1117	1801	726	240	26	700	147	93	246	362	477	313	32644	29126	26674	28728	38791	30312
"SH3BP1"	3783	27884	4562	865	2668	1894	451	414	1478	516	3951	680	3423	2524	4244	2389	5433	2687
"SH3BP2"	9432	14772	13409	25296	7272	6137	13235	12061	3082	9658	10508	35410	3726	8327	4010	7131	4805	3783
"SH3BP4"	5248	77029	90	0	45	45	0	0	410	99	0	0	368	295	316	161	555	318
"SH3BP5"	2940	78341	1041	464	673	368	281	183	738	198	252	185	256	66	278	584	1020	698
"SH3BP5L"	3189	15505	620	20	344	276	0	20	300	76	178	0	1042	721	1636	1076	1929	1120
"SH3D19"	5294	106229	0	0	0	0	0	0	19	0	0	0	0	3	0	0	3	0
"SH3D20"	2210	4395	670	11	482	188	7	4	239	112	173	99	92	89	49	131	128	140
"SH3GL1"	2452	40105	3712	1776	2058	1654	906	870	1707	2002	4640	5965	1366	815	751	1394	2257	1514
"SH3GL2"	2735	218169	0	0	0	0	0	0	10	0	0	0	0	0	0	0	0	0
"SH3GL3"	2216	171402	0	0	0	0	0	0	13	0	0	0	0	0	0	0	0	0
"SH3GLB1"	6469	43611	2504	1548	1517	987	895	653	1374	705	449	857	4445	4039	3516	2703	4188	2571
"SH3GLB2"	2023	20267	710	253	306	404	118	135	197	219	518	401	498	467	1157	771	1136	766
"SH3KBP1"	4783	353662	5742	2365	2977	2765	1290	1075	3413	2600	492	2241	2022	2046	2505	2497	3165	2087
"SH3PXD2A"	11261	261382	3226	888	1866	1360	453	435	3291	1681	492	674	79	1509	1807	1806	943	1308
"SH3PXD2B"	7788	121024	80	0	62	18	0	0	212	42	0	0	449	531	396	416	264	73
"SH3RF1"	5277	176844	0	0	0	0	0	0	16	0	0	5	15	50	14	4	17	33
"SH3RF2"	5653	143952	0	0	0	0	0	0	9	0	0	0	21	18	0	0	0	0
"SH3RF3"	5618	516212	12	10	0	12	10	0	1233	469	18	29	37	0	198	167	117	160
"SH3TC1"	4359	41770	6607	3695	3594	3013	1942	1753	2416	2518	5060	6988	1895	1830	1964	1733	2522	1748
"SH3TC2"	26668	81024	55	15	26	29	8	7	69	10	0	103	52	38	73	0	42	0
"SH3YL1"	2617	2617	388	81	248	140	26	55	419	42	0	37	254	265	213	172	267	155
"SHANK1"	6666	55113	0	0	0	0	0	0	75	69	0	0	0	0	0	0	0	0
"SHANK2"	10498	621882	0	0	0	0	0	0	2466	572	0	0	0	0	0	0	0	0
"SHANK3"	7168	58573	3	0	3	0	0	0	194	134	0	0	0	0	0	0	0	0
"SHARPIN"	1823	5604	433	55	250	183	42	13	218	90	320	30	1308	461	1367	1061	1842	1226
"SHB"	6026	153316	10356	2445	5649	4707	1276	1169	5449	1649	4406	1558	643	482	525	405	1047	723
"SHBG"	1319	5415	53	26	27	26	20	6	83	47	0	0	536	159	894	828	905	707
"SHC1"	4245	6317	859	668	481	378	342	326	409	303	613	709	736	1945	2702	2074	1753	1947
"SHC2"	2505	44413	0	0	0	0	0	0	95	91	0	0	0	0	0	0	0	0
"SHC3"	2419	165637	0	0	0	0	0	0	58	0	0	0	0	0	0	0	0	0
"SHC4"	4568	139709	123	48	65	58	30	18	65	13	0	0	3758	3909	4019	3221	4625	2841
"SHCBP1"	3240	40840	59	9	21	38	2	7	89	0	8	16	452	262	344	210	464	232
"SHD"	2582	12124	2	0	1	1	0	0	33	15	0	0	0	0	0	0	0	0
"SHE"	6245	22630	0	0	0	0	0	0	12	0	0	0	5	24	19	7	10	4
"SHF"	2506	33961	1960	2417	1085	875	1284	1133	641	618	101	944	211	451	155	77	246	147
"SHFM1"	1236	36968	941	851	573	368	496	355	463	475	80	417	552	951	554	1079	955	987
"SHH"	1579	9411	0	0	0	0	0	0	20	12	0	0	0	0	0	0	0	0
"SHINC3"	7535	25689	1736	834	968	768	377	457	755	299	324	273	2487	2636	2312	1994	2463	1792
"SHISA2"	2891	6465	0	0	0	0	0	0	0	0	0	0	0	0	0	0	0	0
"SHISA3"	1972	4649	0	0	0	0	0	0	9	0	0	0	0	0	0	0	0	0
"SHISA4"	1142	3396	0	0	0	0	0	0	0	23	0	0	8	20	9	5	75	36
"SHISA5"	2392	32288	414	0	207	207	0	0	144	137	136	85	133	1789	3098	1754	2956	1866
"SHISA6"	2237	317458	0	0	0	0	0	0	26	0	0	0	0	0	0	0	0	0
"SHISA7"	6039	14127	0	0	0	0	0	0	72	115	0	0	0	1	0	0	0	0
"SHISA9"	6731	338797	40	0	29	11	0	0	53	11	0	0	0	9	0	0	0	0
"SHKBP1"	2382	14549	861	439	478	383	220	219	486	326	420	454	3542	3244	2583	2961	3255	2442
"SHMT1"	2651	13776	64	0	12	52	0	0	114	0	0	0	261	27	65	57	76	776
"SHMT2"	2385	4565	193	61	120	73	21	40	221	100	20	0	2236	2006	1953	1290	2899	1842
"SHOC2"	4141	94125	6511	5975	3895	2616	3308	2667	3116	3414	858	4195	2100	2399	2108	1710	2356	1548
"SHOX"	3763	22481	0	0	0	0	0	0	0	0	0	0	0	0	0	0	0	0
"SHOX2"	3228	10153	0	0	0	0	0	0	0	0	0	0	0	0	0	0	0	0
"SHPK"	3845	28062	2501	225	1756	745	113	112	1298	222	2825	379	1111	182	1279	896	1616	919
"SHPRH"	11782	52100	2050	331	1182	868	166	165	1401	166	408	278	583	798	752	487	731	466
"SHQ1"	2887	99170	526	207	367	159	119	88	445	274	113	50	409	408	315	243	354	244
"SHROOM1"	3396	8126	25	476	9	16	258	218	76	187	5	0	69	47	114	79	275	133
"SHROOM2"	7455	162987	0	0	0	0	0	0	153	0	0	0	158	188	0	0	28	0
"SHROOM3"	11028	348152	0	0	0	0	0	0	21	9	0	0	0	0	0	43	0	0
"SHROOM4"	9569	222403	0	0	0	0	0	0	32	0	0	0	0	0	0	0	0	0
"SI"	6057	99597	0	0	0	0	0	0	0	0	0	0	0	0	0	0	0	0
"SIAE"	2848	38025	105	62	44	61	28	34	128	47	7	0	432	463	397	571	1162	835
"SIAH1"	2684	92034	5934	7952	3384	2550	4220	3732	1818	2768	2314	6642	1310	1844	862	1083	1087	1027
"SIAH2"	2621	22354	545	3586	295	250	1976	1610	237	2217	8	2864	537	2752	578	3565	741	1796
"SIAH3"	3994	71430	0	0	0	0	0	0	54	13	0	0	0	0	0	0	0	0
"SID6-306"	929	68435	6782	2062	3781	3001	1095	967	3308	757	2169	1626	1106	1336	1111	867	1289	958
"SIDT1"	5045	97205	0	0	0	0	0	0	9	10	0	0	7	11	0	0	3	0
"SIDT2"	3945	18224	4095	1577	2268	1827	771	806	1806	1147	3591	781	4227	3605	10223	7610	9112	5995
"SIGIRR"	1753	9285	160	38	73	87	0	38	177	104	0	69	324	229	547	488	655	545
"SIGLEC1"	6739	20158	4283	2832	2360	1923	1293	1539	4615	4304	2189	1661	602	1246	10696	2458	2960	2767
"SIGLEC10"	3798	8177	1590	606	973	617	318	288	377	166	1138	335	7392	7352	2339	1422	3493	1588
"SIGLEC11"	3174	12179	4	28	4	0	19	9	0	23	0	10	0	2	0	0	0	0
"SIGLEC12"	2134	10432	0	0	0	0	0	0	24	4	35	0	508	456	100	84	164	179
"SIGLEC14"	2118	4326	227	0	60	167	0	0	60	0	182	7	1585	1248	961	713	1066	729
"SIGLEC15"	1511	16978	33	0	13	20	0	0	35	7	0	0	62	36	224	198	219	215
"SIGLEC16"	1849	6165	4	13	4	0	7	6	51	54	1	3	0	2	0	0	0	0
"SIGLEC5"	2506	18947	0	0	0	0	0	0	37	55	21	27	12	20	899	807	915	731
"SIGLEC6"	2084	12282	0	0	0	0	0	0	22	0	0	0	10	8	30	46	12	12
"SIGLEC7"	1761	11227	371	21	196	175	13	8	333	291	328	239	1368	1231	1191	1174	1500	1394
"SIGLEC8"	2955	7458	0	0	0	0	0	0	56	17	0	0	0	21	73	52	59	65
"SIGLEC9"	1696	5403	3237	2354	1777	1460	1229	1125	1165	1364	1393	3216	3020	3212	2938	5351	3342	4263
"SIGLECP3"	2229	6191	1	0	0	1	0	0	23	31	0	6	74	33	197	134	227	177
"SIGMAR1"	1745	3011	10	0	0	10	0	0	25	0	0	0	1007	826	960	753	1149	856
"SIK1"	4717	12606	0	0	0	0	0	0	25	16	0	0	13	63	22	56	11	18
"SIK2"	5691	124462	2807	439	1567	1240	227	212	1769	697	179	571	1207	762	915	639	1162	601
"SIK3"	6091	254875	13408	22051	7733	5675	11760	10291	6557	13381	3822	19617	893	914	1178	974	1524	847
"SIKE1"	5506	11203	97	0	61	36	0	0	116	7	0	0	643	554	614	331	818	370
"SIL1"	2032	249807	3636	1756	2095	1541	1023	733	3728	2191	945	2606	666	504	872	913	758	818
"SILV"	2768	12570	0	0	0	0	0	0	48	11	0	0	1	0	0	0	3	0
"SIM1"	4582	76056	0	0	0	0	0	0	43	22	0	0	0	1	0	0	0	0
"SIM2"	4188	50521	0	0	0	0	0	0	68	54	0	0	9	0	0	0	0	0
"SIMP"	1537	87277	5866	825	3259	2607	444	381	3476	283	653	395	1881	2335	1870	1684	1719	1274
"SIN3A"	6798	82367	1698	1908	911	787	1131	777	904	2303	166	4635	858	1389	1302	1922	1734	1280
"SIN3B"	5149	50948	2045	446	1118	927	245	201	1455	665	2355	1294	1190	1385	1541	1392	2084	1337
"SIP1"	1367	22689	11	0	6	5	0	0	0	0	0	0	46	43	97	28	84	51
"SIP1-beta"	1486	22689	11	0	6	5	0	0	0	0	0	0	46	43	97	28	84	51
"SIPA1"	3646	10801	1547	439	835	712	193	246	826	507	1756	1297	2965	2477	4250	3843	4513	3212
"SIPA1L1"	6560	153122	3943	7552	2305	1638	3976	3576	2584	4785	561	4667	1130	1300	925	891	1139	708
"SIPA1L2"	6507	117531	363	92	227	136	33	59	651	239	32	83	555	611	992	1041	712	706
"SIPA1L3"	8003	301140	15780	9613	8728	7052	5441	4172	7515	6398	10265	15561	1325	1484	1440	1317	2145	1281
"SIRPA"	4209	45728	22670	65699	12458	10212	32869	32830	5252	35756	12555	62479	12044	29597	17381	36852	25041	28637
"SIRPB1"	2418	55661	458	22	234	224	10	12	302	0	0	0	1247	298	3886	2552	2585	1897
"SIRPB2"	2838	16999	244	0	129	115	0	0	310	0	11	0	306	145	228	122	194	5
"SIRPD"	814	23446	253	10	157	96	10	0	217	0	0	0	186	138	160	110	45	21
"SIRPG"	1722	28629	0	0	0	0	0	0	0	0	0	0	0	0	0	1	3	1
"SIRT1"	4102	33721	2589	723	1390	1199	373	350	1144	296	1081	951	1325	1193	1452	915	1646	1006
"SIRT2"	2549	15852	596	442	264	332	219	223	378	659	398	823	1223	1302	1453	1593	1860	1392
"SIRT3"	2962	21333	178	14	90	88	14	0	168	41	20	112	1478	1336	1216	846	1579	951
"SIRT4"	1174	10883	0	0	0	0	0	0	0	16	0	0	8	0	13	0	4	0
"SIRT5"	3925	39910	139	0	74	65	0	0	237	0	14	16	91	135	153	115	207	104
"SIRT6"	1643	8491	248	71	136	112	66	5	162	204	320	255	423	393	522	530	646	500
"SIRT7"	1854	6227	1139	530	674	465	284	246	396	249	621	612	817	569	1682	1200	2083	1074
"SIT"	1104	1652	0	0	0	0	0	0	0	0	0	0	52	25	61	43	97	40
"SIT1"	1241	1652	0	0	0	0	0	0	0	0	0	0	52	25	61	43	97	40
"SITAC18"	1156	16494	269	105	137	132	45	60	146	74	171	39	9	7	8	9	4	8
"SIVA1"	4213	6522	236	71	156	80	35	36	179	170	0	44	392	196	563	514	634	444
"SIX1"	2688	4739	0	0	0	0	0	0	0	0	0	0	0	0	0	0	0	0
"SIX2"	2162	4220	0	0	0	0	0	0	13	0	0	0	0	0	0	0	0	0
"SIX3"	1699	3355	0	0	0	0	0	0	10	0	0	0	0	0	0	0	0	0
"SIX4"	6218	14538	0	0	0	0	0	0	0	0	0	0	0	0	0	0	0	0
"SIX5"	3333	4455	0	0	0	0	0	0	0	92	0	238	65	286	67	754	122	472
"SIX6"	1475	2587	0	0	0	0	0	0	0	0	0	0	0	0	0	0	0	0
"SKA1"	2921	19144	0	0	0	0	0	0	0	0	0	0	0	0	0	0	0	0
"SKA2"	2976	45494	36	0	19	17	0	0	94	0	0	0	375	423	387	331	513	319
"SKA3"	2896	22977	0	0	0	0	0	0	0	0	0	0	0	0	0	0	0	0
"SKAP1"	1663	296794	77	89	67	10	64	25	44	19	0	48	13	9	8	17	18	9
"SKAP2"	3981	197653	18417	5355	10325	8092	2987	2368	8560	3349	4719	3192	1240	1810	2798	5326	5124	1804
"SKI"	5713	81519	26114	9705	14374	11740	5161	4544	10068	5272	28640	12104	3830	2556	4840	2384	6260	3184
"SKIL"	3517	35477	772	6661	445	327	3639	3022	181	2334	0	5798	1061	5713	932	3415	642	1383
"SKINTL"	1521	80715	0	0	0	0	0	0	0	0	0	0	0	0	0	0	0	0
"SKIP"	893	7767	83	52	40	43	29	23	197	127	18	178	175	203	221	143	258	239
"SKIV2L"	4198	10953	747	744	360	387	409	335	354	861	345	378	1198	1384	1670	1444	1697	1011
"SKIV2L2"	4230	117834	2798	959	1673	1125	552	407	1620	864	352	775	1564	2312	2274	1773	2467	1717
"SKP1"	2702	20642	618	491	331	287	270	221	440	347	173	607	1082	2187	2807	1727	1979	1484
"SKP2"	1604	30089	371	0	169	202	0	0	376	8	59	0	351	265	354	145	430	140
"SLA"	3467	66338	30523	26251	16925	13598	14079	12172	10136	12871	21383	20219	4147	19564	4531	4158	6172	3207
"SLA2"	2501	33636	229	65	135	94	32	33	109	46	0	0	2073	2031	2602	1926	2431	2003
"SLAIN1"	2400	23084	0	0	0	0	0	0	0	0	0	0	3	22	0	15	14	3
"SLAIN2"	6017	84602	4427	996	2525	1902	523	473	2237	764	857	1118	2048	2368	2311	2022	2340	1688
"SLAMF1"	2193	11532	5815	11497	3203	2612	6128	5369	2065	6332	1027	11715	1251	5688	366	3459	1271	2258
"SLAMF6"	2744	38224	67	17	61	6	0	17	63	11	0	86	103	168	45	60	83	59
"SLAMF7"	2663	15525	2669	27236	1482	1187	14609	12627	262	13940	382	12796	1341	12896	2397	20926	2118	9461
"SLAMF8"	3304	10804	4605	1429	2520	2085	756	673	1610	362	3386	1708	13474	11915	12924	8325	19390	10474
"SLAMF9"	1158	2762	0	0	0	0	0	0	0	11	0	0	0	20	85	93	60	57
"SLBP"	1754	19505	129	27	81	48	19	8	273	34	62	47	1061	897	590	715	664	385
"SLC10A1"	1636	21456	660	2408	386	274	1294	1114	260	932	82	8605	0	36	0	0	0	0
"SLC10A2"	3783	22848	0	0	0	0	0	0	0	0	0	0	0	0	0	0	0	0
"SLC10A3"	2129	3352	0	0	0	0	0	0	16	21	0	0	533	367	577	402	891	529
"SLC10A4"	2121	6183	0	0	0	0	0	0	0	0	0	0	0	0	0	0	0	0
"SLC10A5"	1316	1316	0	0	0	0	0	0	0	0	0	0	0	0	0	0	0	0
"SLC10A6"	1508	25797	0	0	0	0	0	0	0	0	0	0	0	0	0	0	0	0
"SLC10A7"	3907	267988	924	54	517	407	43	11	960	198	11	132	288	407	345	292	359	229
"SLC11A1"	3941	14866	8	2	6	2	0	2	63	16	0	0	179	118	157	183	184	149
"SLC11A2"	4438	40149	5139	6296	2889	2250	3549	2747	2302	3258	2867	8189	3349	4960	3953	5092	3766	3498
"SLC12A1"	8652	79752	0	0	0	0	0	0	11	0	0	0	0	0	0	0	0	0
"SLC12A2"	6952	105898	115	76	56	59	47	29	43	37	27	7	478	529	470	387	457	270
"SLC12A3"	5591	50643	0	0	0	0	0	0	190	44	0	0	2	0	0	0	0	0
"SLC12A4"	4789	25222	808	75	448	360	45	30	752	226	942	65	589	553	805	716	997	881
"SLC12A5"	6085	30970	3	60	1	2	36	24	129	121	0	0	19	77	21	13	34	21
"SLC12A6"	7864	107765	4425	2476	2557	1868	1399	1077	2283	841	1755	1372	3282	3510	3803	3271	4307	3022
"SLC12A7"	5326	61683	16730	45779	9025	7705	23796	21983	4351	25266	7877	30488	1914	5360	3182	8891	7814	5387
"SLC12A8"	3568	196611	4444	1583	2455	1989	903	680	2300	799	632	973	1836	1493	1399	768	1675	857
"SLC12A9"	3307	14277	4643	1981	2535	2108	1015	966	1281	992	4486	1941	5768	4746	4391	3858	7422	3713
"SLC13A1"	4315	86438	0	0	0	0	0	0	0	0	0	0	0	0	0	0	0	0
"SLC13A2"	2572	24134	0	0	0	0	0	0	69	63	0	0	0	0	0	0	0	0
"SLC13A3"	4080	126646	56	0	39	17	0	0	101	0	0	0	26	18	1	1	0	0
"SLC13A4"	2907	46942	364	31	204	160	31	0	574	28	85	43	47	11	1	0	32	0
"SLC13A5"	3292	28701	54	0	33	21	0	0	61	35	31	0	13	0	0	0	0	11
"SLC14A1"	5038	23492	0	0	0	0	0	0	0	0	0	0	0	0	0	0	0	0
"SLC14A2"	4173	68294	0	0	0	0	0	0	28	8	0	0	0	0	0	0	0	0
"SLC15A1"	3148	68874	0	0	0	0	0	0	16	11	0	0	0	0	0	0	0	0
"SLC15A2"	5545	49865	97	76	43	54	48	28	121	26	4	50	92	64	118	52	43	23
"SLC15A3"	2124	14704	5394	3970	2843	2551	2147	1823	1394	2241	2960	7014	5298	5747	5589	10527	9626	9814
"SLC15A4"	2797	30804	1656	133	860	796	90	43	863	174	556	268	1217	792	999	786	1110	778
"SLC16A1"	4381	44215	327	18	218	109	9	9	239	51	25	0	2348	2232	2359	1701	2307	1367
"SLC16A10"	2895	135825	0	0	0	0	0	0	2	0	0	1	0	9	12	13	0	0
"SLC16A11"	1807	2295	0	0	0	0	0	0	37	0	0	0	0	0	0	0	0	0
"SLC16A12"	4625	105259	0	0	0	0	0	0	0	0	0	0	0	0	0	0	0	0
"SLC16A13"	1751	4047	82	0	40	42	0	0	108	28	28	0	195	151	142	86	262	154
"SLC16A14"	4299	33923	0	0	0	0	0	0	0	0	0	0	0	0	0	0	0	0
"SLC16A2"	4378	112669	0	0	0	0	0	0	20	0	0	0	0	0	0	0	0	0
"SLC16A3"	3871	5438	7015	8862	5400	1615	4478	4384	3058	4286	9456	9322	9396	9297	14456	14096	16218	12463
"SLC16A4"	2538	28133	1690	189	960	730	100	89	1009	33	881	241	257	4	181	0	200	0
"SLC16A5"	2057	17215	449	28	272	177	16	12	326	121	356	95	517	278	562	394	593	353
"SLC16A6"	2791	23069	1189	289	692	497	142	147	493	338	638	989	679	1983	1238	1766	1490	1472
"SLC16A7"	3823	92283	0	0	0	0	0	0	39	0	0	4	0	28	4	37	0	3
"SLC16A8"	1900	5027	7	0	0	7	0	0	0	13	0	0	0	0	0	0	0	0
"SLC16A9"	3993	59129	0	0	0	0	0	0	9	9	0	0	0	0	8	3	0	0
"SLC17A1"	1855	49162	0	0	0	0	0	0	0	0	0	0	0	0	0	0	0	0
"SLC17A2"	2272	17850	0	0	0	0	0	0	0	0	0	0	0	0	0	0	0	0
"SLC17A3"	1819	29143	0	0	0	0	0	0	0	0	0	0	0	0	0	0	0	0
"SLC17A4"	3628	19249	0	0	0	0	0	0	0	0	0	0	0	0	0	0	0	0
"SLC17A5"	3427	60636	442	28	253	189	16	12	402	11	162	0	870	722	866	737	896	739
"SLC17A6"	3932	41379	0	0	0	0	0	0	0	0	0	0	0	0	0	0	0	0
"SLC17A7"	2987	12154	23	15	0	23	15	0	154	38	0	0	0	18	3	0	9	3
"SLC17A8"	3994	64981	0	0	0	0	0	0	0	0	0	0	0	0	0	0	0	0
"SLC17A9"	3112	15473	2622	758	1448	1174	434	324	1241	507	3548	1318	1480	1515	2600	1951	4116	2452
"SLC18A1"	2973	38352	7	0	5	2	0	0	9	0	8	0	0	1	0	0	0	0
"SLC18A2"	2182	36381	515	0	298	217	0	0	294	50	0	0	1137	265	1247	983	706	566
"SLC18A3"	2420	2420	0	0	0	0	0	0	0	0	0	0	0	0	0	0	0	0
"SLC19A1"	2848	27724	983	60	554	429	13	47	1129	231	474	2	1070	759	879	719	1514	1061
"SLC19A2"	3640	22059	0	0	0	0	0	0	11	21	0	22	240	260	280	271	236	211
"SLC19A3"	3772	32820	0	0	0	0	0	0	0	0	0	0	0	0	0	0	0	0
"SLC1A1"	3734	97027	0	0	0	0	0	0	0	0	0	0	0	0	0	0	0	0
"SLC1A2"	12016	168354	0	173	0	0	102	71	10	155	0	172	171	499	30	118	100	76
"SLC1A3"	4178	81979	633	21211	381	252	11547	9664	130	12484	0	12943	332	5151	670	5733	471	1411
"SLC1A4"	5796	24417	6456	2002	3586	2870	1088	914	2575	757	3264	697	1369	903	1465	1243	1276	1054
"SLC1A5"	2879	13702	467	53	285	182	43	10	238	61	383	0	2936	1363	1030	1148	2852	1460
"SLC1A6"	3235	11233	0	0	0	0	0	0	46	0	0	0	0	0	0	0	0	0
"SLC1A7"	2687	55435	0	0	0	0	0	0	303	29	0	0	0	0	0	0	0	0
"SLC20A1"	3293	17873	9368	3313	5270	4098	1733	1580	3423	923	6558	2693	8649	7110	6667	3297	8089	4700
"SLC20A2"	3990	84985	2963	1172	1687	1276	645	527	1513	561	1114	1155	1060	1225	1125	940	1140	798
"SLC22A1"	1915	36887	627	315	362	265	170	145	207	234	118	139	0	0	4	4	11	0
"SLC22A10"	2575	21809	0	0	0	0	0	0	0	0	0	0	0	0	0	0	0	0
"SLC22A11"	2521	15902	0	0	0	0	0	0	89	0	0	0	0	0	0	0	0	0
"SLC22A12"	3216	11540	0	0	0	0	0	0	109	59	0	0	0	0	0	0	0	0
"SLC22A13"	2570	12510	0	0	0	0	0	0	0	30	0	0	0	0	0	0	0	0
"SLC22A14"	1987	12416	0	0	0	0	0	0	70	21	0	0	0	7	0	0	0	0
"SLC22A15"	4729	93555	222	4	138	84	2	2	486	0	11	37	110	145	112	41	181	121
"SLC22A16"	2095	51502	0	0	0	0	0	0	0	0	0	0	7	10	9	11	10	16
"SLC22A17"	2365	6554	0	0	0	0	0	0	21	9	0	0	0	0	0	0	0	0
"SLC22A18"	1552	25526	766	86	420	346	37	49	772	387	558	258	460	377	772	859	1525	659
"SLC22A18AS"	1550	15849	71	0	55	16	0	0	192	157	0	51	138	83	121	168	240	126
"SLC22A2"	2520	42168	0	0	0	0	0	0	0	0	0	0	0	0	0	0	0	0
"SLC22A20"	1694	28227	0	0	0	0	0	0	52	20	0	0	0	1	0	0	0	0
"SLC22A23"	6153	187588	88	0	20	68	0	0	394	72	0	0	10	0	0	0	23	0
"SLC22A24"	2106	64281	0	0	0	0	0	0	0	0	0	0	0	0	0	0	0	0
"SLC22A25"	1653	65830	0	0	0	0	0	0	0	0	0	0	0	0	0	0	0	0
"SLC22A3"	5634	106590	0	0	0	0	0	0	0	0	0	0	0	0	0	0	0	0
"SLC22A4"	2200	49754	529	71	313	216	38	33	549	85	40	44	194	130	144	51	196	106
"SLC22A5"	3359	25903	39	0	23	16	0	0	240	9	8	0	260	194	186	110	349	134
"SLC22A6"	2205	8401	0	1	0	0	0	1	14	25	0	0	0	0	0	0	0	0
"SLC22A7"	2562	7279	0	0	0	0	0	0	10	0	0	0	0	0	0	0	0	0
"SLC22A8"	2188	23016	0	0	0	0	0	0	66	14	0	0	0	0	0	0	0	0
"SLC22A9"	2316	40451	83	22	69	14	10	12	34	0	0	0	0	0	0	0	0	0
"SLC23A1"	2370	16150	134	36	65	69	36	0	152	0	0	60	1781	2084	1695	1571	2029	1586
"SLC23A2"	6979	157939	2230	579	1261	969	318	261	2341	535	779	589	1361	1486	2316	2287	2216	1808
"SLC23A3"	2428	8636	35	0	35	0	0	0	43	10	0	0	0	0	0	4	4	0
"SLC24A1"	5777	34329	707	3392	455	252	1768	1624	316	659	0	1485	581	816	305	769	437	297
"SLC24A2"	2231	270950	0	0	0	0	0	0	15	0	0	0	0	0	0	0	0	0
"SLC24A3"	3905	510252	0	0	0	0	0	0	186	35	0	0	3	0	5	9	5	0
"SLC24A4"	4752	43486	444	13	268	176	0	13	578	59	292	31	601	306	345	181	507	261
"SLC24A5"	1625	21421	0	0	0	0	0	0	0	0	0	0	0	10	0	0	0	0
"SLC24A6"	2991	36355	5098	2845	2787	2311	1502	1343	1643	1855	3055	4313	3190	3222	6494	3018	3877	2620
"SLC25A1"	1683	3208	36	0	27	9	0	0	16	31	61	24	1002	932	934	956	1570	525
"SLC25A10"	2403	17636	297	0	171	126	0	0	213	187	52	112	630	810	541	662	882	537
"SLC25A11"	2189	2722	326	68	154	172	48	20	152	77	63	119	1000	1050	1003	781	1599	1293
"SLC25A12"	4013	110900	540	219	264	276	101	118	664	133	77	164	570	575	614	539	670	469
"SLC25A13"	3210	201928	8131	8365	4599	3532	4569	3796	4540	5500	1445	8611	655	729	876	896	805	776
"SLC25A14"	1855	25742	0	0	0	0	0	0	10	0	0	0	77	70	31	71	82	62
"SLC25A15"	4027	23050	30	0	16	14	0	0	31	0	0	0	254	232	242	134	284	175
"SLC25A16"	2734	45488	412	47	195	217	12	35	251	218	251	387	231	283	241	226	316	245
"SLC25A17"	2584	49753	751	33	370	381	14	19	501	41	24	25	330	427	334	281	458	308
"SLC25A18"	2098	30466	33	0	0	33	0	0	97	46	0	0	23	25	29	57	39	35
"SLC25A19"	2349	14695	506	119	268	238	54	65	320	105	310	44	911	518	495	356	808	339
"SLC25A2"	1417	1417	0	0	0	0	0	0	0	0	0	15	0	0	0	0	0	0
"SLC25A20"	1938	42047	25	0	18	7	0	0	85	13	0	0	368	389	758	598	800	542
"SLC25A21"	2005	492789	0	0	0	0	0	0	20	0	0	0	0	0	0	0	0	0
"SLC25A22"	2968	7521	131	6	61	70	0	6	144	108	0	0	211	211	118	211	466	308
"SLC25A23"	3470	19708	4	0	4	0	0	0	44	21	0	0	219	197	162	84	243	121
"SLC25A24"	3484	65527	2807	752	1543	1264	372	380	1693	529	248	283	714	554	2730	937	2313	565
"SLC25A25"	3442	41046	5496	5214	3055	2441	2648	2566	2021	2863	3305	7393	1830	5283	2206	6331	2393	6118
"SLC25A26"	4204	167364	1604	1009	1002	602	547	462	1169	854	85	973	615	653	602	521	667	480
"SLC25A27"	3320	20133	0	0	0	0	0	0	0	0	0	0	3	0	5	0	0	0
"SLC25A28"	1559	9948	524	275	315	209	101	174	257	370	216	358	577	845	863	966	1043	630
"SLC25A29"	2372	15407	3270	1379	1811	1459	679	700	1075	837	2989	2100	2436	2373	2824	985	2042	970
"SLC25A3"	3275	8376	1281	1227	864	417	733	494	390	580	480	910	9335	8897	7663	8808	11805	8806
"SLC25A30"	6066	11090	2074	122	1120	954	69	53	841	20	1236	0	530	471	615	1266	2768	1423
"SLC25A31"	1817	43893	0	0	0	0	0	0	0	0	0	0	0	0	0	0	0	0
"SLC25A32"	3030	16603	547	344	266	281	172	172	265	390	0	373	705	264	350	761	571	486
"SLC25A33"	1544	43304	1212	2160	686	526	1126	1034	656	1147	328	2576	274	613	459	712	482	575
"SLC25A34"	3075	5077	28	166	0	28	103	63	34	127	0	53	0	54	36	78	0	31
"SLC25A35"	2791	7090	488	112	341	147	82	30	390	83	702	213	766	627	961	593	1254	644
"SLC25A36"	4706	38125	1813	436	975	838	216	220	924	332	198	210	2015	1639	2216	978	2392	1034
"SLC25A37"	2344	43700	195	176	77	118	176	0	98	339	143	360	621	982	349	838	565	485
"SLC25A38"	2131	14006	85	0	49	36	0	0	36	0	0	0	257	129	395	208	607	341
"SLC25A39"	1622	5226	258	75	158	100	40	35	183	76	185	84	1539	895	1489	1196	1658	970
"SLC25A4"	1733	4028	0	0	0	0	0	0	0	0	0	0	0	2	4	0	0	0
"SLC25A40"	1524	40250	2962	977	1570	1392	480	497	1126	158	476	354	1025	1044	1398	744	2029	515
"SLC25A41"	1655	7742	0	0	0	0	0	0	18	0	0	0	0	0	0	0	0	0
"SLC25A42"	3128	48891	7	0	7	0	0	0	302	98	0	10	5	33	12	0	44	0
"SLC25A43"	2778	55410	4192	737	2462	1730	413	324	1588	502	1746	957	1100	1243	1243	1148	1403	970
"SLC25A44"	3659	18858	1590	1415	900	690	819	596	756	839	1085	2142	1820	2032	1819	1544	2323	1565
"SLC25A45"	3101	8511	142	23	93	49	16	7	222	155	0	37	316	244	288	205	598	281
"SLC25A46"	2332	23730	1424	172	805	619	119	53	652	54	323	61	2253	1858	2468	1392	2446	1359
"SLC25A5"	1288	2931	141	52	66	75	0	52	65	35	141	76	4758	7286	9500	8371	11067	7259
"SLC25A6"	1659	5955	0	0	0	0	0	0	0	0	0	0	0	0	9348	10052	13013	10311
"SLC26A1"	3662	5779	802	213	434	368	126	87	332	299	904	271	99	103	270	240	381	185
"SLC26A10"	2422	6242	0	0	0	0	0	0	43	19	0	0	0	0	0	0	0	0
"SLC26A11"	2893	33062	2379	739	1311	1068	475	264	1785	615	2475	776	777	655	6842	5592	6323	4931
"SLC26A2"	8074	26661	136	58	99	37	37	21	120	0	0	0	1222	1247	1242	644	1274	573
"SLC26A3"	2915	37768	11	0	0	11	0	0	0	0	0	0	0	0	0	0	0	0
"SLC26A4"	4947	57172	0	0	0	0	0	0	3	0	0	0	2	7	1	4	0	0
"SLC26A5"	2678	71941	174	50	73	101	26	24	137	44	0	95	1148	1685	2180	1909	2352	1802
"SLC26A6"	2749	8123	1807	543	991	816	288	255	568	253	2020	760	845	730	1711	1168	2636	1029
"SLC26A7"	5324	188660	5	0	2	3	0	0	0	0	0	0	0	0	0	0	0	0
"SLC26A8"	3426	81012	5	0	5	0	0	0	0	10	0	0	0	3	3	6	0	0
"SLC26A9"	4817	30411	0	7	0	0	0	7	45	68	0	36	0	161	8	88	0	14
"SLC27A1"	4347	10755	1761	192	982	779	90	102	839	335	1668	486	814	692	715	564	1094	729
"SLC27A2"	2400	54197	0	0	0	0	0	0	0	0	0	0	3	15	8	4	0	0
"SLC27A3"	2422	4866	5988	1685	3274	2714	888	797	1104	371	3263	532	13465	11114	9191	6118	23325	11990
"SLC27A4"	2960	20663	180	37	111	69	13	24	308	68	130	0	722	464	1126	950	1565	1070
"SLC27A5"	2375	13734	23	0	15	8	0	0	180	43	0	0	69	46	98	59	146	90
"SLC27A6"	2847	68123	0	0	0	0	0	0	8	0	0	0	0	0	0	0	0	0
"SLC28A1"	2766	61115	0	0	0	0	0	0	92	42	0	0	0	0	0	0	0	0
"SLC28A2"	2481	23706	8	0	8	0	0	0	0	0	0	0	0	0	0	0	0	0
"SLC28A3"	2437	62583	0	0	0	0	0	0	0	0	0	0	156	65	118	139	83	81
"SLC29A1"	2499	10527	42	0	23	19	0	0	144	83	5	0	310	298	506	440	455	393
"SLC29A2"	2526	9300	18	0	18	0	0	0	110	74	0	0	1	11	0	0	42	9
"SLC29A3"	2277	44137	1502	69	765	737	69	0	1206	128	1971	184	851	518	1610	1134	1508	1262
"SLC29A4"	2900	21143	6	1	5	1	0	1	36	105	0	0	0	3	0	0	0	3
"SLC2A1"	3680	33803	108	36	46	62	28	8	132	17	18	32	346	312	210	148	466	317
"SLC2A10"	4238	26706	0	0	0	0	0	0	9	0	0	0	0	0	0	0	0	0
"SLC2A11"	2401	28666	0	0	0	0	0	0	211	33	0	0	48	25	47	21	67	34
"SLC2A12"	5604	65072	0	0	0	0	0	0	23	0	0	0	111	0	0	0	0	77
"SLC2A13"	7011	350838	193	70	119	74	32	38	571	164	0	63	297	376	368	370	433	278
"SLC2A14"	2886	59057	0	0	0	0	0	0	0	0	0	0	0	0	73	99	8	80
"SLC2A2"	3450	30633	0	0	0	0	0	0	0	0	0	0	0	0	0	0	0	0
"SLC2A3"	3947	17069	1726	969	969	757	546	423	572	427	929	1088	4189	6915	3258	4481	4792	5002
"SLC2A4"	3220	6314	0	0	0	0	0	0	70	12	0	0	1	2	0	0	0	0
"SLC2A4RG"	2285	4192	1036	121	546	490	56	65	85	136	59	192	1207	1272	231	1445	394	276
"SLC2A5"	2448	32882	0	0	0	0	0	0	41	11	0	0	2	0	5	0	11	9
"SLC2A6"	2555	8061	2669	10772	1467	1202	5597	5175	54	7118	1932	15431	2110	9283	2441	18785	3281	12181
"SLC2A7"	1551	23047	0	0	0	0	0	0	0	0	0	0	0	0	0	0	0	0
"SLC2A8"	2122	10698	3	0	0	3	0	0	107	0	0	0	97	93	233	219	227	150
"SLC2A9"	2037	6025	4059	1635	2169	1890	863	772	3579	1445	865	1889	182	353	459	405	349	387
"SLC30A1"	2020	3720	239	0	128	111	0	0	30	18	0	25	0	0	0	0	0	0
"SLC30A10"	2895	14388	0	0	0	0	0	0	0	0	0	0	0	0	0	0	0	0
"SLC30A2"	2481	8092	0	0	0	0	0	0	24	39	0	0	0	0	0	0	0	0
"SLC30A3"	2563	4012	0	0	0	0	0	0	29	10	0	0	8	14	0	0	17	0
"SLC30A4"	4289	40322	2835	783	1674	1161	397	386	1089	391	955	709	623	2275	759	304	1176	411
"SLC30A5"	3014	36063	352	217	149	203	117	100	305	141	91	252	1428	1651	2058	1669	2050	1485
"SLC30A6"	2585	55878	567	0	328	239	0	0	353	15	58	0	1356	1419	1048	843	1182	777
"SLC30A7"	8227	85681	3411	11498	1942	1469	6259	5239	1878	6605	288	8397	1230	2357	1249	1838	1325	1176
"SLC30A8"	5571	225764	0	0	0	0	0	0	0	0	0	0	0	1	0	0	0	0
"SLC30A9"	3396	97029	1715	640	970	745	311	329	1280	440	91	660	1552	1992	1874	1523	1825	1339
"SLC31A1"	4782	42965	586	118	304	282	81	37	737	120	160	233	1899	1772	1875	1648	1968	1622
"SLC31A2"	1777	13185	1206	845	670	536	455	390	745	448	216	378	2221	2439	1986	2241	2068	1976
"SLC32A1"	2577	4913	0	0	0	0	0	0	24	13	0	0	0	0	0	0	0	0
"SLC33A1"	2665	26798	720	0	420	300	0	0	484	41	62	0	719	620	1117	465	404	514
"SLC34A1"	2595	14415	0	0	0	0	0	0	51	73	0	0	0	1	0	0	0	0
"SLC34A2"	4171	22271	0	0	0	0	0	0	0	0	0	0	0	0	0	0	0	0
"SLC34A3"	2137	5623	117	0	41	76	0	0	100	86	109	17	0	1	0	0	0	0
"SLC35A1"	2517	75609	1632	0	891	741	0	0	1196	81	225	152	722	443	955	558	872	576
"SLC35A2"	2708	8348	33	0	19	14	0	0	75	17	0	42	417	432	548	464	627	439
"SLC35A3"	2257	53468	421	61	253	168	61	0	352	43	57	20	524	586	222	264	206	142
"SLC35A4"	3617	4209	139	41	69	70	19	22	102	123	25	92	2112	1891	2188	1790	2663	1870
"SLC35A5"	2946	22109	789	69	425	364	23	46	456	45	12	50	2521	2058	1542	1579	2309	1247
"SLC35B1"	1479	6840	27	8	10	17	8	0	108	15	50	8	356	384	715	486	716	549
"SLC35B2"	2043	3446	539	797	293	246	410	387	88	523	286	1178	786	259	922	1976	1628	1816
"SLC35B3"	2225	22494	256	109	127	129	78	31	307	74	54	102	572	590	597	365	556	274
"SLC35B4"	6824	27738	166	29	74	92	13	16	97	8	9	0	109	907	957	710	1017	645
"SLC35C1"	3489	7927	85	0	38	47	0	0	102	0	37	0	928	538	899	488	1138	535
"SLC35C2"	2504	13637	2665	1385	1452	1213	747	638	935	643	2286	1508	1265	1140	1862	1314	2136	1248
"SLC35D1"	6472	55067	304	27	175	129	12	15	193	46	19	0	675	111	720	631	785	520
"SLC35D2"	2802	70267	857	38	535	322	29	9	699	24	259	9	991	981	653	615	1086	713
"SLC35D3"	2358	3374	0	0	0	0	0	0	0	16	0	0	0	0	0	0	0	0
"SLC35E1"	5097	22545	819	551	485	334	333	218	517	723	513	1975	245	478	1723	1631	1909	1384
"SLC35E2"	2284	22366	1654	672	966	688	370	302	1290	750	1355	645	2873	2460	6071	4412	7494	4440
"SLC35E3"	2350	19917	1433	403	776	657	253	150	640	178	274	460	826	754	456	351	460	318
"SLC35E4"	2749	33211	407	0	271	136	0	0	346	83	456	65	1383	885	832	371	1316	520
"SLC35F1"	4858	410150	0	0	0	0	0	0	0	8	0	0	0	0	0	0	5752	0
"SLC35F2"	3464	54938	0	0	0	0	0	0	22	0	0	0	0	3	5	0	0	0
"SLC35F3"	2899	419585	4822	364	2652	2170	229	135	1726	211	662	169	109	230	162	50	215	69
"SLC35F4"	2927	32977	0	0	0	0	0	0	0	0	0	0	0	0	0	0	0	0
"SLC35F5"	2864	42469	2458	2719	1392	1066	1529	1190	884	1585	325	2024	560	2405	622	707	1074	491
"SLC36A1"	5783	44778	2212	1109	1215	997	610	499	1579	378	557	164	1253	1182	2276	1908	2449	1457
"SLC36A2"	3430	32613	0	0	0	0	0	0	15	0	0	0	0	0	0	0	0	0
"SLC36A3"	4350	21901	72	0	63	9	0	0	109	11	0	0	6	2	0	0	3	0
"SLC36A4"	2474	50245	437	913	242	195	443	470	514	852	61	603	126	317	438	489	273	290
"SLC37A1"	3683	67527	1281	205	719	562	127	78	1335	797	281	935	385	494	576	615	687	582
"SLC37A2"	4214	27400	1647	1786	867	780	966	820	894	945	1453	2055	4724	4031	4911	4277	5851	4342
"SLC37A3"	3324	64759	274	7	137	137	7	0	448	73	173	11	503	484	706	494	873	544
"SLC37A4"	2614	6557	99	11	52	47	11	0	264	135	23	0	385	285	402	465	638	358
"SLC38A1"	8623	86367	118	26	40	78	9	17	52	38	0	66	233	366	46	74	165	53
"SLC38A10"	4533	40717	5532	1890	3093	2439	997	893	2621	1569	6491	3882	3356	2730	3823	3254	4823	3102
"SLC38A11"	1906	57225	0	0	0	0	0	0	0	0	0	0	0	0	0	0	0	0
"SLC38A2"	4899	14675	2734	1146	1538	1196	634	512	871	373	932	564	2612	3655	6180	1874	8692	1166
"SLC38A3"	2465	15715	2	0	2	0	0	0	130	119	0	0	0	5	0	0	0	0
"SLC38A4"	4000	61238	0	0	0	0	0	0	0	0	0	0	0	0	0	0	0	0
"SLC38A5"	2110	8954	0	0	0	0	0	0	134	62	0	0	3	0	0	0	4	4
"SLC38A6"	2806	102508	38038	17144	21177	16861	9272	7872	19102	4605	18409	6336	3624	3512	6420	3912	5652	2901
"SLC38A7"	2853	18315	436	43	258	178	40	3	383	62	295	9	187	103	468	267	976	533
"SLC38A8"	1318	32375	0	0	0	0	0	0	157	70	0	0	0	0	0	0	0	0
"SLC38A9"	2940	86880	2320	221	1366	954	144	77	1626	235	472	381	553	559	381	359	780	350
"SLC39A1"	2723	4364	252	166	112	140	69	97	161	181	35	389	2791	541	3209	3297	823	643
"SLC39A10"	5380	80895	2736	441	1482	1254	241	200	1414	147	850	99	2947	2697	2241	1207	2884	1328
"SLC39A11"	2791	446769	21972	13513	12468	9504	7507	6006	12168	9053	10690	15688	1366	1160	1518	1462	1952	1534
"SLC39A12"	2821	91455	11	0	11	0	0	0	2	16	0	0	6	3	22	28	21	15
"SLC39A13"	3911	61045	29996	27987	16710	13286	15013	12974	9283	12332	25346	4909	9530	10823	15146	20608	19347	15688
"SLC39A14"	4740	55199	0	3	0	0	0	3	49	45	0	0	151	231	15	15	114	70
"SLC39A2"	1413	2613	0	0	0	0	0	0	0	0	0	0	0	0	0	0	0	0
"SLC39A3"	2987	5551	49	5	32	17	0	5	77	33	29	0	678	448	987	707	1161	771
"SLC39A4"	2784	3195	10	0	1	9	0	0	87	17	0	0	148	138	150	95	216	175
"SLC39A5"	2005	7809	64	0	35	29	0	0	81	24	0	0	0	2	0	0	0	0
"SLC39A6"	3629	20864	374	99	187	187	53	46	160	67	0	20	4431	5847	4487	3537	4518	2792
"SLC39A7"	2460	3612	197	114	96	101	69	45	100	83	12	76	2133	1303	2418	1726	2572	1736
"SLC39A8"	4091	94214	11704	49963	6438	5266	26951	23012	1553	34285	37	58094	2018	14318	1953	7610	2387	4077
"SLC39A9"	5406	63700	2066	1689	1116	950	1002	687	1245	984	467	1551	2687	3120	3170	2759	3301	2419
"SLC3A1"	2995	39786	266	0	138	128	0	0	97	0	22	0	851	0	0	0	0	0
"SLC3A2"	2410	32836	1026	952	602	424	518	434	625	366	543	754	4362	4477	4286	4616	3671	4514
"SLC40A1"	3361	20221	0	0	0	0	0	0	0	21	0	55	535	509	755	1159	752	736
"SLC41A1"	4865	23942	0	5	0	0	0	5	37	11	9	0	86	117	49	55	94	90
"SLC41A2"	3553	125198	7567	8541	4265	3302	4608	3933	3282	4067	841	3602	1753	1158	1648	1622	1155	1452
"SLC41A3"	2359	77935	5	0	5	0	0	0	157	48	0	0	414	418	398	315	297	263
"SLC43A1"	2512	31153	0	0	0	0	0	0	13	12	0	0	70	46	22	59	30	29
"SLC43A2"	3245	53940	13019	20781	7271	5748	11013	9768	3738	8125	14761	41699	4406	5742	4308	6805	5403	4060
"SLC43A3"	2736	20096	304	2206	147	157	1224	982	233	1603	81	2230	1344	2356	2128	3016	2015	1734
"SLC44A1"	4554	146753	4219	870	2537	1682	461	409	2881	694	248	666	3360	4529	3160	2572	3489	2393
"SLC44A2"	3455	19065	37	0	15	22	0	0	46	46	32	0	220	235	256	176	531	375
"SLC44A3"	2407	74902	0	0	0	0	0	0	12	0	0	0	0	0	0	0	0	0
"SLC44A4"	2655	15857	0	0	0	0	0	0	211	100	0	0	0	0	0	0	0	0
"SLC44A5"	4078	408985	0	0	0	0	0	0	29	0	0	0	86	126	0	0	0	0
"SLC45A1"	2408	19838	0	0	0	0	0	0	37	0	0	0	0	0	16	0	0	0
"SLC45A2"	2760	38808	0	0	0	0	0	0	0	0	0	0	0	0	0	0	0	0
"SLC45A3"	3387	22651	549	137	323	226	77	60	283	168	91	282	214	253	552	668	282	204
"SLC45A4"	7485	21401	3175	238	1675	1500	134	104	1908	516	1773	188	1012	701	1261	749	1402	986
"SLC46A1"	6493	11569	11	0	0	11	0	0	72	19	0	0	130	68	279	193	358	169
"SLC46A2"	2505	11994	916	125	478	438	65	60	527	141	435	125	563	300	178	144	122	64
"SLC46A3"	6584	6584	1066	28	582	484	28	0	644	0	296	18	3472	2641	3490	907	2383	2099
"SLC47A1"	3296	45181	1604	161	878	726	84	77	1331	119	811	106	1607	1264	2024	1589	1220	940
"SLC47A2"	2371	38416	254	0	75	179	0	0	126	0	0	0	1	0	1	1	1	1
"SLC48A1"	3036	9570	323	8	234	89	0	8	293	37	71	0	0	33	938	842	1501	542
"SLC4A1"	4972	19745	0	0	0	0	0	0	240	108	0	0	4	6	0	0	0	0
"SLC4A10"	5737	360942	0	0	0	0	0	0	0	0	0	0	0	12	0	0	0	0
"SLC4A11"	3271	10773	73	22	15	58	10	12	120	58	10	0	133	110	112	106	321	157
"SLC4A1AP"	2983	31510	257	19	132	125	19	0	193	81	33	23	596	139	647	873	1104	577
"SLC4A2"	4394	13876	432	99	206	226	71	28	411	217	181	17	2309	2338	2377	2351	3285	2579
"SLC4A3"	4267	14411	0	0	0	0	0	0	153	79	0	0	4	0	0	0	0	0
"SLC4A4"	7718	384802	0	0	0	0	0	0	0	0	0	0	0	0	0	0	0	0
"SLC4A5"	6378	127166	1006	1725	587	419	941	784	415	1074	217	2877	3210	7095	463	802	496	727
"SLC4A7"	8067	111625	2434	1167	1370	1064	665	502	1646	663	1300	1200	1844	1994	2221	2203	1863	1398
"SLC4A8"	8042	8042	759	64	446	313	36	28	362	32	295	20	179	267	86	106	187	94
"SLC4A9"	3293	14808	0	0	0	0	0	0	54	0	0	0	0	0	0	0	0	0
"SLC5A1"	5051	69974	0	0	0	0	0	0	0	7	0	0	0	0	0	0	0	0
"SLC5A10"	2215	70016	88	303	38	50	186	117	521	502	0	307	256	332	159	205	415	329
"SLC5A11"	2567	65392	2	0	0	2	0	0	23	0	0	0	0	0	0	0	0	0
"SLC5A12"	6268	55010	0	0	0	0	0	0	13	0	0	0	0	0	0	0	0	0
"SLC5A2"	2288	7655	29	0	17	12	0	0	69	45	2	20	483	0	0	0	0	0
"SLC5A3"	11624	32739	32574	74771	18224	14350	40572	34199	10895	21333	16584	60265	6685	12261	9198	18641	6745	7765
"SLC5A4"	2033	36855	0	0	0	0	0	0	8	0	0	0	0	0	0	0	0	0
"SLC5A5"	3590	23202	0	0	0	0	0	0	43	15	0	0	0	0	0	0	0	0
"SLC5A6"	3161	12614	249	244	134	115	163	81	216	256	125	223	1251	969	584	1128	1622	814
"SLC5A7"	5150	27446	0	0	0	0	0	0	0	0	0	0	0	0	0	0	0	0
"SLC5A8"	3300	54023	0	0	0	0	0	0	0	8	0	0	0	0	0	0	0	0
"SLC5A9"	3804	25961	0	0	0	0	0	0	12	0	0	0	0	0	0	0	0	0
"SLC6A1"	4509	46516	0	0	0	0	0	0	175	47	0	0	0	0	0	0	0	0
"SLC6A10P"	3848	7668	0	0	0	0	0	0	0	0	0	0	0	0	4	0	0	7
"SLC6A11"	2767	9268	0	0	0	0	0	0	150	82	0	0	0	2	0	4	0	0
"SLC6A12"	3389	23244	95	805	38	57	409	396	172	425	76	99	410	308	652	578	569	641
"SLC6A13"	2200	42213	0	0	0	0	0	0	32	14	0	0	1	0	0	0	0	0
"SLC6A14"	4549	24851	0	0	0	0	0	0	0	0	0	0	0	0	0	0	0	0
"SLC6A15"	4840	53339	0	0	0	0	0	0	0	0	0	0	0	0	0	0	0	0
"SLC6A16"	3024	35452	0	0	0	0	0	0	25	12	0	0	0	0	0	0	0	0
"SLC6A17"	6412	51691	0	0	0	0	0	0	159	41	0	0	0	0	0	0	0	0
"SLC6A18"	2132	20835	0	0	0	0	0	0	113	116	0	0	0	0	0	0	0	0
"SLC6A19"	5182	23520	0	10	0	0	10	0	142	99	0	0	0	0	0	0	0	0
"SLC6A2"	3482	47267	0	0	0	0	0	0	41	0	0	0	0	0	0	0	0	0
"SLC6A20"	5501	16891	0	0	0	0	0	0	60	26	0	0	1	0	0	0	0	0
"SLC6A3"	3939	52630	0	0	0	0	0	0	199	116	0	0	1	0	0	0	0	0
"SLC6A4"	4546	39576	0	0	0	0	0	0	21	8	0	0	0	0	0	0	0	0
"SLC6A5"	2877	55664	0	0	0	0	0	0	14	0	0	0	0	0	0	0	0	0
"SLC6A6"	6521	86751	31542	15866	17378	14164	8545	7321	10307	6792	26306	18430	14299	13457	16091	12086	17074	10845
"SLC6A7"	3752	21116	0	0	0	0	0	0	215	62	0	0	0	0	4	0	0	0
"SLC6A8"	3578	8298	83	0	22	61	0	0	56	36	0	0	150	125	326	319	290	219
"SLC6A9"	3388	20843	0	0	0	0	0	0	241	136	0	0	13	8	7	5	30	11
"SLC7A1"	7355	86275	3456	21478	1858	1598	11556	9922	783	11274	99	19139	2095	4612	1605	3507	2252	1995
"SLC7A10"	1957	17188	0	0	0	0	0	0	14	45	0	0	0	0	0	0	0	0
"SLC7A11"	9660	78257	32114	57771	17769	14345	31145	26626	6851	11967	9476	36910	11902	30437	7434	9920	5056	4804
"SLC7A13"	1976	16323	0	0	0	0	0	0	0	0	0	0	0	0	0	0	0	0
"SLC7A14"	10141	126523	0	0	0	0	0	0	0	0	0	0	0	0	0	0	0	0
"SLC7A2"	7576	73475	0	0	0	0	0	0	11	0	0	0	24	279	21	163	0	6
"SLC7A3"	2258	5526	0	0	0	0	0	0	0	0	0	0	0	0	0	0	0	0
"SLC7A4"	2320	3841	0	0	0	0	0	0	14	1	0	0	0	0	0	0	0	0
"SLC7A5"	4552	39472	527	2600	242	285	1284	1316	417	1857	44	3012	1319	2107	1249	2286	1561	1506
"SLC7A5P1"	2535	2535	1242	395	652	590	94	301	340	289	1233	694	0	0	88	139	0	78
"SLC7A6"	6360	37301	3957	1781	2218	1739	1059	722	2045	1170	2797	2374	2526	2717	3428	2382	3942	1982
"SLC7A6OS"	1612	10330	1585	242	934	651	129	113	823	380	436	550	2051	2009	1092	641	1238	623
"SLC7A7"	3121	43244	487	12	208	279	0	12	538	47	111	0	6204	755	2543	2201	2256	1839
"SLC7A8"	4225	58345	6826	522	3829	2997	252	270	2388	103	4742	278	7010	5731	5981	3706	6830	4840
"SLC7A9"	2048	39264	0	0	0	0	0	0	19	0	0	0	0	0	0	0	0	0
"SLC8A1"	6118	339924	40097	37259	22394	17703	20327	16932	26264	21616	35448	40547	1432	1444	3107	1447	2247	1847
"SLC8A2"	5120	44029	0	0	0	0	0	0	208	103	0	0	0	0	0	0	0	0
"SLC8A3"	5275	144854	0	0	0	0	0	0	12	11	0	0	0	0	0	0	0	0
"SLC9A1"	4583	56152	1008	114	643	365	27	87	833	145	227	174	829	698	943	601	1367	752
"SLC9A10"	4149	153321	0	0	0	0	0	0	0	0	0	0	0	0	0	0	0	0
"SLC9A11"	4455	102631	0	0	0	0	0	0	0	0	0	0	0	0	0	0	0	0
"SLC9A2"	5452	91643	0	0	0	0	0	0	0	0	0	0	0	2	6	0	0	0
"SLC9A3"	2794	51217	863	498	471	392	271	227	385	320	114	36	7	84	244	179	507	355
"SLC9A3R1"	2009	20737	267	49	171	96	26	23	242	137	30	0	549	455	774	660	850	559
"SLC9A3R2"	2181	12140	0	0	0	0	0	0	100	45	0	0	28	11	7	5	35	3
"SLC9A3R2 variant protein"	2650	6016	508	56	279	229	23	33	317	132	122	174	497	545	866	515	768	576
"SLC9A4"	4149	60670	0	0	0	0	0	0	0	0	0	0	0	0	0	0	0	0
"SLC9A5"	4030	23240	202	79	141	61	65	14	231	69	16	85	61	75	40	22	294	101
"SLC9A6"	4741	61842	533	0	300	233	0	0	260	0	0	0	1395	1354	1325	941	1461	941
"SLC9A7"	2217	152101	4388	15391	2470	1918	8570	6821	1853	3843	332	6007	2221	2723	323	405	407	282
"SLC9A8"	6271	79524	2948	5266	1611	1337	2858	2408	1596	2147	762	4820	753	1441	1014	1311	1282	1056
"SLC9A9"	3615	583283	79	44	71	8	20	24	557	256	0	102	215	220	198	186	261	134
"SLCO1A2"	7697	130838	0	0	0	0	0	0	0	0	0	0	0	0	0	0	0	0
"SLCO1B1"	2800	108602	0	0	0	0	0	0	0	0	0	0	0	0	0	0	0	0
"SLCO1B3"	2841	106020	0	0	0	0	0	0	0	0	0	0	0	0	0	0	0	0
"SLCO1C1"	3469	58031	0	0	0	0	0	0	0	0	0	0	0	0	0	0	0	0
"SLCO2A1"	4235	97380	0	0	0	0	0	0	88	22	0	0	0	0	0	0	0	0
"SLCO2B1"	4350	55406	10365	2093	5615	4750	1153	940	6148	906	6586	732	5787	4840	11467	8204	11993	5788
"SLCO3A1"	5116	312201	71428	109958	39769	31659	58733	51225	24895	60776	36487	91845	2546	3090	1966	2122	3026	1834
"SLCO4A1"	2788	29852	0	0	0	0	0	0	247	265	0	19	78	55	126	330	109	139
"SLCO4C1"	5343	62561	0	0	0	0	0	0	27	5	0	0	79	97	208	199	152	104
"SLCO5A1"	3798	162731	274538	0	251	274287	0	0	22	48	0	150	0	17	10	5	13	4
"SLCO6A1"	2535	127068	0	0	0	0	0	0	0	0	0	0	0	0	0	0	0	0
"SLFN11"	5281	23391	1454	315	806	648	176	139	728	114	603	93	3215	2646	3178	1988	3100	1728
"SLFN12"	2499	22092	128	0	93	35	0	0	175	1	0	0	207	355	257	123	306	156
"SLFN12L"	2754	62956	2369	621	1413	956	387	234	1549	326	661	474	670	585	414	66	716	187
"SLFN13"	8527	10916	91	0	0	91	0	0	70	35	0	0	167	136	533	351	623	306
"SLFN14"	2886	9968	0	0	0	0	0	0	0	0	0	0	0	0	0	0	0	0
"SLFN5"	4645	24670	444	833	282	162	447	386	336	580	15	387	1422	3090	971	1321	1093	679
"SLFNL1"	2123	6130	711	14	434	277	0	14	743	122	1326	204	0	0	0	0	0	0
"SLICK"	5262	242005	0	0	0	0	0	0	0	0	0	0	0	0	0	0	0	0
"SLIT1"	7968	187890	34	0	24	10	0	0	701	278	0	0	21	15	45	29	72	55
"SLIT2"	4987	365555	0	0	0	0	0	0	0	0	0	0	0	0	0	0	0	0
"SLIT3"	5436	635063	0	0	0	0	0	0	310	76	0	0	0	0	0	0	0	0
"SLITRK1"	5186	5186	0	0	0	0	0	0	0	0	0	0	0	0	0	0	0	0
"SLITRK2"	4410	8013	0	0	0	0	0	0	0	0	0	0	0	0	0	0	0	0
"SLITRK3"	4547	9274	0	0	0	0	0	0	0	0	0	0	0	0	0	0	0	0
"SLITRK4"	3358	7076	0	0	0	0	0	0	0	0	0	0	9	0	0	0	0	0
"SLITRK5"	4446	7000	0	0	0	0	0	0	0	0	0	0	0	0	0	0	0	0
"SLITRK6"	4183	6563	0	0	0	0	0	0	0	0	0	0	0	0	0	0	0	0
"SLK"	5625	59874	1689	794	908	781	439	355	1046	632	192	563	2806	2952	2869	2317	3119	1935
"SLMAP"	4493	171722	3634	815	1997	1637	416	399	2211	832	552	1144	1290	1397	1106	1050	1401	1010
"SLMO1"	1748	12048	0	0	0	0	0	0	77	19	0	0	6	6	0	0	13	0
"SLMO2"	2568	9702	108	0	39	69	0	0	89	124	0	83	1191	1655	1292	1432	448	1278
"SLN"	724	4680	0	0	0	0	0	0	0	0	0	0	0	0	0	0	0	0
"SLP65"	1602	79872	13440	1312	7197	6243	730	582	5900	258	5879	263	2056	2584	1501	569	2720	933
"SLPI"	602	2329	0	0	0	0	0	0	0	0	0	0	0	0	0	0	0	0
"SLTM"	4167	54609	7102	3299	3939	3163	1818	1481	3277	1573	3383	2812	3187	3165	3455	2668	3933	2278
"SLU7"	3575	17521	82	29	51	31	9	20	51	62	26	13	1537	1598	1281	1049	1425	1000
"SLURP1"	539	1468	0	0	0	0	0	0	13	0	0	0	0	0	0	0	0	0
"SMA"	1078	16952	55	30	0	55	30	0	32	0	0	0	60	55	1542	920	2192	1069
"SMA3"	470	470	0	0	0	0	0	0	0	0	0	0	0	37	0	1	0	0
"SMA4"	5149	570496	1403	464	895	508	237	227	1311	437	758	426	2322	2092	19450	12719	23592	12251
"SMAD1"	3184	76362	3578	560	1959	1619	335	225	1416	191	156	247	997	661	861	451	935	579
"SMAD2"	10544	98050	11429	3745	6353	5076	2100	1645	4628	1537	2687	1431	2059	2110	2127	1661	2663	1621
"SMAD3"	6243	129339	1209	1148	743	466	624	524	1884	3689	200	3480	281	208	342	300	531	311
"SMAD4"	10240	32715	3437	3787	1984	1453	2029	1758	1527	1518	354	1473	1117	1348	1122	824	1191	826
"SMAD5"	7103	49888	707	37	361	346	37	0	693	13	40	70	1223	993	1242	742	1270	667
"SMAD6"	3013	79663	140	18	72	68	18	0	388	165	38	17	59	65	38	0	80	0
"SMAD7"	3090	30859	2937	1712	1619	1318	910	802	1195	1391	1784	3866	1099	921	1229	1758	1502	1762
"SMAD9"	2360	72204	82	0	50	32	0	0	52	0	0	0	16	0	26	0	53	0
"SMAGP"	1560	24602	22	0	22	0	0	0	16	0	0	0	116	132	98	58	99	46
"SMAP1"	3347	194237	4969	893	2851	2118	491	402	2686	644	336	667	1281	1307	1189	992	1464	1022
"SMAP2"	2584	49266	15045	9075	8400	6645	4873	4202	6452	2643	9707	4152	6079	5234	4379	3080	6358	4003
"SMARCA1"	4109	76982	0	0	0	0	0	0	0	0	0	0	0	0	0	0	0	0
"SMARCA2"	5788	178281	13119	3094	7197	5922	1654	1440	6730	1916	3642	1526	2765	2647	3031	2268	3607	2147
"SMARCA4"	5827	101363	2178	894	1174	1004	505	389	1803	1085	1382	1442	1552	1456	1935	1592	1959	1566
"SMARCA5"	3874	39952	965	4950	549	416	2623	2327	644	2685	130	2062	3710	6493	3723	4867	4033	2871
"SMARCAD1"	5194	83208	744	30	433	311	17	13	641	31	149	62	1040	1062	1222	896	1206	727
"SMARCAL1"	3285	70637	313	0	202	111	0	0	314	14	34	0	459	440	613	527	730	503
"SMARCB1"	1738	47556	2195	1365	1306	889	800	565	1068	1133	629	2362	742	986	1131	1016	1682	1081
"SMARCC1"	5785	196029	5033	2991	2912	2121	1516	1475	2870	2035	1293	4547	1630	1986	1755	1593	1907	1268
"SMARCC2"	5615	27716	2207	707	735	1472	340	367	715	1427	1059	3019	3152	19070	3110	2489	21642	15178
"SMARCD1"	3441	15512	318	210	151	167	130	80	186	140	92	258	815	886	1067	852	1441	879
"SMARCD2"	2783	10912	1190	323	471	719	152	171	352	248	407	461	4422	2943	3075	2650	4700	3025
"SMARCD3"	2115	8240	929	30	499	430	14	16	693	186	0	25	60	40	1417	188	312	202
"SMARCE1"	2432	20129	780	47	386	394	24	23	536	106	77	72	1650	543	1919	1100	2917	1559
"SMC1A"	9895	48548	2546	1378	1439	1107	803	575	907	479	311	1231	2023	2412	3194	3017	5562	3319
"SMC1B"	4275	69555	154	0	90	64	0	0	113	0	34	0	0	0	0	0	0	0
"SMC2"	6066	46864	3	31	0	3	19	12	7	0	14	0	627	613	679	530	789	438
"SMC3"	4139	36943	351	34	198	153	17	17	235	17	39	15	1171	1134	1739	1030	1624	1048
"SMC4"	5300	34394	363	104	237	126	50	54	221	50	25	130	588	662	742	708	910	488
"SMC5"	5990	95913	2203	6069	1224	979	3287	2782	1317	2925	281	2968	1440	1728	1258	1302	1209	767
"SMC6"	5393	136384	2118	534	1164	954	301	233	1160	313	408	331	972	1209	1420	984	1292	1062
"SMCHD1"	8719	149130	5145	2368	2761	2384	1342	1026	3594	1401	815	1278	2000	2352	2272	1972	2419	1497
"SMCP"	764	6719	0	0	0	0	0	0	0	0	0	0	0	0	0	0	0	0
"SMCR5"	2845	2845	187	84	118	69	62	22	129	71	80	42	0	1	0	0	0	0
"SMCR7"	2595	5247	23	0	10	13	0	0	56	52	0	0	157	44	174	22	253	92
"SMCR7L"	5704	15854	1091	0	633	458	0	0	598	140	557	85	2745	1708	2816	1303	3255	1593
"SMCR8"	8311	12777	1268	601	631	637	344	257	664	349	659	559	2972	2019	3142	2252	3681	2453
"SMEK1"	4484	52857	3670	2090	2113	1557	1123	967	1681	1256	1541	2227	2953	2576	2628	2056	3023	1866
"SMEK2"	4791	69600	3429	2740	1852	1577	1521	1219	1669	1052	642	1774	3132	3343	1879	1340	2713	830
"SMEK3P"	3132	3132	0	0	0	0	0	0	0	0	0	0	0	0	0	0	0	0
"SMG1"	16127	121552	7809	6492	4291	3518	3418	3074	3865	3606	2968	5670	4201	6124	6820	6394	6866	4215
"SMG5"	4583	33605	1704	1323	870	834	742	581	895	716	1005	1310	2283	2061	3399	3082	4162	2899
"SMG6"	5987	243938	16147	12866	8869	7278	7121	5745	6764	6966	8986	16521	1820	1976	1610	1382	2372	1343
"SMG7"	5935	81693	17642	28286	10039	7603	15295	12991	9286	16278	7260	24493	1893	17918	3582	5831	4534	4678
"SMILE"	1892	46652	54	0	25	29	0	0	92	0	0	0	60	33	64	24	40	16
"SMN2"	1636	28073	0	0	0	0	0	0	30	0	0	78	192	205	867	956	1021	860
"SMNDC1"	2034	11910	303	422	174	129	219	203	192	200	0	323	846	1154	372	761	1045	246
"SMO"	3747	24672	0	16	0	0	0	16	114	117	0	60	7	13	3	0	0	17
"SMOC1"	3681	152942	0	0	0	0	0	0	10	29	0	0	3308	3399	3808	3739	0	0
"SMOC2"	2960	226642	0	0	0	0	0	0	422	35	0	0	0	0	0	0	0	0
"SMOX"	2282	38921	40	0	11	29	0	0	277	119	39	18	134	111	566	551	351	371
"SMP1"	2191	24041	228	117	169	59	65	52	193	61	39	117	3974	4705	4059	3579	4633	3469
"SMPD1"	2464	4572	45	0	34	11	0	0	58	31	0	0	475	470	1077	827	1157	878
"SMPD2"	1689	3192	201	15	152	49	0	15	497	27	148	138	438	459	494	444	899	561
"SMPD3"	5276	90179	24	0	0	24	0	0	375	85	0	0	10	1	9	0	23	0
"SMPD4"	4307	6548	603	332	337	266	174	158	586	492	359	562	1140	945	1711	1327	2472	1309
"SMPDL3A"	2200	20893	0	0	0	0	0	0	9	0	0	0	194	206	299	290	202	179
"SMPDL3B"	1951	24160	0	0	0	0	0	0	25	19	0	0	0	0	0	0	0	0
"SMPX"	890	52140	0	0	0	0	0	0	0	0	0	0	0	0	0	0	0	0
"SMR3A"	601	6332	0	0	0	0	0	0	0	0	0	0	0	0	0	0	0	0
"SMR3B"	786	7166	0	0	0	0	0	0	0	0	0	0	0	0	0	0	0	0
"SMRP"	5875	94511	1639	412	936	703	197	215	1034	295	657	467	862	1092	1732	1719	1811	1037
"SMS"	1698	54114	2345	14668	1284	1061	7859	6809	304	6825	0	11533	333	1668	1611	2452	1513	1591
"SMS1"	1003	312717	5727	5465	3343	2384	2991	2474	4306	3384	308	2956	252	262	419	404	438	341
"SMTN"	4602	18124	13	0	13	0	0	0	214	48	0	0	93	41	86	60	153	120
"SMTNL1"	2070	9131	22	0	22	0	0	0	103	12	0	0	0	0	0	0	0	0
"SMTNL2"	2293	23782	6	1	6	0	0	1	116	21	0	0	14	13	0	0	0	0
"SMU1"	7109	34866	804	465	462	342	278	187	361	466	0	461	1232	1710	1474	1380	1698	1110
"SMUG1"	2611	7518	175	0	117	58	0	0	220	11	74	0	189	93	330	181	480	265
"SMURF1"	5756	116661	9626	4848	5394	4232	2724	2124	4617	4084	6222	7404	1322	2009	1118	1342	618	1321
"SMURF2"	3960	117653	4856	4862	2792	2064	2748	2114	1540	2249	837	3530	314	540	565	478	531	467
"SMVT"	656	4696	60	112	23	37	69	43	97	78	85	121	167	154	187	215	338	183
"SMYD1"	4354	45520	0	0	0	0	0	0	9	0	0	0	0	0	0	0	0	0
"SMYD2"	4152	53088	391	65	270	121	41	24	303	25	87	64	432	403	590	462	728	488
"SMYD3"	1869	181482	4669	3630	2697	1972	2175	1455	3315	3937	141	1441	34	61	60	37	65	59
"SMYD4"	4344	50347	180	0	94	86	0	0	173	45	47	45	131	268	187	138	287	180
"SMYD5"	2580	12991	0	0	0	0	0	0	170	35	0	0	315	214	341	224	401	284
"SNAI1"	1693	5893	0	0	0	0	0	0	41	0	0	0	0	5	0	5	0	0
"SNAI2"	2101	3751	0	0	0	0	0	0	0	0	0	0	0	0	0	0	0	0
"SNAI3"	1715	8793	444	4	313	131	4	0	391	117	948	212	1556	279	2317	375	2449	347
"SNAP23"	2315	37423	2233	1707	1296	937	868	839	974	1039	925	2169	4195	5320	3695	3405	4072	2955
"SNAP25"	2318	88590	0	0	0	0	0	0	0	0	0	0	0	0	0	0	0	0
"SNAP29"	4264	32209	220	14	117	103	7	7	256	71	101	20	1393	1436	1700	1373	1797	1197
"SNAP47"	2848	41975	535	39	249	286	34	5	802	155	264	93	506	455	805	514	802	548
"SNAP91"	4749	156522	0	0	0	0	0	0	0	0	0	0	0	0	0	0	0	0
"SNAPC1"	2665	34072	25	0	16	9	0	0	52	0	0	0	122	195	133	96	147	100
"SNAPC2"	1518	2907	41	0	28	13	0	0	51	54	0	0	658	339	644	291	767	486
"SNAPC3"	3103	38846	897	44	394	503	23	21	1548	55	87	4	1458	516	233	355	304	465
"SNAPC4"	4672	22861	950	21	506	444	14	7	751	309	740	116	395	250	637	306	882	439
"SNAPC5"	789	7482	335	785	217	118	441	344	237	2153	123	551	2457	32	1906	1750	2499	1897
"SNAPIN"	1038	3182	202	27	105	97	4	23	25	32	0	3	2201	714	1680	663	2237	703
"SNAR-A1"	123	123	0	0	0	0	0	0	0	0	0	0	0	0	0	0	0	0
"SNAR-A12"	123	123	0	0	0	0	0	0	0	0	0	0	0	0	0	0	0	0
"SNAR-A3"	122	122	0	0	0	0	0	0	0	0	0	0	0	0	0	0	0	0
"SNAR-B2"	121	121	0	0	0	0	0	0	23	0	0	0	0	0	0	0	0	0
"SNAR-C2"	121	121	0	0	0	0	0	0	0	0	0	0	0	0	0	0	0	0
"SNAR-C3"	120	120	0	0	0	0	0	0	0	0	0	0	0	0	0	0	0	0
"SNAR-C4"	121	121	0	0	0	0	0	0	0	0	0	0	0	0	0	0	0	0
"SNAR-D"	120	120	0	0	0	0	0	0	0	0	0	0	0	0	0	0	0	0
"SNAR-E"	121	121	0	0	0	0	0	0	0	0	0	0	0	0	0	0	0	0
"SNAR-F"	124	124	0	0	0	0	0	0	0	0	0	0	0	0	0	0	0	0
"SNAR-G1"	129	129	0	0	0	0	0	0	0	14	0	0	0	0	0	0	0	0
"SNAR-G2"	120	120	0	0	0	0	0	0	0	0	0	0	0	0	0	0	0	0
"SNAR-H"	121	121	0	0	0	0	0	0	0	0	0	0	0	0	0	0	0	0
"SNAR-I"	122	122	0	0	0	0	0	0	0	0	0	0	0	0	0	0	0	0
"SNC73"	1124	277622	18	25	0	18	25	0	1287	528	54	68	466	446	354	367	865	713
"SNCA"	3220	113101	0	0	0	0	0	0	0	0	0	0	62	35	26	32	49	34
"SNCAIP"	5099	151976	0	0	0	0	0	0	0	0	0	0	0	0	0	0	0	0
"SNCB"	1456	10348	0	0	0	0	0	0	66	30	0	0	1	1	0	0	0	0
"SNCG"	831	4731	0	0	0	0	0	0	0	13	0	0	0	0	0	0	0	0
"SND1"	3531	440458	31383	23818	17636	13747	13104	10714	13935	11855	8066	15305	4331	4270	4566	4156	5420	3810
"SNED1"	6866	95390	2570	462	1454	1116	218	244	2143	480	1361	484	596	526	834	681	1233	580
"SNF8"	1219	14695	1985	4916	1128	857	2792	2124	321	2951	80	3309	4571	6801	5098	6109	6997	5865
"SNHG1"	2773	3898	5371	4890	3576	1795	2087	2803	482	1330	776	284	826	657	0	0	0	0
"SNHG10"	1328	1958	0	0	0	0	0	0	0	197	0	0	43	92	0	28	48	85
"SNHG11"	2655	4269	7	0	0	7	0	0	31	15	0	0	100	50	159	53	176	34
"SNHG3-RCC1"	2729	33113	13792	9467	9758	4034	4888	4579	4031	15690	594	4215	993	888	649	532	775	699
"SNHG5"	1082	1716	334	1954	4	330	1031	923	96	777	0	326	169	305	0	0	0	0
"SNHG7"	2363	6820	596	12	323	273	12	0	119	485	32	0	164	108	284	229	282	148
"SNHG8"	621	1062	510	9	298	212	9	0	123	587	0	0	295	354	277	258	281	247
"SNHG9"	233	508	0	0	0	0	0	0	0	63	0	0	5	0	13	0	0	14
"SNIP"	7068	75925	0	0	0	0	0	0	485	243	0	0	0	0	0	3	3	0
"SNIP1"	2472	17760	159	391	115	44	213	178	90	196	0	190	524	660	192	246	212	182
"SNN"	3274	10707	561	1703	389	172	909	794	112	489	55	852	1424	127	0	851	0	459
"SNORA1"	131	131	0	0	0	0	0	0	767	2895	0	0	0	1933	263	325	445	266
"SNORA10"	134	134	447	0	245	202	0	0	52	318	95	0	3871	3690	7326	7104	10893	7847
"SNORA11"	132	132	0	0	0	0	0	0	32	0	0	0	0	0	0	0	0	0
"SNORA11B"	127	127	185	0	111	74	0	0	207	20	93	17	0	0	0	0	0	0
"SNORA11C"	128	128	0	0	0	0	0	0	0	0	0	0	0	0	0	0	0	0
"SNORA11D"	128	128	0	0	0	0	0	0	0	0	0	0	0	0	0	0	0	0
"SNORA11E"	128	128	0	0	0	0	0	0	0	0	0	0	0	0	0	0	0	0
"SNORA12"	148	148	132	273	132	0	142	131	27	0	0	0	0	0	0	0	0	0
"SNORA13"	134	134	0	0	0	0	0	0	40	143	0	68	0	5	0	0	0	0
"SNORA14A"	135	135	0	0	0	0	0	0	0	0	0	0	0	0	0	0	0	0
"SNORA14B"	136	136	0	349	0	0	184	165	91	142	0	0	0	9	0	0	0	0
"SNORA15"	134	134	0	31	0	0	16	15	18	8	0	0	511	1198	0	335	0	0
"SNORA16A"	135	135	490	889	62	428	426	463	0	622	415	0	290	178	239	0	0	0
"SNORA16B"	134	134	173	0	71	102	0	0	73	21	113	0	0	0	0	0	0	0
"SNORA17"	134	134	488	0	287	201	0	0	0	414	0	0	37	30	0	0	0	0
"SNORA18"	133	133	124	0	0	124	0	0	767	2895	0	1340	0	1933	262	325	445	266
"SNORA19"	125	125	0	191	0	0	0	191	439	617	0	0	0	0	0	0	0	0
"SNORA20"	133	133	0	1628	0	0	855	773	0	1412	0	424	0	2396	1146	1957	0	389
"SNORA21"	134	134	217	242	131	86	120	122	48	129	0	136	2019	4461	0	0	0	0
"SNORA22"	134	134	54	0	54	0	0	0	29	0	0	0	0	0	0	22	0	10
"SNORA23"	190	190	240	0	135	105	0	0	51	159	0	124	0	0	0	0	0	0
"SNORA24"	132	132	510	0	298	212	0	0	102	587	0	0	184	99	62	97	224	187
"SNORA25"	131	131	448	870	278	170	463	407	135	2895	95	164	183	1933	183	266	445	203
"SNORA26"	123	123	0	0	0	0	0	0	33	0	0	0	6	0	0	0	0	0
"SNORA27"	127	127	449	1752	145	304	943	809	80	801	84	358	75	543	487	577	0	538
"SNORA28"	127	127	1421	2377	437	984	1978	399	136	1618	163	2932	0	829	0	0	0	0
"SNORA29"	141	141	0	193	0	0	98	95	0	1412	0	80	330	586	58	0	0	0
"SNORA2A"	136	136	0	0	0	0	0	0	0	0	0	0	0	0	0	0	0	0
"SNORA2B"	138	138	95	0	95	0	0	0	58	0	0	0	0	0	0	0	0	0
"SNORA3"	131	131	317	0	177	140	0	0	262	813	0	84	0	2575	5599	5733	1663	5273
"SNORA30"	130	130	1228	756	408	820	302	454	191	443	0	884	0	0	0	0	0	0
"SNORA31"	131	131	881	2654	675	206	1406	1248	397	1199	0	1646	0	48375	0	8528	9587	7531
"SNORA32"	122	122	448	870	278	170	463	407	135	2895	95	164	183	1933	183	266	445	203
"SNORA34"	138	138	139	0	139	0	0	0	80	302	0	149	249	0	0	0	0	0
"SNORA35"	129	129	0	0	0	0	0	0	0	0	0	0	0	0	0	0	0	0
"SNORA36A"	129	129	42	0	0	42	0	0	55	0	0	0	72	0	0	0	0	0
"SNORA36B"	132	132	0	0	0	0	0	0	0	14	0	0	0	0	0	0	0	0
"SNORA36C"	126	126	0	0	0	0	0	0	0	0	0	0	0	0	0	0	0	0
"SNORA37"	130	130	398	205	222	176	85	120	122	61	0	0	0	0	0	0	0	0
"SNORA38"	131	131	226	0	119	107	0	0	151	135	0	113	0	0	0	0	0	0
"SNORA38B"	131	131	0	0	0	0	0	0	0	0	0	0	0	0	0	0	0	0
"SNORA39"	1423	1423	0	0	0	0	0	0	5	0	0	0	23	14	66	10	28	10
"SNORA4"	138	138	5355	8013	3030	2325	4216	3797	1691	3892	2212	2707	6076	0	0	0	0	0
"SNORA40"	127	127	193	0	0	193	0	0	767	2895	224	1340	0	1933	0	0	0	0
"SNORA41"	131	131	0	0	0	0	0	0	0	0	0	0	482	1166	830	460	1076	444
"SNORA42"	135	135	200	0	200	0	0	0	0	0	0	0	0	0	0	0	0	0
"SNORA43"	134	134	287	0	287	0	0	0	38	414	0	0	0	0	0	0	0	0
"SNORA44"	133	133	464	0	36	428	0	0	0	622	0	0	290	178	240	0	0	0
"SNORA45"	132	132	571	898	310	261	480	418	262	813	199	202	1989	2575	5599	5733	9968	5273
"SNORA46"	136	136	84	201	84	0	201	0	0	0	0	123	0	0	0	0	0	0
"SNORA47"	139	139	0	0	0	0	0	0	44	0	0	0	0	0	0	0	0	0
"SNORA48"	136	136	6288	6887	3417	2871	4664	2223	1963	6208	4905	5121	8803	10026	2444	2424	2540	2078
"SNORA49"	137	137	0	0	0	0	0	0	56	199	0	147	0	0	0	0	0	0
"SNORA50"	137	137	277	366	115	162	277	89	155	168	0	105	0	0	0	0	5	1
"SNORA51"	133	133	482	0	417	65	0	0	62	56	0	0	0	0	0	0	623	0
"SNORA52"	135	135	516	0	281	235	0	0	124	344	0	0	47	1284	824	567	1047	918
"SNORA53"	251	251	208	204	208	0	204	0	0	144	0	167	4421	14	0	0	0	883
"SNORA54"	124	124	220	403	116	104	204	199	62	0	0	0	0	0	0	0	0	0
"SNORA55"	138	138	310	642	181	129	359	283	0	236	119	373	448	1197	0	0	0	0
"SNORA56"	129	129	39	0	19	20	0	0	22	0	0	0	0	41	74	0	84	0
"SNORA57"	150	150	2	504	1	1	242	262	0	356	261	0	76	0	39	0	0	0
"SNORA58"	138	138	34	0	0	34	0	0	171	0	0	91	0	0	0	0	0	0
"SNORA59B"	153	153	56	12	43	13	12	0	287	35	37	90	0	33	0	0	0	0
"SNORA5A"	134	134	746	448	389	357	0	448	299	609	912	951	564	917	345	0	955	0
"SNORA5B"	132	132	357	24	0	357	0	24	299	609	72	951	0	917	345	0	955	0
"SNORA5C"	138	138	746	448	389	357	0	448	299	609	912	951	564	917	345	0	955	0
"SNORA6"	150	150	741	629	386	355	348	281	85	322	0	525	1705	1942	1031	1130	1338	1018
"SNORA61"	131	131	235	467	15	220	467	0	0	247	265	0	290	178	165	0	0	0
"SNORA62"	154	154	754	956	494	260	510	446	267	570	0	0	1705	1942	0	0	0	0
"SNORA63"	136	136	5355	8013	3030	2325	4216	3797	1691	3892	2212	2707	6076	0	0	0	0	0
"SNORA64"	135	135	447	422	245	202	224	198	70	318	0	189	3871	3690	7326	7104	10893	7847
"SNORA65"	137	137	186	420	184	2	0	420	68	0	0	0	1676	1743	0	0	0	1
"SNORA66"	134	134	720	456	138	582	229	227	57	267	0	323	2076	4729	0	0	38	0
"SNORA67"	138	138	6288	6332	3417	2871	4664	1668	1963	6208	4905	5121	8803	10026	5234	8402	8040	8920
"SNORA68"	134	134	823	1414	368	455	807	607	251	1049	310	395	0	351	0	3289	0	2437
"SNORA69"	133	133	0	0	0	0	0	0	0	0	0	0	0	14	0	0	0	0
"SNORA70"	136	136	341	757	0	341	420	337	310	607	240	730	0	4329	7437	7879	10738	7609
"SNORA70B"	135	135	0	0	0	0	0	0	14	30	0	0	0	0	0	0	0	0
"SNORA70C"	128	128	0	0	0	0	0	0	0	0	0	0	0	0	0	0	0	0
"SNORA71A"	139	139	276	99	144	132	0	99	71	604	0	471	0	0	0	0	0	0
"SNORA71B"	137	137	599	757	346	253	385	372	141	604	0	471	0	107	0	0	0	0
"SNORA71C"	139	139	222	97	180	42	70	27	136	69	224	230	0	33	0	29	0	0
"SNORA71D"	139	139	0	0	0	0	0	0	98	343	0	149	0	0	0	0	0	0
"SNORA72"	133	133	176	446	176	0	446	0	119	275	0	0	522	6040	0	0	0	0
"SNORA74A"	201	201	247	176	117	130	176	0	0	172	0	0	0	0	0	0	0	0
"SNORA74B"	205	205	501	468	296	205	247	221	189	416	241	271	0	0	0	0	0	0
"SNORA75"	138	138	306	0	306	0	0	0	76	594	0	0	590	0	0	1993	0	0
"SNORA76"	133	133	1472	0	1472	0	0	0	165	858	481	327	0	0	0	0	0	0
"SNORA77"	126	126	0	0	0	0	0	0	14	0	0	0	0	0	0	0	0	0
"SNORA78"	128	128	0	0	0	0	0	0	0	63	0	0	0	0	0	0	0	0
"SNORA79"	141	141	0	0	0	0	0	0	0	0	0	0	0	0	0	0	0	0
"SNORA7B"	140	140	313	330	181	132	182	148	0	0	0	107	0	0	0	0	0	0
"SNORA8"	139	139	0	0	0	0	0	0	767	2895	452	1340	0	1933	263	325	445	266
"SNORA80"	136	136	18	0	18	0	0	0	0	0	0	0	0	0	0	0	0	0
"SNORA81"	179	179	5355	8013	3030	2325	4216	3797	1691	3892	0	2707	6076	0	1754	1634	1954	409
"SNORA84"	134	134	0	0	0	0	0	0	0	0	0	0	0	0	0	0	0	0
"SNORA9"	134	134	422	0	214	208	0	0	40	0	0	1811	0	0	0	733	0	0
"SNORD10"	148	148	6288	6332	3417	2871	4664	1668	1963	6208	4905	5121	8803	10026	2253	4733	4649	4202
"SNORD101"	2046	2046	88	266	0	88	147	119	147	236	0	217	1749	1799	5192	5738	6473	5216
"SNORD102"	73	73	449	1752	145	304	943	809	80	801	84	358	75	543	487	577	1280	538
"SNORD103A"	178	13518	1090	558	780	310	260	298	462	267	454	454	277	174	298	301	419	243
"SNORD104"	81	81	1472	0	1472	0	0	0	165	858	481	327	0	0	0	0	0	0
"SNORD105"	86	86	96	0	0	96	0	0	39	0	0	0	0	0	3	0	0	0
"SNORD105B"	93	93	0	0	0	0	0	0	0	495	0	0	0	0	0	0	0	0
"SNORD107"	1796	1796	337	25	163	174	0	25	186	16	0	0	0	7	0	6	0	1
"SNORD109B"	68	68	0	0	0	0	0	0	0	0	0	0	0	0	0	0	0	0
"SNORD11"	85	85	118	127	118	0	0	127	26	85	0	71	0	130	0	0	0	0
"SNORD110"	74	74	695	0	417	278	0	0	41	242	0	102	305	0	198	235	184	78
"SNORD111"	95	95	0	56	0	0	33	23	0	29	0	0	0	0	0	0	0	0
"SNORD111B"	95	95	0	0	0	0	0	0	0	0	0	0	0	0	0	0	0	0
"SNORD113-1"	71	71	0	0	0	0	0	0	0	0	0	0	0	0	0	0	0	0
"SNORD113-2"	71	71	0	0	0	0	0	0	0	0	0	0	0	0	0	0	0	0
"SNORD113-4"	74	74	0	0	0	0	0	0	0	0	0	0	0	0	0	0	0	0
"SNORD113-5"	78	78	0	0	0	0	0	0	0	0	0	0	0	0	0	0	0	0
"SNORD113-6"	74	74	0	0	0	0	0	0	0	0	0	0	0	0	0	0	0	0
"SNORD113-7"	76	76	0	0	0	0	0	0	0	0	0	0	0	0	0	0	0	0
"SNORD113-9"	71	71	0	0	0	0	0	0	0	0	0	0	0	0	0	0	0	0
"SNORD114-1"	71	71	0	0	0	0	0	0	0	0	0	0	0	0	0	0	0	0
"SNORD114-10"	71	71	0	0	0	0	0	0	0	0	0	0	0	0	0	0	0	0
"SNORD114-11"	74	74	0	0	0	0	0	0	0	0	0	0	0	0	0	0	0	0
"SNORD114-12"	74	74	0	0	0	0	0	0	0	0	0	0	0	0	0	0	0	0
"SNORD114-13"	73	73	0	0	0	0	0	0	0	0	0	0	0	0	0	0	0	0
"SNORD114-14"	74	74	0	0	0	0	0	0	0	0	0	0	0	0	0	0	0	0
"SNORD114-15"	72	72	0	0	0	0	0	0	0	0	0	0	0	0	0	0	0	0
"SNORD114-16"	69	69	0	0	0	0	0	0	0	0	0	0	0	0	0	0	0	0
"SNORD114-17"	74	74	0	0	0	0	0	0	0	0	0	0	0	0	0	0	0	0
"SNORD114-18"	71	71	0	0	0	0	0	0	0	0	0	0	0	0	0	0	0	0
"SNORD114-19"	74	74	0	0	0	0	0	0	0	0	0	0	0	0	0	0	0	0
"SNORD114-2"	77	77	0	0	0	0	0	0	0	0	0	0	0	0	0	0	0	0
"SNORD114-20"	72	72	0	0	0	0	0	0	0	0	0	0	0	0	0	0	0	0
"SNORD114-21"	71	71	0	0	0	0	0	0	0	0	0	0	0	0	0	0	0	0
"SNORD114-22"	71	71	0	0	0	0	0	0	0	0	0	0	0	0	0	0	0	0
"SNORD114-23"	71	71	0	0	0	0	0	0	0	0	0	0	0	0	0	0	0	0
"SNORD114-24"	72	72	0	0	0	0	0	0	0	0	0	0	0	0	0	0	0	0
"SNORD114-25"	72	72	0	0	0	0	0	0	0	0	0	0	0	0	0	0	0	0
"SNORD114-26"	71	71	0	0	0	0	0	0	0	0	0	0	0	0	0	0	0	0
"SNORD114-27"	69	69	0	0	0	0	0	0	0	0	0	0	0	0	0	0	0	0
"SNORD114-28"	71	71	0	0	0	0	0	0	0	0	0	0	0	0	0	0	0	0
"SNORD114-29"	70	70	0	0	0	0	0	0	0	0	0	0	0	0	0	0	0	0
"SNORD114-3"	74	74	0	0	0	0	0	0	0	0	0	0	0	0	0	0	0	0
"SNORD114-30"	71	71	0	0	0	0	0	0	0	0	0	0	0	0	0	0	0	0
"SNORD114-31"	74	74	0	0	0	0	0	0	0	0	0	0	0	0	0	0	0	0
"SNORD114-4"	104	104	0	0	0	0	0	0	0	0	0	0	0	0	0	0	0	0
"SNORD114-5"	69	69	0	0	0	0	0	0	0	0	0	0	0	0	0	0	0	0
"SNORD114-6"	71	71	0	0	0	0	0	0	0	0	0	0	0	0	0	0	0	0
"SNORD114-7"	77	77	0	0	0	0	0	0	0	0	0	0	0	0	0	0	0	0
"SNORD114-8"	72	72	0	0	0	0	0	0	0	0	0	0	0	0	0	0	0	0
"SNORD114-9"	71	71	0	0	0	0	0	0	0	0	0	0	0	0	0	0	0	0
"SNORD115-1"	83	83	0	0	0	0	0	0	0	0	0	0	0	0	0	0	0	0
"SNORD115-10"	83	83	0	0	0	0	0	0	39	28	0	0	0	0	0	0	0	0
"SNORD115-11"	83	83	0	0	0	0	0	0	11	0	0	0	0	0	0	0	0	0
"SNORD115-13"	83	83	0	0	0	0	0	0	0	0	0	0	0	0	0	0	0	0
"SNORD115-14"	82	82	0	0	0	0	0	0	17	0	0	0	0	0	0	0	0	0
"SNORD115-15"	166	26208	0	0	0	0	0	0	191	112	0	0	0	0	0	0	0	0
"SNORD115-16"	83	83	0	0	0	0	0	0	0	0	0	0	0	0	0	0	0	0
"SNORD115-17"	83	83	0	0	0	0	0	0	25	0	0	0	0	0	0	0	0	0
"SNORD115-2"	83	83	0	0	0	0	0	0	0	0	0	0	0	0	0	0	0	0
"SNORD115-22"	83	83	0	0	0	0	0	0	20	0	0	0	0	0	0	0	0	0
"SNORD115-25"	83	83	0	0	0	0	0	0	0	0	0	0	0	0	0	0	0	0
"SNORD115-26"	83	83	0	0	0	0	0	0	0	0	0	0	0	0	0	0	0	0
"SNORD115-3"	83	83	0	0	0	0	0	0	0	0	0	0	0	0	0	0	0	0
"SNORD115-30"	83	83	0	0	0	0	0	0	0	0	0	0	0	0	0	0	0	0
"SNORD115-31"	83	83	0	0	0	0	0	0	0	0	0	0	0	0	0	0	0	0
"SNORD115-32"	83	83	0	0	0	0	0	0	0	0	0	0	0	0	0	0	0	0
"SNORD115-33"	83	83	0	0	0	0	0	0	0	0	0	0	0	0	0	0	0	0
"SNORD115-35"	83	83	0	0	0	0	0	0	18	0	0	0	0	0	0	0	0	0
"SNORD115-37"	83	83	0	0	0	0	0	0	0	0	0	0	0	0	0	0	0	0
"SNORD115-38"	83	83	0	0	0	0	0	0	0	0	0	0	0	0	0	0	0	0
"SNORD115-39"	83	83	0	0	0	0	0	0	0	0	0	0	0	0	0	0	0	0
"SNORD115-4"	83	83	0	0	0	0	0	0	0	0	0	0	0	0	0	0	0	0
"SNORD115-40"	83	83	0	0	0	0	0	0	0	0	0	0	0	0	0	0	0	0
"SNORD115-41"	83	83	0	0	0	0	0	0	0	0	0	0	0	0	0	0	0	0
"SNORD115-44"	83	83	0	0	0	0	0	0	0	0	0	0	0	0	0	0	0	0
"SNORD115-48"	77	77	0	0	0	0	0	0	0	0	0	0	0	0	0	0	0	0
"SNORD115-5"	83	83	0	0	0	0	0	0	0	28	0	0	0	0	0	0	0	0
"SNORD115-6"	83	83	0	0	0	0	0	0	0	0	0	0	0	0	0	0	0	0
"SNORD115-7"	83	83	0	0	0	0	0	0	0	0	0	0	0	0	0	0	0	0
"SNORD115-8"	83	83	0	0	0	0	0	0	0	0	0	0	0	0	0	0	0	0
"SNORD116-1"	97	97	0	0	0	0	0	0	0	0	0	0	0	0	0	0	0	0
"SNORD116-10"	104	104	0	0	0	0	0	0	0	0	0	0	0	0	0	0	0	0
"SNORD116-11"	94	94	0	0	0	0	0	0	0	0	0	0	0	0	0	0	0	0
"SNORD116-12"	95	95	0	0	0	0	0	0	0	0	0	0	0	0	0	0	0	0
"SNORD116-13"	94	94	0	0	0	0	0	0	0	0	0	0	0	0	0	0	0	0
"SNORD116-14"	94	94	0	0	0	0	0	0	0	0	0	0	0	0	0	0	0	0
"SNORD116-15"	94	94	0	0	0	0	0	0	0	0	0	0	0	0	0	0	0	0
"SNORD116-16"	94	94	0	0	0	0	0	0	0	0	0	0	0	0	0	0	0	0
"SNORD116-18"	94	94	23	0	12	11	0	0	0	0	0	0	0	0	0	0	0	0
"SNORD116-19"	94	94	0	0	0	0	0	0	0	0	0	0	0	0	0	0	0	0
"SNORD116-2"	98	98	0	0	0	0	0	0	0	0	0	0	0	0	0	0	0	0
"SNORD116-22"	100	100	0	0	0	0	0	0	0	0	0	0	0	0	0	0	0	0
"SNORD116-23"	94	94	0	0	0	0	0	0	0	0	0	0	0	0	0	0	0	0
"SNORD116-24"	94	94	0	0	0	0	0	0	0	0	0	0	0	0	0	0	0	0
"SNORD116-25"	94	94	0	0	0	0	0	0	0	0	0	0	0	0	0	0	0	0
"SNORD116-26"	98	98	0	0	0	0	0	0	0	0	0	0	0	0	0	0	0	0
"SNORD116-27"	94	94	0	0	0	0	0	0	0	0	0	0	0	0	0	0	0	0
"SNORD116-28"	92	92	0	0	0	0	0	0	0	0	0	0	0	0	0	0	0	0
"SNORD116-29"	85	85	0	0	0	0	0	0	0	0	0	0	0	0	0	0	0	0
"SNORD116-3"	97	97	0	0	0	0	0	0	0	0	0	0	0	0	0	0	0	0
"SNORD116-4"	98	98	0	0	0	0	0	0	4	0	0	0	0	0	0	0	0	0
"SNORD116-5"	97	97	0	0	0	0	0	0	0	0	0	0	0	0	0	0	0	0
"SNORD116-8"	97	97	0	0	0	0	0	0	0	0	0	0	0	0	0	0	0	0
"SNORD117"	77	77	5746	427	3096	2650	427	0	1786	2101	4674	260	0	0	0	0	0	0
"SNORD119"	97	97	0	118	0	0	118	0	15	0	0	0	0	0	0	0	0	0
"SNORD11B"	113	113	0	111	0	0	57	54	0	94	0	0	0	0	0	0	0	0
"SNORD12"	91	91	4418	8644	2565	1853	4893	3751	1039	3882	0	3626	1579	4725	246	246	161	137
"SNORD121A"	91	91	36	31	36	0	31	0	0	0	0	0	0	0	0	0	0	0
"SNORD121B"	94	94	0	0	0	0	0	0	0	0	0	33	0	0	0	0	0	0
"SNORD123"	89	89	0	0	0	0	0	0	0	0	0	0	0	0	0	0	0	0
"SNORD124"	104	104	0	0	0	0	0	0	0	25	0	0	0	0	0	0	94	0
"SNORD125"	97	97	386	246	0	386	127	119	0	0	0	811	0	0	0	0	0	0
"SNORD126"	100	100	0	0	0	0	0	0	0	0	0	0	0	0	0	0	0	0
"SNORD127"	98	98	0	0	0	0	0	0	20	23	0	0	60	80	0	0	0	0
"SNORD12B"	104	104	4419	8644	2565	1854	4893	3751	1039	3882	0	3626	1579	4725	99	246	161	137
"SNORD12C"	79	79	2661	8644	2565	96	4893	3751	1039	3882	0	3626	0	4725	0	186	0	0
"SNORD15A"	149	149	1	0	1	0	0	0	102	382	0	238	0	1662	0	0	0	0
"SNORD15B"	147	147	839	2778	839	0	1472	1306	795	3854	1172	1412	2210	2102	0	1354	0	1499
"SNORD16"	99	99	1110	2964	626	484	1497	1467	198	1839	0	1505	4681	0	2899	3700	0	0
"SNORD17"	238	238	5976	3649	3107	2869	2063	1586	1243	2523	1797	2146	17	19	31	0	0	0
"SNORD18A"	71	71	1110	2964	626	484	1497	1467	198	1839	0	1505	4681	0	2899	3700	0	0
"SNORD18B"	71	71	93	2964	0	93	1497	1467	37	1839	0	1505	1275	0	0	0	916	0
"SNORD18C"	68	68	139	2964	46	93	1497	1467	37	1839	0	1505	1603	0	0	0	0	0
"SNORD19"	77	77	95	25	59	36	0	25	0	42	38	69	149	173	88	80	93	0
"SNORD19B"	94	94	165	76	77	88	50	26	31	65	85	144	362	462	213	153	241	161
"SNORD1A"	75	75	0	0	0	0	0	0	22	32	0	54	0	19	0	0	0	0
"SNORD1B"	87	87	0	0	0	0	0	0	22	32	0	0	0	0	0	43	0	0
"SNORD1C"	79	79	0	224	0	0	120	104	0	73	0	0	11	38	0	30	0	31
"SNORD2"	71	71	5355	8013	3030	2325	4216	3797	1691	3892	358	2707	6076	0	1754	1634	1954	1074
"SNORD20"	81	81	306	0	306	0	0	0	0	594	0	0	590	0	0	0	0	0
"SNORD21"	96	96	1115	1211	533	582	610	601	346	356	192	412	3325	4729	0	1437	21	1398
"SNORD22"	127	127	1295	2663	1295	0	1347	1316	242	1	558	0	823	0	0	0	0	0
"SNORD23"	110	110	0	0	0	0	0	0	22	29	0	79	0	82	28	156	0	29
"SNORD24"	75	75	1074	0	407	667	0	0	54	0	0	49	0	0	790	3883	0	0
"SNORD25"	67	67	0	1487	0	0	0	1487	245	546	218	129	823	0	0	0	0	0
"SNORD26"	76	76	183	1487	183	0	0	1487	245	546	218	129	823	0	0	0	0	0
"SNORD27"	73	73	2	0	2	0	0	0	245	546	0	0	823	0	0	0	0	0
"SNORD28"	76	76	7	653	7	0	653	0	245	546	0	119	823	0	0	0	0	0
"SNORD29"	66	66	2	0	2	0	0	0	245	64	0	119	823	0	0	0	0	0
"SNORD30"	71	71	1293	1403	1293	0	87	1316	245	64	0	0	823	0	0	0	0	0
"SNORD31"	69	69	1293	1403	1293	0	87	1316	242	0	558	0	823	0	0	0	0	0
"SNORD32A"	83	83	6775	5702	3809	2966	285	5417	1819	7889	578	1975	619	96	0	37	1	25
"SNORD32B"	77	77	0	0	0	0	0	0	0	0	0	0	0	0	0	0	0	0
"SNORD33"	84	84	6775	10439	3809	2966	4993	5446	1819	7889	0	1975	619	0	0	0	0	0
"SNORD34"	67	67	6771	10385	3809	2962	4968	5417	1819	7889	0	267	619	126	0	0	0	0
"SNORD35A"	87	87	6767	10389	3809	2958	4973	5416	1819	7889	0	267	619	126	0	0	0	0
"SNORD35B"	86	86	433	680	210	223	327	353	134	304	124	264	6427	6459	5649	6400	8000	6100
"SNORD36A"	71	71	1144	1137	477	667	617	520	101	0	89	157	2549	0	2853	3883	5527	4076
"SNORD36B"	72	72	1144	1137	477	667	617	520	101	0	89	157	2549	0	2853	3883	5527	4076
"SNORD36C"	66	66	1144	1137	477	667	617	520	101	0	0	157	2549	0	2853	3883	5527	4076
"SNORD37"	67	67	16	246	16	0	0	246	0	7	0	0	0	0	0	0	0	0
"SNORD38A"	70	70	622	508	343	279	273	235	152	1113	235	267	9369	10141	5449	5498	7583	5437
"SNORD38B"	69	69	622	508	343	279	273	235	152	1113	0	267	9369	10141	5449	1530	7583	1548
"SNORD41"	71	71	0	0	0	0	0	0	57	75	0	60	0	53	0	0	0	0
"SNORD42A"	64	64	0	0	0	0	0	0	19	74	0	0	0	0	0	0	0	0
"SNORD42B"	68	68	311	570	160	151	303	267	50	111	0	209	0	14	1718	0	0	1766
"SNORD43"	63	63	42	0	0	42	0	0	73	314	0	77	0	12	0	0	0	0
"SNORD44"	62	62	0	0	0	0	0	0	43	21	0	0	376	478	0	0	0	0
"SNORD45A"	85	85	2569	1977	1426	1143	1088	889	727	1060	170	846	1469	1703	146	72	99	18
"SNORD45B"	72	72	2569	1977	1426	1143	1088	889	727	1060	117	846	1469	1703	502	344	474	226
"SNORD45C"	79	79	2569	1977	1426	1143	1088	889	727	1060	0	846	1469	1703	42	39	56	37
"SNORD46"	99	99	1495	1147	374	1121	628	519	152	1113	540	147	0	10141	0	0	0	2
"SNORD47"	78	78	0	2086	0	0	1127	959	179	619	0	182	376	478	0	0	0	0
"SNORD48"	65	65	230	0	123	107	0	0	95	87	0	42	972	926	0	67	293	53
"SNORD49A"	72	72	390	427	201	189	222	205	137	141	95	145	637	605	348	370	348	243
"SNORD49B"	48	48	390	427	201	189	222	205	137	141	0	145	641	607	376	404	393	261
"SNORD4A"	73	73	237	194	110	127	194	0	84	74	139	178	920	1054	0	0	0	0
"SNORD4B"	75	75	0	0	0	0	0	0	19	0	0	0	0	0	0	0	0	0
"SNORD5"	74	74	124	1	0	124	1	0	767	2895	0	1340	0	1933	263	325	445	266
"SNORD50A"	76	76	0	1848	0	0	1031	817	0	777	0	326	0	305	0	0	0	0
"SNORD50B"	72	72	9	1848	4	5	1031	817	1	777	0	326	0	305	0	0	0	0
"SNORD51"	71	71	0	0	0	0	0	0	0	0	0	0	482	1166	0	460	0	444
"SNORD52"	64	64	158	127	98	60	66	61	0	17	0	206	972	926	315	81	491	86
"SNORD53"	77	77	53	138	0	53	75	63	44	44	0	0	0	0	1	0	0	0
"SNORD54"	64	64	118	494	0	118	289	205	60	233	0	66	0	3756	0	3253	0	3122
"SNORD55"	75	75	2057	0	936	1121	0	0	153	1113	540	0	773	10141	539	503	0	1272
"SNORD56"	71	71	1299	0	715	584	0	0	198	0	0	0	0	0	813	0	0	0
"SNORD56B"	71	71	0	1616	0	0	917	699	62	416	0	252	0	0	0	0	0	0
"SNORD57"	73	73	1299	0	715	584	0	0	198	0	0	0	0	0	813	404	910	0
"SNORD58A"	66	66	762	1172	432	330	639	533	103	195	0	0	623	719	1315	0	0	1290
"SNORD58B"	67	67	762	1172	432	330	639	533	103	195	0	0	623	719	1315	0	0	1290
"SNORD59A"	76	76	287	374	0	287	0	374	126	158	206	232	6007	6520	0	2417	0	0
"SNORD59B"	76	76	363	254	0	363	0	254	217	0	224	247	7978	8713	0	0	0	0
"SNORD6"	72	72	0	0	0	0	0	0	767	2895	0	0	22	1933	183	266	445	266
"SNORD60"	84	84	317	245	172	145	0	245	0	163	140	107	24	0	0	0	0	0
"SNORD61"	74	74	152	440	152	0	248	192	0	0	0	0	0	0	0	0	0	0
"SNORD62A"	86	86	133	0	48	85	0	0	63	58	0	0	83	0	114	0	131	84
"SNORD63"	68	68	192	301	97	95	150	151	23	0	0	0	0	961	0	0	0	0
"SNORD65"	74	74	161	0	0	161	0	0	36	130	0	0	1796	1727	0	589	751	0
"SNORD66"	75	75	425	626	298	127	320	306	9	563	0	325	0	0	508	0	0	0
"SNORD67"	111	111	152	0	152	0	0	0	38	101	0	0	0	0	0	0	0	0
"SNORD68"	73	73	1118	1986	0	1118	0	1986	153	786	0	296	3507	2653	4091	4254	8143	4321
"SNORD69"	78	78	79	164	0	79	164	0	3	40	0	0	692	1194	0	754	376	0
"SNORD7"	98	98	0	0	0	0	0	0	0	0	0	0	23	0	0	0	0	0
"SNORD70"	87	87	0	0	0	0	0	0	0	63	0	106	0	0	0	0	0	0
"SNORD71"	87	87	218	283	124	94	283	0	52	127	0	0	0	0	0	0	0	0
"SNORD72"	81	81	67	41	67	0	41	0	0	97	0	0	0	634	0	0	0	0
"SNORD73A"	66	66	191	116	101	90	61	55	56	46	0	0	1344	1519	223	256	282	235
"SNORD74"	73	73	37	71	37	0	0	71	25	59	0	64	0	0	0	0	0	0
"SNORD75"	61	61	0	0	0	0	0	0	95	319	0	0	376	478	0	0	0	0
"SNORD76"	82	82	0	0	0	0	0	0	95	319	0	0	376	478	0	0	0	0
"SNORD77"	62	62	0	0	0	0	0	0	0	21	0	0	376	478	0	0	0	0
"SNORD78"	54	54	0	0	0	0	0	0	43	619	0	0	376	478	0	0	0	0
"SNORD79"	82	82	0	0	0	0	0	0	43	619	0	0	376	478	0	0	0	0
"SNORD8"	110	110	0	0	0	0	0	0	21	0	0	0	0	0	0	0	0	0
"SNORD80"	72	72	333	2086	333	0	1127	959	179	619	0	0	376	478	0	0	0	0
"SNORD81"	44	44	85	959	85	0	0	959	179	619	0	182	376	478	0	0	0	0
"SNORD82"	76	76	279	0	151	128	0	0	0	132	0	0	0	0	0	0	0	0
"SNORD84"	79	79	1440	1032	777	663	1032	0	409	557	0	0	71	951	0	0	0	70
"SNORD85"	76	76	103	0	103	0	0	0	0	53	0	0	0	0	0	0	0	0
"SNORD86"	87	87	15	0	0	15	0	0	198	6	0	0	1	3	562	452	627	261
"SNORD87"	77	77	109	113	100	9	0	113	0	0	0	0	0	410	0	0	0	0
"SNORD88A"	98	98	0	0	0	0	0	0	0	0	0	0	0	0	0	0	0	0
"SNORD88B"	98	98	33	0	0	33	0	0	36	20	0	0	0	0	0	0	0	0
"SNORD88C"	98	98	0	0	0	0	0	0	0	0	0	0	0	0	0	0	0	0
"SNORD89"	115	115	840	1998	488	352	1043	955	179	694	261	151	391	0	0	161	95	0
"SNORD9"	104	104	0	0	0	0	0	0	0	0	0	0	0	0	0	0	0	0
"SNORD90"	108	108	2	0	0	2	0	0	0	0	0	0	0	0	0	0	0	0
"SNORD91A"	93	93	0	0	0	0	0	0	0	0	0	0	0	0	0	0	0	0
"SNORD91B"	87	87	0	0	0	0	0	0	0	152	0	0	0	0	0	0	0	0
"SNORD92"	90	90	0	0	0	0	0	0	0	0	0	46	0	0	0	0	0	0
"SNORD93"	74	74	0	0	0	0	0	0	11	16	0	0	0	0	0	0	0	0
"SNORD94"	138	138	297	253	183	114	123	130	361	194	0	0	117	0	0	0	90	0
"SNORD95"	64	64	5266	9947	2983	2283	5210	4737	458	2606	702	680	0	6446	0	0	2629	34
"SNORD96A"	73	73	533	0	308	225	0	0	126	2606	290	396	0	6446	0	0	3842	2930
"SNORD96B"	73	73	19	0	0	19	0	0	0	0	0	0	0	0	0	0	0	0
"SNORD97"	141	141	31	30	17	14	0	30	32	78	14	3	28108	0	0	0	0	0
"SNORD98"	68	68	1291	179	1176	115	93	86	1017	119	0	512	490	957	461	0	0	0
"SNORD99"	81	81	37	589	37	0	307	282	0	261	0	0	290	178	64	20	0	0
"SNPH"	5576	43011	0	0	0	0	0	0	150	52	0	0	1	0	0	0	0	0
"SNRK"	5271	64630	3812	2931	2236	1576	1674	1257	1990	1116	821	2072	1709	1402	1716	852	1869	870
"SNRNP200"	7217	31188	14846	3329	8476	6370	1767	1562	9751	1296	9580	1652	8971	7211	9329	5740	17309	6364
"SNRNP25"	1090	3841	0	0	0	0	0	0	50	0	0	0	550	477	763	599	948	659
"SNRNP27"	1409	11260	0	0	0	0	0	0	9	0	0	0	353	428	367	298	411	274
"SNRNP35"	1637	8292	452	34	306	146	34	0	185	71	302	89	484	360	417	319	520	398
"SNRNP40"	1855	37229	662	209	355	307	115	94	466	146	282	248	161	513	805	685	1059	630
"SNRNP48"	5844	21769	639	12	314	325	12	0	421	30	56	0	493	348	428	185	552	230
"SNRNP70"	1993	23406	4770	3189	2592	2178	1633	1556	1532	1477	3699	3652	3167	3294	5483	4913	6630	4420
"SNRP70"	3407	23406	4770	3189	2592	2178	1633	1556	1532	1477	3699	3652	3167	3294	5483	4913	6630	4420
"SNRPA"	1610	14515	1029	155	559	470	59	96	459	320	545	577	265	466	1	25	0	0
"SNRPA1"	1066	13745	575	791	317	258	418	373	335	566	286	1066	388	807	632	784	767	698
"SNRPB"	1972	9212	350	496	178	172	321	175	124	248	95	370	1250	2118	1310	2130	2070	2080
"SNRPB2"	1288	11410	56	103	21	35	52	51	33	42	0	33	518	835	1054	1059	1188	1057
"SNRPC"	719	16261	0	0	0	0	0	0	67	27	0	0	446	138	560	836	1058	780
"SNRPD1"	1604	17950	125	90	69	56	52	38	61	150	53	364	242	546	595	530	675	579
"SNRPD2"	871	4732	0	0	0	0	0	0	59	11	0	0	4	333	877	0	828	567
"SNRPD3"	1761	27236	449	119	231	218	68	51	270	200	0	270	2514	2762	1737	1421	1666	1395
"SNRPE"	1607	9553	0	0	0	0	0	0	36	25	0	0	214	26	406	431	547	438
"SNRPF"	795	7529	10	23	0	10	15	8	0	19	0	0	232	266	337	334	417	313
"SNRPG"	1217	12056	70	304	37	33	147	157	144	209	0	253	1411	332	496	568	562	487
"SNRPN"	1843	23661	571	69	311	260	49	20	344	20	0	45	623	1023	853	979	1232	902
"SNTA1"	2348	35937	163	15	130	33	0	15	194	40	50	12	124	102	67	44	136	91
"SNTB1"	4981	276325	59	8	59	0	0	8	604	196	0	0	274	276	226	219	405	283
"SNTB2"	9777	121906	1236	54	753	483	21	33	842	74	151	9	932	910	827	434	1061	555
"SNTG1"	1983	883080	0	0	0	0	0	0	0	0	0	0	0	0	0	0	0	0
"SNTG2"	1901	424829	0	0	0	0	0	0	207	34	0	0	0	0	0	9	4	0
"SNTN"	1578	12539	0	0	0	0	0	0	0	0	0	0	0	0	0	0	0	0
"SNUPN"	1945	27605	110	0	51	59	0	0	106	15	58	0	483	274	579	327	396	459
"SNURF"	1411	44157	1815	328	1065	750	174	154	1022	159	0	94	589	925	879	1004	1256	918
"SNURF-SNRPN"	9009	32832	5868	2585	3386	2482	1462	1123	3582	1355	703	1284	2617	3499	2541	2300	2653	1899
"SNW1"	2137	43553	740	763	476	264	406	357	362	614	42	956	1015	1227	1394	1270	1842	1264
"SNX 3A"	1555	49748	2142	51	1264	878	32	19	1018	106	881	189	5723	418	787	1594	886	1107
"SNX1"	8234	48256	5917	3008	3352	2565	1628	1380	2992	1852	3509	3632	4099	4389	5084	4040	6246	3621
"SNX10"	2695	82424	966	361	567	399	193	168	1124	437	187	308	1051	1568	638	938	1287	1137
"SNX11"	2410	15187	424	555	219	205	287	268	256	566	89	798	940	1302	1403	1977	1739	1344
"SNX12"	1081	78869	752	100	382	370	59	41	379	0	125	21	1990	2037	1911	1423	2397	1431
"SNX13"	6881	147667	11221	3469	6174	5047	2001	1468	5775	1788	2215	1890	1721	2245	1759	1678	1965	1326
"SNX14"	3944	76349	6201	1867	3529	2672	1069	798	3992	1006	2086	1297	2784	3260	2427	1991	3031	1962
"SNX15"	2471	26458	58	0	44	14	0	0	171	77	0	0	1215	1046	1008	937	1870	1164
"SNX16"	3463	42703	546	190	301	245	80	110	365	125	0	70	348	427	275	182	436	271
"SNX17"	2183	6607	764	183	423	341	77	106	538	219	594	246	5170	4213	4170	3213	6085	3609
"SNX18"	5377	28828	1717	158	904	813	74	84	903	17	678	31	1818	706	1800	505	2104	784
"SNX19"	6088	40617	3354	1527	1856	1498	881	646	2506	1433	1941	1956	2444	3019	1411	1160	2296	1016
"SNX2"	2372	54792	4364	151	2515	1849	99	52	2428	184	773	111	3804	4234	5425	4133	5003	3543
"SNX20"	3308	15055	1353	985	726	627	583	402	589	637	700	1049	4337	4641	2389	1520	4705	2840
"SNX21"	3189	9446	191	10	102	89	10	0	101	11	164	0	206	59	152	88	208	81
"SNX22"	3621	5766	215	42	137	78	21	21	71	37	42	31	293	1405	1750	1999	2534	448
"SNX24"	2219	163743	1281	179	756	525	93	86	1421	135	0	95	338	418	452	386	365	305
"SNX25"	3223	153829	62	0	37	25	0	0	51	3	0	0	67	130	132	116	154	99
"SNX26"	4181	13250	30	314	3	27	155	159	123	202	17	30	10	14	38	28	119	3
"SNX27"	7097	86899	2555	702	1451	1104	400	302	1125	269	1013	484	1758	1541	2295	1531	2488	1380
"SNX29"	7016	522092	72374	62247	40626	31748	33531	28716	33262	34241	45958	61458	4574	4908	5205	4725	6889	4119
"SNX3"	1467	49748	2142	51	1264	878	32	19	1018	106	881	189	5723	418	787	1594	886	1107
"SNX30"	7614	124134	10419	932	5837	4582	505	427	4665	1586	5120	1620	4074	3916	4332	3226	5270	2996
"SNX31"	2467	76781	0	0	0	0	0	0	0	0	0	0	0	0	0	0	0	0
"SNX32"	1716	19762	1629	448	932	697	349	99	237	694	264	2749	1	0	0	0	0	0
"SNX33"	3233	9620	781	133	445	336	67	66	480	129	451	102	1004	741	1265	875	1820	969
"SNX4"	2537	73565	1322	169	715	607	86	83	742	88	379	178	606	1070	874	979	1310	876
"SNX5"	3096	20394	9159	5943	4968	4191	3180	2763	2808	3579	5354	3810	3396	3815	3857	3442	5901	3716
"SNX6"	3120	68750	2595	1502	1444	1151	830	672	1319	1234	1249	3324	2514	2719	1763	2420	3658	1224
"SNX7"	1784	98820	0	0	0	0	0	0	0	0	0	0	0	0	0	0	0	0
"SNX8"	1502	59460	26457	24082	14619	11838	12841	11241	6369	9612	24754	40485	3460	8125	6304	2569	4682	3137
"SNX9"	4218	121817	1221	4400	716	505	2334	2066	1513	2560	116	1524	1256	1206	1667	1553	1987	1206
"SOAT1"	3408	61437	20501	8890	11528	8973	4898	3992	7021	3105	8704	9600	12071	12558	11825	9358	14247	9406
"SOAT2"	2087	21050	0	0	0	0	0	0	0	10	0	0	0	0	0	0	0	0
"SOBP"	6234	171193	1881	41	1185	696	23	18	909	63	187	148	206	223	216	103	450	209
"SOCS1"	1218	1767	2052	481	1148	904	256	225	728	449	913	868	24	1297	0	1789	0	1470
"SOCS2"	2213	6382	0	0	0	0	0	0	0	27	0	0	70	193	148	364	132	148
"SOCS3"	2736	3301	380	2063	226	154	1053	1010	52	1258	0	2130	843	21158	527	21858	815	18246
"SOCS4"	7013	22362	442	91	222	220	70	21	344	174	0	0	1111	1193	1086	848	1221	740
"SOCS5"	4511	63579	1857	253	1162	695	173	80	1383	241	164	254	633	492	684	309	772	296
"SOCS6"	5848	41299	1735	231	940	795	104	127	926	355	334	158	889	482	1195	554	1302	482
"SOCS7"	2620	48014	600	85	321	279	52	33	397	98	4	159	850	954	567	444	695	137
"SOD1"	1748	9221	214	136	118	96	81	55	98	64	0	102	1279	1516	1695	1248	1861	1372
"SOD2"	2044	2324	4861	67214	3766	1095	36286	30928	92	28031	97	48241	4670	167400	2886	90086	2770	51644
"SOD3"	1530	5383	0	0	0	0	0	0	0	0	0	0	0	0	0	0	0	0
"SOHLH1"	1990	6119	0	0	0	0	0	0	32	18	0	0	0	0	0	0	0	0
"SOHLH2"	2664	129647	0	0	0	0	0	0	0	0	0	0	0	0	0	0	0	0
"SOLH"	4756	26780	4177	2683	2277	1900	1342	1341	1680	2398	5774	6658	1727	1576	1973	2225	3214	2020
"SOLO"	5169	19510	1399	72	766	633	31	41	666	121	480	40	2572	1794	2402	1650	3044	1782
"SON"	8424	34464	11754	12061	6481	5273	6443	5618	5189	5241	5373	7855	13419	17351	17903	16230	19106	10865
"SONE"	3566	11290	0	0	0	0	0	0	69	103	0	0	3	7	28	45	83	39
"SORBS1"	7344	249642	0	0	0	0	0	0	30	0	0	0	0	15	4	0	19	0
"SORBS2"	6587	371273	0	0	0	0	0	0	56	0	0	0	0	0	0	0	0	0
"SORBS3"	3143	23758	4328	1435	2355	1973	678	757	1300	928	5512	3095	3145	2336	4485	3561	5402	2802
"SORCS1"	7297	590872	0	0	0	0	0	0	0	8	0	0	0	0	0	0	0	0
"SORCS2"	6079	550191	0	12	0	0	12	0	3279	1534	0	0	0	0	0	0	0	0
"SORCS3"	5784	624136	0	0	0	0	0	0	9	7	0	0	0	0	0	0	0	0
"SORD"	2619	51699	65	0	27	38	0	0	203	0	0	0	315	362	804	800	945	867
"SORL1"	10972	181512	263	100	135	128	58	42	252	80	56	241	1361	1818	1539	1619	1248	674
"SORT1"	7038	88373	2031	370	1170	861	166	204	1969	468	432	444	3753	3466	6033	2110	8299	6011
"SOS1"	8339	138914	6987	2693	3864	3123	1488	1205	3876	2236	1194	2690	1437	1619	918	667	1159	641
"SOS2"	5335	114254	3835	672	2116	1719	415	257	2222	498	938	509	2194	1370	1362	1016	1492	792
"SOST"	2302	5059	0	0	0	0	0	0	0	9	0	0	0	0	0	0	0	0
"SOSTDC1"	2476	69099	0	0	0	0	0	0	9	0	0	0	0	0	0	0	0	0
"SOX1"	4109	4109	0	0	0	0	0	0	0	0	0	0	0	0	0	0	0	0
"SOX10"	2866	12222	11	0	11	0	0	0	143	39	0	0	0	0	0	0	0	0
"SOX11"	8719	8719	0	0	0	0	0	0	0	0	0	0	0	0	0	0	0	0
"SOX12"	4628	4628	121	30	95	26	11	19	145	35	0	15	293	127	305	102	382	148
"SOX13"	4085	54625	0	0	0	0	0	0	192	49	0	0	3	12	42	37	10	14
"SOX14"	819	819	0	0	0	0	0	0	0	0	0	0	0	0	0	0	0	0
"SOX15"	1396	1992	124	10	110	14	10	0	17	94	0	45	1069	1227	1102	1279	1313	1149
"SOX17"	2351	2962	0	0	0	0	0	0	0	0	0	0	0	0	0	0	0	0
"SOX18"	1705	1900	0	0	0	0	0	0	0	0	0	0	0	0	0	0	0	0
"SOX2"	2501	2501	0	0	0	0	0	0	0	0	0	0	0	0	0	0	0	0
"SOX21"	2509	2509	0	0	0	0	0	0	0	0	0	0	0	0	0	0	0	0
"SOX2OT"	2498	130854	0	0	0	0	0	0	0	0	0	0	0	0	0	0	0	0
"SOX3"	2075	2075	0	0	0	0	0	0	0	0	0	0	0	0	0	0	0	0
"SOX30"	3270	26743	0	0	0	0	0	0	11	0	0	0	0	0	0	0	0	0
"SOX4"	4877	4877	189	123	107	82	63	60	82	25	0	24	934	600	1054	627	1227	574
"SOX5"	4563	1030150	0	0	0	0	0	0	0	0	0	0	0	0	0	0	0	0
"SOX6"	8993	436419	784	0	459	325	0	0	12	191	0	0	789	560	415	519	410	0
"SOX7"	3331	116022	1233	194	738	495	139	55	869	480	243	390	199	230	214	227	242	196
"SOX8"	3051	5172	0	0	0	0	0	0	35	15	0	0	111	76	45	0	382	213
"SOX9"	3929	5393	0	0	0	0	0	0	11	0	0	0	0	0	0	0	0	0
"SP1"	7661	36247	2838	839	1563	1275	445	394	1516	436	1394	839	5263	3990	6731	3662	7279	3385
"SP100"	5484	129448	8886	2350	5029	3857	1360	990	3994	1037	1902	1342	2132	2429	1522	1091	1727	1108
"SP110"	2596	51184	1996	130	1180	816	46	84	1507	176	458	207	875	603	1300	606	1147	692
"SP140"	3278	87488	332	32	193	139	22	10	474	128	43	11	131	143	275	210	293	203
"SP140L"	2687	76553	1121	178	669	452	109	69	1165	119	149	13	664	528	777	499	791	431
"SP2"	3293	31349	757	368	418	339	190	178	578	421	273	466	706	707	683	616	874	701
"SP3"	3941	55690	7572	1795	4220	3352	1009	786	3145	913	2868	1575	2657	1944	2475	1428	3021	1242
"SP4"	5804	86462	426	90	251	175	33	57	347	54	0	121	296	290	314	168	371	211
"SP5"	1948	2642	0	0	0	0	0	0	0	0	0	0	0	0	0	0	0	0
"SP6"	3850	6281	0	0	0	0	0	0	34	22	0	0	0	0	0	0	0	0
"SP7"	3151	9806	0	0	0	0	0	0	64	23	0	0	0	0	0	0	0	0
"SP8"	3731	4615	0	0	0	0	0	0	0	0	0	0	0	0	0	0	0	0
"SP9"	1457	2449	0	0	0	0	0	0	0	0	0	0	0	0	0	0	0	0
"SPA17"	940	20947	0	0	0	0	0	0	20	19	0	0	35	41	54	48	68	33
"SPACA1"	1505	19044	0	0	0	0	0	0	0	0	0	0	0	0	0	0	0	0
"SPACA3"	824	6012	0	0	0	0	0	0	0	0	0	0	0	0	0	0	0	0
"SPACA4"	972	972	0	0	0	0	0	0	0	0	0	0	0	0	0	0	0	0
"SPACA5"	737	5394	0	0	0	0	0	0	0	0	0	0	0	0	0	0	0	0
"SPAG1"	3871	83476	98	389	69	29	183	206	169	6799	0	491	82	215	58	73	79	77
"SPAG11A"	759	15918	0	0	0	0	0	0	0	0	0	0	0	0	0	0	0	0
"SPAG11B"	797	13107	0	0	0	0	0	0	0	0	0	0	0	0	0	0	0	0
"SPAG16"	4810	956968	0	0	0	0	0	0	23	0	0	0	6	8	0	16	4	6
"SPAG17"	7174	231562	5	0	5	0	0	0	16	4	4	0	139	166	212	77	210	105
"SPAG4"	1464	5158	38	0	25	13	0	0	0	46	0	0	0	0	0	0	0	0
"SPAG4L"	1264	20659	0	0	0	0	0	0	128	19	0	0	0	0	0	0	0	0
"SPAG5"	3830	21473	5812	2150	2258	3554	1175	975	2242	796	3654	1113	680	729	1263	650	2440	1082
"SPAG6"	2747	72119	0	0	0	0	0	0	0	0	0	0	0	0	0	0	0	0
"SPAG7"	1703	7965	253	91	158	95	39	52	87	293	0	367	908	1481	936	580	553	806
"SPAG8"	2015	4477	0	0	0	0	0	0	29	0	0	0	12	6	6	15	25	15
"SPAG9"	8302	158692	8334	35462	4652	3682	19241	16221	2551	14878	1303	20711	2821	3812	3980	5094	4284	3072
"SPAM1"	2386	46132	0	0	0	0	0	0	0	0	0	0	0	0	0	0	0	0
"SPANX"	409	337265	0	0	0	0	0	0	0	0	0	0	0	0	0	0	0	0
"SPANXA1"	419	1065	0	0	0	0	0	0	0	0	0	0	0	0	0	0	0	0
"SPANXB2"	470	1116	0	0	0	0	0	0	0	0	0	0	0	0	0	0	0	0
"SPANXC"	405	1051	0	0	0	0	0	0	0	0	0	0	0	0	0	0	0	0
"SPANXE"	442	1088	0	0	0	0	0	0	0	0	0	0	0	0	0	0	0	0
"SPANXN1"	615	8623	0	0	0	0	0	0	0	0	0	0	0	0	0	0	0	0
"SPANXN2"	1378	9462	0	0	0	0	0	0	0	0	0	0	0	0	0	0	0	0
"SPANXN3"	595	8744	0	0	0	0	0	0	0	0	0	0	0	0	0	0	0	0
"SPANXN4"	432	8363	0	0	0	0	0	0	0	0	0	0	0	0	0	0	0	0
"SPANXN5"	563	1204	0	0	0	0	0	0	0	0	0	0	0	0	0	0	0	0
"SPAP1"	2417	31401	0	0	0	0	0	0	0	0	0	0	25	22	9	0	3	0
"SPARC"	3140	25500	0	0	0	0	0	0	0	4	0	0	405	326	1640	2310	903	1082
"SPARCL1"	3016	56167	0	0	0	0	0	0	0	8	0	0	0	0	0	0	0	0
"SPAST"	5229	94027	2401	39	1255	1146	17	22	1480	19	823	21	1971	1508	1594	780	1618	911
"SPATA1"	1996	59903	1739	135	1123	616	95	40	783	120	116	17	1186	604	612	656	496	326
"SPATA12"	2415	14993	0	0	0	0	0	0	18	0	0	0	0	0	6	0	0	0
"SPATA13"	5669	342828	582	90	242	340	46	44	809	76	25	54	1149	1261	1131	821	917	544
"SPATA16"	2091	251886	0	0	0	0	0	0	0	0	0	0	0	0	0	0	0	0
"SPATA17"	1408	235809	0	0	0	0	0	0	0	0	0	0	0	0	0	0	0	0
"SPATA18"	4312	45866	0	0	0	0	0	0	0	0	0	0	17	29	13	42	16	15
"SPATA19"	873	4877	0	0	0	0	0	0	20	0	0	0	0	0	0	0	0	0
"SPATA2"	4141	10347	70	49	39	31	29	20	105	119	0	213	223	355	320	390	386	354
"SPATA20"	2810	8784	351	139	178	173	80	59	227	132	104	47	733	881	488	423	1325	807
"SPATA21"	3667	41745	610	714	359	251	418	296	335	516	0	682	4090	4608	4387	4603	4966	4197
"SPATA22"	1692	73832	0	0	0	0	0	0	0	0	0	0	0	0	0	0	0	0
"SPATA24"	682	7320	0	0	0	0	0	0	33	10	0	0	0	6	6	5	0	0
"SPATA2L"	2319	5335	46	96	2	44	66	30	150	189	0	378	281	680	291	592	902	799
"SPATA3"	1629	28933	0	79	0	0	39	40	61	37	0	0	0	0	0	0	0	0
"SPATA4"	1239	11099	0	0	0	0	0	0	0	0	0	0	0	0	0	0	0	0
"SPATA5"	8154	396379	635	450	283	352	320	130	717	401	58	381	110	143	45	52	54	19
"SPATA5L1"	2615	19097	405	1321	246	159	765	556	172	765	101	985	258	485	357	436	513	357
"SPATA6"	3106	75028	5	11	5	0	6	5	43	2	0	0	263	304	70	117	232	155
"SPATA7"	2391	22534	0	0	0	0	0	0	22	0	0	0	22	29	18	14	29	19
"SPATA8"	1025	2167	0	0	0	0	0	0	0	0	0	0	0	0	0	0	0	0
"SPATA9"	2406	30831	0	0	0	0	0	0	0	0	0	0	0	0	5	3	4	6
"SPATC1"	2040	15434	60	9	28	32	3	6	99	117	0	13	4	1	0	7	3	0
"SPATS1"	1860	104102	362	63	195	167	29	34	303	85	51	84	491	427	474	384	626	425
"SPATS2"	3895	160521	7594	2575	4173	3421	1467	1108	3472	1601	3630	2707	723	726	846	590	815	483
"SPATS2L"	6390	176368	2521	354	1403	1118	223	131	1832	374	252	203	1621	1664	1580	1376	1722	1220
"SPC24"	659	8655	0	0	0	0	0	0	0	0	0	0	0	0	0	0	0	0
"SPC25"	1352	19544	0	0	0	0	0	0	0	0	0	0	0	3	0	0	0	0
"SPCS1"	1086	2340	0	0	0	0	0	0	54	16	0	0	1837	1829	1721	1522	1994	1640
"SPCS2"	2713	29786	1271	1336	716	555	737	599	529	800	207	724	1192	1404	2059	2029	2289	1758
"SPCS3"	4599	12306	1833	377	1061	772	226	151	911	177	725	202	6875	7066	5904	4723	5419	3513
"SPDEF"	1900	18513	0	0	0	0	0	0	258	40	0	0	0	0	1	0	0	0
"SPDYA"	2098	58292	2089	1872	1199	890	1012	860	903	671	509	1505	5473	6396	4585	4170	4931	3578
"SPDYC"	888	2982	0	0	0	0	0	0	0	0	0	0	0	0	0	0	0	0
"SPDYE1"	2656	9235	362	102	204	158	66	36	169	129	245	184	11	14	256	241	776	11
"SPDYE2"	2441	7731	95	86	53	42	52	34	297	128	744	482	13	103	823	802	1691	725
"SPDYE3"	2891	10050	16	0	0	16	0	0	23	0	0	0	46	64	500	344	246	98
"SPDYE4"	929	5455	0	0	0	0	0	0	18	11	0	0	0	0	0	0	0	0
"SPDYE5"	2674	9330	173	27	58	115	27	0	104	40	77	21	0	0	56	41	110	42
"SPDYE6"	3152	10698	0	0	0	0	0	0	170	82	278	195	0	53	758	724	1734	675
"SPDYE7P"	6339	6339	0	0	0	0	0	0	0	0	0	0	0	0	0	0	0	0
"SPDYE8P"	5782	38074	0	0	0	0	0	0	0	0	0	0	0	0	632	568	340	201
"SPEF1"	1593	3952	1	0	0	1	0	0	21	9	0	0	0	0	0	0	0	0
"SPEF2"	5674	196725	0	0	0	0	0	0	0	0	0	0	2	7	12	4	14	0
"SPEG"	10689	58654	0	0	0	0	0	0	587	345	0	0	0	0	0	0	0	0
"SPEM1"	984	1273	0	0	0	0	0	0	15	0	0	0	0	0	0	0	0	0
"SPEN"	12242	92593	7500	9473	4049	3451	4923	4550	2685	4137	2105	6576	5471	6576	5962	5453	7369	3990
"SPERT"	1843	11432	0	0	0	0	0	0	0	0	0	0	0	0	0	0	0	0
"SPESP1"	1406	16286	0	0	0	0	0	0	0	0	0	0	39	42	32	20	36	35
"SPF31"	1894	32752	139	268	90	49	149	119	110	361	30	530	1329	1575	1256	1225	2383	1662
"SPG11"	7827	100983	9575	10650	5547	4028	5646	5004	4666	3863	5494	6283	4821	6413	5202	5090	6000	4249
"SPG20"	5022	44871	1752	944	1009	743	533	411	939	548	157	649	1936	1926	2254	1974	2244	1577
"SPG21"	1806	26889	2354	3200	1423	931	1796	1404	770	1350	1172	4412	4945	5501	2203	4042	2774	1918
"SPG7"	3098	49370	3627	2469	2013	1614	1354	1115	1632	1544	2596	3733	1216	1216	1594	1421	1914	978
"SPHAR"	1121	1121	150	0	111	39	0	0	69	14	0	0	408	361	389	241	453	299
"SPHK"	1019	1708	8	5	8	0	3	2	0	30	0	29	146	316	1028	468	218	255
"SPHK-2"	2242	10004	515	0	305	210	0	0	385	142	314	0	425	383	518	399	689	389
"SPHK1"	2511	4885	323	22	196	127	7	15	125	132	512	87	366	316	1082	1232	650	776
"SPHK2"	3090	5749	545	0	305	240	0	0	436	195	314	0	550	388	521	405	881	514
"SPHKAP"	6925	201693	0	0	0	0	0	0	13	0	0	0	0	0	0	0	0	0
"SPI1"	1413	23720	25312	25430	14076	11236	13631	11799	7898	11049	20863	270	13999	16219	15804	18106	19681	16834
"SPIB"	1476	10056	1	0	0	1	0	0	105	46	0	0	0	0	0	5	5	0
"SPIC"	1137	11577	0	0	0	0	0	0	0	0	0	0	0	0	0	0	0	0
"SPIN1"	4931	90325	3060	321	1799	1261	195	126	1980	382	1282	356	1733	1565	1738	1194	1924	1133
"SPIN2A"	1320	1976	0	0	0	0	0	0	0	0	0	0	0	0	50	37	59	26
"SPIN2B"	1260	1865	0	0	0	0	0	0	0	0	0	0	20	38	108	69	81	39
"SPIN3"	4461	4726	37	0	19	18	0	0	15	0	0	0	30	29	62	0	22	0
"SPIN4"	4112	4112	0	0	0	0	0	0	10	0	0	0	389	341	285	141	208	87
"SPINK1"	445	7119	0	0	0	0	0	0	0	0	0	0	0	0	0	0	0	0
"SPINK2"	595	11861	0	0	0	0	0	0	0	0	0	0	0	0	0	0	0	0
"SPINK4"	371	8370	0	0	0	0	0	0	9	10	0	0	0	0	0	0	0	0
"SPINK5"	3763	73392	0	0	0	0	0	0	0	0	0	0	0	0	0	0	0	0
"SPINK5L2"	298	5667	0	0	0	0	0	0	0	0	0	0	0	0	0	0	0	0
"SPINK5L3"	807	17492	0	0	0	0	0	0	0	0	0	0	0	0	0	0	0	0
"SPINK6"	689	12297	0	0	0	0	0	0	0	0	0	0	0	0	0	0	0	0
"SPINK7"	551	3491	0	0	0	0	0	0	0	0	0	0	0	0	0	0	0	0
"SPINK8"	445	21497	0	0	0	0	0	0	0	0	0	0	0	0	0	0	0	0
"SPINK9"	457	4292	0	0	0	0	0	0	0	0	0	0	0	0	0	0	0	0
"SPINLW1"	2437	5751	0	0	0	0	0	0	0	0	0	0	0	0	0	0	0	0
"SPINT1"	2484	13608	728	89	324	404	36	53	317	32	366	0	4364	2606	3985	2750	6376	3789
"SPINT2"	1559	27908	4273	2977	2398	1875	1581	1396	1313	1259	3321	4534	11463	10263	16128	14810	22343	17108
"SPINT3"	478	3165	0	0	0	0	0	0	0	0	0	0	0	0	0	0	0	0
"SPINT4"	383	3349	0	0	0	0	0	0	0	0	0	0	0	0	0	0	0	0
"SPIRE1"	5460	211402	1713	403	1018	695	271	132	785	227	105	273	905	972	984	842	1073	739
"SPIRE2"	3355	21455	90	80	48	42	41	39	512	178	164	16	36	35	44	80	37	55
"SPN"	6910	7523	11838	5158	6632	5206	2754	2404	3700	1546	9905	3046	59918	55957	25576	18347	34943	17550
"SPNS1"	3194	10744	721	201	413	308	102	99	371	195	951	470	998	887	1796	1606	2048	1292
"SPNS2"	4362	41101	91	0	42	49	0	0	417	154	0	0	8	1	0	0	0	0
"SPNS3"	1904	54281	0	0	0	0	0	0	180	72	0	0	0	0	0	0	0	0
"SPO11"	1829	14219	0	0	0	0	0	0	0	0	0	0	0	0	0	0	0	0
"SPOCD1"	3904	25557	6	0	6	0	0	0	116	84	21	9	325	257	1184	891	910	453
"SPOCK1"	4876	523452	0	0	0	0	0	0	50	37	0	0	0	0	0	0	0	0
"SPOCK2"	5456	29740	10	0	0	10	0	0	105	90	0	72	159	159	60	105	163	43
"SPOCK3"	3072	501207	0	0	0	0	0	0	0	0	0	0	3	0	0	0	0	0
"SPON1"	5389	305734	0	0	0	0	0	0	25	0	0	0	0	0	0	0	0	0
"SPON2"	1853	5921	112	0	71	41	0	0	181	47	0	34	41	41	139	126	150	132
"SPOP"	3260	47746	4056	253	2210	1846	127	126	2147	118	778	141	1684	1163	1926	1170	2543	1436
"SPOPL"	5743	71455	5705	147	3230	2475	89	58	2892	34	682	77	1509	1718	1916	1391	1956	1241
"SPP1"	1821	7762	115	88	88	27	70	18	26	19	0	0	5008	5994	6042	5697	5609	5763
"SPP2"	1027	26432	0	0	0	0	0	0	0	0	0	0	0	0	0	0	0	0
"SPPL2A"	2016	58173	3344	5529	2002	1342	3031	2498	1313	2698	1146	5189	1376	922	2100	2458	1984	1833
"SPPL2B"	3827	26472	881	82	475	406	36	46	656	308	887	338	608	491	771	653	1169	776
"SPPL3"	3502	6906	14716	5182	8201	6515	2740	2442	6069	2545	4038	3231	1313	1077	1290	927	732	971
"SPR"	1462	4779	0	0	0	0	0	0	24	11	0	0	724	638	626	554	914	684
"SPRED1"	7261	104399	15717	41055	8683	7034	22105	18950	7287	13670	1484	17647	4152	7279	4205	5739	3991	2965
"SPRED2"	4447	121672	11648	97875	6497	5151	52405	45470	1304	48763	345	95811	99	10251	838	6278	927	841
"SPRED3"	1326	5932	1	0	0	1	0	0	55	42	0	0	1	0	0	0	0	0
"SPRN"	3174	3952	573	173	319	254	78	95	115	48	72	157	116	21	282	210	323	259
"SPRR1A"	649	1734	0	0	0	0	0	0	0	0	0	0	0	0	0	0	0	0
"SPRR1B"	620	1698	0	0	0	0	0	0	0	0	0	0	0	0	0	0	0	0
"SPRR2A"	703	85374	0	0	0	0	0	0	0	0	0	0	0	0	0	0	0	0
"SPRR2B"	658	1366	0	0	0	0	0	0	0	0	0	0	0	0	0	0	0	0
"SPRR2D"	710	101770	0	0	0	0	0	0	0	0	0	0	0	0	0	0	0	0
"SPRR2E"	679	1391	0	0	0	0	0	0	0	0	0	0	0	0	0	0	0	0
"SPRR2F"	656	1376	0	0	0	0	0	0	0	0	0	0	0	0	0	0	0	0
"SPRR2G"	651	1370	0	0	0	0	0	0	0	0	0	0	0	0	0	0	0	0
"SPRR3"	988	2110	0	0	0	0	0	0	0	0	0	0	0	0	0	0	0	0
"SPRR4"	768	1943	0	0	0	0	0	0	0	0	0	0	0	0	0	0	0	0
"SPRY1"	2485	4226	0	0	0	0	0	0	10	0	0	0	0	0	0	0	0	0
"SPRY2"	2707	3682	39	0	21	18	0	0	0	0	0	0	210	78	390	0	398	118
"SPRY3"	9040	14668	0	0	0	0	0	0	0	0	0	0	0	0	5	5	62	7
"SPRY4"	4995	14630	0	0	0	0	0	0	0	0	0	0	0	0	0	0	0	0
"SPRYD3"	2579	14742	168	64	63	105	30	34	293	70	175	0	1008	878	542	390	641	411
"SPRYD4"	2105	2466	86	67	86	0	40	27	173	93	0	0	209	256	191	206	276	176
"SPRYD5"	1632	8511	0	0	0	0	0	0	0	0	0	0	0	0	0	0	0	0
"SPSB1"	3118	76649	3861	629	2110	1751	330	299	1981	875	1782	554	438	290	1239	1352	698	622
"SPSB2"	1499	1746	318	155	173	145	83	72	160	132	60	93	135	5105	194	96	7728	15
"SPSB3"	2323	5794	1396	409	808	588	203	206	412	246	1451	695	859	809	1341	1198	288	1171
"SPSB4"	2441	82660	0	0	0	0	0	0	75	16	0	0	0	0	0	0	0	0
"SPTA1"	8069	76012	0	0	0	0	0	0	0	0	0	0	0	0	0	0	0	0
"SPTAN1"	7929	81074	8954	2853	4908	4046	1721	1132	3360	1643	5492	3285	9147	8971	12183	9577	17497	9656
"SPTB"	10188	133601	0	0	0	0	0	0	303	80	0	0	0	0	0	0	0	0
"SPTBN1"	10256	215130	0	0	0	0	0	0	35	22	0	0	112	156	505	580	264	189
"SPTBN2"	7903	36151	22	0	22	0	0	0	261	80	0	0	0	0	0	0	0	0
"SPTBN4"	8722	109240	0	0	0	0	0	0	72	49	0	0	55	8	18	62	136	38
"SPTBN5"	11790	45932	993	752	530	463	411	341	1131	1246	480	398	217	390	426	522	1254	760
"SPTLC1"	3534	62713	2049	2082	1183	866	1137	945	1090	1264	186	1379	912	1185	2083	1772	2403	1568
"SPTLC2"	7244	109840	1039	34	610	429	26	8	611	288	17	66	305	390	1868	1123	2050	1112
"SPTLC3"	3857	157786	0	0	0	0	0	0	8	0	0	0	0	0	3	6	0	0
"SPTY2D1"	5739	28073	162	101	69	93	77	24	118	178	0	192	1344	1625	1188	1280	1175	744
"SPZ1"	1870	1870	0	0	0	0	0	0	10	0	0	0	0	0	0	0	0	0
"SQLE"	2998	23805	115	189	80	35	120	69	104	72	19	194	945	1240	970	724	1574	986
"SQRDL"	1807	60134	7797	18839	4383	3414	10230	8609	2719	9678	3503	12433	4616	8072	3811	4081	4712	4152
"SQSTM1"	3080	15592	2425	6518	1279	1146	3472	3046	918	2128	1339	5049	7957	10247	10181	18255	4454	14030
"SR+89"	2668	40477	3155	2307	1839	1316	1267	1040	1466	1543	2803	4202	405	743	609	792	542	744
"SR-A"	2438	53474	15	0	6	9	0	0	0	3	0	0	261	270	649	483	603	586
"SR140"	7492	59197	1790	1252	936	854	714	538	1168	813	356	718	2316	3022	2686	2061	2813	1606
"SRA1"	2012	8026	964	617	541	423	312	305	329	288	222	406	217	407	567	241	540	443
"SRBD1"	3714	222615	1965	216	1099	866	100	116	1635	375	67	225	455	403	363	294	394	270
"SRC"	4111	60733	13240	44239	7157	6083	23306	20933	1624	26373	4427	51487	2621	9219	2104	10013	2641	4765
"SRCAP"	11086	41568	7808	4707	4277	3531	2545	2162	2711	1984	5236	4499	5248	5129	6325	5450	8098	4845
"SRCRB-S4D"	1231	4162	0	0	0	0	0	0	0	0	0	0	27	10	7	0	39	25
"SRCRB4D"	2816	20367	0	0	0	0	0	0	106	0	0	0	41	11	11	9	43	25
"SRD5A1"	2770	36175	647	652	379	268	372	280	463	685	0	657	306	750	334	200	466	224
"SRD5A2"	2449	56386	0	0	0	0	0	0	0	0	0	0	0	0	0	0	0	0
"SRD5A3"	2665	25459	374	499	229	145	247	252	96	152	0	537	871	1151	1012	727	709	656
"SREBF1"	4672	8794	9026	5455	4787	4239	2868	2587	3857	3355	8479	7136	5923	4281	6320	4844	9461	6030
"SREBF2"	4323	73269	12178	13037	6742	5436	6974	6063	4500	6347	5888	15386	6465	7733	6338	6211	9945	7184
"SREBP-1"	520	707	195	254	0	195	143	111	0	0	0	0	1455	2	1352	848	1448	1336
"SREC"	3384	11891	1781	2605	944	837	1611	994	620	865	1633	1627	1756	765	1613	3003	1960	2640
"SRF"	4324	10325	893	1684	507	386	906	778	240	1004	156	2029	1555	3664	1471	3880	2202	2274
"SRFBP1"	2844	66641	348	316	239	109	221	95	349	285	0	270	409	557	399	366	435	253
"SRGAP1"	8497	303074	24759	24738	13948	10811	13641	11097	6658	5733	2162	6296	1091	1239	1061	834	841	477
"SRGAP2"	5993	121584	11331	8638	6293	5038	4882	3756	5432	5404	4422	7354	2938	3241	5739	4464	6947	4061
"SRGAP3"	8923	269035	0	0	0	0	0	0	164	18	0	0	0	4	9	0	20	8
"SRGN"	1255	16739	3245	18813	2173	1072	10015	8798	923	12020	927	22474	15886	51097	27269	44682	16467	28685
"SRI"	2018	14963	422	190	212	210	94	96	225	370	14	466	983	1502	1151	1515	1573	1299
"SRL"	4218	52706	0	0	0	0	0	0	179	126	0	0	0	0	0	0	0	0
"SRM"	1281	5444	0	0	0	0	0	0	6	0	0	0	303	389	766	596	709	552
"SRM160"	1501	18068	1999	2098	1174	825	1230	868	934	1125	408	2255	886	1185	1101	675	1334	753
"SRMS"	1524	6696	1	0	0	1	0	0	139	43	0	0	4	0	0	0	0	0
"SRP14"	1172	3500	0	31	0	0	17	14	31	20	0	0	2244	2476	1405	1437	1470	2234
"SRP14P1"	332	332	0	0	0	0	0	0	0	0	0	0	0	0	0	0	0	0
"SRP19"	921	6611	196	134	102	94	73	61	64	135	0	159	739	1019	738	835	877	727
"SRP54"	2295	46669	880	1141	512	368	649	492	495	816	685	1535	1408	2002	978	1302	1217	1058
"SRP68"	2531	33418	371	264	234	137	163	101	361	451	91	689	1415	1553	967	1049	1219	916
"SRP72"	3894	36086	558	88	330	228	43	45	218	125	0	82	3038	3454	2977	2747	3426	2238
"SRP9"	1621	12652	907	414	479	428	241	173	447	229	343	439	3059	3363	3757	3126	4323	3144
"SRPK1"	4776	88032	461	61	266	195	36	25	339	221	0	182	769	917	762	632	1018	639
"SRPK2"	3730	152655	30746	13370	17309	13437	7440	5930	15504	8023	16819	12843	3743	3690	5165	4352	5255	3501
"SRPK3"	4559	9377	24	0	13	11	0	0	36	109	0	0	1	0	0	0	0	0
"SRPR"	2956	5915	584	494	523	61	189	305	487	493	314	503	4253	4811	2485	5222	2627	2096
"SRPRB"	1752	14848	33	0	14	19	0	0	59	11	0	0	1167	970	1105	895	1346	854
"SRPX"	1862	71540	0	0	0	0	0	0	0	0	0	0	0	0	0	0	0	0
"SRPX2"	2199	27133	0	0	0	0	0	0	0	0	0	0	0	0	0	0	0	0
"SRR"	2485	21307	394	43	214	180	28	15	209	65	52	113	1481	1604	1129	980	1214	824
"SRRD"	1299	8055	88	84	55	33	71	13	146	36	3	40	665	532	561	366	664	357
"SRRM1"	3987	30179	2425	2347	1371	1054	1267	1080	1095	1312	408	2503	1865	2337	2065	1839	2897	1832
"SRRM2"	9366	19083	22033	17049	12145	9888	8972	8077	8118	6662	15718	10416	16009	20770	24263	24189	34881	21125
"SRRM3"	3629	85391	0	0	0	0	0	0	142	35	0	0	0	0	0	0	0	0
"SRRM4"	8395	181463	0	0	0	0	0	0	69	0	0	0	0	0	0	0	0	0
"SRRM5"	2732	17913	225	25	165	60	0	25	285	160	37	45	459	473	611	434	714	452
"SRRT"	3033	13586	1280	1489	662	618	820	669	516	1247	533	1522	1718	2382	1916	3245	2698	2383
"SRXN1"	2565	6622	478	180	305	173	111	69	253	131	247	104	5677	5070	4234	3576	4805	2974
"SRY"	898	898	0	0	0	0	0	0	0	0	0	0	0	0	0	0	0	0
"SS-56"	3305	9537	0	0	0	0	0	0	26	0	0	0	236	108	288	89	284	116
"SS18"	3445	74394	3256	1693	1926	1330	870	823	1869	935	395	1094	1790	2333	1561	1318	1769	1128
"SS18L1"	4561	38748	2028	186	1191	837	89	97	1101	629	1386	506	606	658	796	545	839	532
"SS18L2"	818	4194	62	0	36	26	0	0	29	12	0	0	322	372	336	291	448	294
"SSAT2"	924	1578	53	26	27	26	20	6	14	12	0	0	532	151	699	288	888	548
"SSB"	1789	12782	106	20	48	58	20	0	48	28	0	0	1173	1041	1755	1086	2008	901
"SSBP1"	1429	8152	177	93	101	76	33	60	150	49	0	0	605	840	741	701	855	699
"SSBP2"	1988	331401	1531	622	895	636	399	223	1770	757	55	131	132	251	161	93	146	86
"SSBP3"	2204	179898	9143	1835	5059	4084	998	837	5032	3016	3516	6942	946	873	752	535	797	588
"SSBP4"	1729	15152	1373	230	730	643	124	106	710	209	1292	275	3317	2701	2599	1679	2583	2165
"SSC5D"	4923	30597	0	0	0	0	0	0	82	99	0	0	0	0	0	0	0	0
"SSFA2"	5308	38992	2066	553	1150	916	347	206	1205	308	671	412	3171	3013	3738	2999	4000	2331
"SSH1"	8549	74894	9093	976	5343	3750	503	473	4437	469	9028	800	4870	3642	3189	2464	5661	2636
"SSH2"	9263	304055	20916	15670	11984	8932	8670	7000	9807	6459	8343	9185	3137	3122	3361	2215	3569	1871
"SSH3"	3033	9159	238	32	126	112	16	16	161	14	97	1	523	479	518	460	879	521
"SSNA1"	944	1770	53	0	37	16	0	0	81	48	0	0	761	602	960	721	1225	861
"SSPN"	4532	39202	0	0	0	0	0	0	0	0	0	0	0	0	0	0	0	0
"SSPO"	15661	57922	0	0	0	0	0	0	439	289	0	0	0	0	0	0	0	0
"SSR1"	9871	32253	1191	128	663	528	50	78	638	46	181	46	5665	5341	4743	3628	5112	2822
"SSR2"	1835	3993	146	61	73	73	26	35	95	85	0	234	2994	3003	2906	2903	3269	2659
"SSR3"	3106	14392	3109	405	2433	676	269	136	1167	96	976	128	7949	7625	5648	4604	6773	5262
"SSR4"	745	4051	565	61	194	371	38	23	370	124	64	0	956	937	1471	1528	1629	1105
"SSRP1"	2835	9893	191	39	83	108	18	21	133	53	66	25	876	951	1730	1765	1863	1207
"SSSCA1"	651	1291	41	100	18	23	63	37	23	106	3	79	185	285	221	364	301	354
"SST"	632	1507	0	0	0	0	0	0	0	0	0	0	0	0	0	0	0	0
"SSTR1"	4294	5066	0	0	0	0	0	0	0	0	0	0	0	0	0	0	0	0
"SSTR2"	2964	6902	0	0	0	0	0	0	20	8	0	0	0	0	0	0	0	0
"SSTR3"	2124	6109	2	3	2	0	0	3	0	30	0	0	0	0	0	0	0	0
"SSTR4"	1259	1259	0	0	0	0	0	0	0	0	0	0	0	0	0	0	0	0
"SSTR5"	1363	1363	0	0	0	0	0	0	10	0	0	0	0	0	0	0	0	0
"SSU72"	2972	12532	3400	2788	1879	1521	1492	1296	1308	1792	2514	4150	1801	3039	1384	1753	2165	1828
"SSX-HSTT"	3518	74394	3249	1693	1926	1323	870	823	1852	923	395	1094	1790	2333	1560	1303	1744	1128
"SSX1"	1289	12983	0	0	0	0	0	0	0	0	0	0	0	0	0	0	0	0
"SSX2"	1461	10311	0	0	0	0	0	0	0	0	0	0	0	0	0	0	0	0
"SSX2IP"	5653	46376	12	0	0	12	0	0	22	0	0	0	211	180	153	67	136	100
"SSX3"	1281	10281	0	0	0	0	0	0	0	0	0	0	0	0	0	0	0	0
"SSX4"	1225	9819	0	0	0	0	0	0	0	0	0	0	0	0	0	0	0	0
"SSX4B"	1225	9822	0	0	0	0	0	0	0	0	0	0	0	0	0	0	0	0
"SSX5"	1393	10545	0	0	0	0	0	0	0	0	0	0	0	0	0	0	0	0
"SSX6"	1466	6319	0	0	0	0	0	0	0	0	0	0	0	0	0	0	0	0
"SSX7"	1348	10841	0	0	0	0	0	0	0	0	0	0	0	0	0	0	0	0
"SSX8"	1455	11015	0	0	0	0	0	0	0	0	0	0	0	0	0	0	0	0
"SSX9"	1262	10731	0	0	0	0	0	0	0	0	0	0	0	0	0	0	0	0
"ST13"	3204	32086	965	111	540	425	65	46	538	55	171	143	2921	3164	6911	3675	8423	3115
"ST14"	3318	50576	1800	87	1086	714	33	54	646	114	579	21	1543	1363	207	156	3428	2780
"ST18"	6356	299049	428	268	265	163	101	167	149	40	0	46	13	16	91	46	9	7
"ST20"	1013	16417	0	0	0	0	0	0	11	9	0	0	32	28	1	39	12	20
"ST3GAL1"	6980	117094	10535	3737	5885	4650	2084	1653	5613	2578	4333	3488	2225	2680	3741	3756	3604	3133
"ST3GAL2"	5421	21205	19532	19398	10858	8674	10301	9097	4830	14055	16891	37571	1568	4279	2797	3061	4321	3234
"ST3GAL3"	2462	223614	285	76	161	124	59	17	449	206	17	54	86	137	113	125	109	94
"ST3GAL4"	1862	8443	6062	6723	3326	2736	3526	3197	2662	3876	5148	13834	620	862	787	773	879	775
"ST3GAL5"	2475	22146	5917	1239	3404	2513	729	510	2546	1237	2905	906	1016	1985	1162	1605	1396	706
"ST3GAL6"	2103	61664	12331	9487	6876	5455	5153	4334	4011	2296	7462	5124	937	772	1096	726	836	496
"ST3Gal VI"	1845	62084	12331	9487	6876	5455	5153	4334	4011	2296	7462	5124	937	772	1096	726	836	496
"ST3GalIII"	2138	194928	327	76	185	142	59	17	449	206	17	54	86	137	113	125	109	94
"ST3GalV"	1130	37772	4611	1068	2590	2021	618	450	2107	1039	2451	806	304	352	411	234	467	179
"ST5"	4566	217600	0	0	0	0	0	0	155	30	0	1	43	41	117	128	209	139
"ST6GAL1"	4409	147825	12958	6142	7310	5648	3350	2792	7890	3502	8599	9536	6437	6301	7092	5780	9414	6106
"ST6GAL2"	6861	85507	0	0	0	0	0	0	0	0	0	0	0	0	0	0	0	0
"ST6GALNAC III"	2959	556282	0	0	0	0	0	0	0	0	0	0	0	0	0	0	0	0
"ST6GALNAC V"	1840	195555	0	0	0	0	0	0	23	0	0	0	0	0	0	0	0	0
"ST6GALNAC1"	2689	19049	0	0	0	0	0	0	42	12	0	0	0	0	0	0	0	0
"ST6GALNAC2"	2113	20685	13	26	0	13	18	8	125	139	0	0	133	107	50	68	250	141
"ST6GALNAC3"	3264	556282	0	0	0	0	0	0	0	0	0	0	0	0	0	0	0	0
"ST6GALNAC4"	1696	9141	74	15	73	1	9	6	136	22	89	14	591	268	536	428	323	181
"ST6GALNAC5"	2035	196551	0	0	0	0	0	0	23	0	0	0	0	0	0	0	0	0
"ST6GALNAC6"	2430	12088	1120	264	627	493	147	117	438	215	743	273	363	241	1269	936	1364	523
"ST6GalNAc VI"	2378	20028	1120	264	627	493	147	117	438	215	743	273	363	241	1269	936	1364	523
"ST7"	2909	270576	10107	13114	5779	4328	7090	6024	4442	5706	473	4050	782	1041	1142	805	1164	802
"ST7L"	4541	95900	967	55	541	426	20	35	892	291	105	339	443	359	275	348	281	86
"ST7OT1"	1887	1887	0	65	0	0	40	25	0	140	0	53	0	67	31	25	0	0
"ST7OT2"	1356	18710	1794	2303	1068	726	1240	1063	1066	892	173	603	317	370	444	426	494	389
"ST7OT4"	1577	5916	313	154	170	143	82	72	88	180	0	208	0	0	1	0	0	0
"ST8SIA1"	9718	141324	0	0	0	0	0	0	0	0	0	0	0	0	0	0	0	0
"ST8SIA2"	5630	74818	0	0	0	0	0	0	43	14	0	0	0	0	0	0	0	0
"ST8SIA3"	10155	16440	0	0	0	0	0	0	0	0	0	0	0	0	0	0	0	0
"ST8SIA4"	6324	96349	14033	12231	7755	6278	6725	5506	7942	3867	1512	3776	3794	5743	2228	1271	2837	1434
"ST8SIA5"	2739	77960	0	0	0	0	0	0	28	16	0	0	0	0	0	0	0	0
"ST8SIA6"	1405	133579	697	224	360	337	119	105	637	35	43	26	161	60	163	71	253	25
"ST8Sia VI"	1291	133579	697	224	360	337	119	105	637	35	43	26	161	60	163	71	253	25
"STAB1"	7993	29155	13628	6407	7332	6296	3153	3254	7454	5297	10377	5186	13495	15458	25714	28937	33265	17777
"STAB2"	8297	179433	0	0	0	0	0	0	0	10	0	0	0	3	0	0	5	0
"STAC"	2974	167401	34341	19183	19202	15139	10450	8733	14389	5911	9972	10313	2470	2997	2510	2286	2697	1783
"STAC2"	3221	15186	0	0	0	0	0	0	120	34	0	0	0	0	0	0	0	0
"STAC3"	1662	7736	31	7	12	19	0	7	85	40	20	0	232	282	312	271	440	239
"STAG1"	5200	415248	14164	9678	8120	6044	5293	4385	6327	5683	4353	8892	1026	1390	1026	1044	1250	632
"STAG2"	6302	142030	17354	14902	9817	7537	8125	6777	8006	7417	5057	11574	2869	3733	3214	3234	3304	2045
"STAG3"	4239	36474	618	25	335	283	13	12	417	78	128	19	491	517	566	469	908	584
"STAG3L1"	2824	37805	7	0	0	7	0	0	22	9	0	0	11	0	477	367	615	274
"STAG3L2"	2812	37790	81	64	65	16	31	33	78	0	99	0	93	41	445	257	668	223
"STAG3L3"	1264	7428	51	0	31	20	0	0	9	0	0	0	27	14	291	172	328	154
"STAG3L4"	2216	18898	962	411	547	415	247	164	547	278	276	661	327	305	196	157	270	131
"STAG3OS"	3557	71578	965	55	499	466	22	33	763	241	164	118	536	565	778	708	1095	678
"STAM"	2980	71785	1492	220	918	574	111	109	922	106	117	111	602	494	665	465	769	475
"STAM2"	5714	59192	2609	1180	1427	1182	659	521	1372	523	318	510	1624	1702	1425	1122	1388	800
"STAMBP"	2412	33865	785	108	427	358	75	33	506	78	27	229	902	904	732	604	768	515
"STAMBPL1"	3660	94886	983	63	579	404	55	8	1272	52	17	10	582	517	805	622	589	435
"STAP1"	1521	48173	4	0	0	4	0	0	3	0	0	0	4	4	12	12	27	29
"STAP2"	2058	18744	0	0	0	0	0	0	181	85	0	0	0	1	0	0	0	0
"STAR"	2702	8384	20	0	20	0	0	0	18	0	0	0	0	0	0	0	0	0
"STARD10"	1994	38977	16	260	0	16	92	168	198	568	6	1216	88	179	87	90	197	165
"STARD13"	6250	573661	0	0	0	0	0	0	82	30	0	0	8	3	49	24	45	19
"STARD3"	2403	10373	1872	617	982	890	305	312	1178	677	1388	1248	1777	1569	2745	2207	2989	2137
"STARD3NL"	1682	52338	419	934	185	234	510	424	232	1060	0	923	520	922	681	809	734	622
"STARD4"	2270	14137	513	2667	238	275	1514	1153	263	1208	95	2015	99	386	584	866	550	497
"STARD5"	1315	11512	271	615	143	128	306	309	1015	462	171	530	2803	1689	733	536	1214	693
"STARD6"	668	29882	0	0	0	0	0	0	0	0	0	0	0	0	0	0	0	0
"STARD7"	3385	23970	5178	748	2915	2263	360	388	1868	191	3631	375	16496	2211	2514	7591	4401	1709
"STARD8"	4954	78168	866	4654	373	493	2437	2217	539	2558	0	3103	862	1875	994	2606	1247	1200
"STAT1"	4333	45216	4263	2790	1927	2336	1533	1257	3082	1317	1487	878	3647	2028	7240	2771	3153	3850
"STAT2"	4444	18527	1686	1270	1069	617	698	572	844	552	1200	1086	1241	3188	3596	2503	3271	1709
"STAT3"	4997	75172	4907	9891	2767	2140	5541	4350	1702	5409	1850	13946	5029	6690	4601	3965	5895	3128
"STAT4"	2966	118890	173	3837	118	55	2072	1765	63	2922	0	2506	93	145	121	193	73	84
"STAT5A"	4417	24075	4890	17270	2695	2195	10525	6745	1072	12212	2123	26121	3235	8374	4716	14947	6166	10884
"STAT5B"	5112	77230	3999	7133	2457	1542	3979	3154	1865	3475	1779	5450	2510	3606	3319	4007	4566	2879
"STAT6"	3997	15968	11055	9371	5952	5103	4644	4727	2916	1939	8489	10917	14963	6166	19909	19887	14995	18362
"STATH"	606	6527	0	0	0	0	0	0	0	0	0	0	0	0	0	0	0	0
"STAU1"	3696	75028	3343	3227	1812	1531	1862	1365	1420	2200	982	4406	2650	1759	2160	2303	2849	1730
"STAU2"	4218	198101	3807	967	2150	1657	609	358	2993	506	72	252	468	644	680	658	801	544
"STBD1"	2607	59431	0	0	0	0	0	0	0	0	0	0	49	37	85	36	73	10
"STC1"	3881	12888	0	0	0	0	0	0	0	0	0	0	0	0	0	0	0	0
"STC2"	5347	14782	0	0	0	0	0	0	42	10	0	0	0	0	0	0	0	0
"STCH"	3774	12072	13	23	0	13	12	11	0	11	0	0	677	960	188	719	158	465
"STEAP1"	1317	10453	0	0	0	0	0	0	0	0	0	0	0	0	0	0	0	0
"STEAP2"	7038	25993	0	0	0	0	0	0	0	0	0	0	0	0	0	0	0	0
"STEAP3"	4288	41843	102	0	80	22	0	0	131	124	0	36	938	781	913	933	853	706
"STEAP4"	4453	30461	13	17	13	0	17	0	0	0	0	0	19	135	8	46	28	21
"STH"	446	446	0	0	0	0	0	0	0	0	0	0	0	0	0	0	0	0
"STI2"	4129	31244	225	6689	136	89	602	6087	151	1140	18	1424	63	72	74	63	97	66
"STIL"	5243	64010	134	5	90	44	5	0	102	32	0	38	253	248	155	115	339	96
"STIM1"	4088	237509	10141	2244	5632	4509	1288	956	4554	1930	2631	2508	1937	2317	2253	2249	2674	1900
"STIM2"	3989	163446	21893	4771	12350	9543	2631	2140	8692	1587	7440	1834	3856	4167	2225	1769	2718	1940
"STIP1"	2215	18435	1104	491	656	448	272	219	603	587	818	1128	2615	3387	7252	6791	5708	5748
"STK10"	6038	146274	21150	24611	11533	9617	13277	11334	6834	10105	13195	26644	4937	5386	5623	5282	7770	4528
"STK11"	3286	22638	909	117	511	398	53	64	510	358	956	429	1149	880	1518	1093	2026	1213
"STK11IP"	3625	18578	599	322	290	309	179	143	462	258	322	214	705	832	912	664	1569	583
"STK16"	3126	4860	75	45	35	40	0	45	56	32	0	0	2766	2175	1656	223	3188	489
"STK17A"	3939	44287	2402	5920	1320	1082	3386	2534	1003	2379	531	3508	968	1697	821	1266	803	705
"STK17B"	5314	38030	2636	1455	1396	1240	758	697	1557	795	789	706	2917	2159	1522	1076	2121	1199
"STK19"	1812	10272	203	401	105	98	240	161	220	607	88	296	547	683	513	563	692	374
"STK24"	4635	126943	15283	13209	8470	6813	7175	6034	6131	7304	7921	6635	2756	2382	2662	2099	3684	2605
"STK25"	2229	14529	1180	275	637	543	147	128	533	236	1046	583	1034	1208	937	1044	2200	1032
"STK3"	6435	113473	24444	32712	13983	10461	17800	14912	11857	15909	5288	18978	4966	5931	5095	4317	5408	3355
"STK31"	3536	122131	0	0	0	0	0	0	0	0	0	0	0	2	0	0	0	0
"STK32A"	2021	140902	0	0	0	0	0	0	0	0	0	0	0	0	0	0	0	0
"STK32B"	3347	449200	0	0	0	0	0	0	66	21	0	0	0	2	0	0	0	0
"STK32C"	2146	124362	20669	3020	11588	9081	1600	1420	7874	3394	19263	4128	2165	2208	1969	1098	2704	1394
"STK33"	3115	83955	0	0	0	0	0	0	0	0	0	0	0	0	0	0	0	0
"STK35"	6118	45784	529	145	345	184	109	36	617	202	63	205	686	390	800	481	835	394
"STK36"	4948	30679	0	0	0	0	0	0	32	7	0	8	50	78	109	61	208	94
"STK38"	3886	46895	4698	1774	2420	2278	968	806	2845	514	4241	1664	3028	768	4041	1071	4269	2730
"STK38L"	5108	81812	7910	15123	4407	3503	8168	6955	3205	3261	1534	5326	2724	3922	1476	1172	3082	1576
"STK39"	3291	293576	892	463	553	339	306	157	891	475	66	186	459	599	551	539	256	368
"STK4"	6339	113473	14034	22844	7946	6088	12294	10550	5859	9949	4566	13369	4504	5407	4673	3826	4931	2968
"STK40"	4840	21712	3395	3569	1937	1458	1823	1746	1495	2493	1915	4595	2237	3054	2759	4135	1247	3234
"STL"	5347	54781	308	24	151	157	24	0	68	12	210	63	34	55	57	63	101	2
"STMN1"	2242	22317	0	0	0	0	0	0	17	0	0	0	56	91	107	136	158	131
"STMN2"	934	55016	0	0	0	0	0	0	0	0	0	0	0	0	0	0	0	0
"STMN3"	2260	13721	7	0	5	2	0	0	91	50	0	0	71	1	91	0	203	0
"STMN4"	1374	22089	0	0	0	0	0	0	0	0	0	0	0	0	0	0	0	0
"STOM"	3211	31193	304	86	214	90	64	22	308	86	0	0	2204	2118	1656	1394	1874	1571
"STOML1"	1992	9076	4	0	0	4	0	0	77	32	0	0	61	41	99	49	113	62
"STOML2"	2098	3232	35	0	17	18	0	0	43	3	44	0	616	592	904	850	692	665
"STOML3"	2005	24935	0	0	0	0	0	0	0	0	0	0	0	0	0	0	0	0
"STON1"	6009	68719	0	0	0	0	0	0	0	0	0	0	0	0	0	0	0	0
"STON1-GTF2A1L"	3839	110589	0	0	0	0	0	0	0	0	0	0	0	0	0	0	0	0
"STON2"	4310	166750	15	15	7	8	7	8	461	51	0	0	132	84	737	436	433	169
"STOX1"	3384	65523	0	0	0	0	0	0	11	0	0	0	31	15	0	0	0	0
"STOX2"	4658	112368	0	0	0	0	0	0	16	0	0	0	0	0	0	0	0	0
"STP"	2044	11823	99	325	75	24	170	155	10	684	0	1134	309	897	263	1518	595	766
"STRA13"	733	4195	89	0	74	15	0	0	95	67	0	0	279	246	494	405	531	297
"STRA6"	2996	30238	0	0	0	0	0	0	336	123	0	0	0	0	0	0	0	0
"STRA8"	1000	26513	0	0	0	0	0	0	26	26	0	0	0	0	0	0	0	0
"STRADA"	3062	39021	4470	2829	2507	1963	1555	1274	2142	887	3221	2401	2492	1156	918	1102	1571	667
"STRADB"	2309	29183	0	0	0	0	0	0	22	0	0	0	358	266	525	462	606	474
"STRAP"	1948	21117	128	316	92	36	166	150	193	313	0	335	887	930	2007	2261	2239	1925
"STRBP"	3357	143858	1582	286	901	681	175	111	666	115	11	91	311	286	428	302	532	369
"STRC"	5543	19238	0	0	0	0	0	0	0	0	0	0	0	0	0	0	0	0
"STRF6"	1561	1561	0	0	0	0	0	0	0	0	0	0	0	0	0	0	0	0
"STRN"	3496	118144	1925	80	1067	858	66	14	1150	98	259	110	514	655	809	759	785	442
"STRN3"	4240	132604	6781	2697	3852	2929	1504	1193	3094	1279	2420	3203	196	774	510	598	642	519
"STRN4"	3226	26952	1934	921	1054	880	420	501	939	991	1735	1955	1490	1254	1248	1281	1433	954
"STS"	6385	135210	0	0	0	0	0	0	37	13	4	9	318	351	390	366	611	373
"STSG4523"	3826	11714	617	1090	333	284	581	509	308	480	136	909	1424	2134	1320	2260	1949	1550
"STT3A"	2910	28543	787	460	392	395	282	178	401	441	230	316	3144	2719	3413	2976	4337	3115
"STT3B"	2495	103065	7261	1224	3977	3284	675	549	4414	488	949	446	5739	6422	6572	5750	6876	5188
"STUB1"	1697	2654	239	58	138	101	30	28	160	70	113	66	1830	1601	2100	1681	2489	1849
"STX10"	757	5764	148	7	72	76	7	0	118	39	81	0	543	431	963	1188	1101	778
"STX11"	5505	41423	3306	39254	1873	1433	21155	18099	372	17358	0	24569	742	11660	828	10164	770	6042
"STX12"	3087	51270	4891	18382	2767	2124	10018	8364	1706	9756	1039	19173	2847	7278	2751	5128	2677	3540
"STX16"	4955	28254	4161	803	2355	1806	441	362	2093	530	2051	784	2606	2676	3414	2638	4051	2343
"STX17"	6915	67904	2294	735	1296	998	405	330	1214	282	380	499	1017	1120	947	661	971	501
"STX18"	2166	123079	4170	3831	2340	1830	2122	1709	2968	2325	1170	3531	493	512	736	855	1026	459
"STX19"	1158	14241	50	0	20	30	0	0	40	34	0	17	0	0	0	0	0	0
"STX1A"	2100	20449	17	0	17	0	0	0	189	76	0	0	0	0	0	0	10	0
"STX1B"	4554	21254	0	0	0	0	0	0	107	108	0	0	3	6	3	7	0	0
"STX2"	3464	49664	506	147	276	230	87	60	632	205	299	132	443	482	579	450	1188	689
"STX3"	2950	47289	3958	1924	2232	1726	1010	914	1934	1087	1617	2081	5188	5296	10957	10503	10030	8816
"STX3A"	2734	47289	3958	1924	2232	1726	1010	914	1934	1087	1617	2081	5188	5296	10957	10503	10030	8816
"STX4"	1510	7070	958	1417	507	451	765	652	367	667	151	978	1150	1840	1660	2733	1874	1856
"STX4A"	1531	6583	958	1406	507	451	754	652	367	649	151	978	1150	1840	1658	2733	1872	1856
"STX5"	1842	25192	1282	2245	694	588	1220	1025	429	1144	253	2868	399	1508	477	595	549	440
"STX5A"	1732	25192	1282	2245	694	588	1220	1025	429	1144	253	2868	399	1508	477	595	549	440
"STX6"	4552	49869	1351	72	803	548	39	33	1041	56	298	0	120	240	257	744	299	1161
"STX7"	4280	55676	9947	572	5607	4340	378	194	4592	130	2246	60	1037	2797	1523	2553	1396	2655
"STX8"	975	325488	4585	2427	2597	1988	1375	1052	3036	2287	1042	2843	343	393	368	348	412	287
"STXBP1"	3987	80511	796	36	429	367	15	21	374	66	33	70	611	751	503	546	819	599
"STXBP2"	1977	3361	2938	1650	1618	1320	876	774	1101	925	3964	3005	4097	4097	5201	4471	6651	4349
"STXBP3"	2513	62856	1857	1973	984	873	1167	806	1036	1310	321	1949	1900	2193	1541	1526	1702	1291
"STXBP4"	6064	195325	19	0	13	6	0	0	28	0	0	0	8	10	12	11	0	5
"STXBP5"	6525	183201	5730	1611	3320	2410	889	722	3899	1174	1041	1134	1032	1449	1129	1072	1292	1005
"STXBP5L"	9392	516559	0	0	0	0	0	0	0	0	0	0	0	0	0	0	0	0
"STXBP6"	1961	237789	0	0	0	0	0	0	12	0	0	0	0	0	0	0	0	0
"STYK1"	3006	55355	0	0	0	0	0	0	16	0	0	0	0	0	0	0	0	0
"STYX"	4872	44822	752	78	394	358	30	48	500	31	65	26	1355	1500	824	749	1237	790
"STYXL1"	1579	49437	1397	335	755	642	219	116	693	275	1518	854	600	559	576	582	707	572
"SUB1"	3815	18582	2475	2505	1405	1070	1393	1112	1032	958	589	1703	2470	3896	2800	2693	3908	2345
"SUCLA2"	2490	95335	807	166	436	371	78	88	552	0	37	82	762	769	1183	982	1121	965
"SUCLG1"	1459	35934	1204	259	718	486	175	84	675	483	271	336	1257	1850	1302	1239	1079	706
"SUCLG2"	2361	279895	5784	2324	3224	2560	1358	966	4236	1976	719	1566	64	786	1231	1234	1357	944
"SUCNR1"	1421	8215	1104	60	649	455	14	46	688	82	136	45	8933	7213	8693	4648	9476	4540
"SUDS3"	4739	41483	806	49	468	338	22	27	799	137	204	189	1141	1148	1455	1058	1700	1147
"SUFU"	4910	129447	11523	821	6338	5185	478	343	5220	528	8272	902	3172	2098	3179	1416	4961	2175
"SUGT1"	1832	35604	545	38	324	221	26	12	481	36	95	18	295	305	690	578	807	583
"SUGT1L1"	5315	11044	1262	499	720	542	304	195	1096	266	43	239	295	280	232	125	279	171
"SUGT1P"	702	291979	4699	3373	2569	2130	1833	1540	3382	1994	954	2983	13264	10662	10533	7721	18332	9713
"SULF1"	5739	168121	38	0	3	35	0	0	10	0	0	7	0	0	0	0	0	0
"SULF2"	4258	129211	22603	13620	12666	9937	7528	6092	10474	7585	14545	11930	11923	13781	14086	15693	18533	7907
"SULT1A1"	1947	17950	80	0	45	35	0	0	265	91	0	43	1311	582	1884	1304	4109	2218
"SULT1A2"	1330	4537	0	0	0	0	0	0	0	24	0	0	0	0	42	212	193	379
"SULT1A3"	2862	10438	45	0	23	22	0	0	18	1	0	0	43	18	3200	2382	3886	1903
"SULT1B1"	1315	33744	0	0	0	0	0	0	0	0	0	0	0	0	0	0	0	0
"SULT1C"	1076	8409	0	0	0	0	0	0	0	0	0	0	0	0	0	0	0	0
"SULT1C1"	1263	17045	0	0	0	0	0	0	0	0	0	0	2	0	0	6	25	10
"SULT1C2"	2844	21277	0	0	0	0	0	0	0	0	0	0	2	0	0	6	27	17
"SULT1C3"	921	18157	0	0	0	0	0	0	9	0	0	0	0	0	0	0	0	0
"SULT1C4"	1685	4939	0	0	0	0	0	0	0	0	0	0	0	0	0	0	0	0
"SULT1E1"	1787	18941	0	0	0	0	0	0	0	0	0	0	0	0	0	0	0	0
"SULT2A1"	1993	15933	0	0	0	0	0	0	0	0	0	0	0	1	0	0	0	0
"SULT2B1"	1258	23692	0	0	0	0	0	0	135	72	0	0	1	0	0	0	0	0
"SULT4A1"	2472	37993	0	0	0	0	0	0	106	9	0	0	0	0	0	0	0	0
"SULT6B1"	940	20728	0	0	0	0	0	0	0	0	0	0	1	0	0	0	3	0
"SULTX3"	2600	37993	0	0	0	0	0	0	106	9	0	0	0	0	0	0	0	0
"SUMF1"	3172	685920	16941	11030	9604	7337	6127	4903	8808	5464	1920	4944	1874	2067	1509	1441	1935	1401
"SUMF2"	2062	16449	925	186	545	380	97	89	251	79	412	36	2806	2395	2233	1873	2566	1815
"SUMO1"	1532	32421	173	50	67	106	41	9	85	162	0	201	1437	1665	1702	1592	1984	325
"SUMO1P1"	1208	1208	0	0	0	0	0	0	0	0	0	0	0	0	0	0	0	0
"SUMO1P3"	1205	1205	259	42	99	160	19	23	57	42	0	78	0	354	0	2	1	1
"SUMO2"	1069	15274	343	68	161	182	45	23	99	157	122	493	1767	1976	816	1941	2662	2030
"SUMO3"	1925	12514	202	51	99	103	30	21	283	43	269	230	3311	2674	3337	2872	3853	2554
"SUMO4"	687	687	451	1408	284	167	746	662	167	1270	89	486	0	9	0	0	0	0
"SUNC1"	1543	41970	0	3	0	0	2	1	23	0	0	0	0	0	0	0	0	0
"SUOX"	2861	4027	618	23	356	262	0	23	359	124	263	86	1312	1103	1536	904	1978	1053
"SUPT16H"	4710	32796	402	210	225	177	144	66	246	247	0	275	1785	1788	1998	2853	3472	2543
"SUPT3H"	2399	549200	147	55	105	42	11	44	247	60	0	54	20	18	14	8	13	13
"SUPT4H1"	1495	7025	1370	1295	709	661	689	606	371	587	331	1002	1594	2239	2247	1968	2489	1623
"SUPT5H"	3811	7773	1517	900	861	656	482	418	803	496	550	603	2666	2849	2525	2569	3156	1920
"SUPT6H"	6016	39948	3853	5517	1835	2018	2954	2563	1590	2950	1465	4983	3660	4401	4048	4912	5373	3752
"SUPT7L"	5056	12772	559	446	345	214	254	192	340	335	167	196	1731	1717	1803	1958	2545	1230
"SUPV3L1"	2625	28858	44	28	17	27	9	19	57	30	11	23	444	353	455	385	548	377
"SURF1"	1046	4697	120	17	76	44	0	17	36	16	71	0	789	611	927	532	1560	788
"SURF2"	850	4621	32	0	0	32	0	0	59	218	0	43	115	67	121	80	193	108
"SURF4"	3278	14094	1179	1180	562	617	616	564	520	763	272	1800	4994	5536	809	5397	5731	968
"SURF6"	2321	5496	432	18	241	191	13	5	159	20	258	0	921	107	335	333	423	582
"SUSD1"	3078	134496	1754	327	950	804	182	145	1739	554	739	420	966	1127	1699	1549	1865	1323
"SUSD2"	3198	7632	49	35	44	5	14	21	96	73	88	60	81	141	6	7	102	40
"SUSD3"	1309	26427	2	3	0	2	3	0	187	60	0	0	74	86	11	12	79	47
"SUSD4"	3486	143240	0	0	0	0	0	0	14	0	0	0	0	0	0	0	0	0
"SUSD5"	5010	69172	0	0	0	0	0	0	0	1	0	0	0	0	0	0	0	0
"SUT-1"	1734	20750	0	0	0	0	0	0	65	5	0	0	0	0	0	0	0	0
"SUV39H"	2465	12275	88	5	48	40	5	0	47	0	0	0	170	108	179	35	243	128
"SUV39H1"	2987	13461	88	5	48	40	5	0	47	0	0	0	170	108	179	35	243	128
"SUV39H2"	3080	25405	859	91	473	386	53	38	410	64	0	35	1293	220	463	123	762	164
"SUV420H1"	4642	57279	5089	1676	2927	2162	899	777	2141	909	1367	1760	1579	1408	1894	822	768	1043
"SUV420H2"	2317	8269	11	5	6	5	0	5	79	93	62	0	80	31	153	37	191	51
"SUZ12"	4493	64015	1569	595	842	727	340	255	1079	372	701	870	1507	1571	1662	1162	1591	1036
"SUZ12P"	2560	61330	22720	3007	14664	8056	1666	1341	7159	857	17584	2453	829	355	700	245	924	295
"SV2A"	4423	14560	0	0	0	0	0	0	42	57	0	0	0	0	0	0	0	0
"SV2B"	5321	69547	0	0	0	0	0	0	13	8	0	0	35	12	9	0	5	0
"SV2C"	2375	242113	0	102	0	0	102	0	81	101	0	74	2175	2988	3883	4608	4683	3647
"SVEP1"	12389	214631	0	0	0	0	0	0	0	0	0	0	0	0	0	0	0	0
"SVIL"	8335	177626	7514	2442	4160	3354	1453	989	4937	2072	2217	1832	2109	1842	2412	1788	2657	1266
"SVIP"	1391	7784	0	0	0	0	0	0	0	0	0	0	69	81	42	131	80	58
"SVOP"	3326	154189	0	0	0	0	0	0	0	0	0	0	0	0	0	0	0	0
"SVOPL"	1818	84761	0	0	0	0	0	0	11	0	0	0	0	0	0	0	0	0
"SWAP70"	4857	88879	3648	1299	2106	1542	687	612	1306	1219	229	847	2747	3357	2140	1749	3055	1703
"SYAP1"	2012	41580	193	52	110	83	31	21	167	187	0	73	1277	1468	900	849	912	669
"SYBL1"	2603	62487	0	0	0	0	0	0	0	0	0	0	0	0	2754	2405	2896	2050
"SYBL1B"	2599	62487	0	0	0	0	0	0	0	0	0	0	0	0	2754	2405	2896	2050
"SYCE1"	2304	6196	0	0	0	0	0	0	0	0	0	0	0	0	0	0	0	0
"SYCE2"	939	20194	0	0	0	0	0	0	61	20	0	0	48	41	78	56	94	76
"SYCN"	484	1346	0	0	0	0	0	0	11	0	0	0	0	0	0	0	0	0
"SYCP1"	3624	140535	0	0	0	0	0	0	0	0	0	0	0	0	0	0	0	0
"SYCP2"	5523	68592	14	0	11	3	0	0	9	0	0	0	25	22	8	12	0	4
"SYCP2L"	3157	87477	0	0	0	0	0	0	0	0	0	0	0	0	0	0	3	0
"SYCP3"	1134	10822	10	0	10	0	0	0	10	0	0	0	60	56	34	30	25	24
"SYDE1"	3841	6147	0	0	0	0	0	0	17	36	0	0	0	0	0	0	0	0
"SYDE2"	4717	43373	0	0	0	0	0	0	10	0	0	0	0	0	0	0	0	0
"SYF2"	1784	10248	68	108	56	12	55	53	50	36	0	0	510	972	1175	809	1494	940
"SYK"	5078	96823	26271	6002	14625	11646	3286	2716	10609	1884	11470	1957	14664	12568	14516	10347	15343	8995
"SYMPK"	6692	36891	5471	4356	2946	2525	2413	1943	2332	2760	5092	7302	2214	2857	2998	2906	4425	2871
"SYN1"	3222	47957	85	39	53	32	28	11	50	141	0	141	1548	2493	1731	3353	1437	2400
"SYN2"	3889	181366	0	0	0	0	0	0	59	7	0	0	0	23	29	4	0	0
"SYN3"	3153	545837	23	720	23	0	392	328	574	3073	37	1934	1338	1436	6618	10756	3339	5365
"SYNC"	3498	22856	1011	339	558	453	161	178	469	137	622	316	41	32	2336	1615	2614	1781
"SYNCRIP"	7339	35542	5295	6670	3019	2276	3593	3077	2114	3121	1403	4737	3717	5183	5565	5667	5744	4383
"SYNE1"	27890	515713	1550	1114	837	713	616	498	1070	470	200	422	1142	1242	2117	2225	2023	1426
"SYNE2"	21991	373484	112	151	55	57	84	67	28	10	63	87	78	228	73	81	234	87
"SYNGAP1"	6028	33620	21	0	10	11	0	0	282	120	0	8	5	22	47	46	43	9
"SYNGR1"	4440	35639	0	0	0	0	0	0	137	73	0	0	27	27	156	134	134	133
"SYNGR1C"	1447	28441	0	0	0	0	0	0	86	73	0	0	27	27	156	134	134	132
"SYNGR2"	1698	4340	1681	1769	897	784	930	839	765	2026	1668	2631	12484	147	14937	14348	23204	16249
"SYNGR3"	2032	4309	1	0	1	0	0	0	0	23	0	0	13	43	0	0	0	0
"SYNGR4"	1007	11972	0	0	0	0	0	0	66	46	0	0	0	0	0	0	0	0
"SYNJ1"	7132	99284	5697	4588	3259	2438	2488	2100	2821	2223	1001	1427	1638	1756	2196	1576	2225	1360
"SYNJ2"	6765	116651	734	60	428	306	23	37	1570	235	339	157	792	700	944	663	1405	1089
"SYNJ2BP"	7062	50594	276	55	136	140	31	24	295	0	24	0	36	835	796	589	788	472
"SYNM"	7356	30515	0	0	0	0	0	0	25	8	0	0	0	7	0	0	0	0
"SYNPO"	5387	18574	12	0	12	0	0	0	248	124	0	0	149	185	93	69	122	41
"SYNPO2"	9938	149674	0	10	0	0	0	10	8	0	0	0	0	366	0	226	0	0
"SYNPO2L"	4921	11189	0	0	0	0	0	0	11	8	0	0	0	0	0	0	0	0
"SYNPR"	2645	173845	0	0	0	0	0	0	0	0	0	0	0	0	0	0	0	0
"SYNRG"	8192	94587	4212	1354	2346	1866	782	572	2253	798	1207	1158	2564	2531	2765	1805	2989	1664
"SYP"	2440	12398	0	0	0	0	0	0	0	10	0	0	15	20	21	29	44	5
"SYPL1"	2166	22106	79	102	28	51	70	32	97	136	0	30	1333	374	344	362	1088	238
"SYPL2"	3784	15665	0	0	0	0	0	0	12	0	0	0	0	0	0	0	0	0
"SYS1"	2897	6148	570	1182	304	266	642	540	345	515	61	848	1163	1457	1205	1636	1466	1294
"SYT1"	4835	588016	131	124	67	64	74	50	28	5	0	0	76	96	111	161	0	0
"SYT10"	3475	64408	0	0	0	0	0	0	0	0	0	0	0	0	0	0	0	0
"SYT11"	5253	25701	0	9	0	0	9	0	16	8	2	0	458	529	396	310	451	288
"SYT12"	3605	28141	0	0	0	0	0	0	95	60	0	0	0	0	0	0	0	0
"SYT13"	5383	46033	0	0	0	0	0	0	41	0	0	0	0	0	0	0	0	0
"SYT14"	5198	226095	0	0	0	0	0	0	0	0	0	0	0	0	0	0	0	0
"SYT14L"	2628	2687	0	0	0	0	0	0	0	0	0	0	0	0	0	0	0	0
"SYT15"	4869	12075	0	0	0	0	0	0	260	61	0	0	0	0	0	0	0	0
"SYT16"	3143	105888	0	0	0	0	0	0	0	0	0	0	0	0	0	0	0	0
"SYT17"	3684	95934	5779	1202	3339	2440	719	483	3836	728	2238	592	841	690	1014	738	1332	679
"SYT2"	7620	52856	0	0	0	0	0	0	347	154	0	10	1	0	2	0	0	0
"SYT3"	2922	16068	0	0	0	0	0	0	37	21	0	0	0	0	0	0	0	0
"SYT4"	4098	9758	0	0	0	0	0	0	0	0	0	0	0	0	0	0	0	0
"SYT5"	2612	7002	0	0	0	0	0	0	20	21	0	0	0	0	0	0	0	0
"SYT6"	4377	64559	0	0	0	0	0	0	151	27	0	0	40	0	11	0	21	14
"SYT7"	4764	65512	0	0	0	0	0	0	737	289	0	0	0	0	0	0	0	0
"SYT8"	1563	2718	10	3	3	7	1	2	67	23	0	0	2	1	0	0	0	0
"SYT9"	3957	217089	0	0	0	0	0	0	28	25	0	3	19	9	47	31	0	4
"SYTL1"	2243	9059	520	43	265	255	13	30	257	89	852	323	492	380	316	266	899	664
"SYTL2"	4815	32246	12	0	0	12	0	0	19	0	21	0	19	43	17	6	38	7
"SYTL3"	2751	103603	17	0	17	0	0	0	154	48	11	40	60	84	86	101	94	85
"SYTL4"	4862	47421	0	0	0	0	0	0	0	0	0	0	0	0	0	0	0	0
"SYTL5"	4834	122239	0	0	0	0	0	0	0	0	0	0	0	0	0	0	0	0
"SYVN1"	3065	7252	529	163	280	249	72	91	313	165	478	232	2067	1844	1037	1429	2840	613
"Sab"	2099	77749	1041	464	673	368	281	183	738	198	252	185	256	66	278	584	1020	698
"ScRG-1"	1661	18230	200	0	118	82	0	0	222	0	0	0	0	0	3	0	0	0
"Sec1"	2653	44207	18	0	0	18	0	0	260	156	0	0	198	119	171	232	475	320
"SerRSmt"	1652	14871	259	88	115	144	64	24	327	90	191	41	310	325	321	379	376	456
"Ses2"	1596	3652	45	0	20	25	0	0	48	39	11	0	192	149	229	147	293	150
"Shax2"	1685	4570	420	170	240	180	98	72	202	66	298	170	1220	917	1011	936	1533	1296
"Shoca-1"	3138	42983	0	0	0	0	0	0	0	0	0	0	0	0	0	0	0	0
"Si-1-2-19"	1585	2181	1009	121	519	490	56	65	59	136	59	192	1190	1264	198	1423	385	256
"Sk-Tmod"	1193	5995	50	0	31	19	0	0	47	0	0	0	0	0	3	1	24	0
"Sptrx"	1745	2656	0	0	0	0	0	0	0	0	0	0	0	15	0	0	2	0
"T"	2527	11047	0	0	0	0	0	0	0	0	0	0	0	0	0	0	0	0
"T-Cell Receptor V-alpha region"	381	522	0	0	0	0	0	0	0	0	0	0	0	0	0	0	0	0
"T-cell-receptor V beta 12.6"	320	320	0	0	0	0	0	0	0	0	0	0	0	0	0	0	0	0
"TAAR1"	1021	1021	0	0	0	0	0	0	0	0	0	0	0	0	0	0	0	0
"TAAR2"	1058	7127	0	0	0	0	0	0	0	0	0	0	0	0	0	0	0	0
"TAAR5"	1148	1148	0	0	0	0	0	0	0	0	0	0	0	0	0	0	0	0
"TAAR6"	1037	1037	0	0	0	0	0	0	0	0	0	0	0	0	0	0	0	0
"TAAR8"	1028	1028	0	0	0	0	0	0	0	0	0	0	0	0	0	0	0	0
"TAAR9"	1046	1048	0	0	0	0	0	0	0	0	0	0	0	0	0	0	0	0
"TAC1"	1193	8513	0	0	0	0	0	0	0	0	0	0	0	0	0	0	0	0
"TAC3"	821	6541	0	0	0	0	0	0	0	0	0	0	0	0	0	0	0	0
"TAC4"	680	9710	781	326	406	375	181	145	375	228	601	476	30	46	0	4	20	0
"TACC1"	8375	124843	7873	4895	4290	3583	2698	2197	3544	4610	3368	5921	6915	8055	8067	6347	7769	4484
"TACC2"	9714	265368	0	0	0	0	0	0	356	67	0	0	0	0	0	0	0	0
"TACC3"	2794	23631	1433	20	754	679	13	7	766	216	781	92	1965	1454	1831	1157	2405	1256
"TACI"	1412	42555	0	0	0	0	0	0	119	39	0	0	0	0	0	0	0	0
"TACO1"	1461	7483	0	0	0	0	0	0	0	1	2	0	259	170	370	192	501	249
"TACR1"	4783	153057	485	0	315	170	0	0	288	75	0	15	0	0	0	0	0	0
"TACR2"	2421	12718	89	0	58	31	0	0	83	40	58	0	0	0	0	0	0	0
"TACR3"	1758	130350	0	0	0	0	0	0	0	0	0	0	0	0	0	0	0	0
"TACSTD2"	2071	2071	243	0	139	104	0	0	28	14	0	0	852	840	775	303	3142	1250
"TADA1"	2539	6704	701	64	282	419	46	18	313	31	55	0	361	62	237	73	341	46
"TADA2A"	1854	69914	873	70	508	365	19	51	531	56	81	0	437	336	322	179	459	243
"TADA2B"	4310	14521	654	137	379	275	61	76	399	129	46	109	1609	875	1502	802	1897	834
"TADA2L"	1199	39387	740	50	432	308	12	38	439	44	36	0	411	306	270	143	388	204
"TADA3"	2561	9609	449	111	216	233	60	51	208	120	89	32	2431	1604	1893	855	1942	1228
"TAF-172"	1322	35903	2929	4314	1702	1227	2434	1880	1216	2394	850	2430	451	750	728	641	797	342
"TAF1"	7729	99742	2537	819	1218	1319	494	325	1273	417	551	1524	1395	1837	1862	1478	2374	1305
"TAF10"	767	1374	699	166	566	133	114	52	53	0	84	253	3632	496	2280	3275	2725	2229
"TAF11"	1538	10266	569	114	308	261	58	56	207	172	104	108	871	2058	692	534	555	441
"TAF12"	1454	39995	203	21	140	63	10	11	234	40	144	27	374	404	614	497	675	442
"TAF13"	581	11628	101	171	58	43	86	85	36	122	0	353	113	218	209	212	153	124
"TAF15"	2169	37751	3956	2447	2182	1774	1285	1162	1629	801	2084	2284	3615	4172	3453	2667	4058	2580
"TAF1A"	1958	32013	65	0	45	20	0	0	21	0	0	11	20	37	83	42	65	38
"TAF1B"	2312	90974	260	44	152	108	32	12	373	186	27	134	261	359	229	167	337	195
"TAF1C"	3937	9202	1043	4634	658	385	2437	2197	351	2109	409	2090	587	388	1028	429	743	831
"TAF1D"	4362	5568	2172	4501	1519	653	2400	2101	1036	2928	982	2046	1112	2012	1219	1636	1229	1227
"TAF1L"	6217	6217	124	50	83	41	23	27	92	21	39	11	210	311	0	0	0	21
"TAF2"	5045	102061	1146	727	672	474	370	357	836	605	215	702	806	1211	1067	996	1085	813
"TAF3"	2796	196042	2836	280	1478	1358	166	114	1886	195	614	143	406	408	360	315	364	214
"TAF4"	4642	91013	3653	217	2007	1646	132	85	2486	487	2163	551	545	498	776	417	784	447
"TAF4B"	4885	165240	19	132	14	5	83	49	58	432	0	171	143	156	150	187	163	88
"TAF5"	3277	21098	0	0	0	0	0	0	19	0	0	17	294	220	239	33	193	113
"TAF5L"	4142	26854	420	286	267	153	150	136	301	173	41	164	824	572	880	719	1029	541
"TAF6"	2760	12287	118	21	58	60	15	6	267	101	126	12	675	503	675	564	974	487
"TAF6L"	2024	15938	86	5	67	19	5	0	102	11	56	0	1670	180	481	214	587	254
"TAF7"	2295	2295	248	247	113	135	129	118	69	88	92	189	2649	3075	2274	2202	2882	2270
"TAF7L"	2353	24805	0	0	0	0	0	0	0	0	0	0	0	0	0	0	0	0
"TAF8"	4454	30394	587	83	332	255	53	30	452	91	97	18	790	716	524	356	685	366
"TAF9"	1749	4724	313	253	168	145	166	87	243	178	0	217	1206	1426	1293	1320	1264	1157
"TAF9B"	2695	9935	451	21	264	187	12	9	235	25	121	21	5509	229	37	128	106	125
"TAG1"	628	230328	0	0	0	0	0	0	0	0	0	0	0	0	0	0	0	0
"TAGAP"	3368	10157	186	245	104	82	133	112	219	146	96	149	872	140	247	538	337	194
"TAGLN"	2183	2920	2422	1570	1263	1159	806	764	1074	712	2048	251	2225	386	5253	4134	4354	757
"TAGLN2"	1647	7334	191	267	111	80	127	140	115	236	0	456	2529	4423	1310	5677	5024	4800
"TAGLN3"	1493	15150	0	0	0	0	0	0	0	0	0	0	0	0	0	0	0	0
"TAIF"	1402	3046	15	8	0	15	0	8	87	64	0	0	42	56	27	51	48	57
"TAL1"	5006	13482	1306	100	696	610	63	37	432	89	465	57	1628	656	1368	318	2448	571
"TAL2"	647	647	0	0	0	0	0	0	0	0	0	0	0	0	0	0	0	0
"TALDO1"	1250	17593	1743	383	970	773	194	189	812	291	1578	399	9108	5618	8793	8562	10131	7128
"TANC1"	7532	264024	0	12	0	0	0	12	23	59	0	26	390	491	62	75	80	43
"TANC2"	11771	418170	14	12	0	14	8	4	159	46	0	0	90	91	172	155	208	41
"TANK"	2097	99218	15639	109893	8796	6843	59632	50261	4529	38267	1962	54368	1639	9238	1646	7203	1922	4459
"TAOK1"	5566	34928	13024	10239	7090	5934	5280	4959	5677	4973	7960	11852	4920	5137	5688	4208	5678	2965
"TAOK2"	4925	14499	1873	597	1012	861	285	312	851	644	1399	930	1366	1346	1736	1220	2497	1419
"TAOK3"	4514	89472	16077	23436	9387	6690	12907	10529	6701	12099	5307	23063	5910	5921	9881	9731	13983	10286
"TAP1"	2962	8763	1045	2124	529	516	1114	1010	389	1208	109	1874	3906	7557	3944	6875	5811	5219
"TAP2"	5688	13361	1129	618	643	486	316	302	592	577	714	855	2562	2464	3268	2253	2891	1618
"TAPBP"	3646	14519	5407	11096	2832	2575	5906	5190	1312	5238	3899	13732	1004	9482	3772	4543	5634	4431
"TAPBPL"	2271	14206	1679	1626	986	693	869	757	628	537	790	714	1110	1584	1447	1155	1545	737
"TAPT1"	4602	66035	17286	16785	9332	7954	8931	7854	6721	8831	8441	11544	4797	8522	4165	4308	4882	3689
"TARBP1"	5159	87791	2508	1518	1436	1072	815	703	1427	746	1152	1073	1320	1561	1693	1459	1678	1014
"TARBP2"	1917	5510	78	0	50	28	0	0	191	97	0	12	317	168	574	256	693	532
"TARDBP"	4222	12871	1953	1385	982	971	725	660	893	650	836	1047	2842	3287	4090	3318	4274	2946
"TARG1"	2812	4353	275	118	138	137	68	50	184	110	44	91	60	3222	2690	2808	3727	2510
"TARP"	1245	13997	0	0	0	0	0	0	7	0	0	10	8	13	26	38	45	47
"TARS"	2967	27298	511	502	324	187	303	199	181	239	93	304	2244	2187	2027	1730	2592	1734
"TARS2"	2389	19829	34	11	25	9	7	4	122	0	14	0	461	411	789	463	575	386
"TARSL2"	3467	70691	270	24	153	117	16	8	246	13	0	6	278	304	261	187	323	206
"TAS1R1"	2704	24384	0	4	0	0	0	4	35	16	0	0	0	0	0	0	0	0
"TAS1R2"	2527	20064	0	0	0	0	0	0	77	43	0	0	0	0	0	0	0	0
"TAS1R3"	2564	3119	11	0	11	0	0	0	122	22	0	0	1	1	4	0	0	0
"TAS2R1"	1356	1356	0	0	0	0	0	0	0	0	0	0	0	0	0	0	0	0
"TAS2R10"	925	925	137	0	75	62	0	0	11	0	0	0	12	0	0	0	0	0
"TAS2R13"	1638	1638	450	122	291	159	85	37	262	118	0	95	0	0	0	0	0	0
"TAS2R14"	954	954	1859	325	734	1125	140	185	242	52	0	156	17	40	0	28	0	0
"TAS2R16"	997	997	0	0	0	0	0	0	0	0	0	0	0	0	0	0	0	0
"TAS2R19"	900	900	485	1576	185	300	957	619	152	591	189	107	0	0	0	0	0	0
"TAS2R20"	1915	1915	844	529	438	406	271	258	91	109	0	0	15	52	0	0	0	0
"TAS2R3"	1102	1102	18	0	18	0	0	0	74	0	0	14	0	0	0	0	0	0
"TAS2R30"	961	961	1604	345	818	786	227	118	238	108	107	100	0	0	0	0	0	0
"TAS2R31"	1022	1022	555	555	237	318	282	273	167	221	0	65	0	0	0	0	0	0
"TAS2R38"	1144	1144	0	0	0	0	0	0	0	0	0	0	0	0	0	0	0	0
"TAS2R39"	1017	1017	0	0	0	0	0	0	0	0	0	0	0	0	0	0	0	0
"TAS2R4"	901	901	0	0	0	0	0	0	47	0	0	0	9	0	0	0	0	0
"TAS2R40"	972	972	0	0	0	0	0	0	0	0	0	0	0	0	0	0	0	0
"TAS2R41"	925	925	0	0	0	0	0	0	12	9	0	0	0	0	0	0	0	0
"TAS2R42"	946	946	0	0	0	0	0	0	11	0	0	0	0	0	0	0	0	0
"TAS2R43"	1028	1028	199	157	85	114	78	79	26	60	0	80	0	0	0	0	0	0
"TAS2R46"	931	931	129	146	64	65	84	62	72	97	0	51	0	0	0	0	0	0
"TAS2R5"	1151	1151	7	0	6	1	0	0	14	0	0	0	0	0	0	0	0	0
"TAS2R50"	1001	1001	298	172	96	202	105	67	165	96	0	39	0	0	0	0	0	0
"TAS2R60"	957	957	0	0	0	0	0	0	51	0	0	0	0	0	0	0	1	0
"TAS2R7"	1096	1096	0	0	0	0	0	0	0	0	0	0	0	0	0	0	0	0
"TAS2R8"	930	930	0	0	0	0	0	0	0	0	0	0	0	0	0	0	0	0
"TAS2R9"	1075	1075	0	0	0	0	0	0	0	0	0	0	0	0	0	0	0	0
"TASP1"	2364	249548	826	869	492	334	445	424	826	591	83	794	112	152	134	117	165	64
"TAT"	2769	10246	0	0	0	0	0	0	0	0	0	0	0	0	0	0	0	0
"TATDN1"	1161	50596	717	150	453	264	75	75	491	235	51	259	280	251	283	121	335	156
"TATDN2"	4914	32730	2077	2494	1143	934	1323	1171	966	1511	1581	2516	2199	2216	2369	2057	2629	1775
"TATDN2/GHRLOS fusion"	1953	12497	1950	1761	1117	833	906	855	720	755	2246	1596	1002	996	1093	797	1288	925
"TATDN3"	2619	24999	103	0	64	39	0	0	201	0	26	0	640	550	317	213	383	218
"TAX1BP1"	3481	89648	6225	4021	3577	2648	2179	1842	3542	1855	1268	3076	3967	4827	4112	4070	4801	3514
"TAX1BP3"	1946	5634	927	181	916	11	91	90	738	121	1049	187	6945	5538	4067	3205	5818	3848
"TAZ"	1927	10186	535	76	277	258	48	28	320	150	416	66	523	627	1063	715	1698	931
"TBC1D1"	5707	248075	17291	13530	9634	7657	7316	6214	9526	8390	10144	11856	2778	2911	4065	3992	4419	3254
"TBC1D10A"	2107	10726	2609	7717	1413	1196	4071	3646	1171	4669	739	9449	313	972	631	1899	800	1277
"TBC1D10B"	3297	13102	847	391	499	348	185	206	443	235	776	998	2476	1870	771	611	1077	502
"TBC1D10C"	1714	6149	497	106	295	202	23	83	273	176	421	58	473	338	941	608	1227	910
"TBC1D11"	5524	164036	17221	12033	9822	7399	6563	5470	8340	5522	5369	10497	2579	3249	2890	2304	3649	2213
"TBC1D12"	5762	133905	1592	634	931	661	350	284	913	470	148	940	615	760	874	720	789	446
"TBC1D13"	3890	23202	476	128	284	192	84	44	314	153	481	107	1093	825	1301	837	1499	920
"TBC1D14"	5022	123351	8971	1598	4801	4170	815	783	4861	1083	4413	1433	4063	2994	4482	2744	5285	2640
"TBC1D15"	5853	87142	1055	458	620	435	231	227	1025	232	50	199	1034	1282	1237	888	1239	840
"TBC1D16"	3269	95828	114	131	15	99	43	88	647	485	196	100	301	101	144	251	182	134
"TBC1D17"	2235	11173	7026	14781	3885	3141	628	14153	885	653	947	239	968	7170	1053	6599	1617	5339
"TBC1D19"	2218	171371	0	0	0	0	0	0	0	0	0	0	23	15	7	4	10	6
"TBC1D2"	3362	56724	465	10	332	133	10	0	946	191	313	14	492	417	1330	992	1017	1000
"TBC1D20"	4628	27063	299	267	183	116	168	99	291	219	73	429	1304	1137	1232	1041	1445	892
"TBC1D21"	1216	15587	0	0	0	0	0	0	38	0	0	0	0	0	0	0	0	0
"TBC1D22A"	2637	410085	98035	69632	54634	43401	37026	32606	37773	30638	80694	76271	1642	2163	2016	1930	2879	2050
"TBC1D22B"	3535	75199	1784	1841	1024	760	1141	700	1195	1116	400	1902	481	553	565	443	761	440
"TBC1D23"	3862	64394	3632	3105	2103	1529	1631	1474	1671	1406	775	2377	2071	2306	1891	1688	2212	1518
"TBC1D24"	4355	28341	1864	865	991	873	485	380	1055	633	1333	1276	4358	3675	8218	6402	6111	5528
"TBC1D25"	3818	22924	65	31	36	29	17	14	77	42	0	0	469	432	522	386	653	479
"TBC1D26"	1883	12508	0	0	0	0	0	0	56	13	0	0	0	0	0	0	0	0
"TBC1D28"	1988	8900	0	0	0	0	0	0	0	0	0	0	0	0	0	0	0	0
"TBC1D29"	1213	4467	0	0	0	0	0	0	0	0	0	0	0	0	0	0	0	0
"TBC1D2B"	6079	82668	13703	8984	7660	6043	4818	4166	5910	7546	6975	13231	3941	4615	5074	5893	7760	4686
"TBC1D3"	2848	10309	3305	1972	1858	1447	1096	876	1342	1145	2245	1460	397	10171	2114	17356	4600	75180
"TBC1D30"	5063	53675	0	0	0	0	0	0	19	22	0	0	41	45	13	31	39	33
"TBC1D3B"	2128	10929	0	0	0	0	0	0	0	0	0	0	0	1	439	282	704	373
"TBC1D3C"	2543	11116	7	0	0	7	0	0	0	0	0	0	1	0	616	388	1120	465
"TBC1D3E"	884	7512	0	0	0	0	0	0	0	0	0	0	0	0	0	0	0	0
"TBC1D3F"	2848	10309	72	7	41	31	4	3	23	85	41	31	45	42	649	430	1330	676
"TBC1D3G"	2665	226189	86	1130	65	21	585	545	0	852	0	689	18	9795	948	16457	2335	74248
"TBC1D3H"	2848	10285	0	0	0	0	0	0	0	0	0	0	0	0	529	350	923	391
"TBC1D3P2"	2074	10949	0	0	0	0	0	0	0	0	0	0	0	0	0	0	0	0
"TBC1D4"	6384	197443	132	39	68	64	32	7	145	44	14	62	562	617	752	586	700	293
"TBC1D5"	7875	583746	53008	30546	29749	23259	16690	13856	26170	15637	16862	17694	4898	5638	4348	3866	5643	3341
"TBC1D6"	1448	13301	0	0	0	0	0	0	0	0	0	0	0	0	0	0	0	0
"TBC1D7"	2584	9822	160	485	110	50	223	262	248	105	0	23	279	322	363	642	441	429
"TBC1D8"	4166	144157	5599	1692	3018	2581	949	743	1878	1054	6480	5729	1357	424	2391	2415	928	784
"TBC1D8B"	5729	73458	0	0	0	0	0	0	0	0	0	0	3	3	0	0	3	0
"TBC1D9"	5506	135536	51	36	20	31	16	20	108	50	0	66	335	445	810	677	803	716
"TBC1D9B"	5185	45785	4848	1124	2710	2138	646	478	2323	694	3702	1046	5674	2760	7110	5788	10648	6921
"TBCA"	2370	85113	5160	5179	2904	2256	2869	2310	2656	4033	934	5482	324	528	829	774	832	833
"TBCB"	1481	10963	170	18	114	56	18	0	230	114	0	0	914	953	539	548	894	700
"TBCC"	1651	1651	73	0	48	25	0	0	30	15	0	0	667	218	704	210	904	209
"TBCCD1"	3070	24476	262	150	158	104	73	77	207	77	0	0	369	381	363	247	474	317
"TBCD"	4469	191122	2615	1006	1533	1082	501	505	2571	1173	1757	1841	1369	1266	1346	1282	1725	1080
"TBCE"	2081	81554	822	13	532	290	0	13	511	64	60	4	1110	1140	866	504	1398	898
"TBCEL"	4035	65541	634	172	304	330	120	52	466	108	50	23	403	480	559	355	551	286
"TBCK"	3669	270192	3223	998	1806	1417	609	389	3017	1348	453	946	797	1032	647	643	891	528
"TBETAR1"	383	3778	645	213	330	315	80	133	592	236	199	196	184	146	280	176	155	63
"TBK1"	3003	49956	2552	2409	1394	1158	1350	1059	1112	1242	368	2282	1564	1724	1393	1162	1530	956
"TBKBP1"	4141	16799	788	152	414	374	90	62	391	141	183	197	564	376	559	373	675	325
"TBL1X"	5732	254580	15581	10967	8561	7020	6023	4944	6886	6045	6043	10593	1840	2036	1408	1270	2368	1470
"TBL1XR1"	6565	176507	28837	17847	16154	12683	9680	8167	13060	7058	18063	14941	4592	4287	1244	892	1090	3098
"TBL1Y"	2425	180998	0	0	0	0	0	0	0	0	0	0	0	0	0	0	0	0
"TBL2"	3101	9736	19	6	4	15	6	0	78	0	0	0	589	451	794	585	686	452
"TBL3"	2742	3824	71	8	49	22	6	2	186	91	0	9	539	380	581	501	718	528
"TBP"	1853	18477	133	46	71	62	22	24	138	11	0	14	469	372	521	339	550	310
"TBPIP"	1642	5420	462	0	197	265	0	0	141	15	48	0	1259	1354	1505	1141	1764	1200
"TBPL1"	1577	35276	413	0	265	148	0	0	178	22	40	33	193	187	172	93	201	158
"TBPL2"	1300	26333	1	0	0	1	0	0	0	0	0	0	0	1	0	0	0	0
"TBR1"	3192	8955	0	0	0	0	0	0	0	0	0	0	0	0	0	0	0	0
"TBRG1"	5170	13081	2110	1399	1195	915	758	641	1104	487	697	782	2153	2166	2384	1658	2755	1500
"TBRG4"	2257	11619	1199	1416	625	574	776	640	554	926	1103	1451	1455	1336	1656	1598	2284	1666
"TBX1"	2091	10631	0	0	0	0	0	0	146	102	0	0	0	0	0	0	0	0
"TBX10"	1555	8258	0	0	0	0	0	0	59	24	0	0	0	1	0	0	0	0
"TBX15"	3503	106515	0	0	0	0	0	0	0	0	0	0	0	0	0	0	0	0
"TBX18"	4078	29744	0	0	0	0	0	0	0	0	0	0	0	0	0	0	0	0
"TBX19"	2828	33386	28314	14168	15778	12536	7669	6499	11119	5480	18983	9272	10801	10864	6176	3473	8699	4900
"TBX2"	5690	9228	0	0	0	0	0	0	0	25	0	0	0	0	0	0	0	0
"TBX20"	1362	51201	0	0	0	0	0	0	0	0	0	0	0	0	0	0	0	0
"TBX21"	2578	12877	13	0	0	13	0	0	34	35	0	0	50	40	14	11	80	11
"TBX22"	2364	17015	0	0	0	0	0	0	0	0	0	0	0	0	0	0	0	0
"TBX3"	4791	13912	0	0	0	0	0	0	0	0	0	0	0	0	0	0	0	0
"TBX4"	3405	32692	0	0	0	0	0	0	36	0	0	0	0	0	0	0	0	0
"TBX5"	3834	54513	0	0	0	0	0	0	40	0	0	0	0	0	0	0	0	0
"TBX6"	2167	3973	0	0	0	0	0	0	0	35	0	0	1	4	0	0	0	7
"TBXA2R"	2431	12156	159	452	56	103	211	241	44	190	0	0	1	2	0	0	0	0
"TBXAS1"	2250	241944	18661	11893	10375	8286	6599	5294	12084	6797	13584	14220	4152	4491	6384	6876	5986	5129
"TC2N"	5039	56582	209	195	107	102	135	60	40	26	0	12	16	46	17	18	12	13
"TCAM-1"	3297	7364	0	0	0	0	0	0	0	1	0	0	0	0	0	0	0	0
"TCAP"	964	1209	0	0	0	0	0	0	79	36	0	0	0	1	0	0	0	0
"TCBA1"	3003	542635	0	0	0	0	0	0	0	8	0	0	0	0	0	0	0	0
"TCEA1"	2786	55893	301	26	164	137	10	16	368	42	78	26	912	938	2053	1687	2240	1485
"TCEA2"	1831	7759	49	0	40	9	0	0	354	92	125	38	100	91	129	98	161	123
"TCEA3"	1597	43708	0	0	0	0	0	0	76	19	0	0	0	0	0	0	3	0
"TCEAL1"	1207	2228	15	0	0	15	0	0	0	0	0	0	167	151	166	144	194	136
"TCEAL2"	1103	2025	0	0	0	0	0	0	0	0	0	0	0	0	0	0	0	0
"TCEAL3"	1127	2022	0	0	0	0	0	0	0	0	0	0	138	125	173	144	170	128
"TCEAL4"	1647	2236	26	0	13	13	0	0	10	0	0	0	347	369	393	332	438	322
"TCEAL5"	1171	3183	0	0	0	0	0	0	0	0	0	0	0	0	0	0	0	0
"TCEAL6"	1533	2455	0	0	0	0	0	0	0	0	0	0	0	0	0	0	0	0
"TCEAL7"	1136	2088	0	0	0	0	0	0	0	0	0	0	0	0	0	0	0	0
"TCEAL8"	1214	2199	0	0	0	0	0	0	0	0	0	0	33	584	653	509	74	47
"TCEANC"	2855	19465	0	0	0	0	0	0	12	0	0	0	73	0	0	0	89	0
"TCEB1"	799	25714	576	568	349	227	330	238	339	394	46	807	636	745	359	383	305	294
"TCEB2"	993	5883	1931	1	406	1525	0	1	112	104	0	0	645	252	2098	3658	2183	1258
"TCEB3"	4953	18694	825	335	433	392	143	192	425	323	411	533	1396	1417	2274	2082	2242	1536
"TCEB3B"	3047	3047	0	0	0	0	0	0	0	13	0	0	0	0	0	0	0	0
"TCEB3C"	1876	1876	0	0	0	0	0	0	31	17	0	0	0	0	0	0	0	0
"TCEB3CL"	3518	7803	0	0	0	0	0	0	0	0	38	41	0	0	0	0	0	0
"TCERG1"	4222	64197	3979	2904	2225	1754	1660	1244	1898	1481	716	1894	1629	1791	1418	1244	1920	1021
"TCERG1L"	3585	162140	0	0	0	0	0	0	350	117	0	0	0	0	0	0	0	0
"TCF-4B"	3403	38044	0	0	0	0	0	0	41	9	0	10	40	42	38	12	102	19
"TCF12"	4805	369881	29596	16397	16748	12848	9214	7183	14471	8112	8447	10479	2474	2707	2249	2046	2725	1619
"TCF15"	1227	6273	0	0	0	0	0	0	12	0	0	0	0	0	0	0	0	0
"TCF19"	3310	5686	0	0	0	0	0	0	21	17	0	0	40	43	15	85	99	16
"TCF20"	7412	55428	3013	1126	1663	1350	539	587	1288	1087	1013	1554	1424	1489	1569	1226	2050	1074
"TCF21"	3211	6418	0	0	0	0	0	0	0	0	0	0	0	0	0	0	0	0
"TCF23"	646	3733	0	0	0	0	0	0	10	0	0	0	0	0	0	0	0	0
"TCF25"	2277	37800	5414	5463	2953	2461	2906	2557	2098	2937	5249	7225	3094	3656	4569	4588	5885	4175
"TCF3"	4464	43035	2290	479	1186	1104	242	237	1049	820	1168	3809	1241	984	1526	1087	2156	1251
"TCF4"	8352	366300	3368	1235	1763	1605	802	433	2162	805	318	392	1771	1700	1680	866	2159	964
"TCF7"	3286	33519	1015	329	655	360	146	183	676	583	243	393	38	39	8	16	11	15
"TCF7L1"	2772	176772	0	0	0	0	0	0	88	52	0	0	0	0	0	0	0	0
"TCF7L2"	4104	217427	1081	1252	695	386	637	615	1099	2224	243	3979	82	85	54	28	122	39
"TCFL5"	2869	10269	62	0	23	39	0	0	185	21	103	0	289	264	187	108	323	149
"TCHH"	7175	38915	0	0	0	0	0	0	8	0	0	0	8	62	0	51	0	50
"TCHHL1"	3606	4922	0	0	0	0	0	0	0	0	0	0	0	0	0	0	0	0
"TCHP"	3169	17552	6152	1358	3375	2777	750	608	2877	644	4350	1141	4822	4026	5498	3024	6720	3570
"TCIRG1"	2700	11884	5890	2042	3184	2706	1067	975	2100	1302	7231	3121	5341	4399	10478	9209	11967	8561
"TCL1A"	1399	4230	0	0	0	0	0	0	0	0	0	0	0	0	0	0	0	0
"TCL1B"	1740	6205	0	0	0	0	0	0	12	0	0	0	0	0	0	0	0	0
"TCL6"	4235	16578	0	0	0	0	0	0	13	0	0	0	0	0	0	0	0	0
"TCL6a1"	1948	21064	0	0	0	0	0	0	13	0	0	0	0	0	0	0	0	0
"TCL6d1"	918	4151	0	0	0	0	0	0	0	0	0	0	0	0	0	0	0	0
"TCL6e1"	2201	20673	0	0	0	0	0	0	13	0	0	0	0	0	0	0	0	0
"TCL6f4"	3668	10198	0	0	0	0	0	0	13	0	0	0	0	0	0	0	0	0
"TCN1"	1576	13762	0	0	0	0	0	0	0	0	0	0	44	90	52	61	32	17
"TCN2"	1990	19888	0	0	0	0	0	0	75	29	0	0	222	204	374	379	204	163
"TCOF1"	5122	42670	33651	58573	18578	15073	31065	27508	8749	29571	19470	59850	416047	447101	762	809	674	855
"TCP1"	2464	11206	257	2288	152	105	1203	1085	184	1558	0	990	2012	3733	3210	4912	3176	3202
"TCP10"	2390	27477	0	0	0	0	0	0	15	0	0	0	0	0	0	0	0	0
"TCP10L"	2701	10695	38	0	28	10	0	0	110	12	21	0	242	270	320	199	365	244
"TCP10L2"	3217	10538	0	0	0	0	0	0	19	0	0	0	0	0	0	0	0	0
"TCP11"	2146	23340	0	0	0	0	0	0	0	0	0	0	0	0	0	0	0	0
"TCP11L1"	4118	33778	1148	166	712	436	68	98	840	109	147	183	1786	1965	1458	1197	1710	1046
"TCP11L2"	3198	23091	60	0	25	35	0	0	194	0	0	0	281	182	207	73	234	111
"TCR BV9"	634	5329	51	12	46	5	12	0	28	44	0	37	154	200	128	129	274	166
"TCR-[alpha] V 33.1"	348	460	0	0	0	0	0	0	0	0	0	0	0	0	0	0	0	0
"TCR-alpha"	1216	1376	301	278	123	178	188	90	43	15	0	101	236	347	109	114	159	108
"TCRA"	1609	78798	313	373	135	178	239	134	83	25	0	129	285	412	153	153	283	186
"TCRAV1.2a"	334	478	0	0	0	0	0	0	0	0	0	0	0	0	0	0	20	0
"TCRAV21-J9.11"	41	41	0	0	0	0	0	0	0	0	0	0	0	0	0	0	0	0
"TCRAV23-J37"	33	33	0	0	0	0	0	0	0	0	0	0	0	0	0	0	0	0
"TCRAV5.1a"	399	586	0	0	0	0	0	0	0	0	0	0	0	0	0	0	0	0
"TCRAVN1"	406	687	0	0	0	0	0	0	0	0	0	0	0	0	0	0	0	0
"TCRB"	1434	3731	0	0	0	0	0	0	10	0	0	0	13	10	3	9	38	37
"TCRBC2"	794	5885	51	12	46	5	12	0	28	44	0	37	173	211	130	132	287	171
"TCRBV11S1A1T"	345	468	0	0	0	0	0	0	0	0	0	0	0	3	0	0	0	0
"TCRBV12S2"	439	544	0	0	0	0	0	0	0	0	0	0	0	0	0	0	0	0
"TCRBV12S3"	390	495	0	0	0	0	0	0	0	0	0	0	0	0	0	0	0	0
"TCRBV13"	325	70603	0	0	0	0	0	0	0	0	0	0	13	0	3	9	10	0
"TCRBV13S6A2T"	385	473	0	0	0	0	0	0	0	0	0	0	0	0	0	0	0	0
"TCRBV14S1"	625	753	0	0	0	0	0	0	0	0	0	0	0	0	0	0	0	0
"TCRBV17S1A1T"	539	670	0	0	0	0	0	0	0	0	0	0	0	0	0	0	0	0
"TCRBV19S1P"	60	90426	0	0	0	0	0	0	0	0	0	0	0	3	0	0	25	37
"TCRBV1S1A1N1"	365	496	0	0	0	0	0	0	0	0	0	0	0	0	0	0	5	0
"TCRBV20S1"	548	689	0	0	0	0	0	0	0	0	0	0	0	0	0	0	0	0
"TCRBV20S1A1N2"	447	813	0	0	0	0	0	0	0	0	0	0	0	0	0	0	0	0
"TCRBV21S1"	361	461	0	0	0	0	0	0	0	0	0	0	0	0	0	0	0	0
"TCRBV22S1A2N1T"	405	210237	0	0	0	0	0	0	10	0	0	0	0	0	0	3	3	0
"TCRBV2S1"	446	160395	0	0	0	0	0	0	12	1	0	0	30	30	6	11	59	48
"TCRBV3S1"	367	503	0	0	0	0	0	0	0	0	0	0	0	0	0	0	0	0
"TCRBV4S1A1T"	368	654	0	0	0	0	0	0	0	0	0	0	0	0	0	0	0	0
"TCRBV5S1A1T"	542	449607	0	0	0	0	0	0	22	0	0	0	13	10	3	9	38	37
"TCRBV5S3A2T"	385	507	0	0	0	0	0	0	0	0	0	0	0	0	0	0	0	0
"TCRBV5S6A3N2T"	509	630	0	0	0	0	0	0	0	0	0	0	0	0	0	0	0	0
"TCRBV6S1A1N1"	398	507	0	0	0	0	0	0	0	0	0	0	2	0	0	6	4	0
"TCRBV6S2A1N1T"	344	480	0	0	0	0	0	0	0	0	0	0	0	0	0	0	1	0
"TCRBV6S3A1N1T"	373	527	0	0	0	0	0	0	0	0	0	0	0	0	0	0	0	0
"TCRBV6S6A2T"	394	539	0	0	0	0	0	0	0	0	0	0	0	0	0	0	0	0
"TCRBV6S7"	394	485	0	0	0	0	0	0	0	0	0	0	0	0	0	0	0	0
"TCRBV7S1A1N2T"	374	483	0	0	0	0	0	0	0	0	0	0	0	0	0	0	0	0
"TCRBV7S2A1N4T"	295	377	0	0	0	0	0	0	0	0	0	0	0	0	0	0	0	0
"TCRBV7S3A2"	455	564	0	0	0	0	0	0	0	0	0	0	0	0	0	0	0	0
"TCRBV9S1A1T"	392	507	0	0	0	0	0	0	0	0	0	0	0	0	0	0	0	0
"TCRD"	1040	8153	276	237	113	163	172	65	30	0	0	0	233	346	107	111	156	105
"TCRDV1"	205	286	0	0	0	0	0	0	0	0	0	0	0	0	0	4	0	0
"TCRDV2"	1213	5549	70	96	63	7	71	25	13	0	0	0	191	263	93	90	137	78
"TCRG"	1021	10066	0	0	0	0	0	0	31	0	0	10	8	13	16	40	43	44
"TCRGV"	550	660	277	34	124	153	23	11	78	11	0	0	1	0	0	8	36	1
"TCRVA13"	378	565	0	0	0	0	0	0	0	0	0	0	0	0	0	0	0	0
"TCRVA14.1-J49"	32	32	0	0	0	0	0	0	0	0	0	0	0	0	0	0	0	0
"TCRVA15"	418	593	0	0	0	0	0	0	0	0	0	0	0	0	0	0	0	0
"TCRVA2"	445	124970	0	0	0	0	0	0	0	0	0	0	0	0	0	3	29	8
"TCRVB"	654	6206	51	12	46	5	12	0	40	44	0	37	175	214	130	132	315	208
"TCRg"	1777	58347	0	0	0	0	0	0	24	0	0	10	0	11	8	40	33	34
"TCTA"	2149	4271	132	26	52	80	26	0	139	48	76	0	671	545	656	354	872	529
"TCTE1"	1688	17563	0	0	0	0	0	0	43	16	0	0	0	0	0	0	0	0
"TCTE3"	751	11425	0	0	0	0	0	0	0	0	0	0	17	4	0	0	0	0
"TCTEX1D1"	2400	26591	0	0	0	0	0	0	0	0	0	0	0	0	0	0	0	0
"TCTEX1D2"	678	27071	0	0	0	0	0	0	65	0	80	0	28	0	43	17	31	28
"TCTEX1D4"	1262	1369	1021	8818	488	533	4667	4151	129	5016	196	18985	98	4835	152	4570	167	2667
"TCTN1"	2083	16131	0	0	0	0	0	0	61	0	0	0	691	572	60	380	57	50
"TCTN2"	2927	37289	0	0	0	0	0	0	25	0	0	0	44	31	26	16	23	7
"TCTN3"	2752	30748	113	0	86	27	0	0	185	7	10	64	642	625	878	768	911	751
"TDC1"	2047	133089	9000	4888	5096	3904	2642	2246	4485	2751	3705	7351	5473	3820	7260	3956	7393	3317
"TDE2"	1090	13205	11	0	0	11	0	0	69	73	0	0	97	53	150	139	184	158
"TDG"	3328	23064	837	487	429	408	298	189	381	338	164	360	1034	1295	1508	1519	1385	1011
"TDGF1"	2063	4772	0	0	0	0	0	0	0	0	0	0	0	0	0	0	0	0
"TDGF3"	2711	2711	0	0	0	0	0	0	0	0	0	0	0	0	0	0	0	0
"TDH"	1429	18445	0	0	0	0	0	0	1	0	0	0	0	0	0	0	0	0
"TDO2"	1705	16705	0	0	0	0	0	0	0	0	0	0	0	0	0	0	0	0
"TDP1"	4568	89825	3902	1150	2213	1689	685	465	1482	183	214	179	582	604	545	462	735	487
"TDRD1"	4536	53036	0	0	0	0	0	0	0	0	0	0	0	0	0	0	0	0
"TDRD10"	2540	45929	0	0	0	0	0	0	36	0	0	0	0	1	3	3	0	0
"TDRD12"	3939	101489	0	0	0	0	0	0	47	10	0	0	0	0	0	0	0	0
"TDRD3"	3033	177423	1847	448	1095	752	264	184	1208	288	171	450	410	544	1161	1269	434	312
"TDRD5"	3696	99375	0	0	0	0	0	0	0	0	0	0	0	0	0	0	0	0
"TDRD6"	6820	14285	1032	1018	401	631	424	594	44	139	106	347	2203	2195	864	612	479	1202
"TDRD7"	3777	84103	2135	2737	1202	933	1497	1240	1206	2456	156	1472	919	1119	772	745	1158	711
"TDRD9"	4798	124187	11	0	4	7	0	0	5	0	12	19	231	281	199	191	207	204
"TDRG1"	1087	1470	0	0	0	0	0	0	14	0	0	0	0	0	0	0	0	0
"TDRKH"	2850	17053	21	0	21	0	0	0	134	45	0	0	642	668	637	540	761	449
"TEAD1"	9443	270331	0	0	0	0	0	0	8	15	0	0	0	0	0	0	0	0
"TEAD2"	2451	19840	0	0	0	0	0	0	112	33	0	0	71	48	0	85	295	0
"TEAD3"	4358	7645	0	0	0	0	0	0	91	126	0	0	0	0	0	0	0	0
"TEAD4"	1789	81347	0	0	0	0	0	0	349	74	0	0	0	0	0	0	0	0
"TEC"	3637	134015	399	724	227	172	445	279	345	285	0	5	122	129	153	113	142	123
"TECPR1"	4371	35410	348	40	161	187	25	15	320	95	105	14	369	317	816	725	1049	534
"TECPR2"	8627	139441	321	51	182	139	51	0	640	245	152	38	561	470	615	485	886	461
"TECR"	1264	36411	412	6	226	186	6	0	445	38	260	0	486	474	1003	1099	1274	1158
"TECRL"	2818	130995	0	0	0	0	0	0	0	0	0	0	0	0	0	0	0	0
"TECTA"	6489	88140	0	0	0	0	0	0	32	10	0	0	0	0	0	3	0	0
"TECTB"	1000	19579	0	0	0	0	0	0	0	0	0	0	0	0	0	0	0	0
"TEDDM1"	2499	2499	0	0	0	0	0	0	0	0	0	0	0	0	0	0	0	0
"TEF"	4381	17367	104	0	63	41	0	0	191	46	0	0	704	523	987	497	943	570
"TEGT"	2636	23426	2651	2840	1448	1203	1543	1297	903	1202	880	2578	37461	41201	34081	34428	39151	28770
"TEK"	4781	121026	0	0	0	0	0	0	31	0	0	0	0	0	0	0	0	0
"TEKT1"	1420	31761	0	0	0	0	0	0	11	0	0	0	0	0	0	0	0	0
"TEKT2"	1741	3932	0	0	0	0	0	0	12	14	0	0	0	0	0	0	0	0
"TEKT3"	1791	37829	0	0	0	0	0	0	0	0	0	0	0	0	0	0	0	0
"TEKT4"	2164	5338	0	0	0	0	0	0	0	0	0	0	0	0	0	0	0	0
"TEKT5"	1616	67443	0	0	0	0	0	0	27	9	0	0	0	0	0	0	0	0
"TELO2"	3348	17109	364	61	165	199	42	19	395	156	199	36	408	478	718	623	822	614
"TEM7"	6651	89931	0	0	0	0	0	0	129	52	0	0	0	0	0	0	3	0
"TEM7R"	1364	136893	16466	16197	9201	7265	8740	7457	7316	6969	3071	8603	8899	9103	4299	3864	3761	2618
"TENC1"	4978	15429	20	2	0	20	0	2	174	160	0	11	677	557	7	36	0	4
"TEP1"	10748	47754	5268	1385	2977	2291	750	635	2682	680	3418	1032	3026	3092	3430	2168	5287	2597
"TEPP"	1627	11678	0	0	0	0	0	0	77	33	0	0	0	0	0	0	0	0
"TERC"	452	452	0	0	0	0	0	0	0	12	0	0	0	0	0	0	0	0
"TERF1"	2970	38892	235	0	140	95	0	0	187	20	0	0	267	255	348	255	462	243
"TERF2"	2904	30340	1489	569	833	656	280	289	560	242	677	449	1230	665	908	541	1275	737
"TERF2IP"	2119	9646	424	174	268	156	79	95	342	69	171	65	1419	2321	1546	1816	1843	1856
"TERT"	4029	41877	0	0	0	0	0	0	218	97	0	0	0	1	0	0	0	0
"TES"	2753	48256	3960	9676	2220	1740	5215	4461	1272	3387	332	4048	2131	2824	587	507	1954	1168
"TESC"	1030	60523	0	0	0	0	0	0	97	28	0	0	58	30	36	39	95	59
"TESK1"	2525	4758	178	40	99	79	40	0	88	74	186	0	924	765	1190	987	1404	997
"TESK2"	3087	147287	28	1	5	23	0	1	37	71	0	0	191	57	187	214	286	189
"TESS 2"	2162	48256	3960	9676	2220	1740	5215	4461	1272	3387	332	4048	2131	2824	587	507	1954	1168
"TESSP1"	961	6648	4	5	4	0	2	3	1	0	0	0	1	0	0	0	0	0
"TESSP2"	886	3692	0	0	0	0	0	0	0	0	0	0	0	0	0	0	0	0
"TESSP5"	1005	6550	0	0	0	0	0	0	24	0	0	0	0	0	0	0	0	0
"TET1"	9595	134123	1	0	0	1	0	0	0	0	0	0	0	0	0	0	0	0
"TET2"	9688	133017	26769	18111	14990	11779	9806	8305	11573	6507	7877	8662	4862	6567	4459	4070	4715	2928
"TET3"	10989	61852	15675	3896	8609	7066	2093	1803	7107	1898	7590	2768	4104	4444	6245	4102	7235	3974
"TEX10"	3134	50902	1841	968	989	852	540	428	1089	655	156	903	768	921	709	679	891	544
"TEX101"	1591	30005	0	0	0	0	0	0	0	0	0	0	0	0	0	0	0	0
"TEX11"	3170	379778	0	0	0	0	0	0	0	0	0	0	0	0	0	0	0	0
"TEX12"	1148	5185	0	0	0	0	0	0	0	0	19	0	3	2	0	0	3	3
"TEX13A"	1374	1748	0	0	0	0	0	0	0	0	0	0	0	0	0	0	0	0
"TEX13B"	1251	1508	0	0	0	0	0	0	0	0	0	0	0	0	0	0	0	0
"TEX14"	4978	135379	0	123	0	0	70	53	1	33	0	0	1	0	0	0	0	3
"TEX15"	10114	17473	0	0	0	0	0	0	0	0	0	0	0	0	0	0	0	0
"TEX19"	1904	4497	0	0	0	0	0	0	0	13	0	0	0	0	0	0	0	0
"TEX2"	5102	83322	273	0	149	124	0	0	617	34	14	0	810	867	1208	1177	1181	943
"TEX261"	3371	8933	707	161	394	313	72	89	345	169	331	263	2714	2505	2968	2301	3956	2358
"TEX264"	2334	33069	2013	59	1094	919	31	28	866	206	930	0	1424	703	1190	743	2542	853
"TEX28"	1551	24633	0	0	0	0	0	0	0	2	0	0	75	83	0	0	0	0
"TEX9"	4448	32896	0	0	0	0	0	0	0	0	0	0	0	0	0	0	0	0
"TF"	4018	78426	0	0	0	0	0	0	30	0	0	0	0	0	0	0	0	0
"TFAM"	2010	10722	21	0	12	9	0	0	24	15	0	0	882	806	602	437	711	346
"TFAMP1"	2223	2223	0	0	0	0	0	0	0	0	0	0	0	0	0	0	0	0
"TFAP2A"	3814	15692	0	0	0	0	0	0	39	34	0	0	0	0	0	0	0	0
"TFAP2B"	5776	28888	0	0	0	0	0	0	0	12	0	0	0	0	0	0	0	0
"TFAP2C"	2870	9980	0	0	0	0	0	0	0	0	0	0	0	0	0	0	0	0
"TFAP2D"	2178	59490	0	0	0	0	0	0	0	0	0	0	0	0	0	0	0	0
"TFAP2E"	2192	21956	0	0	0	0	0	0	41	13	0	0	0	0	0	0	4	0
"TFAP4"	2146	15815	70	0	37	33	0	0	153	30	0	0	97	17	113	8	150	18
"TFAR19"	1814	6199	57	0	29	28	0	0	51	62	0	70	241	304	478	413	525	360
"TFB1M"	1291	56837	1326	128	722	604	98	30	670	116	0	105	179	114	196	84	258	141
"TFB2M"	1789	25699	38	0	16	22	0	0	80	0	0	0	193	182	336	224	276	254
"TFCP2"	2396	78058	7753	3003	4323	3430	1755	1248	3393	1371	5327	3087	922	1009	1183	863	1473	935
"TFCP2L1"	9299	68614	0	0	0	0	0	0	107	21	0	0	0	0	0	0	0	0
"TFDP1"	2743	56200	2161	154	1209	952	109	45	1639	379	1328	486	1083	1142	1532	1339	2273	1296
"TFDP2"	1798	196984	3	0	3	0	0	0	96	26	0	19	73	109	84	83	110	67
"TFDP3"	1681	1681	0	0	0	0	0	0	0	0	0	0	0	0	0	0	0	0
"TFE3"	3403	14750	974	467	633	341	204	263	220	482	464	941	2470	3172	954	1114	1288	1150
"TFEB"	2602	47326	4343	393	2408	1935	210	183	2201	887	4097	1896	833	435	908	569	1155	683
"TFEC"	6639	95598	25897	83948	15437	10460	45372	38576	11384	30303	7607	50182	712	3732	1429	2967	1095	1785
"TFF1"	495	4255	0	0	0	0	0	0	0	0	0	0	0	0	0	0	0	0
"TFF2"	709	4741	0	0	0	0	0	0	0	0	0	0	0	0	0	0	0	0
"TFF3"	670	3544	0	0	0	0	0	0	0	10	0	0	0	0	0	0	0	0
"TFG"	2095	39652	2279	4138	1311	968	2295	1843	917	2102	151	1820	1559	2954	1596	2208	1909	1692
"TFIIH"	2660	6839	30	3	17	13	0	3	48	0	15	0	168	254	290	235	371	245
"TFIP11"	2987	20451	155	46	101	54	28	18	186	143	53	120	1042	822	1288	862	1723	964
"TFL"	2499	34970	2485	265	1418	1067	156	109	706	59	638	16	239	135	107	117	231	219
"TFPI"	4044	90261	0	83	0	0	28	55	0	16	0	7	26	81	15	21	26	19
"TFPI2"	1193	4322	0	0	0	0	0	0	0	0	0	0	0	6	0	0	0	3
"TFPT"	1211	8737	349	50	185	164	32	18	167	102	0	69	204	290	432	310	798	355
"TFR2"	2934	21164	0	1	0	0	0	1	84	23	0	3	3	2	5	0	4	4
"TFRC"	5242	32807	1406	1087	932	474	566	521	569	337	494	2744	10557	14105	8198	19436	5491	14284
"TG"	8499	267938	30731	26350	17004	13727	14146	12204	10359	12980	21556	22030	16375	19606	16162	14033	21138	13554
"TGDS"	1913	22204	154	21	71	83	12	9	123	0	0	0	343	271	308	152	414	179
"TGFA"	4476	106353	5096	5330	2770	2326	2949	2381	1937	2379	1503	10140	2031	3027	2645	3143	1738	121
"TGFB1"	2353	23167	1349	585	739	610	272	313	683	603	1218	2139	4390	1520	2805	6208	3283	2711
"TGFB1I1"	1813	4756	11	0	11	0	0	0	48	23	0	0	0	2	0	0	0	0
"TGFB2"	7782	65817	0	0	0	0	0	0	35	0	0	0	1	1	0	0	8	0
"TGFB3"	3190	23652	25	0	10	15	0	0	56	9	0	0	0	0	0	0	0	0
"TGFBI"	3273	34924	23862	6323	13314	10548	3291	3032	11194	1264	17528	1099	79435	62108	70670	53927	82280	42990
"TGFBR1"	6481	49061	5519	3848	2980	2539	2029	1819	2598	1498	1419	2902	3104	3495	3519	2431	3679	2101
"TGFBR2"	4709	87639	19704	10268	11067	8637	5498	4770	7894	3901	7587	10328	8365	7778	9719	9281	10055	6810
"TGFBR3"	6531	205887	74	83	34	40	54	29	33	17	0	45	44	78	3	42	15	9
"TGFBRAP1"	2977	62608	1105	134	601	504	64	70	746	44	87	84	422	896	462	803	515	786
"TGIF1"	2211	2994	429	320	210	219	155	165	149	134	146	0	781	725	948	440	836	401
"TGIF2"	3406	20342	575	761	360	215	403	358	322	610	194	2138	483	1044	451	763	523	619
"TGIF2LX"	847	942	0	0	0	0	0	0	0	0	0	0	0	0	0	0	0	0
"TGIF2LY"	861	956	0	0	0	0	0	0	0	0	0	0	0	0	0	0	0	0
"TGM1"	2790	14096	27	0	13	14	0	0	172	66	0	0	15	2	21	9	39	7
"TGM2"	3932	36836	549	505	328	221	295	210	584	743	1040	1853	6183	1833	16589	16144	5461	7536
"TGM3"	2689	45113	0	0	0	0	0	0	0	0	0	0	0	0	0	0	0	0
"TGM4"	3011	39990	0	0	0	0	0	0	46	11	0	0	0	0	0	1	0	0
"TGM5"	2198	33682	0	0	0	0	0	0	15	41	0	0	0	0	0	0	0	0
"TGM6"	2305	51847	0	0	0	0	0	0	0	15	0	0	0	0	0	0	0	0
"TGM7"	2325	25976	0	0	0	0	0	0	18	0	0	0	0	0	0	0	0	0
"TGN"	5852	10229	2377	3643	631	1746	2009	1634	279	660	3412	2557	17794	3113	18745	14117	25510	16117
"TGOLN2"	6319	10229	2377	3643	631	1746	2009	1634	279	660	3412	2557	17794	3113	18745	14117	25510	16117
"TGS1"	3703	52214	176	140	65	111	82	58	286	248	9	238	521	638	642	491	698	385
"TH"	1923	7877	0	0	0	0	0	0	101	21	0	0	0	0	0	0	0	0
"TH1"	967	8636	369	67	221	148	24	43	3383	112	287	158	35605	43233	210	342	431	324
"TH1L"	2270	13877	1924	186	1131	793	93	93	3384	5379	1399	1808	35638	43286	37669	39669	38199	36617
"THADA"	6988	33824	1813	962	1154	659	503	459	1740	997	335	693	699	712	868	751	834	690
"THAP1"	2169	6658	2	0	2	0	0	0	0	9	0	0	60	91	366	257	84	299
"THAP10"	2030	11073	0	0	0	0	0	0	0	0	0	0	0	0	0	0	0	0
"THAP11"	1886	1886	15	25	0	15	14	11	23	14	0	0	842	404	825	302	1143	500
"THAP2"	4725	16635	901	1743	900	1	1724	19	11	443	0	0	263	345	102	252	76	164
"THAP3"	2099	10437	191	0	109	82	0	0	49	66	56	0	169	51	210	84	308	62
"THAP4"	2163	52836	986	72	572	414	9	63	659	199	439	109	607	452	648	467	855	554
"THAP5"	3428	7226	207	0	128	79	0	0	181	10	0	29	564	29	502	254	569	283
"THAP6"	3976	15506	35	0	23	12	0	0	191	0	0	33	380	303	343	187	368	198
"THAP7"	1246	2345	15	0	5	10	0	0	93	0	0	0	286	119	345	162	119	219
"THAP8"	1829	19779	38	0	23	15	0	0	173	40	0	0	51	69	131	58	156	81
"THAP9"	4043	19449	23	0	14	9	0	0	41	0	1	1	37	32	49	15	7	0
"THBD"	4032	4032	0	0	0	0	0	0	0	28	0	81	649	1317	670	1347	587	1069
"THBS1"	5811	16389	0	12	0	0	8	4	0	3	0	0	40	248	13	192	22	42
"THBS2"	5831	38263	0	0	0	0	0	0	81	0	0	0	0	0	0	0	0	0
"THBS3"	3168	12311	340	40	169	171	23	17	377	235	478	187	253	306	750	510	457	430
"THBS4"	3373	48116	14	0	0	14	0	0	28	0	0	0	0	0	0	0	0	3
"THEG"	1328	13952	0	0	0	0	0	0	24	20	0	0	0	0	0	0	0	0
"THEM4"	2212	36055	12	0	12	0	0	0	12	9	0	0	44	58	45	33	44	34
"THEM5"	1105	6597	0	0	0	0	0	0	11	0	0	0	0	0	0	0	0	0
"THEMIS"	4036	210398	0	0	0	0	0	0	0	8	0	0	0	0	0	0	0	0
"THG1L"	1310	8450	20	9	0	20	0	9	0	14	0	20	396	359	259	192	375	242
"THNSL1"	3771	10085	0	0	0	0	0	0	0	13	0	0	62	30	38	0	40	10
"THNSL2"	3657	15168	9	0	9	0	0	0	22	7	0	0	0	0	237	167	324	205
"THOC1"	2263	11882	1512	1020	802	710	533	487	808	469	180	744	681	2673	1240	963	1065	931
"THOC2"	5648	132493	2688	439	1618	1070	284	155	1957	441	109	546	2089	2500	2312	2261	2491	1612
"THOC3"	2063	8325	0	46	0	0	27	19	46	10	0	0	236	201	539	443	559	455
"THOC4"	1103	3753	189	155	106	83	65	90	98	131	19	200	467	956	827	768	1012	987
"THOC5"	2697	45489	113	31	45	68	28	3	191	32	28	36	417	455	480	450	705	467
"THOC6"	1433	3726	193	70	95	98	55	15	119	107	0	61	972	915	805	948	1207	555
"THOC7"	1015	30052	334	50	165	169	35	15	270	17	38	11	867	948	736	676	884	512
"THOP1"	2554	28086	198	16	94	104	0	16	437	244	33	7	254	215	766	629	700	639
"THPO"	1811	6161	0	0	0	0	0	0	11	14	0	0	2	1	0	0	0	0
"THRA"	2546	31057	17	0	9	8	0	0	376	153	0	0	299	191	593	519	409	382
"THRAP3"	4574	80940	6282	4931	3397	2885	2704	2227	2421	2702	2518	6755	5041	4581	5797	4054	6977	3572
"THRAP4"	1741	34539	349	104	192	157	69	35	526	175	228	101	1022	1087	1260	984	1624	985
"THRB"	7646	377668	0	27	0	0	0	27	26	24	0	0	0	13	0	0	0	0
"THRSP"	1175	4491	0	0	0	0	0	0	25	0	0	0	571	0	0	0	0	0
"THSD1"	3350	29326	0	0	0	0	0	0	0	0	0	0	0	0	4	0	0	0
"THSD4"	9162	641936	0	0	0	0	0	0	59	25	0	0	1009	237	4407	4137	2055	6139
"THSD7A"	6501	457653	0	0	0	0	0	0	0	0	0	0	19	32	3	0	0	0
"THSD7B"	5870	686827	0	0	0	0	0	0	0	10	0	0	0	0	0	0	0	0
"THTPA"	2201	3590	249	0	29	220	0	0	1273	302	368	268	712	728	171	711	1193	714
"THUMPD1"	4415	8210	1251	1970	675	576	1057	913	349	394	616	1123	1665	1810	770	567	907	582
"THUMPD2"	2356	43218	303	36	227	76	18	18	426	64	0	0	202	163	172	125	199	93
"THUMPD3"	3988	23758	610	1011	416	194	378	633	316	331	0	457	815	920	656	637	540	376
"THY1"	2400	5592	0	0	0	0	0	0	12	31	0	0	0	0	0	0	0	0
"THYN1"	1326	5087	37	0	22	15	0	0	102	0	0	0	182	197	290	243	508	242
"TIA1"	4795	39204	3029	1136	1541	1488	665	471	1606	572	1844	946	2883	2409	2992	1967	3638	1791
"TIAF1"	2090	2090	18	19	12	6	6	13	0	2	2	351	81	99	3475	0	5498	3417
"TIAL1"	4280	23565	2772	817	1490	1282	453	364	1191	363	742	647	1222	1307	2179	1464	1789	1350
"TIAM1"	7227	440556	44278	66306	24574	19704	35578	30728	15400	33385	22882	69909	6212	6946	6008	2315	7986	4615
"TIAM2"	7009	425027	10140	6367	5865	4275	3350	3017	4247	2507	3508	4470	1163	1335	1339	1004	1393	1018
"TICAM1"	2704	15800	2033	5181	1202	831	2726	2455	360	1890	1052	7669	1065	3917	1128	4475	1584	3721
"TICAM2"	3624	47532	1902	1696	1082	820	842	854	1124	1470	112	289	2860	4389	3787	2463	3512	2326
"TID1"	2251	30917	67	0	39	28	0	0	280	119	74	0	684	525	748	526	847	594
"TIE"	1144	8541	4	0	0	4	0	0	8	0	0	0	125	86	84	74	140	119
"TIE1"	3904	22116	11	0	3	8	0	0	54	21	3	0	346	297	228	181	382	267
"TIFA"	3074	10278	122	548	65	57	315	233	38	296	0	483	839	2166	503	1612	822	1557
"TIFAB"	1273	3531	2674	7636	1510	1164	4043	3593	137	2433	266	6301	2947	12022	0	2827	1733	2140
"TIGA1"	693	693	0	0	0	0	0	0	40	143	0	68	94	68	71	52	107	72
"TIGD1"	2449	2449	867	157	542	325	93	64	549	135	161	0	55	21	0	0	0	108
"TIGD2"	2084	2084	0	0	0	0	0	0	0	0	0	0	141	40	144	0	131	22
"TIGD3"	1966	2800	6	7	6	0	0	7	0	0	0	3	2	0	0	0	0	0
"TIGD4"	2433	10371	0	0	0	0	0	0	61	10	0	0	0	0	0	0	0	0
"TIGD5"	2265	2265	89	0	50	39	0	0	21	0	81	0	457	89	403	100	592	130
"TIGD6"	3991	7488	19	0	19	0	0	0	40	0	0	0	295	177	148	164	311	182
"TIGD7"	2568	2568	84	41	49	35	26	15	72	22	0	0	93	97	60	0	115	0
"TIGIT"	2864	16196	0	0	0	0	0	0	0	15	0	0	14	15	0	4	3	0
"TIL4"	220	3760	455	12460	224	231	6818	5642	551	8126	40	16633	110	9897	67	487	43	151
"TIM23"	1061	31248	248	201	120	128	107	94	97	127	0	205	66	545	409	413	456	323
"TIM9b"	2747	3235	644	531	373	271	304	227	669	428	198	334	1166	1316	1111	812	1272	739
"TIMD4"	1378	43975	0	0	0	0	0	0	13	0	0	0	0	0	0	0	3	0
"TIMELESS"	5167	33045	52	13	31	21	6	7	35	11	16	0	392	482	496	454	568	340
"TIMM10"	677	2298	0	0	0	0	0	0	19	0	0	0	264	224	290	287	314	292
"TIMM13"	1959	2255	232	163	130	102	64	99	81	6	142	184	717	410	725	111	226	159
"TIMM17A"	1663	15170	972	853	564	408	521	332	413	418	562	1145	2238	2677	1953	1944	2519	1956
"TIMM17B"	1028	4374	144	111	85	59	57	54	43	59	0	35	367	383	426	696	594	586
"TIMM22"	1675	5033	1704	412	5	1699	213	199	1464	118	612	221	214	93	254	192	317	191
"TIMM23"	2852	363205	1586	2978	836	750	1604	1374	1154	1988	170	3055	7879	13125	11362	23264	11473	13110
"TIMM44"	1845	16936	512	67	302	210	43	24	256	183	164	189	603	526	607	527	931	549
"TIMM50"	2583	10478	111	22	66	45	8	14	169	125	0	89	613	625	619	587	681	585
"TIMM8A"	1444	3315	0	0	0	0	0	0	0	0	0	0	121	818	62	86	9	73
"TIMM8B"	413	1589	0	0	0	0	0	0	38	0	0	0	1115	65	1196	1098	1525	623
"TIMM9"	1083	18863	25	0	23	2	0	0	19	0	0	0	66	51	75	61	119	178
"TIMP1"	1582	4100	0	0	0	0	0	0	32	109	0	123	1117	1992	1258	2885	837	1929
"TIMP2"	3656	72411	12118	1887	6559	5559	877	1010	4904	1200	14079	2186	3232	717	2401	2255	1742	1740
"TIMP3"	5490	62227	23	720	23	0	392	328	480	3016	37	1934	1338	1436	6618	10756	3339	5365
"TIMP4"	1429	6076	0	0	0	0	0	0	17	0	0	0	0	2	19	4	0	0
"TINAG"	2232	13904	0	0	0	0	0	0	0	0	0	0	0	0	0	0	0	0
"TINAGL1"	2247	11201	0	0	0	0	0	0	24	14	0	0	0	0	4	4	0	0
"TINF2"	2181	3029	130	655	39	91	454	201	80	66	165	76	1771	2806	2559	2403	3289	1519
"TIP49b"	1492	22028	31	0	16	15	0	0	140	48	0	0	387	286	432	417	526	405
"TIPARP"	4096	31816	3912	1270	2191	1721	734	536	1772	398	930	227	1611	845	1551	1012	1707	861
"TIPIN"	1288	20048	0	0	0	0	0	0	0	0	0	0	20	20	43	39	57	27
"TIPRL"	3040	23180	115	93	46	69	48	45	57	139	0	98	654	910	719	798	913	652
"TIRAP"	2354	11848	492	209	251	241	138	71	316	304	69	568	808	872	401	437	583	349
"TIRC7"	384	938	3309	300	1355	1954	136	164	335	193	1813	621	3386	2099	2976	2432	5167	2036
"TISP43"	2355	9899	0	0	0	0	0	0	6	0	0	0	0	0	0	0	0	0
"TJAP1"	3843	17081	1038	1216	581	457	716	500	677	863	297	2128	532	710	723	891	968	777
"TJP1"	7190	122349	3	0	0	3	0	0	0	0	0	0	25	18	950	3	18	6
"TJP2"	4624	81031	2562	11294	1505	1057	6246	5048	1241	4231	116	5498	1698	3041	1642	1878	3581	2420
"TJP3"	2967	42301	1	0	1	0	0	0	107	119	0	0	1	5	0	0	0	0
"TK1"	1658	13085	756	2314	409	347	1202	1112	759	2060	1883	3452	30	123	34	69	34	92
"TK2"	3774	40965	760	81	373	387	49	32	743	99	436	0	457	440	2006	290	2495	1433
"TKT"	2904	31346	3373	1414	1872	1501	801	613	1733	841	3443	1063	7697	4282	7621	7624	10951	6487
"TKTL1"	2664	34687	1	0	0	1	0	0	58	29	0	0	11	19	0	0	0	0
"TKTL2"	2801	2801	0	0	0	0	0	0	0	0	0	0	0	0	0	0	0	0
"TLCD1"	1023	1864	14	0	10	4	0	0	32	25	0	0	37	17	132	140	189	125
"TLE1"	5165	100760	69	46	51	18	9	37	274	315	0	91	389	329	852	781	719	546
"TLE2"	2727	31530	0	0	0	0	0	0	271	105	0	0	4	0	0	0	5	0
"TLE3"	5351	49715	4662	5537	2553	2109	2973	2564	1936	5045	2148	8206	786	1236	755	2071	972	781
"TLE4"	4865	154781	11243	12165	6194	5049	6580	5585	6304	6470	1944	7578	1468	1640	1866	1647	2356	1464
"TLE6"	2025	17648	0	0	0	0	0	0	127	77	0	0	0	0	0	0	0	0
"TLH6"	1257	2207	0	0	0	0	0	0	33	44	0	0	0	0	0	0	0	0
"TLK1"	5815	170079	7530	2539	4285	3245	1396	1143	4854	1832	1594	2743	1788	1699	2739	2096	2996	1988
"TLK2"	5523	136455	2144	1683	1277	867	926	757	1421	1218	590	2164	351	340	854	787	990	765
"TLL1"	6745	230585	0	0	0	0	0	0	0	0	0	0	0	0	0	0	0	0
"TLL2"	6774	149304	4	57	4	0	30	27	44	50	0	0	0	6	0	0	0	0
"TLN1"	8491	35060	7157	4338	3849	3308	2376	1962	2603	2667	3747	4003	24065	22358	23851	23254	29767	17936
"TLN2"	11703	197319	455	296	223	232	141	155	943	384	122	43	724	759	948	1003	1000	463
"TLR1"	2853	8536	355	0	209	146	0	0	433	30	33	0	48	1587	1460	590	47	704
"TLR10"	3569	10328	0	0	0	0	0	0	13	0	0	0	0	18	0	0	20	0
"TLR2"	3403	21801	2822	12460	1553	1269	6818	5642	1178	8126	599	16633	2259	9897	2339	9962	2143	5373
"TLR3"	3044	15943	0	0	0	0	0	0	0	0	0	0	18	17	26	13	108	10
"TLR4"	5773	13306	986	406	557	429	227	179	1034	307	45	56	3755	3171	4580	3230	3723	2325
"TLR5"	3437	33042	0	0	0	0	0	0	140	0	0	0	197	159	58	47	350	238
"TLR6"	2810	30032	1673	106	984	689	53	53	870	40	600	29	1	4	989	3	1728	8
"TLR7"	4994	23279	0	0	0	0	0	0	9	0	0	0	0	45	135	424	0	63
"TLR8"	4335	16530	126	186	92	34	107	79	229	211	0	40	3599	3715	2636	2101	3317	2170
"TLR9"	3870	5083	562	87	271	291	46	41	119	119	338	27	4026	2343	5380	3627	6139	4114
"TLS/FUS-ERG"	80	80	5604	4152	2984	2620	2236	1916	1803	1635	2424	2638	3368	3916	3361	2798	4863	1695
"TLT3"	1140	9393	0	0	0	0	0	0	0	0	0	0	0	0	0	0	3	0
"TLT4"	2050	9669	0	0	0	0	0	0	0	0	0	0	0	0	0	0	0	0
"TLT5"	214	214	0	0	0	0	0	0	0	0	0	0	0	0	0	0	0	0
"TLX1"	2109	6486	0	0	0	0	0	0	18	45	0	0	0	0	0	0	0	0
"TLX1NB"	1884	41826	0	0	0	0	0	0	83	25	0	0	1	1	0	0	0	0
"TLX2"	1755	2281	1	0	0	1	0	0	13	0	0	0	0	0	0	0	0	0
"TLX3"	1495	2851	0	0	0	0	0	0	0	0	0	0	0	0	0	0	0	0
"TM2D1"	1257	44378	2797	1736	1609	1188	891	845	1174	777	817	1919	671	768	606	430	644	379
"TM2D2"	3644	7715	62	80	39	23	49	31	81	43	0	23	1117	1287	1136	1201	1456	790
"TM2D3"	1904	10542	451	80	273	178	49	31	289	83	0	138	584	384	722	576	752	465
"TM4SF1"	3117	6691	0	0	0	0	0	0	0	0	0	0	0	0	0	0	0	0
"TM4SF18"	1158	12565	0	0	0	0	0	0	0	0	0	0	0	0	0	0	0	0
"TM4SF19"	1029	14841	74	15	46	28	15	0	242	69	92	58	2068	1644	1484	1299	848	760
"TM4SF2"	2033	127442	38	31	27	11	15	16	54	0	0	16	223	212	111	112	231	108
"TM4SF20"	2298	17150	0	0	0	0	0	0	0	0	0	0	0	0	0	0	0	0
"TM4SF4"	1433	28636	0	0	0	0	0	0	0	0	0	0	0	0	0	0	0	0
"TM4SF5"	713	11321	0	0	0	0	0	0	17	0	0	0	0	0	0	0	0	0
"TM6SF1"	1918	29788	6185	986	3458	2727	505	481	2759	211	4103	465	3715	2371	3271	1453	4496	1916
"TM6SF2"	1493	8902	0	0	0	0	0	0	66	11	0	0	0	0	0	0	0	0
"TM7SF1"	1566	30496	5427	21857	3054	2373	11735	10122	2134	13018	2056	15975	2238	4661	1972	3312	2036	1986
"TM7SF2"	2106	4334	36	10	12	24	4	6	66	20	7	0	72	47	63	73	114	68
"TM7SF3"	4353	42833	1205	52	686	519	39	13	895	10	100	0	1648	1423	1868	1472	1784	1190
"TM7SF4"	1956	16864	1109	359	614	495	218	141	1133	528	1761	876	3066	2397	7128	5404	4925	3893
"TM9SF1"	3866	25434	1567	446	878	689	280	166	773	412	412	473	2952	2942	2713	1949	4036	2312
"TM9SF2"	2406	61550	3967	843	2286	1681	408	435	2209	657	960	735	5858	6608	6803	6066	8098	5145
"TM9SF3"	6154	68943	4866	6796	2753	2113	3635	3161	2295	3007	591	5007	5622	6938	5884	5548	6226	4594
"TM9SF4"	4050	57524	2324	1951	1320	1004	1110	841	1230	1353	843	2600	1804	1838	1913	1703	2426	1672
"TMABADH"	2562	36376	378	32	212	166	18	14	248	79	100	28	1833	1764	2079	1860	2224	1386
"TMBIM1"	2956	12657	2358	3380	1250	1108	1766	1614	897	1846	1202	2954	1612	6915	1949	2708	8800	1845
"TMBIM4"	2262	33091	6197	3966	3436	2761	2193	1773	3142	1745	3851	3067	3979	4205	2788	2384	3325	2050
"TMBIM6"	3589	23125	2651	2840	1448	1203	1543	1297	903	1202	880	2578	37461	41201	34081	34428	39151	28770
"TMC1"	3225	314552	0	0	0	0	0	0	8	0	0	0	0	3	0	0	3	0
"TMC2"	3189	105179	0	0	0	0	0	0	8	0	0	0	1	0	0	0	0	0
"TMC3"	3327	41660	0	0	0	0	0	0	0	0	0	0	5	2	0	0	0	0
"TMC4"	2493	13110	4	0	4	0	0	0	174	66	0	0	0	1	38	22	127	76
"TMC5"	4936	88377	4	0	4	0	0	0	15	0	0	0	0	0	0	0	6	0
"TMC6"	3247	15856	3695	1049	1966	1729	483	566	1414	886	4964	1667	3222	2901	5999	4589	7310	4105
"TMC7"	4511	79653	0	0	0	0	0	0	0	0	0	0	0	0	0	0	0	0
"TMC8"	4435	12192	537	145	280	257	93	52	537	284	284	347	583	642	1117	827	1321	745
"TMCC1"	6157	245768	7781	2216	4422	3359	1346	870	5187	1765	2885	2478	932	1041	772	677	836	602
"TMCC2"	3798	45381	0	416	0	0	262	154	368	1220	0	1899	260	886	269	621	467	495
"TMCC3"	5867	83426	15	0	15	0	0	0	0	0	0	0	157	123	109	50	38	0
"TMCO1"	4642	44598	178	28	115	63	10	18	154	14	19	49	1430	1707	1240	1174	1443	1108
"TMCO2"	743	3794	0	0	0	0	0	0	0	0	0	0	0	0	0	0	0	0
"TMCO3"	3097	59236	2562	179	1455	1107	118	61	1845	121	751	118	1618	1599	2815	2374	3009	1844
"TMCO4"	2989	117705	2315	551	1269	1046	347	204	1754	639	624	1214	669	733	643	549	835	608
"TMCO5A"	1951	33100	0	0	0	0	0	0	0	0	0	0	0	0	0	0	0	0
"TMCO6"	1957	4098	0	6	0	0	6	0	103	13	0	0	390	368	368	91	486	328
"TMCO7"	4834	241576	3683	1637	2131	1552	826	811	2025	1012	1116	2354	1010	812	866	808	1434	906
"TMED1"	1359	3869	434	32	238	196	32	0	155	168	55	0	1487	462	1674	528	749	570
"TMED10"	4149	45180	501	18	329	172	0	18	392	23	0	140	5462	5446	5431	4297	5535	3751
"TMED2"	2123	13607	30	141	0	30	80	61	107	103	0	40	4101	5054	4465	4211	4334	3122
"TMED3"	1390	11699	984	68	518	466	48	20	667	97	256	217	641	514	1171	1011	1156	989
"TMED4"	1959	2314	495	124	294	201	103	21	208	116	247	311	192	1904	337	348	451	280
"TMED5"	4007	28837	3455	4092	1994	1461	2243	1849	1365	1606	509	2245	641	316	1649	5660	1481	952
"TMED6"	910	8531	177	7	124	53	7	0	57	0	0	18	44	578	0	0	129	0
"TMED7"	3762	12669	439	288	259	180	166	122	328	273	36	120	345	2994	552	512	300	281
"TMED8"	3509	42032	252	20	149	103	0	20	388	17	56	7	1132	1281	1015	710	1080	607
"TMED9"	1396	3886	298	55	156	142	14	41	98	92	41	148	3029	2515	4121	3168	4836	3205
"TMEFF1"	2440	135728	444	2224	216	228	1217	1007	49	777	0	1240	929	2929	540	1849	769	1231
"TMEFF2"	3762	18177	0	0	0	0	0	0	0	0	0	0	0	0	0	0	0	0
"TMEM1"	1203	9576	982	771	547	435	442	329	420	463	528	1198	351	537	618	505	714	427
"TMEM100"	2255	12494	0	0	0	0	0	0	0	0	0	0	0	0	0	0	0	0
"TMEM101"	1542	3790	20	15	20	0	15	0	67	15	0	0	454	396	541	343	209	477
"TMEM102"	2074	2181	167	21	101	66	0	21	50	33	134	0	954	510	650	318	1187	531
"TMEM104"	4757	63300	839	26	526	313	16	10	1663	522	80	222	618	527	1045	815	1255	895
"TMEM105"	3320	19402	0	0	0	0	0	0	101	69	0	0	0	0	0	0	0	0
"TMEM106A"	2826	7697	15281	18597	8592	6689	9818	8779	5062	10943	13246	22919	3857	8199	2340	4149	2958	2432
"TMEM106B"	6522	26043	64	0	53	11	0	0	76	0	0	0	797	790	731	434	772	454
"TMEM106C"	1595	5332	0	0	0	0	0	0	8	0	0	0	72	74	54	36	85	52
"TMEM107"	2384	2656	2510	0	2473	37	0	0	726	15	46	0	166	86	199	149	266	144
"TMEM108"	5083	264858	0	0	0	0	0	0	11	0	0	0	0	0	0	0	0	0
"TMEM109"	2390	9544	22	0	0	22	0	0	67	28	0	0	1841	1531	1987	1675	2449	1650
"TMEM11"	1691	16647	546	96	269	277	64	32	381	326	275	590	405	293	500	359	598	354
"TMEM110"	1585	57650	1098	398	554	544	216	182	1376	301	420	239	966	1131	1066	924	1402	966
"TMEM111"	1897	18177	477	324	269	208	194	130	260	305	49	568	1623	2322	1995	1365	1953	970
"TMEM114"	645	2725	0	0	0	0	0	0	8	0	0	0	0	0	0	0	0	0
"TMEM115"	2097	4761	88	26	60	28	26	0	139	166	167	109	740	500	834	680	759	761
"TMEM116"	1729	81834	72	0	58	14	0	0	84	15	0	0	124	105	67	67	145	83
"TMEM117"	2704	553580	10024	7685	5609	4415	4316	3369	3702	3001	294	1994	138	149	280	218	211	216
"TMEM119"	2701	8272	0	0	0	0	0	0	112	40	0	0	1	0	0	0	0	0
"TMEM120A"	1584	7838	118	32	82	36	11	21	114	99	51	62	353	376	1357	2071	385	468
"TMEM120B"	7520	69316	1211	3372	729	482	1693	1679	820	4632	690	14038	1956	9587	1135	7406	2417	7592
"TMEM121"	1521	3588	0	0	0	0	0	0	0	0	0	0	0	0	0	0	0	0
"TMEM123"	3593	56719	16651	98531	9251	7400	53615	44916	4178	36423	4562	50613	18734	1999	15533	18271	16607	15433
"TMEM125"	1853	3978	0	0	0	0	0	0	27	0	0	0	0	0	0	0	0	0
"TMEM126A"	723	8536	217	79	125	92	48	31	171	54	30	52	419	381	411	328	508	334
"TMEM126B"	1368	6468	196	0	116	80	0	0	99	0	0	0	563	278	666	431	717	412
"TMEM127"	4210	15420	2276	1106	1287	989	616	490	949	710	1959	1675	4936	4408	4866	3939	6182	4017
"TMEM128"	5204	12686	78	0	28	50	0	0	53	11	0	18	508	414	520	335	421	243
"TMEM129"	2840	5406	400	15	234	166	15	0	173	29	446	46	1302	821	1601	1162	2323	1304
"TMEM130"	3072	23563	428	81	238	190	58	23	424	196	811	315	1818	1078	1304	1043	2236	1591
"TMEM131"	6681	239553	23065	20244	12911	10154	11026	9218	11128	11669	6804	16806	3672	3753	5207	5390	6875	3501
"TMEM132A"	4005	7570	5906	729	3217	2689	397	332	506	1166	1337	1572	1392	76	26	3568	2868	3062
"TMEM132B"	7587	332429	0	0	0	0	0	0	54	0	0	0	0	0	0	0	0	0
"TMEM132C"	4859	293174	0	0	0	0	0	0	153	0	0	0	0	0	0	0	0	0
"TMEM132D"	5786	831943	0	0	0	0	0	0	118	20	0	0	0	0	0	0	0	0
"TMEM132E"	4378	58570	0	0	0	0	0	0	87	48	0	0	0	0	0	0	0	0
"TMEM133"	1856	1856	0	0	0	0	0	0	0	0	0	0	0	0	0	0	0	0
"TMEM134"	1150	2611	133	7	75	58	0	7	83	0	232	13	434	295	415	374	661	404
"TMEM135"	3608	285505	1546	518	841	705	204	314	1584	668	0	101	625	822	631	542	655	562
"TMEM136"	4287	8374	0	0	0	0	0	0	0	0	0	0	1	0	0	0	0	0
"TMEM138"	3471	6826	475	415	235	240	235	180	228	270	42	942	716	1013	452	1153	861	870
"TMEM139"	2365	3079	0	0	0	0	0	0	22	9	0	0	0	0	0	0	0	0
"TMEM140"	2056	18202	948	1177	536	412	634	543	584	626	530	682	2212	1893	2051	1713	441	269
"TMEM141"	862	1993	31	0	20	11	0	0	23	26	7	0	218	247	421	390	488	305
"TMEM143"	2257	31572	60	0	24	36	0	0	215	13	0	115	131	99	164	121	217	126
"TMEM144"	3330	45039	507	70	304	203	44	26	490	13	30	29	266	252	597	429	409	286
"TMEM145"	1794	11739	0	0	0	0	0	0	72	23	0	0	1	0	0	0	0	0
"TMEM146"	2534	58055	0	0	0	0	0	0	94	12	0	1	1	0	0	0	0	0
"TMEM147"	993	1885	20	0	20	0	0	0	45	50	0	0	625	766	1146	721	1191	870
"TMEM149"	1940	6186	537	125	379	158	64	61	387	196	508	165	3214	2904	3910	2305	5274	3471
"TMEM14A"	1017	15501	0	16	0	0	11	5	0	0	0	0	95	112	35	26	101	27
"TMEM14B"	1591	104993	1254	101	726	528	48	53	1096	61	588	85	590	552	799	315	939	657
"TMEM14C"	1069	6220	246	20	137	109	20	0	109	4	0	0	1562	1543	1493	1346	1995	1527
"TMEM14E"	1293	1293	93931	58528	58196	35735	32453	26075	22924	22590	2972	20307	0	0	0	0	0	0
"TMEM150A"	2329	4123	86	0	11	75	0	0	197	81	41	0	522	291	594	466	690	445
"TMEM150B"	1203	14586	1322	2392	697	625	1285	1107	402	1261	951	2580	200	428	624	2190	431	1015
"TMEM150C"	2023	77908	0	0	0	0	0	0	0	8	0	0	0	0	0	0	0	0
"TMEM151A"	2530	4762	0	0	0	0	0	0	27	39	0	0	0	0	0	0	0	0
"TMEM151B"	4622	8704	210	19	121	89	5	14	200	79	28	18	364	357	359	288	478	328
"TMEM154"	3092	53922	52	9	23	29	0	9	185	10	0	20	107	76	66	77	75	38
"TMEM155"	2322	6257	0	0	0	0	0	0	0	0	0	0	0	0	0	0	0	0
"TMEM156"	1864	65600	0	0	0	0	0	0	0	0	0	0	0	6	0	0	0	0
"TMEM158"	1859	1859	0	0	0	0	0	0	0	0	0	0	122	80	0	92	51	0
"TMEM159"	2013	22025	0	0	0	0	0	0	18	0	0	0	364	271	203	96	355	159
"TMEM160"	657	2716	0	0	0	0	0	0	0	16	0	0	106	151	168	168	232	295
"TMEM161A"	1832	18838	98	5	50	48	5	0	184	83	0	0	442	383	459	390	562	491
"TMEM161B"	2738	73643	1031	72	603	428	54	18	885	51	135	149	406	347	471	326	541	350
"TMEM163"	1900	263242	80	13	51	29	0	13	105	71	0	0	0	0	0	0	0	0
"TMEM164"	1314	170413	5565	1477	3071	2494	763	714	3715	1368	2158	1530	2740	2762	3779	3492	3883	2572
"TMEM165"	2075	30254	7795	19233	4418	3377	9796	9437	3533	5646	5339	24977	3285	7117	3121	4855	3323	4285
"TMEM167A"	4589	24607	1084	525	635	449	287	238	588	285	0	277	3232	3598	3212	1642	1946	2189
"TMEM167B"	2752	6152	251	174	167	84	99	75	119	122	0	95	1887	1956	1677	1498	2287	1392
"TMEM168"	4046	24691	2069	1213	1255	814	638	575	1243	728	760	1108	1567	1572	1437	646	705	779
"TMEM169"	3464	20918	0	0	0	0	0	0	40	0	0	0	0	0	0	0	0	0
"TMEM16A"	1066	18134	0	0	0	0	0	0	68	0	0	0	0	0	0	0	0	0
"TMEM17"	2471	5844	0	0	0	0	0	0	0	0	0	0	3	0	0	0	0	0
"TMEM170A"	4802	21172	741	425	376	365	255	170	454	200	111	366	129	1119	669	439	845	521
"TMEM170B"	8364	45247	250	0	149	101	0	0	489	0	43	0	1003	634	1044	433	961	379
"TMEM171"	1270	11258	0	0	0	0	0	0	0	0	0	0	0	0	0	0	0	0
"TMEM173"	1695	6744	0	0	0	0	0	0	25	0	0	0	34	50	55	42	78	85
"TMEM174"	1758	1947	0	0	0	0	0	0	0	0	0	0	0	0	0	0	0	0
"TMEM175"	2278	26181	383	130	116	267	72	58	709	369	418	146	251	825	651	664	1998	559
"TMEM176A"	1045	4356	0	0	0	0	0	0	16	0	0	35	68	52	1154	1097	214	146
"TMEM176B"	1434	10072	138	43	71	67	25	18	0	0	200	190	195	156	3286	3009	574	440
"TMEM177"	2097	44450	8	0	8	0	0	0	25	0	0	0	63	9	78	0	86	0
"TMEM178"	1630	52010	0	0	0	0	0	0	0	0	0	0	0	0	0	0	0	0
"TMEM179"	1626	10679	0	0	0	0	0	0	35	0	0	0	0	0	0	0	0	0
"TMEM179B"	1047	2999	294	18	167	127	18	0	177	28	107	15	1510	1231	1294	910	1599	1058
"TMEM18"	2127	9466	294	130	160	134	90	40	103	105	0	30	122	167	388	337	472	273
"TMEM180"	2842	15632	27	4	11	16	0	4	260	35	62	0	140	138	111	85	150	72
"TMEM181"	5413	99000	5258	2641	3000	2258	1398	1243	2335	1201	2763	2305	1197	1495	1383	1174	1502	883
"TMEM182"	3591	55648	0	0	0	0	0	0	0	0	0	0	0	0	3	0	0	0
"TMEM183A"	2393	16665	390	146	203	187	99	47	251	127	270	164	515	713	1917	1639	2252	1276
"TMEM183B"	2228	16665	390	146	203	187	99	47	251	127	270	164	515	713	1917	1639	2252	1276
"TMEM184A"	6894	8748	384	144	139	245	90	54	180	107	203	153	898	1004	1190	1311	1535	1370
"TMEM184B"	3635	53374	478	139	249	229	89	50	740	875	105	1023	616	666	1031	969	1430	1036
"TMEM184C"	2981	18133	278	11	148	130	0	11	130	0	36	0	1260	1261	918	766	1031	633
"TMEM185A"	2820	35353	372	29	163	209	0	29	268	33	11	31	1360	1560	1302	1341	1507	1074
"TMEM186"	1449	2469	39	0	25	14	0	0	52	10	0	0	153	103	203	92	282	91
"TMEM187"	1669	10657	0	3	0	0	3	0	45	12	0	0	155	108	160	103	177	124
"TMEM188"	2103	11811	126	0	60	66	0	0	109	7	0	18	551	345	742	267	686	292
"TMEM189"	2301	30063	999	129	537	462	101	28	638	358	143	122	1009	756	1112	759	1126	872
"TMEM189-UBE2V1"	2924	72674	3712	1876	2085	1627	1051	825	1900	1335	1317	1885	4236	4124	3983	3423	4767	3561
"TMEM19"	4662	17961	164	0	54	110	0	0	136	0	53	1	1649	1775	1256	839	1403	897
"TMEM190"	598	1410	0	0	0	0	0	0	0	0	0	0	1	0	0	0	0	0
"TMEM192"	4500	36795	211	65	109	102	27	38	97	41	81	79	289	306	1330	1140	1122	749
"TMEM194A"	5625	23149	1538	3189	870	668	1751	1438	848	297	330	1439	356	963	1845	4202	2474	2610
"TMEM194B"	3645	27850	276	34	181	95	21	13	234	0	0	0	111	129	74	78	62	53
"TMEM195"	2488	361699	0	0	0	0	0	0	0	0	0	0	0	0	0	0	0	0
"TMEM196"	3367	53467	0	0	0	0	0	0	0	0	0	0	0	0	0	0	0	0
"TMEM198"	2413	6932	0	0	0	0	0	0	66	54	0	0	0	0	0	0	0	0
"TMEM199"	1454	4403	281	65	147	134	41	24	229	106	42	27	685	676	792	587	931	641
"TMEM2"	6547	85520	572	2829	367	205	1563	1266	284	1375	25	883	1125	1986	1430	2259	1380	1416
"TMEM20"	2405	8762	0	0	0	0	0	0	0	13	0	0	2	17	6	0	11	3
"TMEM200A"	5021	5948	0	0	0	0	0	0	0	8	0	0	0	0	0	0	0	0
"TMEM200B"	2463	4469	14	20	14	0	0	20	0	14	0	22	790	796	347	311	478	357
"TMEM200C"	1921	1921	0	0	0	0	0	0	0	0	0	0	0	0	0	0	0	0
"TMEM201"	3854	16031	226	0	138	88	0	0	396	175	104	0	346	222	365	131	539	224
"TMEM202"	1300	10041	0	0	0	0	0	0	0	0	0	0	0	0	0	0	0	0
"TMEM203"	1555	1555	31	0	18	13	0	0	0	13	0	0	1002	732	981	585	0	772
"TMEM204"	1519	21587	33	0	19	14	0	0	428	111	0	0	0	0	0	1	79	46
"TMEM205"	1298	3531	69	30	39	30	15	15	39	25	0	0	353	332	411	161	466	378
"TMEM206"	2151	50450	3543	88	1935	1608	50	38	1915	45	1851	10	341	317	631	529	813	516
"TMEM207"	1453	21223	0	9	0	0	0	9	0	0	0	0	0	0	0	0	0	0
"TMEM208"	826	2168	684	40	16	668	22	18	0	247	0	63	324	223	417	351	406	342
"TMEM209"	3560	40785	127	9	78	49	9	0	53	10	16	0	424	428	465	274	433	243
"TMEM211"	510	4108	0	0	0	0	0	0	0	0	0	0	0	0	0	0	0	0
"TMEM212"	1866	15951	0	0	0	0	0	0	0	0	0	0	0	0	0	0	0	0
"TMEM213"	3391	8030	0	0	0	0	0	0	0	0	0	0	0	0	0	0	0	0
"TMEM214"	3056	8792	356	144	185	171	74	70	229	114	34	117	1032	970	1590	1190	1841	989
"TMEM215"	5383	5702	0	0	0	0	0	0	0	0	0	0	0	0	0	0	0	0
"TMEM216"	1280	6460	0	0	0	0	0	0	0	0	0	0	112	88	169	110	183	89
"TMEM217"	1994	40514	321	5690	185	136	3085	2605	137	1476	0	2404	129	379	78	196	152	163
"TMEM218"	2105	6806	28	124	4	24	86	38	167	72	20	16	159	316	409	327	493	338
"TMEM219"	1331	10377	250	337	188	62	197	140	202	292	68	130	1431	1832	1078	1028	1296	572
"TMEM22"	2060	36873	25	0	16	9	0	0	111	0	0	1	48	52	49	14	74	33
"TMEM220"	3097	17008	23	0	13	10	0	0	0	0	0	0	61	13	0	0	0	0
"TMEM222"	1619	14256	203	12	116	87	0	12	228	262	35	130	534	520	1064	1166	589	337
"TMEM223"	939	1701	249	0	169	80	0	0	212	43	159	127	1561	1072	990	576	1286	844
"TMEM224"	863	12483	1322	2392	697	625	1285	1107	402	1261	951	2580	199	410	624	2190	431	1015
"TMEM225"	1100	2707	0	0	0	0	0	0	0	0	0	0	0	0	0	0	0	0
"TMEM229A"	2554	2554	0	0	0	0	0	0	0	0	0	0	0	0	0	0	0	0
"TMEM229B"	4070	45039	9	0	9	0	0	0	333	114	52	0	21	267	347	196	323	202
"TMEM231"	3019	18155	0	0	0	0	0	0	0	0	0	0	9	0	0	5	11	3
"TMEM232"	4223	295872	0	0	0	0	0	0	13	0	0	0	0	0	0	0	0	0
"TMEM25"	2538	4748	0	0	0	0	0	0	30	0	0	0	30	49	76	58	98	60
"TMEM26"	5161	46809	0	0	0	0	0	0	12	4	0	0	24	30	328	165	36	69
"TMEM27"	1574	37705	0	0	0	0	0	0	0	9	0	0	0	0	1	0	0	0
"TMEM29"	2946	11159	158	52	81	77	31	21	16	16	0	0	47	28	1540	800	2173	872
"TMEM30A"	4551	31996	1786	1034	927	859	561	473	773	893	329	1392	7685	8550	9659	8585	9050	6498
"TMEM30B"	4441	4441	0	0	0	0	0	0	0	0	0	0	0	0	0	0	0	0
"TMEM30C"	374	8360	9	42	9	0	27	15	12	0	0	0	0	0	0	0	0	0
"TMEM31"	733	3123	0	0	0	0	0	0	0	0	0	0	0	0	0	0	0	0
"TMEM33"	7724	25689	1736	834	968	768	377	457	755	299	324	273	2487	2636	2312	1994	2463	1792
"TMEM35"	2070	17519	0	0	0	0	0	0	0	0	0	0	0	0	0	0	0	0
"TMEM37"	1687	6650	0	0	0	0	0	0	14	0	0	0	97	25	366	241	342	170
"TMEM38A"	1629	27878	0	0	0	0	0	0	48	36	0	0	8	0	10	0	15	11
"TMEM38B"	2082	80621	24	0	24	0	0	0	69	12	0	14	342	414	504	489	433	359
"TMEM39A"	3076	32772	7428	20900	2900	4528	9398	11502	3363	11554	415	13659	1504	16781	707	1777	1016	1086
"TMEM39B"	1828	29964	284	13	187	97	8	5	279	50	26	126	316	236	335	229	438	272
"TMEM40"	1810	35566	0	0	0	0	0	0	26	11	0	0	0	0	0	0	0	0
"TMEM41A"	2832	9458	112	89	89	23	48	41	130	25	0	19	342	45	343	242	381	192
"TMEM41B"	3957	34093	1631	1890	935	696	1031	859	598	777	710	1853	1195	1689	869	911	1001	862
"TMEM42"	972	3746	44	0	30	14	0	0	36	4	0	0	259	153	276	153	384	170
"TMEM43"	3354	18742	1942	599	1063	879	315	284	774	489	1013	715	3078	3005	2633	2238	3722	2167
"TMEM44"	2463	45712	316	4	197	119	0	4	604	74	227	103	291	372	305	177	389	131
"TMEM45A"	1570	84824	0	0	0	0	0	0	0	0	0	0	0	0	0	0	0	0
"TMEM45B"	2592	9832	6360	524	3590	2770	250	274	2203	88	3162	219	2762	2136	1050	676	2417	887
"TMEM47"	4055	30224	0	0	0	0	0	0	0	0	0	0	0	0	0	0	0	0
"TMEM48"	2537	70787	71	4	45	26	4	0	126	29	0	0	495	549	517	407	551	375
"TMEM49"	2184	133089	9000	4888	5096	3904	2642	2246	4485	2751	3705	7351	5473	3820	7260	3956	7393	3317
"TMEM5"	1622	29252	23	0	14	9	0	0	38	0	0	11	180	151	195	182	232	138
"TMEM50A"	2285	24041	228	117	169	59	65	52	193	61	39	117	3974	4705	4059	3579	4633	3469
"TMEM50B"	3101	47490	4496	4551	2794	1702	2285	2266	1277	3085	1635	7876	6375	10847	4840	10113	6025	9237
"TMEM51"	2019	67947	5764	2958	3128	2636	1605	1353	3251	1022	4473	1497	867	490	1081	1046	1092	645
"TMEM52"	1120	1209	0	0	0	0	0	0	11	37	0	0	0	0	0	0	0	0
"TMEM53"	1602	20599	1133	248	620	513	163	85	780	257	613	320	1972	1069	2545	1455	3147	1678
"TMEM54"	999	6759	306	4219	187	119	2211	2008	25	6	0	5468	2	1659	0	1081	0	1188
"TMEM55A"	2408	46701	3679	664	2128	1551	353	311	1296	83	366	871	292	384	519	213	703	494
"TMEM55B"	1721	3627	528	172	292	236	103	69	182	88	219	91	1065	2088	1409	558	4386	864
"TMEM56"	7065	80166	302	0	185	117	0	0	234	0	135	12	478	165	260	86	231	72
"TMEM57"	3947	69310	866	31	441	425	15	16	593	14	100	48	612	605	829	541	890	581
"TMEM59"	1903	16337	926	84	506	420	72	12	503	76	144	38	3241	3169	4003	3923	4080	2672
"TMEM59L"	1621	8163	0	0	0	0	0	0	26	9	0	0	0	0	0	0	0	0
"TMEM60"	874	4703	102	0	45	57	0	0	108	44	0	0	516	315	480	227	713	303
"TMEM61"	1099	11502	0	0	0	0	0	0	16	0	0	0	0	0	0	0	0	0
"TMEM62"	2777	51616	681	0	439	242	0	0	449	76	48	0	411	226	390	213	448	293
"TMEM63A"	4099	36810	2829	755	1598	1231	457	298	1627	587	2132	897	1791	766	1335	2375	1499	2145
"TMEM63B"	3222	27881	586	198	309	277	82	116	495	614	222	723	572	868	697	945	917	857
"TMEM63C"	5426	77738	0	0	0	0	0	0	294	88	0	0	7	0	3	0	126	13
"TMEM64"	4822	23912	24	27	12	12	17	10	0	36	0	14	384	496	374	482	351	387
"TMEM65"	4312	61781	1648	71	933	715	58	13	1073	117	280	76	357	474	302	213	364	268
"TMEM66"	1982	20019	1377	264	663	714	166	98	673	118	303	131	7994	9337	6771	3784	7703	3320
"TMEM67"	4753	63276	4	0	0	4	0	0	25	15	0	0	10	13	7	16	14	0
"TMEM68"	2421	24269	36	0	22	14	0	0	58	0	0	0	317	339	299	207	309	226
"TMEM69"	1474	6263	26	0	12	14	0	0	207	26	0	48	654	757	593	528	839	489
"TMEM70"	2042	6583	28	10	22	6	0	10	50	0	0	0	1420	1181	1616	918	1566	1064
"TMEM71"	2089	50722	2074	186	1095	979	117	69	1722	131	84	56	730	1451	714	629	1193	1367
"TMEM72"	1090	23880	5	22	2	3	15	7	84	56	0	0	0	2	0	3	0	0
"TMEM74"	2089	4426	0	0	0	0	0	0	25	0	0	0	0	0	0	0	0	0
"TMEM75"	2166	2166	42	0	42	0	0	0	50	8	0	25	0	0	0	0	0	0
"TMEM79"	2231	9533	156	0	90	66	0	0	131	0	34	8	144	48	1396	32	56	56
"TMEM80"	1626	8513	391	28	196	195	14	14	318	82	0	0	304	156	336	164	687	209
"TMEM81"	1332	1332	0	43	0	0	23	20	0	24	0	40	33	0	39	0	28	43
"TMEM82"	1524	5560	0	0	0	0	0	0	40	24	0	0	0	0	0	0	0	0
"TMEM84"	2528	14973	0	0	0	0	0	0	16	16	0	0	0	0	0	0	0	0
"TMEM85"	1178	1512	62	144	37	25	91	53	62	65	0	0	2577	2833	1424	1264	1555	1366
"TMEM86A"	3585	5983	104	0	52	52	0	0	126	0	209	0	397	215	926	357	920	430
"TMEM86B"	1643	2521	347	0	238	109	0	0	121	29	0	0	42	2	98	0	56	0
"TMEM87A"	3024	63028	1973	864	1124	849	514	350	979	536	331	605	1938	1754	1541	1331	926	1248
"TMEM87B"	5231	64097	1054	58	559	495	37	21	800	47	122	23	1465	1443	1492	1052	1483	975
"TMEM88"	874	1033	1600	34413	985	615	18114	16299	34	16749	0	42580	0	883	0	12	0	2925
"TMEM88B"	493	1660	0	0	0	0	0	0	1	0	0	0	0	0	0	0	0	0
"TMEM89"	481	915	0	0	0	0	0	0	22	0	0	0	0	0	0	1	0	0
"TMEM8A"	3668	11175	690	155	394	296	92	63	293	140	711	104	1922	1478	3058	2249	3514	2270
"TMEM8B"	3726	25332	2	0	0	2	0	0	80	12	0	2	0	0	0	0	3	0
"TMEM8C"	670	10209	0	0	0	0	0	0	145	59	0	0	0	0	0	0	0	0
"TMEM9"	1964	19669	0	0	0	0	0	0	128	13	0	0	311	278	414	325	181	314
"TMEM90A"	2611	20211	0	0	0	0	0	0	34	0	0	0	0	0	0	0	0	0
"TMEM90B"	2441	197334	0	0	0	0	0	0	222	54	0	0	0	0	0	0	0	0
"TMEM91"	1873	7549	804	148	472	332	50	98	697	324	795	521	3385	2715	4360	4062	5019	3918
"TMEM92"	2686	7009	0	0	0	0	0	0	24	0	0	0	0	0	0	0	0	0
"TMEM93"	790	874	11	0	0	11	0	0	102	0	0	0	645	292	439	459	494	0
"TMEM95"	1176	2043	0	0	0	0	0	0	28	0	0	0	0	0	0	0	0	0
"TMEM97"	2570	9591	0	0	0	0	0	0	41	0	0	0	0	150	91	25	29	128
"TMEM98"	1801	13739	0	0	0	0	0	0	12	0	0	0	0	0	0	0	0	0
"TMEM99"	2068	17154	0	0	0	0	0	0	14	0	0	0	27	34	74	53	80	45
"TMEM9B"	1758	17151	175	64	104	71	26	38	144	56	13	111	2295	2254	653	518	742	465
"TMF1"	6903	32506	786	239	439	347	126	113	579	220	130	364	1367	1629	1569	1243	1641	865
"TMIE"	1865	9592	0	0	0	0	0	0	50	14	0	0	0	0	0	0	0	0
"TMIGD1"	1208	17701	0	0	0	0	0	0	0	0	0	0	0	0	0	0	0	0
"TMIGD2"	1267	10201	0	0	0	0	0	0	43	15	0	0	1	0	0	0	0	0
"TML1"	3583	29375	0	0	0	0	0	0	25	0	0	0	0	0	0	0	0	0
"TMLHE"	2863	122846	7219	792	4187	3032	462	330	3963	299	3019	685	349	462	414	567	728	500
"TMOD1"	2853	99611	69	32	40	29	19	13	65	25	0	34	0	0	0	0	422	204
"TMOD2"	9275	64800	0	126	0	0	74	52	21	234	0	165	52	234	10	19	23	9
"TMOD3"	2125	79957	5740	3403	3275	2465	1847	1556	2958	2132	1995	3439	4343	4635	3388	2522	4030	2306
"TMOD4"	1331	6085	50	0	31	19	0	0	47	0	0	0	0	0	3	1	24	0
"TMPIT"	670	1003	62	17	26	36	11	6	22	58	51	0	96	209	254	144	164	152
"TMPO"	3379	34714	850	100	462	388	58	42	684	63	64	0	2396	2114	1944	1324	1892	1159
"TMPPE"	3994	6408	1165	257	638	527	155	102	603	132	813	186	858	284	0	270	453	7
"TMPRSS11A"	2438	53215	0	0	0	0	0	0	0	0	0	0	0	0	0	0	0	0
"TMPRSS11B"	2654	19042	0	0	0	0	0	0	0	0	0	0	0	0	0	0	0	0
"TMPRSS11D"	2786	63117	0	0	0	0	0	0	84	0	0	0	0	0	0	0	0	0
"TMPRSS11E"	2145	50156	0	0	0	0	0	0	0	0	0	0	0	0	0	0	0	0
"TMPRSS11F"	2087	76673	0	0	0	0	0	0	0	0	0	0	0	0	0	0	0	0
"TMPRSS12"	3336	44962	0	0	0	0	0	0	0	0	0	0	1	0	0	0	0	0
"TMPRSS13"	3404	28757	643	541	376	267	358	183	311	468	4	125	49	99	157	99	89	33
"TMPRSS2"	3255	43515	0	0	0	0	0	0	48	0	0	0	0	0	0	0	0	0
"TMPRSS3"	3368	42803	1	0	1	0	0	0	78	52	0	0	0	0	0	0	0	0
"TMPRSS4"	3538	42829	1	0	1	0	0	0	19	23	0	0	0	0	0	0	0	0
"TMPRSS5"	2326	18801	0	0	0	0	0	0	13	10	0	1	0	0	2	1	0	0
"TMPRSS6"	3209	38216	139	0	56	83	0	0	413	237	0	45	0	2	0	0	0	0
"TMPRSS7"	2639	41653	0	0	0	0	0	0	0	0	0	0	0	0	0	0	0	0
"TMPRSS9"	3196	36303	340	102	157	183	70	32	128	49	34	225	484	27	0	0	0	0
"TMSB10"	485	1038	764	678	392	372	370	308	181	263	321	249	30490	33226	39434	36674	50024	37071
"TMSB15A"	668	3090	0	0	0	0	0	0	0	0	0	0	0	0	0	0	0	0
"TMSB15B"	2197	3322	0	0	0	0	0	0	0	0	0	0	22	7	0	3	38	14
"TMSB4X"	632	2122	1757	1643	961	796	858	785	434	583	894	938	64496	70157	141350	132964	167494	129318
"TMSB4Y"	1664	2452	0	0	0	0	0	0	29	0	0	0	37	2	26	30	0	0
"TMSL3"	627	627	97	0	0	97	0	0	0	53	0	0	19474	21382	51946	47727	62384	48146
"TMTC1"	8837	283935	2988	534	1668	1320	316	218	3249	953	118	188	1964	2518	813	737	1211	760
"TMTC2"	4850	447131	1442	615	852	590	380	235	1475	778	99	706	287	431	342	405	273	229
"TMTC3"	7216	57592	63	0	25	38	0	0	106	0	0	0	208	164	160	67	178	47
"TMTC4"	3772	71014	348	0	223	125	0	0	578	0	44	0	293	257	262	231	388	178
"TMUB1"	1800	2242	4	0	0	4	0	0	25	15	15	0	508	396	461	200	398	414
"TMUB2"	2425	4526	565	226	393	172	140	86	384	194	650	219	3050	2632	3785	2785	4878	2994
"TMX"	940	5685	297	0	164	133	0	0	223	0	0	0	359	343	631	569	708	422
"TMX1"	4205	17486	1225	36	673	552	27	9	669	29	87	47	2829	2592	2920	2319	3279	2217
"TMX2"	1752	28404	1616	969	921	695	520	449	712	848	485	1943	1667	1694	2080	1982	2752	1987
"TMX3"	4759	41428	2930	688	1643	1287	352	336	1542	175	611	253	3689	3659	3388	2248	3262	1827
"TMX4"	2373	38679	439	118	224	215	81	37	170	39	0	42	495	531	462	426	402	238
"TNC"	7626	97682	946	25042	476	470	13612	11430	9	13597	0	13447	274	4109	13	1509	296	871
"TNF"	1671	2762	2504	17526	1372	1132	9236	8290	51	6953	0	8264	691	103846	356	108780	583	98987
"TNFAIP1"	3814	11487	235	180	136	99	70	110	309	323	11	382	137	311	119	207	139	208
"TNFAIP2"	4186	11114	9892	36491	5529	4363	19201	17290	1201	28595	3614	56922	3479	64103	5272	114743	5003	71474
"TNFAIP3"	4536	15723	5300	60257	2899	2401	32269	27988	160	29060	177	38895	999	92851	968	86614	1686	70774
"TNFAIP6"	1428	22456	57	5924	34	23	3214	2710	0	1901	0	2823	3	5180	8	7882	0	1471
"TNFAIP8"	2505	39827	22234	104344	12223	10011	55790	48554	4437	50445	2799	72332	3951	30846	2285	15953	2926	10633
"TNFAIP8L1"	2188	14424	157	8	100	57	8	0	221	125	177	296	797	574	209	175	291	193
"TNFAIP8L2"	1180	3122	326	0	200	126	0	0	179	19	111	0	2292	1523	2343	1342	2864	1522
"TNFAIP8L3"	2259	48674	0	0	0	0	0	0	0	0	0	0	62	60	88	35	111	19
"TNFRSF10A"	1718	33670	471	104	255	216	72	32	639	33	0	13	131	103	238	152	468	330
"TNFRSF10B"	4161	49054	4169	15493	2379	1790	8337	7156	1412	6926	1049	11042	2778	8680	3629	7582	3806	5317
"TNFRSF10C"	1390	14516	0	3	0	0	3	0	26	17	0	0	22	53	33	17	137	67
"TNFRSF10D"	3541	28438	503	165	206	297	94	71	281	193	25	94	326	304	299	210	340	223
"TNFRSF11A"	3134	60956	1653	0	953	700	0	0	1390	75	85	59	449	392	3609	2540	1519	1398
"TNFRSF11B"	2350	28588	0	0	0	0	0	0	0	0	0	0	31	91	57	25	34	9
"TNFRSF12A"	1034	2070	0	0	0	0	0	0	25	11	0	0	105	35	179	27	259	70
"TNFRSF13B"	1432	31582	0	0	0	0	0	0	36	21	0	0	0	0	0	0	0	0
"TNFRSF13C"	940	1787	0	0	0	0	0	0	33	0	0	0	0	0	0	0	0	0
"TNFRSF14"	4465	7385	5367	5652	2920	2447	2995	2657	1979	3149	5863	7210	3549	4241	7430	7729	9881	7207
"TNFRSF17"	996	2962	0	0	0	0	0	0	16	0	0	0	0	0	0	0	0	0
"TNFRSF18"	1204	3202	286	6166	87	199	3182	2984	26	3182	0	14289	22	2889	5	61	12	1499
"TNFRSF19"	4275	105510	0	0	0	0	0	0	0	0	0	0	0	0	0	0	0	0
"TNFRSF1A"	2213	13339	2622	587	1584	1038	353	234	1045	401	2217	881	3823	664	2487	1389	5241	2117
"TNFRSF1B"	3684	42218	3116	3479	1728	1388	1858	1621	1467	2108	2130	4047	4126	3574	5516	5365	5294	4942
"TNFRSF21"	3639	78413	16	0	16	0	0	0	34	0	0	0	292	327	460	364	317	311
"TNFRSF25"	1652	5036	224	62	163	61	45	17	119	41	152	0	226	90	212	102	280	208
"TNFRSF4"	1705	2793	591	6948	125	466	3590	3358	2	3636	0	16138	293	4064	221	2735	218	1696
"TNFRSF6B"	2013	2904	748	379	374	374	189	190	286	342	802	682	296	244	386	484	795	440
"TNFRSF8"	3699	80830	0	0	0	0	0	0	219	105	1	0	32	1	4	0	0	0
"TNFRSF9"	1891	20981	0	44	0	0	26	18	0	39	0	25	7	67	0	47	4	4
"TNFSF10"	1763	17806	0	0	0	0	0	0	15	24	0	0	57	172	225	86	198	129
"TNFSF11"	2366	45279	0	0	0	0	0	0	0	7	0	0	16	37	14	36	0	0
"TNFSF12"	1392	8833	93	0	50	43	0	0	172	35	0	22	903	564	1303	792	1488	951
"TNFSF12-TNFSF13"	2197	3318	372	23	209	163	23	0	385	123	167	56	2595	1958	4172	3129	4380	2907
"TNFSF13"	2282	3318	279	23	159	120	23	0	213	88	167	34	1694	1398	2869	2339	2894	1957
"TNFSF13B"	1209	37389	5163	10000	2813	2350	5336	4664	2610	4241	1096	2433	3960	8593	3600	3465	4155	2529
"TNFSF14"	1481	6035	0	0	0	0	0	0	0	0	0	0	203	9	97	14	113	45
"TNFSF15"	1995	16797	0	125	0	0	91	34	0	115	0	0	0	43	0	280	0	0
"TNFSF18"	751	9745	0	67	0	0	43	24	0	65	0	0	8	957	10	19	20	11
"TNFSF4"	3495	23602	0	10	0	0	10	0	0	0	0	0	0	29	0	0	0	0
"TNFSF5"	197	6154	0	0	0	0	0	0	29	0	0	0	0	0	0	0	0	0
"TNFSF8"	1983	27648	112	2160	70	42	1125	1035	14	2013	9	816	16	2840	241	1085	170	282
"TNFSF9"	1668	4931	0	847	0	0	477	370	70	449	0	1155	0	1977	0	2969	0	2296
"TNIK"	5839	397907	13	121	10	3	71	50	63	509	0	150	62	84	173	156	190	51
"TNIP1"	3288	51491	17802	64040	9810	7992	29302	34738	2140	176	3312	99026	2336	7577	3258	15224	3952	5492
"TNIP2"	1980	14718	882	2197	493	389	512	1685	299	2012	0	4758	552	2732	867	719	1259	3576
"TNIP3"	2439	85091	0	1392	0	0	757	635	0	493	0	475	0	1304	0	384	0	116
"TNK1"	2945	8727	18	9	18	0	0	9	57	36	0	0	291	0	0	0	0	0
"TNK2"	5487	17590	6093	2127	3335	2758	1229	898	2426	1442	6060	3352	1472	1534	3134	2116	4292	2065
"TNKS"	9625	226412	2528	1026	1331	1197	627	399	2137	1060	225	840	832	968	1064	744	1163	614
"TNKS1BP1"	5977	22569	150	29	60	90	29	0	131	92	18	33	696	551	701	528	764	477
"TNKS2"	6300	67082	5832	1351	3067	2765	777	574	2783	705	781	756	4860	5829	5398	4138	5309	3482
"TNMD"	3036	15094	0	0	0	0	0	0	0	0	0	0	0	0	0	0	0	0
"TNN"	5027	80210	0	0	0	0	0	0	0	0	0	0	0	0	0	0	0	0
"TNNC1"	701	2951	7	0	4	3	0	0	66	13	0	0	1	1	0	0	0	0
"TNNC2"	685	4098	0	0	0	0	0	0	37	13	0	0	0	0	0	0	0	0
"TNNI1"	6148	17981	0	0	0	0	0	0	132	47	0	0	0	0	0	0	0	0
"TNNI2"	740	2193	40	8	9	31	7	1	87	0	85	0	1	11	42	25	29	26
"TNNI3"	846	5965	0	0	0	0	0	0	26	32	0	0	0	0	0	0	0	0
"TNNI3K"	3831	173852	105	9	66	39	0	9	246	4	60	0	731	542	743	370	771	367
"TNNT1"	1117	14157	1	0	1	0	0	0	106	26	0	0	0	1	0	0	0	0
"TNNT2"	1168	18664	0	0	0	0	0	0	143	62	0	0	0	0	0	0	0	0
"TNNT3"	1452	19138	14	0	7	7	0	0	161	101	0	0	0	5	0	0	0	0
"TNP1"	401	600	0	0	0	0	0	0	0	0	0	0	0	0	0	0	0	0
"TNP2"	598	1447	0	0	0	0	0	0	0	0	0	0	0	0	0	0	0	0
"TNPO1"	8583	97798	4647	1858	2508	2139	1005	853	2198	892	1014	813	4867	6114	6595	5477	6157	4068
"TNPO2"	5495	22522	762	602	500	262	366	236	349	769	192	820	646	1029	793	1160	1122	460
"TNPO3"	3854	100252	2866	434	1589	1277	210	224	1847	314	499	545	1696	1638	1586	1071	2019	1083
"TNR"	5213	420819	0	0	0	0	0	0	52	15	0	0	0	0	0	0	0	0
"TNRC11"	3107	12775	446	486	210	236	257	229	336	339	62	720	591	601	639	881	981	620
"TNRC18"	10592	116748	15899	3162	8632	7267	1787	1375	5785	2386	17166	6698	3547	2365	5454	4369	6168	4275
"TNRC18B"	1440	35944	6767	1297	3604	3163	674	623	2516	944	8661	3265	135	107	290	198	328	155
"TNRC4"	3310	14462	0	0	0	0	0	0	56	36	0	0	0	0	0	0	0	0
"TNRC6A"	8445	96498	9478	1586	5205	4273	834	752	4563	875	3356	1416	1638	1497	2085	1391	2157	1244
"TNRC6B"	18302	157884	15452	4728	8376	7076	2582	2146	7363	2609	5048	3982	1903	2199	1961	1669	2223	1308
"TNRC6C"	9793	104600	269	223	163	106	131	92	231	125	72	33	1091	1117	302	229	582	237
"TNS1"	10309	144286	4879	5541	2508	2371	2908	2633	2871	2690	1971	8965	1916	2110	1748	1348	1733	1256
"TNS3"	7657	264448	11398	6566	6292	5106	3466	3100	7027	5424	2829	5676	2511	2548	3713	3271	3386	2351
"TNS4"	4083	25774	0	0	0	0	0	0	153	54	0	0	0	0	0	0	0	0
"TNXB"	13169	68221	0	0	0	0	0	0	370	176	0	0	2	2	0	0	0	0
"TOB1"	1826	1826	114	53	64	50	29	24	82	14	0	0	45	29	49	45	177	76
"TOB2"	4567	13537	572	19	336	236	0	19	368	206	491	238	176	725	1384	1032	1755	751
"TOCA1"	2849	10554	86	0	43	43	0	0	89	7	0	0	252	344	205	89	320	157
"TOE1"	2507	4309	7	46	3	4	25	21	24	55	0	0	277	36	267	273	407	291
"TOLLIP"	3625	28373	4571	2394	2479	2092	1271	1123	1773	1413	3864	3263	468	344	2801	2739	3946	670
"TOM1"	2710	48190	3154	9222	1758	1396	4899	4323	1620	3258	1287	9592	1753	3090	1936	3540	2281	2522
"TOM1L1"	2482	16758	45	0	27	18	0	0	127	7	0	0	495	374	423	19	309	0
"TOM1L2"	5822	128963	789	163	404	385	86	77	1181	454	82	471	429	415	598	592	684	477
"TOMM20"	3388	19598	516	820	246	270	455	365	358	658	0	862	2384	2784	2683	497	647	464
"TOMM20L"	615	12777	13	0	13	0	0	0	16	0	0	0	5	0	1	1	0	0
"TOMM22"	1380	2811	0	0	0	0	0	0	23	25	0	0	2638	1215	1152	1097	1433	1028
"TOMM34"	2055	18344	519	2047	298	221	1102	945	282	615	0	416	149	987	657	588	804	543
"TOMM40"	3427	12460	419	78	200	219	43	35	254	287	102	349	582	437	1191	1218	1397	1137
"TOMM40L"	3406	17256	127	0	43	84	0	0	86	55	0	0	809	620	854	501	1171	536
"TOMM5"	905	4224	26	0	13	13	0	0	11	47	0	0	3	515	869	277	288	244
"TOMM6"	1538	3136	37	29	21	16	14	15	50	38	0	18	706	2264	2575	2247	3165	2327
"TOMM7"	729	10169	0	0	0	0	0	0	28	0	0	0	0	630	578	615	847	608
"TOMM70A"	4370	37918	634	80	323	311	56	24	348	177	133	206	735	1823	2010	1411	2115	1269
"TOP1"	3752	95664	10006	19565	5602	4404	10563	9002	4574	9685	3372	11388	3059	4317	4728	4409	4774	3529
"TOP1MT"	2099	25522	1075	234	593	482	136	98	737	203	663	94	1001	615	767	622	955	814
"TOP1P1"	2428	2428	30	14	30	0	14	0	0	0	0	22	462	628	241	0	249	171
"TOP1P2"	1518	1518	0	0	0	0	0	0	0	0	0	0	0	0	0	0	0	0
"TOP2A"	5730	29373	0	0	0	0	0	0	27	19	0	0	20	12	3	3	37	0
"TOP2B"	5268	66358	5291	1362	3017	2274	744	618	2597	770	971	833	6045	6019	4880	4761	6918	4195
"TOP3A"	4135	41088	941	197	532	409	114	83	992	228	186	244	1077	799	660	445	956	526
"TOP3B"	3124	25745	905	56	460	445	35	21	551	215	322	244	217	298	644	292	878	508
"TOPBP1"	5373	61289	625	151	322	303	92	59	455	95	117	116	1028	905	1182	891	1533	820
"TOPORS"	4150	12060	661	1057	402	259	533	524	308	432	68	557	1172	1564	1045	1056	1169	794
"TOR1A"	2110	11221	679	24	360	319	11	13	297	69	108	26	2843	2694	715	529	2672	494
"TOR1AIP1"	3818	37794	983	428	615	368	219	209	612	300	195	445	3577	3419	2811	2200	3101	2003
"TOR1AIP2"	3479	32982	2599	914	1505	1094	576	338	1121	612	559	708	1638	1456	1308	874	1132	715
"TOR1B"	2774	8130	312	60	154	158	12	48	194	154	284	83	2614	2492	1330	870	1614	904
"TOR2A"	2511	3802	158	0	112	46	0	0	128	48	0	75	867	634	969	875	1325	857
"TOR3A"	2126	14017	1143	2710	348	795	672	2038	304	77	970	29402	1607	3277	2003	3929	2828	4270
"TORC2"	2233	6638	574	246	282	292	142	104	231	398	460	405	969	1040	1132	1093	1793	1167
"TOSO"	2988	18747	0	0	0	0	0	0	31	31	0	0	116	124	317	345	183	170
"TOX"	4140	313792	2861	620	1714	1147	359	261	1533	312	49	245	140	149	181	134	177	98
"TOX2"	2550	153472	18	38	8	10	38	0	148	70	0	0	68	62	0	0	53	8
"TOX3"	3131	109798	0	0	0	0	0	0	0	0	0	0	0	0	0	0	0	0
"TOX4"	4531	21984	769	441	442	327	319	122	383	298	12	433	1850	2646	1548	1595	2213	1519
"TP53"	2731	19145	503	220	285	218	98	122	380	145	379	178	2031	2152	1755	1617	2143	1542
"TP53AIP1"	2654	7552	0	0	0	0	0	0	0	14	0	0	0	0	0	0	0	0
"TP53BP1"	6263	103296	198	0	107	91	0	0	335	68	20	25	1014	923	712	706	887	597
"TP53BP1 variant protein"	2228	10003	60	0	34	26	0	0	141	7	0	0	570	510	235	200	273	212
"TP53BP2"	4807	66080	6331	52662	3556	2775	28291	24371	1632	19327	616	28097	1527	12236	2995	11317	3697	8905
"TP53I11"	3720	17813	1790	1540	993	797	799	741	1080	1218	1294	2550	2031	2364	2038	2604	3071	2754
"TP53I13"	1459	4437	288	110	170	118	59	51	230	46	444	95	895	659	1064	698	1166	637
"TP53I3"	1680	7425	428	90	237	191	68	22	252	31	92	18	296	17	616	194	650	695
"TP53INP1"	5656	23416	632	1974	383	249	1047	927	511	1451	138	768	1524	1682	1862	3040	1985	1633
"TP53INP2"	4129	9091	899	2673	491	408	1438	1235	175	1137	129	1977	1031	4269	1034	4270	1250	2465
"TP53RK"	3374	5273	19	0	19	0	0	0	14	33	0	0	92	668	506	492	566	424
"TP53TG3"	2869	4039	0	0	0	0	0	0	0	0	0	0	0	0	0	0	0	0
"TP53TG3b"	3327	4039	0	0	0	0	0	0	0	0	0	0	0	0	0	0	0	0
"TP53TG5"	984	4437	98	254	57	41	118	136	70	91	59	113	42	75	48	32	52	24
"TP63"	4923	265854	0	0	0	0	0	0	19	0	0	0	0	0	6	0	3	0
"TP73"	2859	81340	0	0	0	0	0	0	660	360	0	0	0	0	0	0	0	0
"TPBG"	2875	3693	0	0	0	0	0	0	0	0	0	0	0	15	0	0	0	0
"TPCN1"	5376	77129	7408	1584	4047	3361	845	739	5481	1589	10676	1880	3662	3582	7652	6732	6276	4886
"TPCN2"	5051	41724	4017	2203	2100	1917	1099	1104	2280	1817	2840	4528	924	824	1094	1224	1323	1037
"TPD52"	4249	45907	2181	496	1347	834	250	246	1750	861	361	671	314	481	306	374	482	395
"TPD52L1"	2409	99527	0	0	0	0	0	0	0	0	0	0	0	0	0	0	0	0
"TPD52L2"	2418	26300	2974	729	1633	1341	390	339	1310	829	2924	1569	3103	2486	4740	4084	4627	3221
"TPD52L3"	2296	2296	0	0	0	0	0	0	0	0	0	0	0	0	0	0	0	0
"TPH1"	1825	20253	2	0	0	2	0	0	0	0	0	0	0	0	0	0	0	0
"TPH2"	2371	93597	0	0	0	0	0	0	0	0	0	0	0	0	0	0	0	0
"TPI1"	1599	2832	612	236	330	282	134	102	158	180	106	135	6929	6212	10955	10167	13339	9445
"TPIP"	2224	138695	0	0	0	0	0	0	0	0	0	0	0	0	0	0	0	0
"TPK1"	2439	384105	11543	7593	6547	4996	4216	3377	7247	5029	935	3599	1139	246	245	778	1192	781
"TPM1"	1922	29275	2673	13	1478	1195	7	6	1270	24	979	11	506	438	1376	655	2855	863
"TPM2"	1890	8023	50	15	33	17	15	0	95	43	0	6	75	110	119	74	144	62
"TPM3"	7106	30321	9002	9165	4998	4004	4904	4261	2719	3530	5519	7645	17328	20231	18363	19138	24728	18195
"TPM4"	2653	26680	10538	20967	5812	4726	11089	9878	2241	10801	7380	28422	19857	27077	21907	22483	27261	19272
"TPMT"	3255	26830	211	12	88	123	0	12	250	124	6	44	2320	2302	2017	1619	2460	1586
"TPO"	3162	129267	0	0	0	0	0	0	157	54	0	0	0	0	0	0	0	0
"TPP1"	3554	6590	1278	963	671	607	520	443	268	497	1216	1509	18778	19913	19437	7775	21515	15569
"TPP2"	4737	82237	8164	3228	4511	3653	1740	1488	4293	1494	2540	2115	3699	3591	4820	3594	4091	2770
"TPPP"	6620	18917	0	0	0	0	0	0	187	187	0	0	0	0	0	28	7	20
"TPPP2"	799	1987	0	0	0	0	0	0	0	0	0	0	0	0	0	0	0	0
"TPPP3"	1732	2137	0	0	0	0	0	0	21	33	0	0	0	0	0	0	0	0
"TPR"	9755	63671	1456	1365	830	626	750	615	908	696	105	461	2560	2758	3516	3365	4348	2806
"TPRA1"	1996	18025	915	4320	512	403	2288	2032	348	4113	179	6529	517	593	881	2270	884	782
"TPRG1"	4727	376269	2507	2334	1431	1076	1323	1011	6501	4047	694	2408	686	1316	1034	971	359	236
"TPRG1L"	2430	5138	47	0	16	31	0	0	25	20	43	0	977	688	888	586	1186	678
"TPRKB"	782	4760	48	0	20	28	0	0	36	0	0	0	335	218	356	190	460	183
"TPRX1"	1841	2363	0	0	0	0	0	0	0	0	0	0	0	0	0	0	0	0
"TPRXL"	2357	48531	0	0	0	0	0	0	20	0	0	0	0	0	0	0	0	0
"TPSAB1"	1219	2915	0	0	0	0	0	0	10	0	0	0	0	0	60	72	44	35
"TPSB2"	1171	1850	0	0	0	0	0	0	10	0	0	0	0	0	41	41	22	21
"TPSD1"	860	2223	0	0	0	0	0	0	42	17	0	0	0	3	0	1	0	0
"TPSG1"	1111	3605	0	0	0	0	0	0	138	0	0	0	0	0	0	0	0	0
"TPST1"	2148	155180	0	0	0	0	0	0	0	0	0	0	0	0	0	0	0	0
"TPST2"	2007	39656	5711	875	3182	2529	510	365	2543	808	4823	1815	1899	1836	1433	1629	2077	1547
"TPT1"	883	1138	1115	2654	675	440	1406	1248	397	1232	65	1646	899	48462	31062	50788	51055	38627
"TPTE"	2210	84179	1403	435	887	516	223	212	1180	706	134	349	680	668	132	85	347	218
"TPTE2"	1982	113884	0	0	0	0	0	0	0	0	0	0	0	0	0	0	0	0
"TPX2"	3789	62701	14	93	4	10	45	48	12	0	0	24	29	29	8	6	22	5
"TR"	3706	61400	8383	3232	4772	3611	1710	1522	3145	901	4212	3047	8935	8821	11498	10055	10365	8604
"TR2IT1"	2363	47611	11	0	8	3	0	0	6	0	0	0	115	113	106	84	137	89
"TRA"	2576	4211	0	0	0	0	0	0	0	0	0	0	0	0	0	0	0	0
"TRA16"	260	626	5	0	0	5	0	0	18	35	0	0	199	170	167	129	255	147
"TRA2A"	2236	27256	4855	6327	2682	2173	3351	2976	1914	2721	2682	5459	1551	2620	2036	2350	2801	2057
"TRA2B"	7252	22850	6948	12442	3861	3087	6701	5741	2925	6317	3565	9867	3141	6943	3906	5831	4044	4567
"TRA@"	1228	129626	313	373	135	178	239	134	83	25	0	129	285	412	153	150	274	178
"TRABD"	2325	13669	2514	617	1370	1144	347	270	867	351	3062	965	2497	1445	3968	2210	4841	2807
"TRAC"	628	400415	313	373	135	178	239	134	71	15	0	129	264	380	132	137	210	146
"TRAD"	1796	6691	87	16	51	36	9	7	140	9	0	0	52	164	158	96	90	115
"TRADD"	1849	2065	607	350	307	300	164	186	152	194	209	407	772	0	825	753	1228	455
"TRAF1"	4457	24503	35730	1598	19848	15882	670	928	724	157235	1037	311945	1698	2967	1647	98739	2242	51047
"TRAF2"	2404	44683	1063	572	573	490	312	260	856	979	369	2413	333	264	383	405	564	383
"TRAF3"	2579	128814	19210	47081	10586	8624	25190	21891	4659	25612	8712	57182	2200	3048	2483	3283	3177	2399
"TRAF3IP1"	4191	80356	26	3	16	10	3	0	291	12	0	15	174	174	148	113	192	102
"TRAF3IP2"	2786	47331	0	0	0	0	0	0	58	13	0	0	57	52	28	8	45	15
"TRAF3IP3"	2360	23823	6021	7389	3305	2716	3874	3515	2216	5556	3726	9017	2779	4309	2516	4675	3318	2108
"TRAF4"	2908	6954	279	335	132	147	165	170	155	273	170	637	541	884	716	834	841	805
"TRAF5"	4043	48138	2779	816	1592	1187	507	309	1572	489	1416	694	1143	1245	2046	1476	1626	1063
"TRAF6"	2582	21101	781	339	468	313	167	172	300	454	54	433	822	437	176	125	180	108
"TRAF7"	3687	22332	581	172	334	247	116	56	561	421	271	708	2988	2202	3027	2892	3596	2620
"TRAFD1"	3190	28060	1160	299	665	495	159	140	759	161	289	363	3330	2260	3466	2168	4688	2198
"TRAG3"	793	6296	0	0	0	0	0	0	0	0	0	0	0	0	0	0	0	0
"TRAIP"	2039	27966	0	0	0	0	0	0	43	0	0	0	3	12	0	0	21	10
"TRAITS"	773	2584	10	15	10	0	0	15	17	31	0	0	22	32	15	35	16	28
"TRAK1"	5132	134523	8922	6394	5087	3835	3550	2844	3830	2921	4424	5433	3357	3481	3384	2791	4050	2559
"TRAK2"	6542	74390	1781	301	988	793	171	130	1196	536	128	454	2740	3222	1024	2332	2918	666
"TRAM1"	2800	34933	2646	610	1431	1215	364	246	1255	332	916	197	2826	3789	4956	3885	5197	2952
"TRAM1L1"	2022	2022	0	0	0	0	0	0	0	0	0	0	0	0	0	0	0	0
"TRAM2"	7066	79662	2450	255	1461	989	170	85	1767	134	747	162	2021	2110	1891	1443	2310	1295
"TRANK1"	8899	34102	654	132	371	283	70	62	460	150	18	57	1196	1153	1265	1064	2029	1111
"TRAP1"	2322	20268	2059	165	1131	928	53	112	1456	306	1226	352	1780	1444	1288	857	2800	1810
"TRAPPC1"	810	1593	31	28	25	6	19	9	52	0	0	0	1201	1301	1196	546	757	1255
"TRAPPC10"	7107	94226	12366	13681	6749	5617	7245	6436	4555	7002	5750	13079	3182	3950	4395	4017	5000	3132
"TRAPPC2"	2854	22383	298	75	193	105	63	12	190	33	0	33	384	281	234	157	291	165
"TRAPPC2L"	1481	1481	474	184	400	74	87	97	272	162	102	686	634	267	733	640	995	530
"TRAPPC3"	1541	12925	569	107	352	217	61	46	448	166	228	375	1273	1355	1376	321	657	1206
"TRAPPC4"	1217	2219	152	15	86	66	0	15	175	41	36	0	3224	3999	3014	3155	369	3104
"TRAPPC5"	798	1989	0	0	0	0	0	0	10	10	0	0	640	494	837	710	1064	713
"TRAPPC6A"	800	15300	225	39	131	94	23	16	399	58	238	0	252	247	204	360	372	356
"TRAPPC6B"	3357	22621	877	183	517	360	98	85	314	60	229	136	783	1017	671	578	706	501
"TRAPPC9"	4497	726094	19941	14294	11057	8884	7685	6609	13625	12519	7671	15006	727	740	703	704	818	561
"TRAT1"	1701	32085	0	0	0	0	0	0	0	0	0	0	24	23	48	62	15	3
"TRAV12-1"	442	636	0	0	0	0	0	0	0	0	0	0	0	0	0	0	0	0
"TRBV"	322	89184	0	0	0	0	0	0	0	0	0	0	13	0	3	9	10	0
"TRD"	770	550896	313	373	135	178	239	134	71	15	0	129	264	380	132	137	210	146
"TRD@"	34	7595	153	125	35	118	85	40	0	0	0	0	43	67	18	27	26	33
"TRDMT1"	7291	58700	47	15	35	12	5	10	40	0	0	0	207	207	101	109	93	62
"TRDN"	4516	420461	0	0	0	0	0	0	0	0	0	0	0	0	0	0	0	0
"TREH"	1867	21441	0	170	0	0	119	51	27	666	0	450	0	51	0	498	0	0
"TREM1"	924	10747	0	0	0	0	0	0	0	0	0	0	0	0	0	4	9	6
"TREM2"	1096	4678	5386	463	3104	2282	266	197	1748	141	2743	188	5465	2165	3253	3440	11967	5422
"TREML1"	984	4728	5611	666	3104	2507	373	293	2131	155	1304	269	5790	96	347	137	814	192
"TREML2"	3763	11375	59	0	21	38	0	0	58	0	0	0	871	187	245	122	1369	473
"TREML4"	2075	10059	0	0	0	0	0	0	0	0	0	0	0	0	0	0	0	0
"TRERF1"	7658	227116	40168	11764	22169	17999	6391	5373	18635	6233	36676	13832	2734	3270	3623	3158	4841	3381
"TREX1"	3027	7859	303	65	134	169	30	35	108	118	240	69	121	572	1659	670	2230	967
"TREX2"	1256	1768	0	0	0	0	0	0	47	0	1	0	33	35	41	40	42	50
"TRF4-2"	2293	81561	1668	227	970	698	127	100	1236	801	503	654	688	640	823	687	935	735
"TRFP"	2607	15590	7	9	4	3	0	9	40	27	0	0	281	214	204	123	245	119
"TRG11"	1905	3333	1455	1945	807	648	1200	745	275	1140	680	191	290	178	619	302	482	183
"TRGV3"	1496	1611	558	101	264	294	45	56	521	22	246	28	47	57	93	66	100	56
"TRH"	2010	3664	0	0	0	0	0	0	0	0	0	0	0	0	0	0	0	0
"TRHDE"	5570	392894	0	0	0	0	0	0	10	0	0	0	0	0	0	0	0	0
"TRHR"	1341	32086	0	0	0	0	0	0	0	0	0	0	0	0	0	0	0	0
"TRIAP1"	1183	2452	0	0	0	0	0	0	37	10	0	0	639	548	858	566	861	546
"TRIB1"	3633	8081	1993	4391	1058	935	2276	2115	669	2056	591	4045	1268	4836	812	2105	1219	4534
"TRIB2"	4407	25860	794	643	378	416	363	280	342	337	0	17	2310	1495	1589	683	1613	752
"TRIB3"	2454	16895	11	0	11	0	0	0	27	0	0	0	461	295	300	154	509	248
"TRIL"	5054	5055	0	0	0	0	0	0	0	0	0	0	0	0	0	0	0	0
"TRIM10"	3552	8990	0	0	0	0	0	0	46	0	0	0	0	0	0	0	0	0
"TRIM11"	2695	13140	988	159	557	431	83	76	606	329	583	286	290	476	189	491	1118	101
"TRIM13"	7292	21462	4762	6102	2631	2131	3432	2670	3201	4437	2652	4719	1539	2058	1275	1025	1548	1059
"TRIM14"	4472	34853	2251	1197	1241	1010	660	537	1487	560	830	275	3583	3861	5882	3852	6499	3758
"TRIM15"	2224	9485	0	0	0	0	0	0	21	0	0	0	0	2	0	0	0	0
"TRIM16"	3184	56334	21	9	21	0	3	6	183	10	0	0	211	153	216	123	257	150
"TRIM16L"	2402	36966	0	0	0	0	0	0	18	0	1	0	47	21	88	35	114	57
"TRIM17"	2090	8947	513	48	262	251	17	31	333	93	410	28	0	0	0	0	0	0
"TRIM2"	6804	186206	0	0	0	0	0	0	0	0	0	0	0	0	0	0	3	0
"TRIM21"	1936	8801	133	0	96	37	0	0	67	57	57	0	717	855	964	706	851	774
"TRIM22"	3754	14697	1470	607	792	678	362	245	787	323	707	107	2305	2489	4785	3144	3593	2771
"TRIM23"	3909	34680	131	0	74	57	0	0	165	7	45	0	103	205	396	173	368	190
"TRIM24"	4021	125253	1505	2019	930	575	1074	945	1103	1550	65	1978	1238	1040	1063	884	1228	846
"TRIM25"	5814	26140	2286	1195	1329	957	702	493	1212	593	1014	335	928	2686	4139	2330	1144	2263
"TRIM26"	3606	28921	5221	18533	2847	2374	9898	8635	1359	8025	1547	11655	1020	1054	2576	6921	3270	4021
"TRIM27"	7089	20990	1568	339	885	683	122	217	840	285	1131	407	2028	541	2145	1249	1106	454
"TRIM28"	2976	6248	1613	1116	866	747	555	561	448	800	620	966	6459	6550	4893	5943	8934	6119
"TRIM29"	3147	26870	0	0	0	0	0	0	166	111	0	0	0	0	0	0	0	0
"TRIM3"	3056	25847	227	104	120	107	65	39	217	82	23	80	305	284	324	317	440	309
"TRIM31"	2036	10195	0	0	0	0	0	0	50	0	0	0	0	0	0	0	0	8
"TRIM32"	3721	14000	14	0	14	0	0	0	122	25	0	0	166	66	446	49	430	131
"TRIM33"	8357	118382	4617	1080	2538	2079	610	470	2327	556	677	972	1500	1734	2127	1478	2073	1227
"TRIM34"	2316	24451	270	0	176	94	0	0	173	10	30	0	620	493	1108	816	1069	865
"TRIM35"	4233	26432	461	0	265	196	0	0	226	8	96	0	605	304	561	163	713	317
"TRIM36"	4439	55778	1734	773	968	766	464	309	870	1035	853	1243	782	1059	879	850	1180	838
"TRIM37"	4539	108706	521	63	302	219	38	25	452	40	93	37	430	446	458	391	654	500
"TRIM38"	3276	22281	4910	4602	2713	2197	2537	2065	2097	1486	1722	2952	3968	3582	2803	2122	2691	1855
"TRIM39"	3570	16499	1118	967	653	465	798	169	245	572	16	572	609	1116	581	820	900	701
"TRIM4"	3425	29119	1463	889	811	652	470	419	786	472	199	671	1188	1303	1064	600	1064	497
"TRIM40"	2092	12629	0	0	0	0	0	0	0	0	0	0	0	2	0	0	0	0
"TRIM41"	6569	12499	640	200	335	305	110	90	312	177	198	115	763	758	956	816	1541	854
"TRIM41a"	2664	12504	640	200	335	305	110	90	312	177	198	115	763	758	956	816	1541	854
"TRIM42"	2543	23112	0	0	0	0	0	0	16	0	0	0	0	0	0	0	0	0
"TRIM43"	1630	7703	0	0	0	0	0	0	0	0	0	0	0	0	0	0	0	0
"TRIM44"	4342	146579	3532	2993	2002	1530	1570	1423	2358	1918	308	804	2357	2828	2691	2595	2897	1913
"TRIM45"	3587	10736	0	0	0	0	0	0	0	0	0	0	0	3	0	0	4	4
"TRIM46"	3348	10217	220	0	135	85	0	0	354	153	426	0	136	86	755	561	509	379
"TRIM47"	2267	4411	0	0	0	0	0	0	35	33	0	0	213	182	352	335	424	307
"TRIM48"	1741	8979	0	0	0	0	0	0	0	0	0	0	0	0	0	0	0	0
"TRIM49"	2170	10921	0	0	0	0	0	0	0	0	0	0	0	0	0	0	0	0
"TRIM5"	2998	21507	2420	1061	1241	1179	642	419	1077	659	804	507	3608	2951	5329	3940	4403	3545
"TRIM50"	2054	15552	0	0	0	0	0	0	52	10	0	0	0	0	0	0	0	0
"TRIM52"	2228	4733	665	194	315	350	100	94	237	141	0	92	959	718	994	306	1253	87
"TRIM54"	1766	24708	0	0	0	0	0	0	1	10	0	0	5	9	7	0	24	0
"TRIM55"	2860	48440	0	0	0	0	0	0	0	0	0	0	0	0	0	0	0	0
"TRIM56"	3528	5103	957	579	467	490	305	274	324	435	799	830	952	1243	1159	1104	1237	724
"TRIM58"	5160	22937	0	0	0	0	0	0	10	0	0	0	52	69	4	0	12	4
"TRIM59"	3878	14336	0	0	0	0	0	0	0	0	0	0	131	55	48	0	50	0
"TRIM6"	3419	16306	0	0	0	0	0	0	15	0	0	0	0	0	0	0	0	1
"TRIM6-TRIM34"	3471	47741	270	0	176	94	0	0	188	10	30	0	620	493	1108	816	1069	865
"TRIM60"	1905	2545	0	0	0	0	0	0	0	0	0	0	0	0	0	0	0	0
"TRIM61"	1583	23220	0	0	0	0	0	0	0	0	0	0	0	0	0	0	0	0
"TRIM62"	3845	36669	74	0	53	21	0	0	180	59	0	0	47	22	212	115	293	149
"TRIM63"	1773	16325	0	0	0	0	0	0	52	10	40	0	0	0	33	25	115	69
"TRIM64"	1537	5568	0	0	0	0	0	0	0	0	0	0	0	0	7	0	5	0
"TRIM65"	3414	8014	736	41	401	335	27	14	250	37	438	0	1286	694	753	294	1553	418
"TRIM66"	9771	46799	1698	451	992	706	236	215	1023	405	248	209	314	312	634	359	1300	591
"TRIM67"	8532	58642	0	0	0	0	0	0	61	17	0	0	0	0	0	0	0	0
"TRIM68"	3307	9537	0	0	0	0	0	0	26	0	0	0	236	108	288	89	284	116
"TRIM69"	2461	38808	0	159	0	0	89	70	54	76	0	0	966	1604	896	1016	1038	1023
"TRIM7"	3014	7008	0	0	0	0	0	0	0	0	0	0	0	5	6	0	2	0
"TRIM71"	3141	74262	0	0	0	0	0	0	42	18	0	0	0	0	0	0	0	0
"TRIM72"	2086	11097	8	0	7	1	0	0	18	12	0	0	105	83	9	0	36	25
"TRIM73"	1453	15376	0	0	0	0	0	0	0	0	0	0	0	1	28	61	44	61
"TRIM74"	1906	15822	2	0	0	2	0	0	0	0	0	0	0	0	39	12	455	12
"TRIM75"	1407	1407	0	0	0	0	0	0	0	0	0	0	0	0	0	0	0	0
"TRIM77"	1357	7573	0	0	0	0	0	0	0	0	0	0	0	0	0	0	0	0
"TRIM8"	2750	13826	4028	3592	2172	1856	1868	1724	949	1927	3551	2258	3641	3106	4226	3613	5083	2888
"TRIM9"	4935	120442	0	0	0	0	0	0	9	0	0	0	2	0	3	4	0	0
"TRIML1"	1651	8053	0	0	0	0	0	0	0	0	0	0	0	0	0	0	0	0
"TRIML2"	1719	14319	0	0	0	0	0	0	0	0	0	0	0	0	0	0	0	0
"TRIO"	10276	365623	24188	14889	13522	10666	8058	6831	12737	8380	8772	10516	1867	2563	3987	3335	4134	2360
"TRIOBP"	10168	79569	1125	164	612	513	84	80	1343	573	443	241	1367	1248	1735	1251	2025	1255
"TRIP10"	2193	11823	99	325	75	24	170	155	10	684	0	1134	309	897	263	1518	595	766
"TRIP11"	7304	71357	1427	473	811	616	221	252	883	298	294	270	1260	1207	1482	1008	1509	791
"TRIP12"	6614	154727	14947	17470	8471	6476	9580	7890	6198	8247	4443	13801	7018	10392	9226	7859	9782	5474
"TRIP13"	2362	25156	0	0	0	0	0	0	70	45	0	0	12	6	0	1	9	0
"TRIP4"	2039	67482	1214	91	787	427	51	40	854	109	376	202	440	795	828	673	1043	860
"TRIP6"	1755	6122	648	192	166	482	149	43	117	257	560	241	707	829	749	1064	418	331
"TRIT1"	2137	42471	1951	13	1118	833	11	2	1121	6	661	48	624	460	644	331	789	301
"TRIpartite motif protein"	1265	23198	317	141	146	171	76	65	105	75	30	101	1243	370	1053	866	1166	964
"TRMT1"	2281	11751	125	0	68	57	0	0	158	180	17	65	220	291	772	770	624	681
"TRMT11"	2153	52844	117	0	75	42	0	0	91	13	0	0	72	91	90	65	115	86
"TRMT112"	582	867	249	71	13	236	32	39	104	81	0	56	1676	1420	2312	2018	2886	2113
"TRMT12"	2218	2218	111	10	60	51	10	0	71	9	0	0	261	151	215	82	306	154
"TRMT2A"	2971	5372	530	271	316	214	145	126	213	276	353	286	872	798	1276	1339	1601	1208
"TRMT2B"	3322	42524	1074	206	628	446	136	70	214	163	448	242	164	217	545	461	590	348
"TRMT5"	5284	9615	440	5	17	423	3	2	241	10	0	4	541	341	524	173	567	228
"TRMT6"	2322	12689	322	91	179	143	38	53	177	93	9	147	574	762	475	523	592	601
"TRMT61A"	3243	7901	79	0	48	31	0	0	184	115	0	32	203	241	406	502	439	356
"TRMT61B"	1848	20487	182	0	78	104	0	0	178	66	52	0	205	188	207	154	261	164
"TRMU"	1974	21940	805	148	520	285	104	44	584	166	524	174	364	239	592	209	758	214
"TRNAU1AP"	2487	25529	463	54	356	107	29	25	204	321	100	120	319	323	261	305	411	296
"TRNP1"	1950	7183	0	0	0	0	0	0	35	13	0	0	15	9	0	0	9	0
"TRNT1"	2281	22106	1146	1023	689	457	557	466	665	629	72	814	1323	1074	987	682	1056	302
"TRO"	4653	10615	0	0	0	0	0	0	14	0	0	0	0	0	0	0	0	0
"TROAP"	2901	8544	0	0	0	0	0	0	52	34	0	0	0	0	0	0	0	0
"TROVE2"	3625	26488	1297	1870	730	567	1063	807	606	1147	0	1330	2027	3239	1427	1946	1725	1594
"TRPA1"	5216	54334	7820	4709	4454	3366	2530	2179	3209	1504	1269	2097	1036	1388	527	449	547	435
"TRPC1"	4181	83463	0	0	0	0	0	0	0	0	0	0	0	0	0	0	0	0
"TRPC3"	3560	72728	0	0	0	0	0	0	0	0	0	0	0	0	0	0	0	0
"TRPC4"	3460	233166	0	0	0	0	0	0	0	0	0	0	0	0	0	0	0	0
"TRPC4AP"	3181	90405	4843	2883	2950	1893	1592	1291	2489	2295	1868	3087	2687	1874	3808	1972	2328	2155
"TRPC5"	5851	308464	44	0	32	12	0	0	27	9	0	0	0	0	0	0	0	0
"TRPC6"	4624	132365	0	0	0	0	0	0	0	0	0	0	0	0	0	0	0	0
"TRPC7"	2598	143952	0	0	0	0	0	0	11	0	0	0	0	0	0	0	0	0
"TRPM1"	5439	100373	90	0	90	0	0	0	44	11	0	0	0	1	0	0	26	9
"TRPM2"	6253	89827	1907	776	1009	898	407	369	1386	825	816	950	604	626	930	859	991	780
"TRPM3"	6294	586548	0	0	0	0	0	0	0	13	0	0	0	0	0	0	0	0
"TRPM4"	4078	54041	530	16	271	259	7	9	561	233	447	148	273	334	246	275	739	418
"TRPM4B"	3841	54041	530	16	271	259	7	9	561	233	447	148	273	334	246	275	739	418
"TRPM5"	3974	18529	1	59	1	0	12	47	103	229	0	210	9	17	0	0	0	0
"TRPM6"	8561	165601	0	0	0	0	0	0	0	0	0	0	18	29	146	131	19	0
"TRPM7"	7285	126505	6240	2267	3546	2694	1176	1091	3294	883	2417	1248	1993	2527	2633	1857	1900	1743
"TRPM8"	5646	102124	0	0	0	0	0	0	49	0	0	0	0	0	0	0	0	0
"TRPS1"	9996	260505	34762	38986	19341	15421	21208	17778	16344	14715	8799	16388	839	1010	1474	1074	1255	639
"TRPT1"	1066	2456	629	334	356	273	166	168	347	202	368	369	5153	6743	3848	3610	3825	3093
"TRPV1"	4430	27432	4077	642	2288	1789	385	257	2185	590	5504	880	1581	430	1761	1256	862	1265
"TRPV2"	2789	21429	4767	1441	2688	2079	740	701	1700	861	3702	2061	5454	6357	8370	6333	9511	6266
"TRPV3"	3528	44805	0	0	0	0	0	0	98	24	0	0	0	0	0	0	0	0
"TRPV4"	3258	31804	34	0	20	14	0	0	364	49	0	11	48	34	66	42	149	126
"TRPV5"	2501	25174	0	0	0	0	0	0	22	15	0	0	0	0	0	0	0	0
"TRPV6"	3088	6821	0	0	0	0	0	0	52	23	0	0	0	0	0	0	0	0
"TRRAP"	12747	134753	6346	4088	3395	2951	2193	1895	3533	2070	2551	4133	3101	3980	3571	3689	4722	3418
"TRUB1"	3419	39488	64	0	53	11	0	0	53	0	0	0	409	361	409	259	464	273
"TRUB2"	1447	13303	10	0	10	0	0	0	96	54	12	0	285	231	391	269	565	327
"TRV3J34"	473	562	0	0	0	0	0	0	0	0	0	0	0	0	0	0	0	0
"TRX2"	1290	14596	510	88	309	201	42	46	337	192	264	242	1691	646	1914	914	2787	940
"TRXR2A"	2043	57038	771	146	465	306	61	85	1214	499	443	417	416	336	685	664	640	624
"TRYX3"	1128	5885	0	0	0	0	0	0	0	0	0	0	0	0	0	0	0	0
"TS"	1339	15897	35	17	0	35	9	8	43	26	0	0	32	31	95	92	59	67
"TSC1"	8639	53287	1370	460	766	604	283	177	878	312	551	278	1398	1351	1933	1340	2087	1167
"TSC2"	5673	40724	1360	226	768	592	99	127	1036	538	871	457	1062	1043	1738	1381	2079	1329
"TSC22D1"	4817	143042	3156	568	1827	1329	357	211	1856	431	592	579	431	407	520	433	316	560
"TSC22D2"	3887	50827	6771	6660	3696	3075	3652	3008	2804	2989	1038	3493	876	1189	1118	1078	988	832
"TSC22D3"	2263	62559	0	0	0	0	0	0	44	27	0	0	360	107	227	63	480	112
"TSC22D4"	2386	12760	3505	1388	2004	1501	640	748	1227	1118	4958	4511	4463	3707	4812	4870	6527	5439
"TSEN15"	2078	22532	389	0	279	110	0	0	371	0	0	0	661	616	417	294	483	302
"TSEN2"	3352	47150	564	48	329	235	38	10	657	45	51	22	160	134	154	93	201	136
"TSEN34"	1557	2945	16	0	12	4	0	0	49	37	0	0	358	272	194	357	350	191
"TSEN54"	1952	8213	0	0	0	0	0	0	22	10	13	0	187	164	168	101	218	96
"TSFM"	2304	14833	40	11	15	25	11	0	81	39	0	8	265	338	351	249	366	227
"TSG1"	4823	28452	0	0	0	0	0	0	0	0	0	0	0	0	0	0	0	0
"TSG101"	1542	46631	712	595	453	259	342	253	508	357	119	618	1127	1374	935	908	1183	975
"TSGA10"	3705	157464	32	0	20	12	0	0	82	0	0	0	128	91	115	10	161	75
"TSGA10IP"	1732	14321	0	0	0	0	0	0	63	28	16	0	5	0	0	0	0	0
"TSGA13"	2055	18782	0	0	0	0	0	0	0	0	0	0	0	1	0	0	0	0
"TSGA14"	3535	44479	0	0	0	0	0	0	12	0	0	0	197	196	179	149	187	127
"TSHB"	581	4528	0	0	0	0	0	0	0	0	0	0	0	0	0	0	0	0
"TSHR"	4410	190779	0	0	0	0	0	0	211	0	0	0	0	2	0	3	0	0
"TSHZ1"	4968	79171	2002	85	1093	909	44	41	1852	148	323	32	657	457	778	323	750	360
"TSHZ2"	4355	515090	0	0	0	0	0	0	14	0	0	0	0	0	0	0	0	0
"TSHZ3"	4913	74339	3258	635	1801	1457	307	328	2222	832	334	404	376	287	325	196	499	189
"TSIX"	37028	37028	15132	13408	8497	6635	8003	5405	7402	5803	23962	24148	0	0	0	0	19492	10936
"TSKS"	1822	23505	0	1	0	0	0	1	108	40	0	0	23	33	7	0	7	20
"TSKU"	2711	14914	49	86	17	32	52	34	48	449	0	90	420	1119	325	418	543	864
"TSL-A"	1313	11518	275	14	174	101	0	14	106	9	0	0	0	0	0	0	0	0
"TSLP"	3839	7946	0	0	0	0	0	0	11	11	0	0	0	20	0	4	0	6
"TSN"	3512	12307	61	10	52	9	10	0	112	18	0	0	1640	1434	1547	1055	1743	968
"TSNARE1"	2124	132698	4365	7563	2260	2105	4086	3477	3264	4349	2033	5319	414	579	637	618	1094	741
"TSNAX"	2653	37870	466	43	278	188	28	15	378	0	39	0	1242	1214	1105	628	1092	789
"TSNAXIP1"	2461	20962	0	0	0	0	0	0	58	71	1	0	0	0	0	0	3	0
"TSP50"	1776	6192	0	0	0	0	0	0	56	52	0	0	0	0	0	0	0	0
"TSPAN-3"	1562	25183	2513	812	1597	916	432	380	803	299	267	531	2247	1931	936	826	1223	789
"TSPAN1"	1624	10873	0	0	0	0	0	0	77	0	0	0	0	1	0	0	0	0
"TSPAN10"	1718	4260	1	0	1	0	0	0	14	24	0	0	0	0	0	0	0	0
"TSPAN11"	5836	70176	0	0	0	0	0	0	171	49	0	0	0	0	0	0	0	0
"TSPAN12"	2570	70803	0	0	0	0	0	0	0	0	0	0	0	0	4	0	0	0
"TSPAN13"	1906	30810	0	0	0	0	0	0	0	0	0	0	0	3	5	0	0	0
"TSPAN14"	5587	68354	9932	3101	5498	4434	1685	1416	4263	2659	7330	2270	5180	4451	5656	4580	5908	3924
"TSPAN15"	1707	56199	2064	223	1119	945	131	92	1819	200	795	20	1321	1165	587	368	1422	906
"TSPAN16"	1054	19821	33	0	19	14	0	0	140	24	41	0	730	362	562	242	525	251
"TSPAN17"	2894	11669	419	63	181	238	32	31	342	96	302	32	1431	1076	1163	788	1823	1017
"TSPAN18"	3054	70999	70	0	42	28	0	0	359	166	0	0	0	0	0	0	0	0
"TSPAN19"	1028	21962	0	0	0	0	0	0	0	0	0	0	0	0	0	0	0	0
"TSPAN2"	3212	41482	0	0	0	0	0	0	19	0	0	0	11	0	4	0	0	0
"TSPAN3"	1831	25183	2513	812	1597	916	432	380	803	299	267	531	2247	1931	936	826	1223	789
"TSPAN31"	1745	3243	18	26	0	18	26	0	46	47	47	0	999	1748	976	1024	1160	893
"TSPAN32"	1386	16189	5719	1877	3120	2599	987	890	1862	964	5670	2324	1453	1133	2440	1721	4583	2163
"TSPAN33"	1925	23961	2612	1907	1465	1147	1008	899	1358	1370	1325	3264	3612	3421	2678	2899	7012	5289
"TSPAN4"	1471	22672	742	61	405	337	36	25	684	290	181	0	408	360	1491	1310	1770	1271
"TSPAN5"	1429	186320	37	0	20	17	0	0	64	14	0	0	59	15	6	6	39	59
"TSPAN6"	2077	8001	0	0	0	0	0	0	0	0	0	0	0	0	0	0	0	0
"TSPAN7"	1865	127442	38	31	27	11	15	16	54	0	0	16	223	212	111	112	231	108
"TSPAN8"	1516	316803	0	0	0	0	0	0	0	0	0	0	0	0	0	0	0	0
"TSPAN9"	4323	209174	0	0	0	0	0	0	833	263	0	0	0	0	0	0	0	0
"TSPEAR"	4042	213722	4	0	0	4	0	0	561	161	0	0	185	194	4	22	0	0
"TSPO"	869	11714	1164	1522	646	518	775	747	394	982	994	2709	4343	4257	4688	6868	7231	5969
"TSPO2"	1016	1839	0	0	0	0	0	0	14	0	0	35	0	0	0	0	0	0
"TSPY1"	1482	42827	0	0	0	0	0	0	0	0	0	0	0	0	0	0	0	0
"TSPY2"	1177	2791	0	0	0	0	0	0	0	0	0	0	0	0	0	0	0	0
"TSPY3"	1925	2784	0	0	0	0	0	0	0	0	0	0	0	0	0	0	0	0
"TSPYL1"	3534	3534	272	51	144	128	13	38	99	30	0	33	2325	1856	2409	1403	3198	1742
"TSPYL2"	2821	6174	43	0	29	14	0	0	0	17	0	0	78	85	78	46	160	55
"TSPYL3"	1216	1216	0	0	0	0	0	0	20	166	0	26	0	0	0	0	0	0
"TSPYL4"	4130	4130	0	0	0	0	0	0	12	0	0	0	157	130	265	81	209	32
"TSPYL5"	4463	4463	0	12	0	0	0	12	0	0	0	0	403	460	278	147	332	172
"TSPYL6"	3096	3096	14	11	14	0	0	11	13	10	0	0	0	0	0	0	0	0
"TSR1"	4885	14688	360	269	187	173	165	104	205	230	60	294	1728	1987	1771	1627	1862	1318
"TSR2"	1328	4877	57	0	26	31	0	0	68	39	0	14	526	605	784	620	847	625
"TSSC1"	2024	130706	3051	421	1696	1355	229	192	2996	986	1657	722	370	283	465	534	509	602
"TSSC4"	1607	3118	626	1123	410	216	759	364	330	895	256	2525	471	494	496	786	748	761
"TSSC6"	2155	3166	5719	1877	3120	2599	987	890	1862	964	5670	2324	1453	1133	2440	1721	4583	2163
"TSSK1B"	2479	2479	0	0	0	0	0	0	0	0	0	0	0	0	0	0	0	0
"TSSK2"	1817	1817	0	0	0	0	0	0	0	0	0	0	0	0	0	0	0	0
"TSSK3"	1315	2062	205	278	72	133	143	135	304	91	274	236	0	1485	144	1	0	121
"TSSK4"	1289	2492	355	157	174	181	100	57	214	87	0	155	0	68	84	1	0	0
"TSSK6"	1518	3129	0	0	0	0	0	0	18	35	0	0	33	0	33	0	28	0
"TST"	1757	8568	188	1	134	54	0	1	198	22	85	0	355	378	267	371	409	426
"TSTA3"	1369	4946	40	0	10	30	0	0	37	51	0	0	417	491	775	604	870	385
"TSTD1"	673	1352	180	0	180	0	0	0	23	0	0	0	115	24	86	63	205	89
"TSTD2"	4436	33600	786	548	453	333	317	231	630	545	0	666	829	369	784	387	972	453
"TTBK1"	7143	44777	1	0	1	0	0	0	187	50	0	0	0	0	0	0	0	0
"TTBK2"	5640	176467	1431	185	841	590	100	85	1308	173	293	290	725	309	274	260	284	216
"TTC1"	1414	56371	849	141	520	329	83	58	582	219	100	95	945	913	913	864	1114	741
"TTC12"	2949	51791	80	4	38	42	4	0	201	0	15	0	139	157	147	111	164	88
"TTC13"	3298	72619	7185	1660	3876	3309	907	753	3641	640	2214	731	1567	1383	1636	1211	3142	1129
"TTC14"	4796	9001	1317	367	699	618	184	183	691	100	306	34	1108	888	1422	594	1689	567
"TTC15"	2536	99898	8236	3256	4443	3793	1731	1525	4208	1803	5774	3256	1854	1916	2567	1748	2984	1851
"TTC16"	2898	15523	0	0	0	0	0	0	98	42	0	0	0	1	729	0	1019	0
"TTC17"	3503	135004	12345	7453	6838	5507	4118	3335	5708	3433	3757	5278	2218	2905	2151	1834	2214	1281
"TTC18"	3731	105102	0	8	0	0	0	8	10	9	0	16	4	3	6	0	30	0
"TTC19"	2794	29316	2812	1496	1559	1253	841	655	1603	628	963	531	1161	962	724	595	968	566
"TTC21A"	4287	31244	225	6689	136	89	602	6087	151	1140	18	1424	63	72	74	63	97	66
"TTC21B"	4924	79896	278	51	152	126	31	20	304	33	30	9	402	430	336	301	399	279
"TTC22"	2224	16718	0	0	0	0	0	0	42	0	0	0	0	0	0	0	0	0
"TTC23"	3914	113288	7	0	7	0	0	0	67	32	2	0	158	162	141	86	216	90
"TTC23L"	3082	5410	1	0	0	1	0	0	16	0	0	0	0	0	1	0	0	1
"TTC24"	1613	4882	0	0	0	0	0	0	44	0	0	0	0	0	0	0	0	0
"TTC25"	2089	30780	0	0	0	0	0	0	73	28	3	0	0	1	0	0	0	0
"TTC26"	2169	56062	7	0	7	0	0	0	20	0	0	0	0	5	0	0	0	6
"TTC27"	2894	192989	46	51	33	13	29	22	154	97	36	91	423	390	335	273	376	287
"TTC28"	11816	701851	14	0	14	0	0	0	380	23	0	12	2	12	22	31	14	3
"TTC29"	1953	238856	0	0	0	0	0	0	0	0	0	0	0	0	0	0	0	0
"TTC3"	9122	117318	9342	2849	5295	4047	1555	1294	4431	1303	4309	2793	4480	4736	5677	5725	8894	5389
"TTC30A"	4669	4669	0	0	0	0	0	0	0	0	0	0	78	14	26	0	0	0
"TTC30B"	2640	2640	0	0	0	0	0	0	0	0	0	0	45	22	83	1	36	0
"TTC31"	2942	11493	592	61	289	303	27	34	395	154	323	144	675	635	984	568	1363	620
"TTC32"	818	5228	352	44	218	134	44	0	164	45	0	78	206	161	226	162	350	83
"TTC33"	5509	44394	129	161	85	44	114	47	201	297	0	210	492	503	479	412	535	328
"TTC35"	1249	43285	619	94	372	247	54	40	348	32	0	47	613	741	695	544	616	371
"TTC36"	818	3532	23	0	23	0	0	0	23	0	0	0	0	0	0	0	0	0
"TTC37"	5196	90561	825	82	470	355	37	45	830	58	72	29	1325	1658	1845	1681	2269	1489
"TTC38"	2622	26044	155	43	44	111	24	19	336	121	103	14	570	508	617	495	778	513
"TTC39A"	6266	34098	0	0	0	0	0	0	86	69	0	0	0	0	0	0	0	0
"TTC39B"	2462	60883	5442	9480	3100	2342	5107	4373	2067	3578	4001	14361	706	1441	605	663	411	458
"TTC39C"	5253	121191	3949	297	2117	1832	188	109	2032	240	1162	517	493	534	514	473	500	386
"TTC4"	5801	100555	23	148	0	23	75	73	435	223	25	41	331	306	577	392	799	439
"TTC5"	1873	16852	68	7	54	14	3	4	72	0	44	0	169	195	225	158	225	167
"TTC6"	2349	47183	0	0	0	0	0	0	0	0	0	0	0	0	0	0	0	0
"TTC7A"	5250	134963	31354	5894	17211	14143	3275	2619	12998	2202	23057	2900	5046	5228	5509	4416	8733	5068
"TTC7B"	3453	275830	8222	4256	4642	3580	2317	1939	6629	5053	3439	6243	867	867	905	862	1733	1265
"TTC8"	2325	53418	304	0	160	144	0	0	300	0	0	0	258	283	306	207	341	217
"TTC9"	5220	33575	0	0	0	0	0	0	18	8	0	0	84	72	23	17	128	127
"TTC9B"	844	2341	0	0	0	0	0	0	0	16	0	0	0	0	0	0	0	0
"TTC9C"	1422	10523	1180	28	676	504	12	16	574	33	1334	38	2386	1811	1175	768	1988	1303
"TTF1"	3144	31284	51	43	0	51	21	22	151	0	0	52	300	282	308	156	334	179
"TTF2"	4875	42542	467	52	260	207	20	32	354	150	105	205	588	720	630	522	737	449
"TTK"	2997	37880	0	0	0	0	0	0	0	0	0	0	7	0	3	3	0	3
"TTL"	5166	50477	7740	2954	4462	3278	1610	1344	3239	1365	4624	2849	5183	4859	4340	3629	6074	3525
"TTL/TEL fusion"	4106	133872	0	0	0	0	0	0	136	32	0	0	0	0	0	0	0	0
"TTLL1"	1887	49912	5	0	1	4	0	0	191	32	0	4	123	113	131	63	210	114
"TTLL10"	2294	24029	1	375	1	0	208	167	142	257	0	591	0	75	0	24	0	20
"TTLL11"	3261	271682	1073	19	689	384	19	0	1108	156	64	87	164	114	143	93	177	71
"TTLL12"	3366	20480	253	16	124	129	3	13	349	142	104	99	1218	1051	1287	492	1954	1350
"TTLL13"	1803	9550	0	0	0	0	0	0	42	45	0	0	0	0	0	1	3	0
"TTLL2"	2880	17605	0	0	0	0	0	0	14	0	0	0	0	0	0	0	0	0
"TTLL3"	4797	17760	7088	5526	3971	3117	2977	2549	2802	2686	6236	6403	12204	13150	11110	10587	15137	10543
"TTLL4"	5014	44570	470	36	223	247	9	27	449	106	400	140	672	632	831	697	934	644
"TTLL5"	4715	293802	3045	2202	1967	1078	1355	847	2722	1858	299	1494	360	399	385	378	368	271
"TTLL6"	4519	54877	0	0	0	0	0	0	16	0	0	0	0	0	0	0	0	0
"TTLL7"	3916	129776	0	0	0	0	0	0	0	0	0	0	0	0	9	3	0	0
"TTLL8"	2518	39504	0	0	0	0	0	0	132	82	0	0	0	3	0	0	0	0
"TTLL9"	3033	65135	0	0	0	0	0	0	127	13	0	0	0	4	0	0	0	3
"TTMP"	3728	19552	0	0	0	0	0	0	0	0	0	0	0	0	0	0	0	0
"TTN"	101804	281432	6043	19098	3472	2571	10271	8827	4329	19829	2120	23726	1120	4982	1811	6584	2119	2196
"TTPA"	1254	25183	0	0	0	0	0	0	0	0	0	0	0	0	0	0	0	0
"TTPAL"	6221	18699	436	189	293	143	103	86	144	105	76	173	307	401	233	203	314	139
"TTR"	930	7256	0	0	0	0	0	0	0	0	0	0	0	0	0	0	0	0
"TTRAP"	1931	16911	878	144	454	424	90	54	554	113	227	105	1805	1527	1706	1649	2031	1095
"TTS-2.1"	1319	1691	153	30	88	65	16	14	12	63	109	0	799	760	1308	1210	1040	1037
"TTTY15"	5245	29856	0	0	0	0	0	0	0	0	0	0	20	39	0	16	0	0
"TTTY16"	194	1892	0	0	0	0	0	0	0	0	0	0	0	0	1	0	0	0
"TTTY17"	166	1131	0	0	0	0	0	0	0	0	0	0	0	0	0	0	0	0
"TTTY18"	223	510	0	0	0	0	0	0	0	0	0	0	0	0	0	0	0	0
"TTTY19"	271	813	0	0	0	0	0	0	0	0	0	0	0	0	0	0	0	0
"TTTY20"	260	4953	0	0	0	0	0	0	0	0	0	0	0	0	0	0	0	0
"TTTY21"	309	3645	0	0	0	0	0	0	0	0	0	0	0	0	0	0	0	0
"TTTY22"	432	12094	0	0	0	0	0	0	0	0	0	0	0	0	0	0	0	0
"TTTY23"	515	1166	0	0	0	0	0	0	0	0	0	0	0	0	0	0	0	0
"TTTY6B"	473	1846	0	0	0	0	0	0	0	0	0	0	0	0	0	0	0	0
"TTY1"	945	21165	0	0	0	0	0	0	0	0	0	0	0	0	0	0	0	0
"TTY10"	1634	53562	0	0	0	0	0	0	0	0	0	0	0	0	0	0	0	0
"TTY11"	834	34066	0	0	0	0	0	0	0	0	0	0	0	0	0	0	0	0
"TTY12"	978	5758	0	0	0	0	0	0	0	0	0	0	0	0	0	0	0	0
"TTY13"	664	11067	0	0	0	0	0	0	0	0	0	0	0	0	0	0	0	0
"TTY14"	515	144717	678	172	379	299	88	84	684	141	0	0	186	218	36	0	131	21
"TTY2"	1640	22201	0	0	0	0	0	0	0	0	0	0	0	0	0	0	0	0
"TTY3"	347	4897	0	0	0	0	0	0	0	0	0	0	0	0	0	0	0	0
"TTY4"	1349	36830	0	0	0	0	0	0	0	0	0	0	0	0	0	0	0	0
"TTY5"	1563	2079	0	0	0	0	0	0	0	0	0	0	0	0	0	0	0	0
"TTY6"	595	1868	0	0	0	0	0	0	0	0	0	0	0	0	0	0	0	0
"TTY7"	1372	8438	0	0	0	0	0	0	0	0	0	0	0	0	0	0	0	0
"TTY8"	533	2600	0	0	0	0	0	0	0	0	0	0	0	0	0	0	0	0
"TTY9"	1642	9317	0	0	0	0	0	0	0	0	0	0	0	0	0	0	0	0
"TTYH1"	3688	14522	787	77	478	309	59	18	428	204	595	307	0	0	0	0	20	0
"TTYH2"	3457	48461	4031	19229	2261	1770	10210	9019	1065	6971	1210	19702	1091	4013	1212	3983	1437	1962
"TTYH3"	4827	32826	10821	9653	5721	5100	4957	4696	2850	5465	11581	13511	11568	10602	17704	18025	19660	16166
"TU12B1-TY"	1133	6703	0	0	0	0	0	0	24	0	0	0	116	320	29	1	70	5
"TUB"	6427	67475	0	0	0	0	0	0	116	80	0	0	0	0	0	0	0	0
"TUBA1A"	1840	3891	2061	1407	1139	922	766	641	687	405	582	501	63809	5841	98862	9657	127516	79181
"TUBA1B"	3202	3612	2536	1357	1400	1136	753	604	708	512	610	699	69547	37545	104509	49788	137326	84728
"TUBA1C"	1811	45406	545	562	330	215	339	223	293	381	158	844	3963	4419	26102	27382	35807	25261
"TUBA3C"	1490	8018	0	0	0	0	0	0	11	0	0	0	0	0	0	0	0	0
"TUBA3D"	1548	6840	0	0	0	0	0	0	22	12	0	0	0	0	0	0	0	0
"TUBA3E"	1542	6715	0	0	0	0	0	0	0	0	0	0	0	0	0	0	0	0
"TUBA4A"	1935	4331	94	69	49	45	24	45	81	71	0	0	2205	2051	1622	212	2768	242
"TUBA4B"	1384	18947	0	0	0	0	0	0	32	44	0	0	61	25	78	0	145	77
"TUBA8"	2776	53814	1610	1307	922	688	727	580	855	1656	333	2329	1436	1612	1238	1071	1348	901
"TUBAL3"	1801	11733	0	0	0	0	0	0	0	0	0	0	0	0	0	0	0	0
"TUBB"	2555	3773	974	760	511	463	413	347	246	412	94	523	20331	28300	3166	27635	33093	27622
"TUBB1"	3498	7400	303	198	180	123	113	85	174	70	0	29	40	77	0	20	28	24
"TUBB2A"	2171	18329	6794	6867	3888	2906	3656	3211	2258	3201	4215	6349	6455	9598	6959	10248	9913	8116
"TUBB2B"	2022	3474	0	0	0	0	0	0	0	0	0	0	0	6	514	793	507	574
"TUBB2C"	2067	2449	1235	917	653	582	502	415	475	577	221	631	24556	32775	8242	33614	40533	33660
"TUBB3"	3728	5664	0	0	0	0	0	0	118	61	0	0	100	111	313	61	451	475
"TUBB4"	2812	7992	0	0	0	0	0	0	22	0	0	0	2	0	0	0	0	0
"TUBB4Q"	1552	2435	0	0	0	0	0	0	0	0	0	0	0	0	0	0	0	0
"TUBB6"	1912	3474	6996	7078	3875	3121	3787	3291	2258	3305	4394	6541	8071	10963	8117	11043	11444	9082
"TUBB8"	1608	2678	0	0	0	0	0	0	0	0	0	0	0	0	0	0	0	0
"TUBBP5"	2664	27321	0	0	0	0	0	0	16	0	0	0	0	0	0	0	0	0
"TUBD1"	2481	33447	40	0	24	16	0	0	112	2	61	15	90	108	156	94	142	109
"TUBE1"	2308	16892	48	0	19	29	0	0	117	0	0	0	106	117	181	105	494	233
"TUBG1"	1960	5898	42	0	0	42	0	0	171	0	0	0	262	263	442	552	954	349
"TUBG2"	1968	7700	93	10	52	41	10	0	96	23	5	0	89	56	240	176	398	212
"TUBGCP2"	3579	32705	2392	1013	1278	1114	558	455	1542	919	1849	1555	2667	2290	3109	2971	4145	2656
"TUBGCP3"	3912	103155	5415	325	2977	2438	175	150	3491	129	1606	151	1166	998	1278	805	1356	908
"TUBGCP4"	3088	34927	59	11	17	42	7	4	110	11	67	61	784	687	327	238	299	190
"TUBGCP5"	3869	40496	354	52	174	180	33	19	363	16	143	27	305	430	548	372	509	341
"TUBGCP6"	6044	27284	1104	626	644	460	308	318	903	668	1183	587	726	1047	1619	995	2418	1326
"TUFM"	2081	3999	338	53	204	134	29	24	80	63	0	66	2548	2325	3608	2774	3249	3620
"TUFT1"	3263	43279	0	43	0	0	37	6	49	147	0	0	0	73	13	62	24	21
"TUG1"	5563	7130	2918	2912	1897	1021	1517	1395	1664	1272	2167	2011	3913	5384	4847	4688	5333	3418
"TULP1"	2107	14996	0	0	0	0	0	0	74	20	0	0	0	0	0	0	0	0
"TULP2"	1773	17776	453	21800	269	184	11544	10256	72	12715	0	15815	0	77	0	82	6	0
"TULP3"	3117	50275	0	0	0	0	0	0	92	0	4	0	115	137	165	118	193	117
"TULP4"	11131	199164	3293	1235	1896	1397	615	620	2053	1056	229	1158	639	793	747	702	1044	672
"TUSC1"	2464	2464	0	0	0	0	0	0	0	0	0	0	84	52	92	65	166	80
"TUSC2"	1685	3329	26	0	20	6	0	0	63	13	0	0	501	421	571	439	846	487
"TUSC3"	1600	224265	0	0	0	0	0	0	0	0	0	0	0	0	0	0	0	0
"TUSC4"	1926	3280	235	0	145	90	0	0	175	119	57	90	89	482	666	414	905	394
"TUSC5"	3599	21326	15	42	15	0	23	19	111	40	0	12	0	0	0	0	0	0
"TUT1"	2835	16594	31	7	24	7	0	7	184	125	40	0	375	173	463	284	584	149
"TUWD12"	3048	105841	687	199	398	289	126	73	571	342	90	351	868	801	728	895	789	559
"TVAS2"	4019	43558	9576	8950	5416	4160	4911	4039	3281	3596	3492	7349	26347	29829	28048	26113	33236	20708
"TVAS4"	2741	2741	0	0	0	0	0	0	0	0	0	0	0	0	0	0	0	0
"TVAS5"	2555	2555	0	0	0	0	0	0	0	0	0	0	0	0	0	0	0	0
"TVAS7"	2578	2578	64	0	18	46	0	0	26	32	0	0	716	669	726	566	908	577
"TWF1"	3312	12522	78	0	55	23	0	0	146	11	0	0	664	755	1408	1190	1279	928
"TWF2"	1633	10558	1033	100	508	525	45	55	376	61	1432	68	4719	3225	7125	2608	8142	4990
"TWIST1"	1666	2204	0	0	0	0	0	0	0	0	0	0	0	8	0	0	0	0
"TWIST2"	1176	39220	0	0	0	0	0	0	39	22	0	0	0	0	0	0	0	0
"TWISTNB"	3896	13577	10	0	0	10	0	0	17	26	0	0	63	598	451	431	392	255
"TWSG1"	3920	67654	210	289	134	76	233	56	110	158	19	196	777	1053	1187	954	1079	741
"TXK"	2927	67863	42	41	21	21	27	14	118	54	0	24	11	40	20	22	5	7
"TXL2"	1781	63495	739	164	443	296	113	51	406	31	0	92	656	503	788	562	1005	614
"TXLNA"	5021	18221	1889	1400	1038	851	797	603	645	771	1195	1657	2932	2880	3647	2603	3927	2594
"TXLNB"	4694	52011	0	0	0	0	0	0	15	0	0	0	58	106	0	0	6	4
"TXN"	513	12470	4245	19604	2381	1864	10527	9077	944	7562	3036	13863	2371	8826	5242	8147	7630	7929
"TXN2"	1340	14596	510	88	309	201	42	46	337	192	264	242	1691	646	1914	914	2787	940
"TXNDC11"	3141	63707	3862	2227	2174	1688	1283	944	1823	1681	831	2133	2352	933	1184	1154	1317	956
"TXNDC12"	1603	35242	410	101	264	146	54	47	314	192	0	194	831	1013	1100	1549	2305	1641
"TXNDC15"	3694	27865	696	71	403	293	49	22	267	12	205	65	828	892	791	657	823	666
"TXNDC16"	4764	121994	7	4	7	0	4	0	41	16	0	0	276	319	199	209	286	163
"TXNDC17"	2078	3640	159	0	65	94	0	0	158	8	0	0	0	21	999	729	1160	733
"TXNDC2"	2125	2429	0	0	0	0	0	0	0	0	0	0	0	15	0	0	2	0
"TXNDC3"	2327	51803	747	240	362	385	117	123	821	128	0	164	256	317	201	157	217	96
"TXNDC5"	3094	182895	301	36	206	95	25	11	408	49	38	25	2071	1899	2777	882	2363	1734
"TXNDC6"	2145	68451	739	164	443	296	113	51	406	31	0	92	656	503	788	562	1005	614
"TXNDC8"	497	34259	11	0	11	0	0	0	0	0	0	0	0	0	0	0	0	0
"TXNDC9"	1533	17373	221	88	144	77	58	30	197	71	137	22	795	795	946	713	963	737
"TXNIP"	2933	4166	4304	1193	2382	1922	627	566	2527	534	3734	1147	46547	10352	49778	8339	53167	10406
"TXNL1"	3626	30228	894	1775	571	323	1033	742	473	1104	102	1434	802	1418	1060	1410	1349	1169
"TXNL4A"	1459	15665	2048	186	1132	916	84	102	1113	254	746	476	1238	804	1224	780	1347	747
"TXNL4B"	2543	8783	152	67	71	81	50	17	270	133	0	76	242	440	274	319	335	319
"TXNRD1"	3916	63333	8383	3232	4772	3611	1710	1522	3145	914	4212	3047	12845	12279	15662	14294	15429	12482
"TXNRD2"	3203	66314	771	146	465	306	61	85	1214	499	443	417	416	336	685	664	640	624
"TXNRD3"	2472	47611	11	0	8	3	0	0	6	0	0	0	115	113	106	84	137	89
"TXNRD3IT1"	1215	36855	11	0	8	3	0	0	19	0	0	0	54	42	32	11	39	30
"TYK2"	4272	30045	3901	2286	2140	1761	1227	1059	1432	1143	4478	3987	3731	2558	5780	4883	7517	5275
"TYMP"	1701	4332	3282	5957	1539	1743	3125	2832	456	3399	1846	6712	4842	8810	4714	7473	6775	4801
"TYMS"	1590	15897	35	17	0	35	9	8	43	26	0	0	32	31	95	92	59	67
"TYR"	2069	117888	0	0	0	0	0	0	0	0	0	0	0	0	0	0	0	0
"TYRO3"	3968	20296	0	0	0	0	0	0	72	8	0	0	0	0	0	0	0	3
"TYROBP"	568	3882	72	87	50	22	52	35	161	10	49	229	6782	1371	8726	11776	4411	9437
"TYRP1"	2883	16881	0	0	0	0	0	0	0	0	0	0	0	0	0	0	0	0
"TYSND1"	3804	8763	472	114	276	196	63	51	252	84	349	104	519	350	607	341	809	456
"TYW1"	3344	242681	774	221	451	323	138	83	783	301	228	309	396	372	587	526	848	572
"TYW1B"	3169	259322	150	29	100	50	21	8	307	133	0	89	213	199	144	153	352	255
"TYW3"	3527	33498	427	0	270	157	0	0	332	58	0	36	777	814	613	485	820	531
"Tie-2"	906	64215	0	0	0	0	0	0	0	0	0	0	0	0	0	0	0	0
"Tmp21-II"	4033	4033	52	0	32	20	0	0	96	0	0	0	316	13	21	5	5	3
"Tom5"	3242	9992	72	19	31	41	19	0	55	97	0	70	456	515	869	738	771	660
"Tom6"	3299	9136	37	29	21	16	14	15	61	60	0	18	720	2268	2593	2253	3209	2337
"TopBP1"	984	10340	159	17	72	87	17	0	59	0	0	17	159	324	290	203	459	183
"Trad"	772	66281	0	0	0	0	0	0	0	11	0	0	0	0	0	0	0	0
"Trip230"	1360	10066	157	0	85	72	0	0	74	0	61	24	56	63	109	66	96	47
"U00684"	554	18761	64	26	24	40	26	0	0	0	0	34	0	0	125	89	159	86
"U2AF1"	2174	14617	2729	3878	1552	1177	2023	1855	1221	1878	1810	3490	1376	235	2143	2452	2169	1970
"U2AF1L4"	1844	2211	219	36	120	99	25	11	151	126	60	111	640	574	341	246	492	253
"U2AF2"	3142	20667	2896	1995	1653	1243	1114	881	987	1135	2714	3385	2887	2905	3987	3191	4528	3393
"U42379"	52	52	29	0	15	14	0	0	15	0	4	1	27	0	33	47	77	49
"U48725"	276	276	0	0	0	0	0	0	0	0	0	0	0	0	0	0	0	0
"U48729"	871	871	0	0	0	0	0	0	0	0	0	0	0	0	0	0	0	0
"U50535"	2314	2314	2364	2043	2357	7	1113	930	0	0	1	0	27	3751	170	145	126	60
"U52827"	2326	2326	0	0	0	0	0	0	19	0	0	0	0	0	0	0	0	0
"U58"	91	91	0	176	0	0	81	95	0	30	0	0	623	719	1349	0	0	1449
"U79272"	4099	4099	194	48	100	94	37	11	140	88	18	30	826	1105	695	717	860	596
"U80769"	586	90119	667	577	474	193	299	278	787	741	159	415	340	182	411	427	409	275
"U80770"	1136	129332	147	194	115	32	109	85	414	136	0	117	0	0	0	0	0	0
"U80773"	1524	12326	0	0	0	0	0	0	0	0	0	0	0	0	0	0	0	0
"U84523"	117	117	0	0	0	0	0	0	17	0	0	0	0	0	0	0	0	0
"U87HG"	476	3614	179	229	100	79	116	113	16	18	31	0	216	542	459	445	747	460
"U90917"	1303	2504	139	21	60	79	21	0	77	21	0	0	91	57	100	38	212	72
"U92992"	1163	60481	1	0	1	0	0	0	22	0	0	0	0	0	0	0	0	0
"UACA"	7097	47727	97	15	49	48	15	0	144	0	0	0	268	331	222	137	259	146
"UAP1"	2336	38338	52	1188	39	13	765	423	58	1402	0	2016	398	1298	462	1398	422	799
"UAP1L1"	3373	7038	1237	409	687	550	205	204	496	258	1483	364	1010	782	2592	1446	3798	2145
"UBA1"	3624	21327	2664	2510	1450	1214	1349	1161	1102	1570	900	2941	7444	7571	6376	6707	9755	7215
"UBA2"	2821	41018	1694	969	971	723	527	442	791	681	521	2144	1348	1769	1941	1921	2179	1726
"UBA3"	2136	25644	1717	220	915	802	110	110	960	151	760	305	2329	1564	2103	1372	2403	1350
"UBA5"	3042	17805	787	58	453	334	23	35	573	68	125	93	824	650	778	517	864	413
"UBA52"	3438	5582	197	161	89	108	80	81	124	189	67	422	3932	4196	7350	7383	9800	7285
"UBA6"	6479	85411	3111	2088	1725	1386	1241	847	4334	1728	800	1590	1727	2351	1699	1558	908	718
"UBA7"	3336	8754	1201	476	653	548	214	262	673	368	853	431	2249	2087	2983	1811	4337	2290
"UBAC1"	1876	28412	2530	267	1462	1068	156	111	1582	128	1816	119	2292	1741	2373	1820	3147	1740
"UBAC2"	2834	185590	17171	24352	9605	7566	13234	11118	7676	12071	3639	14146	3740	31911	3956	27394	3553	15612
"UBAP1"	2865	73511	2771	4777	1590	1181	2608	2169	1027	2488	741	5555	1577	1749	1736	1675	2124	1569
"UBAP2"	4313	127258	1379	781	721	658	466	315	693	778	74	972	458	453	620	514	739	546
"UBAP2L"	4021	50662	14898	10638	8313	6585	5786	4852	6192	3640	8909	7539	9515	8605	9641	8100	13446	7577
"UBASH3A"	2907	43755	2	0	2	0	0	0	156	103	0	0	0	4	0	0	0	0
"UBASH3B"	6916	158790	17439	22218	9644	7795	11999	10219	7106	13450	10188	17968	1676	1819	1835	1519	2088	1286
"UBB"	1442	2343	2371	2579	1361	1010	1383	1196	876	1173	1424	1079	45133	34513	79543	53660	95135	19539
"UBC"	2574	3385	2229	2379	1270	959	1272	1107	796	1076	1424	1006	34178	22238	61018	32521	75077	1076
"UBD"	991	4314	0	0	0	0	0	0	0	0	0	0	0	22	63	1	46	15
"UBE1C"	1966	25644	1717	220	915	802	110	110	960	151	760	305	2329	1564	2103	1372	2403	1350
"UBE2A"	2642	4081	571	637	294	277	343	294	272	360	204	600	2494	3020	2147	2263	2438	1892
"UBE2B"	2636	20930	1392	1517	785	607	890	627	673	888	633	2343	1557	2110	1190	1463	1285	1453
"UBE2C"	1453	4341	0	0	0	0	0	0	11	6	0	0	0	0	0	0	0	0
"UBE2CBP"	3246	29784	273	46	166	107	46	0	226	57	0	12	26	82	49	24	57	30
"UBE2D1"	2658	35772	257	117	180	77	73	44	318	90	0	27	789	829	912	905	920	749
"UBE2D2"	2872	67267	4294	1891	2411	1883	1102	789	1857	1613	2741	5108	1456	1558	1442	1226	1801	1342
"UBE2D3"	2583	31973	9650	10997	5558	4092	5918	5079	4193	3841	4954	8083	6528	8905	2884	3067	3374	2552
"UBE2D4"	1405	27118	138	59	98	40	36	23	85	54	9	18	514	474	434	374	498	293
"UBE2DNL"	740	740	0	0	0	0	0	0	0	0	0	0	0	0	0	0	0	0
"UBE2E1"	1467	85365	23461	104789	13048	10413	56511	48278	5485	52312	5289	51307	2841	7684	2784	4246	2795	2922
"UBE2E2"	1766	387514	52062	70936	29247	22815	38423	32513	23061	28606	20258	39569	767	878	826	813	1039	751
"UBE2E3"	1549	82810	3777	1362	2059	1718	732	630	2388	878	478	767	554	676	829	662	937	647
"UBE2F"	1356	74978	5411	321	3003	2408	174	147	2980	184	2184	315	1549	1465	2735	2064	3118	1984
"UBE2G1"	4212	97457	2253	191	1249	1004	131	60	1521	294	782	689	1613	1252	1619	916	1750	1089
"UBE2G2"	3031	32784	2351	1247	1360	991	665	582	1086	910	841	1049	2962	3276	2882	2554	3176	2102
"UBE2H"	2735	119796	6786	14427	3748	3038	7798	6629	2980	8635	2526	13609	1758	2176	162	216	217	135
"UBE2I"	1774	7490	2607	2633	1408	1199	1441	1192	947	1373	2369	4031	3509	3966	3753	4120	5023	3851
"UBE2J1"	4349	26276	1402	660	838	564	383	277	614	299	140	340	1070	1475	4465	4882	4926	1086
"UBE2J2"	2394	19942	1870	1703	1038	832	888	815	715	1137	992	2707	541	1274	1120	1654	1421	1084
"UBE2K"	5248	84746	10294	3061	5764	4530	1664	1397	4247	1406	6954	5192	2479	2736	2357	1951	2694	1763
"UBE2L3"	3021	56368	4144	851	2262	1882	449	402	1729	993	2078	1820	2262	2164	3469	2806	4479	3100
"UBE2L6"	1273	16326	95	0	53	42	0	0	99	27	37	0	1295	1133	738	1293	2392	635
"UBE2M"	1529	3265	52	0	27	25	0	0	64	211	0	0	432	238	635	406	815	408
"UBE2MP1"	962	962	0	0	0	0	0	0	0	0	0	0	0	354	0	0	0	0
"UBE2N"	2554	33938	2671	3251	1466	1205	1797	1454	1109	1819	283	2713	1977	2626	1739	1888	750	1684
"UBE2NL"	1184	1184	0	0	0	0	0	0	0	0	0	0	0	0	0	0	0	0
"UBE2O"	5372	63676	736	0	426	310	0	0	706	123	146	23	584	450	754	235	822	255
"UBE2Q1"	3236	10071	219	79	96	123	51	28	122	55	44	39	2444	2248	2312	1931	3156	1914
"UBE2Q2"	3116	57768	638	211	434	204	110	101	501	268	29	183	1140	1226	1281	1052	1552	1053
"UBE2QL1"	2002	43971	0	0	0	0	0	0	42	0	0	0	0	0	0	0	0	0
"UBE2QP1"	2156	43601	15	0	0	15	0	0	49	0	0	0	3	0	0	3	15	0
"UBE2QP2"	1599	60531	0	0	0	0	0	0	0	0	0	0	0	0	6354	6570	9231	6832
"UBE2R2"	4460	103219	5305	732	2954	2351	355	377	2509	399	4424	2142	1701	1470	2338	1827	2530	1896
"UBE2S"	1195	6677	21	0	10	11	0	0	13	51	0	22	5	107	534	295	681	602
"UBE2T"	914	10310	0	0	0	0	0	0	12	0	0	0	31	41	59	35	33	8
"UBE2U"	1145	40539	0	0	0	0	0	0	0	0	0	0	0	0	0	0	0	0
"UBE2V1"	2541	34833	2681	1747	1530	1151	950	797	1209	977	1174	1763	3173	3292	2871	2664	3612	2691
"UBE2V2"	1526	53459	731	156	472	259	69	87	431	273	308	860	1107	1252	1000	870	1055	789
"UBE2W"	4044	88270	25223	19707	14012	11211	10638	9069	9387	6919	16108	20156	3183	5047	3028	3082	3189	2531
"UBE2Z"	3097	20657	4848	9985	2787	2061	5363	4622	1198	3956	2646	7720	5107	8815	5424	6691	7474	6300
"UBE3A"	5487	101733	8309	6691	4650	3659	3690	3001	3712	3189	1151	4812	2730	3604	2702	1571	1847	1087
"UBE3B"	5757	59069	1210	253	638	572	160	93	1025	355	571	370	1469	1257	1714	1569	2271	1422
"UBE3C"	5460	48705	9233	3062	5003	4230	1832	1230	4114	2289	3301	3874	2606	3070	2602	2752	2754	2111
"UBE4A"	6140	39624	1754	844	951	803	457	387	792	647	362	856	2740	3158	2877	2458	3231	1916
"UBE4B"	5930	148280	1798	589	1011	787	310	279	1309	368	436	630	1340	1467	1575	1425	1807	1113
"UBFD1"	4936	16848	167	33	139	28	15	18	285	50	88	0	850	764	1109	697	1141	654
"UBIAD1"	3655	15237	63	24	28	35	5	19	108	25	0	27	733	582	564	284	502	395
"UBL3"	4350	86276	21620	28526	12062	9558	15680	12846	7269	9712	7544	18655	2536	3219	3321	1336	2635	879
"UBL4A"	2307	2876	0	0	0	0	0	0	0	10	0	0	1554	772	1680	704	264	947
"UBL4B"	1508	1508	0	0	0	0	0	0	20	0	0	0	0	0	0	0	0	0
"UBL5"	524	2231	0	0	0	0	0	0	28	52	0	0	250	696	1213	1334	1522	1141
"UBL7"	1541	15194	99	0	40	59	0	0	161	33	25	0	737	496	911	787	1202	870
"UBLCP1"	2403	22961	248	85	151	97	52	33	201	146	0	106	922	1267	917	775	1114	860
"UBN1"	7324	35693	4132	2010	2341	1791	1123	887	1845	1255	2356	2304	3169	2571	3668	2807	5114	2734
"UBN2"	14461	76752	1988	1388	1064	924	753	635	1259	1256	480	590	908	1028	1177	512	1156	437
"UBOX5"	4333	52322	1051	310	567	484	208	102	743	588	458	744	1351	1207	1125	1054	1565	967
"UBP1"	4161	52041	4537	1334	2558	1979	715	619	2132	892	1724	1367	924	2690	1503	1120	3745	894
"UBQLN1"	4178	48291	2629	910	1524	1105	478	432	1793	1142	614	1393	4516	4674	4974	4377	5232	3587
"UBQLN2"	3299	3299	337	71	181	156	54	17	120	104	55	80	2068	1927	2522	1785	2447	1577
"UBQLN3"	2347	2625	0	0	0	0	0	0	0	0	0	0	0	0	0	0	0	0
"UBQLN4"	3517	18425	143	45	84	59	27	18	189	227	0	100	724	820	1187	1123	1813	362
"UBQLNL"	2334	2334	0	0	0	0	0	0	0	0	0	0	0	0	0	0	0	0
"UBR1"	7787	163185	418	64	223	195	36	28	337	121	60	86	762	886	923	756	924	616
"UBR2"	5313	126853	5354	1039	2888	2466	636	403	2822	675	1724	795	2565	2169	2866	1727	2993	1673
"UBR3"	7990	256621	8055	5197	4613	3442	2982	2215	4875	2508	1429	2420	1886	1924	2812	2553	2925	1965
"UBR4"	15986	135746	9934	13345	5305	4629	7129	6216	4899	8525	3874	11866	4372	4178	6090	6080	8081	4166
"UBR5"	9453	158928	15673	7228	8711	6962	3910	3318	8247	3808	7193	5887	3007	3392	3852	3290	4653	2186
"UBR7"	3699	22156	25	10	14	11	5	5	39	0	17	0	870	712	906	512	1067	627
"UBTD1"	1560	72194	842	0	445	397	0	0	1014	106	224	0	363	337	662	462	616	661
"UBTD2"	3018	74147	7769	7444	4309	3460	4023	3421	3041	2904	3536	6527	1556	1560	1211	1123	1747	1078
"UBTF"	5017	16594	1281	275	527	754	162	113	442	265	779	320	2036	1408	2358	1327	3059	1589
"UBTFL1"	1182	1182	0	0	0	0	0	0	0	0	0	0	0	0	0	0	0	0
"UBXD2"	4023	31525	1517	1581	871	646	824	757	901	737	355	650	4033	4326	3950	3308	4082	2732
"UBXN1"	2090	2574	266	119	137	129	77	42	136	119	0	90	1679	1289	1986	1682	1150	896
"UBXN10"	2973	7365	0	0	0	0	0	0	0	0	0	0	0	0	0	0	0	0
"UBXN11"	1905	22344	1176	647	209	967	329	318	904	445	1237	590	5666	5179	3908	6677	4816	7674
"UBXN2A"	2210	73538	53	67	28	25	30	37	72	60	0	93	400	592	160	240	265	89
"UBXN2B"	5075	40238	709	0	453	256	0	0	422	7	0	0	1063	854	648	404	595	349
"UBXN4"	4026	43445	2215	2283	1301	914	1146	1137	1342	1031	639	1357	4083	4516	4131	3530	4131	2831
"UBXN6"	1667	12531	484	133	301	183	86	47	287	194	463	251	2415	1537	2062	2532	2311	2400
"UBXN7"	4741	78976	1277	310	683	594	144	166	693	111	282	385	161	256	920	566	915	390
"UBXN8"	1627	22829	0	0	0	0	0	0	11	3	0	0	109	57	108	107	125	83
"UCA1"	1416	6475	0	0	0	0	0	0	0	0	0	0	0	0	0	0	0	0
"UCC1"	2388	31378	0	0	0	0	0	0	39	0	0	0	99	78	183	147	205	149
"UCH37"	1323	43623	1280	89	808	472	42	47	944	44	36	32	332	447	502	492	559	325
"UCHL1"	1613	11549	4	0	4	0	0	0	0	0	0	0	247	222	213	208	391	318
"UCHL3"	850	56141	59	0	29	30	0	0	67	0	0	0	231	262	221	210	218	180
"UCHL5"	1922	40222	1437	310	911	526	185	125	944	175	36	167	333	447	534	492	563	372
"UCHL5IP"	2432	26426	224	0	145	79	0	0	679	150	49	0	286	258	272	288	405	279
"UCK1"	2287	7480	128	238	73	55	125	113	203	133	71	75	441	420	628	460	816	479
"UCK2"	1251	80449	1768	64	1056	712	31	33	987	69	577	95	876	614	607	323	442	324
"UCKL1"	2055	11290	2324	732	1228	1096	378	354	821	599	2788	1527	456	377	770	701	1249	495
"UCKL1AS"	3573	3603	283	96	144	139	46	50	167	137	567	378	79	43	42	78	190	87
"UCMA"	824	12559	0	0	0	0	0	0	0	0	0	0	0	0	0	0	0	0
"UCN"	617	867	0	0	0	0	0	0	0	0	0	0	1	0	0	1	13	2
"UCN2"	1487	2052	0	0	0	0	0	0	45	17	0	0	0	0	0	0	0	0
"UCN3"	712	9195	0	0	0	0	0	0	0	0	0	0	0	0	0	0	0	0
"UCP1"	1004	8909	0	0	0	0	0	0	0	0	0	0	0	0	0	0	0	0
"UCP2"	1654	8175	2569	344	1425	1144	176	168	1101	201	1886	543	5539	2216	3722	3354	4038	2865
"UCP3"	2428	8954	0	10	0	0	10	0	43	0	0	13	0	8	24	6	21	7
"UCRC"	977	3046	0	0	0	0	0	0	21	17	0	16	1248	1177	1076	1442	1321	1416
"UCRP"	2051	107154	0	0	0	0	0	0	0	0	0	0	0	0	0	0	0	0
"UDP-GlcNAc"	3513	31625	61	0	38	23	0	0	137	31	0	0	422	464	614	566	646	466
"UEVLD"	2130	57038	263	144	160	103	55	89	257	105	0	347	199	159	368	327	315	208
"UFC1"	1127	5113	52	0	34	18	0	0	50	40	0	0	1598	1884	1838	1078	2705	999
"UFD1"	5092	28596	855	416	490	365	159	257	491	338	179	644	406	237	874	909	1070	731
"UFD1L"	5118	28596	855	416	490	365	159	257	491	338	179	644	406	237	874	909	1070	746
"UFM1"	2606	13202	1046	1178	546	500	693	485	396	534	154	574	2370	3409	2424	2504	2145	1726
"UFSP1"	995	995	42	0	42	0	0	0	106	263	0	0	229	0	312	0	579	0
"UFSP2"	2494	26447	384	0	218	166	0	0	375	19	28	0	599	448	716	543	741	526
"UGCG"	1638	36227	1897	771	1080	817	441	330	667	330	461	882	1224	1467	1299	1321	947	928
"UGCGL1"	10971	104467	1646	327	924	722	194	133	1224	189	650	212	3511	3674	3846	3363	4112	2506
"UGCGL2"	1721	68577	1883	468	998	885	278	190	1222	120	359	347	108	181	132	142	183	94
"UGDH"	3201	28838	53	0	43	10	0	0	34	12	0	0	694	642	639	443	622	403
"UGGT1"	10818	104495	1646	327	924	722	194	133	1224	189	650	212	3511	3674	3846	3363	4112	2506
"UGGT2"	4966	251900	6366	3011	3564	2802	1762	1249	3911	1423	925	1761	555	905	486	495	624	439
"UGP2"	2177	49683	6281	20579	3539	2742	10985	9594	1973	9198	660	15974	2606	9138	4450	9048	4021	5842
"UGPP"	3347	8385	327	97	197	130	49	48	310	208	253	110	150	307	499	289	924	502
"UGT1A1"	3409	11344	0	0	0	0	0	0	0	0	0	0	0	0	0	0	0	0
"UGT1A10"	3431	135140	0	0	0	0	0	0	0	8	0	0	0	0	0	0	0	0
"UGT1A3"	2354	44178	0	0	0	0	0	0	0	0	0	0	0	0	0	0	0	0
"UGT1A4"	2383	54513	0	0	0	0	0	0	0	0	0	0	0	0	0	0	0	0
"UGT1A5"	2354	60313	0	0	0	0	0	0	0	8	0	0	0	0	0	0	0	0
"UGT1A6"	3530	78751	0	0	0	0	0	0	0	8	0	0	0	0	0	0	0	0
"UGT1A7"	2342	91367	0	0	0	0	0	0	0	8	0	0	0	0	0	0	0	0
"UGT1A8"	2405	155660	0	0	0	0	0	0	0	8	0	0	0	0	0	0	0	0
"UGT1A9"	2379	101407	0	0	0	0	0	0	0	8	0	0	0	0	0	0	0	0
"UGT2A1"	2661	64833	0	0	0	0	0	0	0	0	0	0	0	0	0	0	0	0
"UGT2A2"	3159	64833	0	0	0	0	0	0	0	0	0	0	0	0	0	0	0	0
"UGT2A3"	2975	23334	0	0	0	0	0	0	0	0	0	0	0	0	0	0	0	0
"UGT2B10"	2760	16028	0	0	0	0	0	0	0	0	0	0	0	0	0	0	0	0
"UGT2B11"	1710	14398	0	0	0	0	0	0	0	0	0	0	24	79	102	54	34	4
"UGT2B15"	4223	133471	0	0	0	0	0	0	0	0	0	0	0	0	0	0	0	0
"UGT2B28"	1868	15820	0	0	0	0	0	0	0	0	0	0	0	0	0	0	0	0
"UGT2B4"	2108	15744	0	0	0	0	0	0	0	0	0	0	0	0	0	0	0	0
"UGT2B7"	1892	16513	0	0	0	0	0	0	0	0	0	0	0	0	0	0	0	0
"UGT3A1"	5010	38499	0	0	0	0	0	0	0	0	0	0	0	0	0	0	0	0
"UGT3A2"	2348	31862	0	0	0	0	0	0	0	0	0	0	0	0	0	0	0	0
"UGT8"	2912	78593	0	0	0	0	0	0	0	0	0	0	0	0	0	0	0	0
"UHMK1"	2908	26191	863	315	516	347	168	147	515	211	141	261	6136	7573	2695	2052	2183	1065
"UHRF1"	4078	51600	1256	144	720	536	93	51	632	224	1424	604	302	164	142	92	411	61
"UHRF1BP1"	9652	85497	3399	757	1846	1553	409	348	1226	693	1204	998	2247	2425	2375	1766	2231	1408
"UHRF1BP1L"	5194	105779	4240	728	2483	1757	378	350	1986	601	609	1083	2696	3232	2087	1910	1900	1160
"UHRF2"	3735	93900	1924	479	1070	854	275	204	1370	302	377	335	776	675	1070	585	1263	695
"UIMC1"	2619	101439	2706	1042	1543	1163	554	488	1423	688	351	997	475	342	509	372	652	429
"ULBP1"	3145	9703	0	0	0	0	0	0	54	54	0	0	0	0	0	0	0	0
"ULBP2"	1349	7232	0	0	0	0	0	0	31	11	0	0	0	0	0	0	0	0
"ULBP3"	1555	3470	0	0	0	0	0	0	0	10	0	0	0	0	0	0	0	0
"ULK1"	5249	28429	529	215	274	255	86	129	607	179	515	105	738	613	878	611	1247	746
"ULK2"	9165	97097	325	0	182	143	0	0	386	17	0	0	616	861	904	968	879	630
"ULK3"	2651	7095	293	69	124	169	55	14	160	143	221	69	497	445	583	539	1186	804
"ULK4"	4395	715571	733	529	365	368	286	243	956	614	192	446	86	109	66	62	87	41
"UMOD"	2425	19665	0	0	0	0	0	0	0	0	0	0	0	0	0	0	0	0
"UMODL1"	5464	80039	40	8	40	0	0	8	411	107	0	0	0	0	0	0	0	0
"UMPS"	2866	14827	61	20	52	9	15	5	136	12	0	0	520	461	613	569	717	536
"UNC-119"	873	1143	596	38	15	581	32	6	122	0	218	95	1490	49	59	41	140	62
"UNC-18c"	2517	62856	1857	1973	984	873	1167	806	1036	1310	321	1949	1900	2193	1541	1526	1702	1291
"UNC119"	1655	5923	608	259	27	581	147	112	502	112	1541	372	1526	1282	1465	962	3691	1565
"UNC119B"	4815	13613	176	0	121	55	0	0	135	0	16	0	818	625	761	420	967	481
"UNC13A"	10142	87265	1	0	1	0	0	0	208	92	0	49	2	92	0	143	0	0
"UNC13B"	6466	243344	88	121	42	46	75	46	202	83	27	5	825	941	896	893	995	641
"UNC13B variant protein"	1621	208406	74	45	42	32	29	16	165	32	27	5	168	195	155	160	202	86
"UNC13C"	8170	615706	0	0	0	0	0	0	0	0	0	0	0	0	0	0	0	0
"UNC13D"	4704	13418	1509	321	826	683	160	161	915	280	1396	319	2688	2367	2666	2095	3283	2678
"UNC24"	2121	9076	4	0	0	4	0	0	77	13	0	0	61	41	99	49	113	62
"UNC45A"	4024	23914	289	45	170	119	41	4	401	141	99	17	1379	1327	1710	1127	2964	1330
"UNC45B"	5698	41529	162947	77827	87413	75534	39196	38631	26682	0	0	0	0	0	0	0	0	0
"UNC50"	2174	9935	1428	324	746	682	222	102	1351	182	612	245	1143	843	1209	545	1453	481
"UNC5A"	3746	70339	1936	706	748	1188	353	353	1627	674	1789	1063	5	3	515	6	27	0
"UNC5B"	5015	88453	1396	8	745	651	3	5	1978	363	478	0	843	833	557	496	1033	840
"UNC5C"	3662	380475	0	53	0	0	35	18	0	73	0	0	0	243	0	0	0	0
"UNC5CL"	2995	12158	576	161	275	301	91	70	513	80	0	102	417	346	387	255	489	270
"UNC5D"	7306	559207	0	0	0	0	0	0	9	0	0	0	419	428	1113	978	1314	967
"UNC80"	13626	227309	0	0	0	0	0	0	0	0	0	0	0	0	0	0	0	0
"UNC84A"	4048	22657	3441	2809	1976	1465	1485	1324	1982	2723	1321	2625	2140	2916	2151	3208	2996	2197
"UNC84B"	3994	20725	3781	7385	2090	1691	4220	3165	965	6493	1847	8544	2009	719	5032	5931	6115	4842
"UNC93A"	2118	24700	0	0	0	0	0	0	104	29	0	0	0	0	0	0	0	0
"UNC93B1"	2325	13020	1777	433	953	824	208	225	670	225	1401	440	2707	1488	4998	2797	4375	2210
"UNCX"	1598	3960	0	0	0	0	0	0	0	0	0	0	0	0	0	0	0	0
"UNG"	2070	12793	0	0	0	0	0	0	0	0	0	0	158	236	248	195	328	205
"UNK"	4065	41206	1672	1257	956	716	646	611	1120	1082	761	1916	521	624	678	571	654	519
"UNKL"	4323	16477	1032	248	474	558	108	140	1216	270	702	316	128	1613	1077	1184	1299	1127
"UNQ151"	4757	103464	178	28	115	63	10	18	172	21	19	49	1483	1757	1298	1215	1650	1158
"UNQ154"	1878	22885	2284	232	1312	972	114	118	1210	123	293	109	1953	965	2322	1244	1782	934
"UNQ155"	1283	14503	114	22	72	42	12	10	165	75	0	113	501	457	687	612	667	462
"UNQ168"	4923	6783	112	89	89	23	48	41	130	25	0	19	342	45	343	242	381	192
"UNQ175"	2099	15350	0	0	0	0	0	0	29	16	0	0	0	1	0	0	0	1
"UNQ1866"	1450	50571	81	131	42	39	71	60	84	197	0	313	109	211	4449	4866	6520	4901
"UNQ1882"	3251	8766	703	161	390	313	72	89	345	169	331	252	2714	2499	2931	2286	3956	2343
"UNQ1900"	1748	14036	0	0	0	0	0	0	0	15	0	0	0	0	0	0	0	0
"UNQ192"	2710	26360	59	8	37	22	0	8	49	13	0	0	61	50	490	322	522	397
"UNQ1932"	1724	2701	0	0	0	0	0	0	22	9	0	0	0	0	0	0	0	0
"UNQ1934"	1196	9087	1233	220	604	629	128	92	497	156	385	61	1253	968	1881	1496	1973	1513
"UNQ1948"	2267	2267	6648	2470	6647	1	1047	1423	4523	1265	1280	1068	0	0	0	0	0	0
"UNQ196"	3190	143383	0	0	0	0	0	0	14	0	0	0	0	0	0	0	0	0
"UNQ208"	1914	20557	0	0	0	0	0	0	0	0	0	0	48	58	12	0	33	0
"UNQ243"	2865	29082	1659	1441	947	712	800	641	738	710	170	954	2723	3247	756	2566	2829	2240
"UNQ2430"	3029	90769	848	104	552	296	38	66	980	203	49	179	20	49	26	56	17	8
"UNQ2432"	1369	13246	26	0	10	16	0	0	93	11	53	0	1329	1436	1586	1358	1604	1276
"UNQ2487"	1971	11851	0	0	0	0	0	0	50	14	0	0	0	0	4	0	0	0
"UNQ2494"	2977	29357	1030	874	446	584	505	369	919	540	817	1146	605	2095	1999	1884	1105	807
"UNQ2513"	2723	10738	566	136	245	321	83	53	510	172	693	249	78	117	165	143	193	129
"UNQ2538"	1011	93689	607	2901	319	288	1666	1235	698	1681	85	3494	177	199	405	430	393	353
"UNQ2553"	1612	5535	178	0	99	79	0	0	134	28	181	1	1108	718	1679	1094	2041	1256
"UNQ2559"	3073	23334	0	0	0	0	0	0	0	0	0	0	0	0	0	0	0	0
"UNQ2560"	2405	2405	333	4	238	95	0	4	200	16	0	0	33	18	62	64	102	36
"UNQ2573"	1374	60171	182	0	72	110	0	0	259	58	102	0	225	259	498	407	511	283
"UNQ2754"	2106	21286	0	0	0	0	0	0	53	16	0	0	0	0	0	0	0	0
"UNQ2771"	2428	28972	1921	790	1015	906	388	402	1023	754	1369	1497	1416	1110	1697	1446	2412	1538
"UNQ2783"	1980	36273	0	0	0	0	0	0	32	0	0	0	0	0	3	0	3	0
"UNQ2790"	2555	2555	2107	707	1154	953	388	319	662	280	985	808	1797	591	495	111	538	34
"UNQ284"	2265	13196	2040	276	1136	904	158	118	887	289	2501	833	1069	674	1538	1052	2293	1155
"UNQ287"	4152	48326	0	0	0	0	0	0	0	0	0	0	0	0	0	0	0	0
"UNQ2963"	5283	13544	34	0	12	22	0	0	29	22	1	0	8	11	7	8	14	2
"UNQ2966"	776	22676	142	0	78	64	0	0	50	0	0	0	710	94	58	49	97	46
"UNQ2998"	2385	34540	564	244	336	228	121	123	706	687	42	639	103	126	169	69	237	150
"UNQ3022"	1592	17780	0	0	0	0	0	0	22	36	0	0	99	220	110	116	117	89
"UNQ3033"	1047	23124	0	0	0	0	0	0	0	0	0	0	0	0	74	60	0	39
"UNQ3047"	3559	16959	899	71	486	413	42	29	518	117	558	205	1471	1067	1175	668	1347	761
"UNQ3056"	2845	13572	0	0	0	0	0	0	26	29	0	0	20	0	5	0	28	3
"UNQ306"	346	1248	0	0	0	0	0	0	0	0	0	0	0	0	8	9	23	8
"UNQ3072"	623	6185	0	0	0	0	0	0	0	0	0	0	0	0	0	0	0	0
"UNQ3098"	1540	22129	0	0	0	0	0	0	48	0	0	0	39	20	27	13	35	23
"UNQ3127"	1595	74489	0	0	0	0	0	0	0	0	0	0	0	0	0	0	0	0
"UNQ322"	2098	13386	291	45	166	125	25	20	183	27	0	0	161	31	65	60	111	69
"UNQ335"	1963	26623	696	71	403	293	49	22	267	12	205	65	828	892	791	657	823	609
"UNQ340"	1628	7198	0	0	0	0	0	0	0	0	0	0	0	0	0	0	0	0
"UNQ397"	4029	28837	3455	4092	1994	1461	2243	1849	1365	1606	509	2245	641	316	1649	5660	1481	952
"UNQ403"	2010	14325	6	3	2	4	2	1	75	3	0	0	1	2	0	0	0	0
"UNQ424"	892	5025	0	0	0	0	0	0	0	0	0	0	0	0	0	0	0	0
"UNQ436"	2200	135630	2747	8869	1518	1229	4753	4116	1411	2506	708	1444	3764	6410	790	1598	680	830
"UNQ439"	2605	9067	90	0	63	27	0	0	104	81	0	0	514	498	744	541	823	432
"UNQ440"	2151	21026	252	30	107	145	0	30	176	44	46	6	149	202	222	171	412	212
"UNQ470"	897	1997	0	0	0	0	0	0	43	27	0	0	209	115	383	330	514	453
"UNQ491"	2925	4514	0	0	0	0	0	0	17	0	0	17	6	34	33	65	43	63
"UNQ493"	1928	48683	3864	296	2217	1647	179	117	2102	242	4838	178	1881	1364	2070	1098	3226	1883
"UNQ514"	2529	2529	0	0	0	0	0	0	0	0	0	0	0	0	0	0	0	0
"UNQ530"	2943	12896	3103	12155	345	2758	6540	5615	3304	5783	2842	7441	651	10411	3809	6531	4186	4468
"UNQ535"	1506	11699	409	0	218	191	0	0	199	60	256	99	641	513	1171	1011	1156	989
"UNQ543"	2446	19049	0	0	0	0	0	0	42	12	0	0	0	0	0	0	0	0
"UNQ548"	1541	7850	233	41	136	97	22	19	227	83	283	122	172	158	262	179	324	184
"UNQ552"	2143	25323	222	103	134	88	61	42	151	115	0	137	382	247	208	334	581	428
"UNQ557"	2030	53215	376	64	245	131	47	17	138	40	0	172	14	0	19	25	27	13
"UNQ564"	2441	25808	12	1	0	12	1	0	28	27	0	16	0	0	1	0	0	0
"UNQ569"	1505	28525	392	518	273	119	252	266	341	132	66	0	194	134	99	265	157	358
"UNQ572"	1062	5589	18	0	16	2	0	0	78	26	0	0	132	68	121	266	162	284
"UNQ573"	1781	32003	408	17	206	202	8	9	331	21	308	64	689	551	842	698	741	735
"UNQ574"	2293	192245	37	21	26	11	0	21	77	0	0	0	306	246	274	65	313	202
"UNQ5782"	660	2593	0	0	0	0	0	0	0	0	0	0	0	0	0	0	0	0
"UNQ5783"	650	24184	7269	3320	2979	4290	1729	1591	2456	1057	9255	2630	2056	17408	2440	1442	3268	2151
"UNQ5807"	2681	15632	236	19	85	151	15	4	388	230	62	0	140	138	111	85	150	72
"UNQ5808"	3716	77638	6992	1640	3883	3109	936	704	3416	971	3531	1523	353	83	313	66	462	86
"UNQ5810"	786	18613	0	0	0	0	0	0	0	0	0	0	0	1	0	0	0	0
"UNQ5810/PRO19627"	659	18613	0	0	0	0	0	0	0	0	0	0	0	1	0	0	0	0
"UNQ582"	1780	18838	98	5	50	48	5	0	184	83	0	0	442	383	459	390	562	491
"UNQ5830"	2414	2874	0	0	0	0	0	0	0	0	0	0	0	0	0	0	0	0
"UNQ5922"	2527	32042	60	0	24	36	0	0	215	13	0	115	131	99	164	121	217	126
"UNQ5929"	2014	4582	19	0	19	0	0	0	47	30	0	0	0	0	0	0	0	0
"UNQ598"	1303	4259	0	0	0	0	0	0	23	20	0	8	0	0	0	0	0	0
"UNQ5982"	2350	177387	0	0	0	0	0	0	7	0	0	0	0	0	0	1	0	0
"UNQ603"	1703	7166	0	0	0	0	0	0	0	0	0	0	28	24	43	17	25	29
"UNQ6118"	2403	16551	39	0	18	21	0	0	133	62	24	21	389	453	485	332	644	397
"UNQ630"	1123	1925	0	0	0	0	0	0	0	0	0	0	1	0	0	0	3	3
"UNQ6308"	3710	22243	0	0	0	0	0	0	0	0	0	0	12	0	42	54	81	66
"UNQ6348"	3591	15665	0	0	0	0	0	0	12	0	0	0	0	0	0	0	0	0
"UNQ638"	1491	3417	2510	0	2473	37	0	0	726	15	46	0	166	86	199	149	266	144
"UNQ6408"	1268	3802	158	0	112	46	0	0	128	48	0	75	867	634	969	875	1325	857
"UNQ6494"	2200	79978	0	14	0	0	14	0	86	0	0	19	5	35	0	8	0	0
"UNQ6501"	1404	1404	34	0	0	34	0	0	18	13	0	0	0	0	0	0	0	1
"UNQ664"	3498	10784	347	19	178	169	19	0	239	139	128	41	341	228	462	220	592	242
"UNQ674"	2139	2679	0	0	0	0	0	0	57	67	0	0	48	40	87	431	81	101
"UNQ679"	2706	73643	1031	72	603	428	54	18	885	51	135	149	406	347	471	326	541	350
"UNQ690"	1547	3513	0	0	0	0	0	0	29	0	0	0	0	0	0	0	0	0
"UNQ694"	2608	31047	0	0	0	0	0	0	52	0	0	0	0	0	0	0	0	0
"UNQ6975"	2228	5117	0	0	0	0	0	0	20	0	0	0	0	0	0	0	0	0
"UNQ706"	1216	5237	0	0	0	0	0	0	36	8	0	0	0	0	0	0	0	0
"UNQ714"	1802	30787	676	644	351	325	374	270	467	427	111	669	341	414	485	474	465	289
"UNQ729"	1145	10554	6	0	6	0	0	0	109	101	0	0	0	0	0	0	0	0
"UNQ732"	2879	94328	0	0	0	0	0	0	28	0	0	0	39	42	32	20	36	35
"UNQ736"	408	6566	25	0	8	17	0	0	28	12	2	36	7	34	53	22	52	33
"UNQ747"	3462	22218	1748	645	964	784	297	348	984	417	2225	719	1606	1127	1879	1245	2666	1682
"UNQ766"	1313	1901	23	0	23	0	0	0	36	17	42	63	99	170	180	170	168	212
"UNQ772"	3067	25248	0	0	0	0	0	0	0	0	0	0	3	0	5	0	0	0
"UNQ8193"	2408	86069	248	108	134	114	52	56	450	23	0	22	617	668	441	272	309	178
"UNQ842"	1815	31862	0	0	0	0	0	0	0	0	0	0	0	0	0	0	0	0
"UNQ847"	3656	7135	0	0	0	0	0	0	0	0	0	0	0	0	0	0	0	0
"UNQ869"	3670	13915	0	0	0	0	0	0	85	51	0	0	0	9	0	0	5	0
"UNQ9217"	2546	54408	612	1245	393	219	656	589	113	73	73	152	59	113	31	18	57	33
"UNQ9334"	6260	491263	0	0	0	0	0	0	31	9	0	0	203	213	2903	2913	0	3102
"UNQ9336"	696	1561	0	0	0	0	0	0	0	0	0	0	0	0	0	0	0	0
"UNQ9339"	2321	44038	0	0	0	0	0	0	0	0	0	0	0	0	0	0	0	0
"UNQ9368"	751	751	73	0	42	31	0	0	0	13645	0	0	0	0	0	22	0	0
"UNQ9369"	2051	35004	0	0	0	0	0	0	61	0	0	0	691	572	60	380	57	50
"UNQ9391"	2378	15787	0	0	0	0	0	0	33	0	0	0	0	0	0	0	0	0
"UNQ9392"	1007	1496	0	0	0	0	0	0	28	23	0	0	0	0	0	0	0	0
"UNQ9424"	1654	89212	0	0	0	0	0	0	0	0	0	0	0	0	0	0	0	0
"UNQ9427"	6582	22398	1865	574	966	899	297	277	1056	273	484	360	107	122	161	111	176	79
"UNQ9438"	532	12777	13	0	13	0	0	0	16	0	0	0	5	0	1	1	0	0
"UOX"	1553	32930	0	0	0	0	0	0	0	0	0	0	0	0	0	0	0	0
"UPB1"	3250	32477	0	0	0	0	0	0	80	39	0	0	0	0	0	19	3	0
"UPF1"	5401	36296	2787	1852	1613	1174	971	881	1168	1510	1222	3024	2136	2067	2759	2141	3814	2126
"UPF2"	5589	115876	1793	737	1053	740	409	328	1026	367	190	360	1180	1625	1393	1031	1582	1076
"UPF3"	2148	24205	898	80	461	437	38	42	609	75	454	230	690	417	1475	871	1456	734
"UPF3A"	2367	24205	898	80	461	437	38	42	609	75	454	230	690	417	1475	871	1456	734
"UPF3B"	2392	18981	241	376	175	66	228	148	72	167	0	242	370	571	226	535	203	175
"UPK1A"	1327	11652	2	20	2	0	7	13	58	15	0	0	0	0	0	0	0	0
"UPK1B"	2065	31576	8	26	2	6	12	14	0	0	0	0	0	0	0	0	0	0
"UPK2"	920	2244	0	0	0	0	0	0	74	14	0	0	0	0	0	0	0	0
"UPK3A"	1030	10867	0	0	0	0	0	0	247	97	0	0	0	1	0	0	0	0
"UPK3B"	1612	17454	43	0	24	19	0	0	30	15	0	0	0	0	48	42	18	20
"UPLC1"	4113	55623	0	0	0	0	0	0	52	10	0	0	0	0	0	0	0	3
"UPLP"	1730	6153	503	195	347	156	92	103	566	317	757	843	350	314	2239	1688	5022	2857
"UPP1"	1847	19976	3174	8879	1752	1422	4801	4078	912	3639	2334	8415	1688	4677	2243	7561	1823	5965
"UPP2"	2418	34285	0	0	0	0	0	0	11	0	0	0	0	0	0	0	0	0
"UPRT"	2211	30473	186	51	87	99	18	33	242	39	45	0	325	386	396	404	405	253
"UQCC"	3706	50185	2953	575	1776	1177	365	210	1961	593	1442	915	808	728	1053	707	644	277
"UQCR"	1266	8259	99	33	50	49	21	12	158	100	64	94	1062	1391	648	580	1517	1175
"UQCRB"	4708	8554	0	0	0	0	0	0	0	0	0	0	2013	2366	3019	1843	4248	3093
"UQCRC1"	1633	10668	1073	493	577	496	288	205	378	319	551	707	2532	5246	6177	5667	7198	4691
"UQCRC2"	2015	14757	2308	2004	1351	957	1117	887	1246	1020	661	1756	4973	6577	5832	5774	7143	5433
"UQCRFS1"	1226	5971	430	543	234	196	308	235	193	252	92	193	2619	2812	3098	384	3747	2874
"UQCRH"	677	13067	439	132	247	192	69	63	281	103	381	237	1128	1490	1521	1115	1977	1047
"UQCRHL"	539	539	0	0	0	0	0	0	0	0	0	0	0	692	876	0	0	0
"UQCRQ"	1588	2219	14	0	0	14	0	0	18	43	0	0	904	867	1350	1295	1609	1224
"URB1"	10847	81984	379	55	197	182	39	16	455	183	106	172	517	421	847	733	969	619
"URB2"	5654	33967	42	0	26	16	0	0	64	9	0	79	285	234	395	268	470	143
"URCC3"	1906	18344	519	2047	298	221	1102	945	282	615	0	416	149	987	657	588	804	543
"URG4"	5671	13732	1937	1998	1065	872	1112	886	812	1110	856	1494	70	155	702	609	1051	669
"URG7"	708	2272	0	0	0	0	0	0	0	0	0	0	0	0	0	0	0	0
"URKL1"	1820	16579	2324	732	1228	1096	378	354	821	599	2788	1527	456	377	770	701	1249	495
"URM1"	1730	19419	400	331	251	149	179	152	402	374	236	315	1225	1138	1451	1249	1777	1272
"UROC1"	3328	36472	0	0	0	0	0	0	203	54	0	0	0	0	0	0	0	0
"UROD"	1443	3513	51	11	9	42	11	0	51	13	0	0	623	551	1005	742	1423	951
"UROS"	1367	34691	304	8	171	133	8	0	391	18	52	0	845	571	1008	734	1078	802
"USE1"	1823	3482	115	134	57	58	87	47	176	145	0	29	136	188	267	195	333	189
"USF1"	1807	6717	521	96	271	250	61	35	271	46	220	11	499	358	2491	1132	2986	1377
"USF2"	1719	10824	1645	338	858	787	144	194	604	197	1506	260	3386	2919	4289	4012	4845	3360
"USH1C"	3272	50522	0	0	0	0	0	0	149	101	0	0	0	0	0	0	0	0
"USH1G"	3564	7177	1	0	0	1	0	0	36	13	0	0	0	0	0	0	0	0
"USH2A"	18955	800504	0	0	0	0	0	0	0	0	0	0	0	0	0	0	0	0
"USH3A"	824	16173	0	0	0	0	0	0	0	0	0	0	0	0	0	0	0	0
"USHBP1"	2423	14697	6	0	4	2	0	0	58	9	0	0	1	0	0	0	0	0
"USMG5"	558	7411	37	10	7	30	10	0	27	0	0	17	560	635	782	601	882	648
"USO1"	3850	85537	3540	5654	1984	1556	3024	2630	1674	3236	509	6303	3825	5178	4419	4525	4848	2948
"USP1"	4388	15534	142	33	99	43	25	8	146	19	30	0	1142	721	1019	422	1130	504
"USP10"	3512	79972	7989	4884	4547	3442	2601	2283	3576	3059	3610	5928	1804	1621	2089	1648	2496	1522
"USP11"	3310	15414	14	96	6	8	58	38	52	110	0	0	361	471	364	382	332	249
"USP12"	2357	103593	13748	95924	7552	6196	51530	44394	2540	36777	865	60335	2175	10075	332	2181	531	682
"USP13"	7952	136256	37	18	17	20	11	7	29	11	0	0	261	292	251	180	191	64
"USP14"	4172	55258	686	252	416	270	124	128	497	246	0	154	899	2710	2239	2008	2132	1776
"USP15"	4720	145713	20529	12762	11554	8975	6955	5807	9304	5736	5163	8787	3084	4261	3665	2758	3833	2755
"USP16"	3053	29869	1285	1343	792	493	780	563	559	718	71	917	1816	2760	1694	1936	2001	1273
"USP17"	14337	149317	0	0	0	0	0	0	29	10	0	0	0	0	0	0	0	0
"USP17L2"	1594	1594	0	0	0	0	0	0	10	0	0	0	0	0	0	0	0	0
"USP18"	2044	27404	0	0	0	0	0	0	10	84	0	0	13	65	263	110	200	197
"USP19"	4731	12107	716	181	436	280	74	107	454	197	404	151	2022	1650	2009	1201	2382	1258
"USP2"	3745	26512	0	0	0	0	0	0	99	29	0	0	60	48	160	26	94	78
"USP20"	4536	46413	775	285	454	321	148	137	468	375	190	118	705	651	875	574	1178	777
"USP21"	2367	6263	61	21	34	27	21	0	253	32	61	0	297	254	447	263	680	321
"USP22"	5296	44167	4770	4205	2715	2055	2259	1946	2010	2010	3200	5229	4802	4484	4731	3802	5813	3777
"USP24"	10127	148725	4157	10679	2412	1745	5802	4877	2497	8701	505	4946	2543	2743	2292	3161	2283	2053
"USP25"	5204	149883	8388	1748	4644	3744	1101	647	4986	1078	1358	769	1418	1493	1797	1506	1857	1318
"USP26"	3671	72083	0	0	0	0	0	0	0	0	0	0	0	0	0	0	0	0
"USP27X"	2698	2698	0	0	0	0	0	0	0	0	0	0	0	0	0	0	0	0
"USP28"	4656	77660	292	85	171	121	47	38	197	10	85	14	614	723	597	448	819	431
"USP29"	3608	11784	0	0	0	0	0	0	0	0	0	0	0	0	0	0	0	0
"USP3"	2495	86851	14557	3824	8092	6465	2077	1747	7070	2503	6529	4201	2206	1672	1660	950	2339	1281
"USP30"	4138	64929	3	0	0	3	0	0	55	9	0	0	190	139	210	74	245	131
"USP31"	10713	87864	2177	155	1250	927	85	70	1200	74	415	95	531	602	503	406	677	471
"USP32"	8213	46639	8452	3251	4962	3490	1740	1511	4379	2382	2406	3147	1023	1861	2428	2141	2474	1601
"USP33"	4527	63863	3205	440	1776	1429	243	197	1621	199	1208	398	2077	769	1818	1191	1510	1323
"USP34"	11389	283260	13411	9682	7599	5812	5286	4396	6841	4861	3706	7589	2546	4083	6129	5024	7009	3891
"USP35"	4208	25797	1415	425	1170	245	239	186	387	319	480	256	170	126	140	79	212	97
"USP36"	5820	44572	3734	3275	2092	1642	1975	1300	1387	1638	1534	3855	1283	785	1132	1333	1236	1278
"USP37"	8098	118112	402	106	203	199	48	58	227	87	26	98	649	659	702	483	804	406
"USP38"	5204	37072	426	19	228	198	19	0	321	56	123	0	1240	920	1286	581	1486	764
"USP39"	2221	33124	1164	102	661	503	43	59	691	202	793	375	2098	1494	1933	1336	2544	1335
"USP4"	4571	35721	5028	1691	2796	2232	1006	685	2389	769	3977	1839	3103	2792	3987	2278	4331	2284
"USP40"	5647	90072	953	258	555	398	133	125	1049	163	292	102	673	831	1329	714	1284	522
"USP41"	1188	22112	0	0	0	0	0	0	0	0	0	0	0	0	68	28	49	50
"USP42"	5954	50440	315	194	179	136	121	73	247	441	85	250	340	360	424	367	453	255
"USP43"	4081	84053	0	0	0	0	0	0	29	0	0	0	3	2	0	0	7	0
"USP44"	3478	31093	0	0	0	0	0	0	11	0	0	0	0	0	0	0	0	0
"USP45"	6404	83070	2671	349	1592	1079	244	105	2232	218	404	262	252	318	203	123	251	66
"USP46"	8140	68375	127	0	60	67	0	0	134	0	0	0	414	434	393	319	477	322
"USP47"	8007	117902	7267	2045	4082	3185	1094	951	3663	1315	1191	1547	2192	2234	2197	1482	2701	1652
"USP48"	4525	104896	3291	943	1706	1585	518	425	1852	505	1121	501	1846	2008	2121	1642	2455	1378
"USP49"	3183	97717	0	0	0	0	0	0	56	22	0	85	21	15	16	56	18	3
"USP5"	3208	14510	296	60	163	133	39	21	380	147	113	98	1372	1604	1908	1739	2504	1679
"USP50"	1413	46144	802	43	374	428	29	14	323	139	38	88	1286	1253	1064	831	1343	1037
"USP51"	2492	2671	0	0	0	0	0	0	0	0	0	0	0	0	0	0	0	0
"USP53"	6735	82892	148	141	83	65	61	80	53	12	0	13	347	557	144	100	216	32
"USP54"	6183	78137	189	21	144	45	0	21	136	3	12	7	340	242	412	145	423	187
"USP6"	8540	58593	8	0	8	0	0	0	91	10	3	0	24	0	143	137	80	98
"USP6-short"	1940	6175	0	0	0	0	0	0	30	10	1	0	0	0	0	0	0	0
"USP6NL"	4754	151172	1359	537	772	587	311	226	887	736	120	504	588	576	425	375	633	356
"USP7"	5445	44594	5460	5056	2962	2498	2823	2233	2572	3131	2125	5729	3144	3022	3764	2421	4181	2723
"USP8"	5869	76699	3912	1180	2193	1719	630	550	2354	1356	743	1388	3273	3608	3877	3251	4068	2779
"USP9X"	12444	150944	6049	13785	3004	3045	7431	6354	2682	6074	1236	6926	4142	4906	5652	4638	5573	3392
"USP9Y"	10086	159610	6	0	6	0	0	0	0	4	0	0	156	234	206	192	0	0
"USPL1"	6407	34264	3628	738	2003	1625	431	307	1614	555	1288	326	1233	748	1469	662	1591	623
"UST"	4398	329856	1170	17413	619	551	9438	7975	10	11021	0	2765	0	94	4	4	9	14
"UST6"	3094	63610	0	0	0	0	0	0	0	0	0	0	0	0	0	0	0	0
"UTF1"	1158	1285	1	0	0	1	0	0	0	0	0	0	0	0	0	0	0	0
"UTP11L"	2924	8243	70	32	30	40	22	10	107	43	0	20	422	547	514	468	480	401
"UTP14A"	2502	23570	50	28	31	19	16	12	147	98	0	51	432	522	603	538	755	481
"UTP14C"	9426	13031	571	57	344	227	41	16	507	152	16	88	1849	2206	1852	1343	2278	1413
"UTP15"	3668	16198	11	14	0	11	7	7	14	0	0	0	334	298	318	184	331	139
"UTP18"	1896	37395	1141	226	723	418	154	72	662	144	125	205	359	797	689	1087	1018	693
"UTP20"	9072	106494	59	47	24	35	24	23	59	31	19	11	609	690	726	570	608	431
"UTP23"	3692	8179	81	16	60	21	0	16	84	24	0	0	482	350	423	216	402	200
"UTP3"	2073	2073	156	52	98	58	52	0	58	35	0	0	1531	2022	1554	1915	1803	1630
"UTP6"	2358	25051	712	60	411	301	47	13	265	223	350	239	720	478	1302	799	1399	925
"UTRN"	12503	561297	35484	26866	20129	15355	14582	12284	18204	12854	8015	13524	2961	3467	3847	3450	4026	2347
"UTS2"	1655	70152	0	19	0	0	0	19	141	45	0	30	555	640	736	478	631	470
"UTS2D"	2416	63382	0	9	0	0	0	9	0	0	0	0	61	57	78	83	97	61
"UTS2R"	1170	1170	0	0	0	0	0	0	0	0	0	0	1	3	0	0	21	0
"UTX"	5539	239422	13721	15734	7814	5907	8663	7071	6226	7727	7426	18206	951	992	934	833	1706	1001
"UTY"	6550	232289	10120	9074	5538	4582	4925	4149	3400	2865	0	0	1563	2103	995	1124	247	256
"UVRAG"	5180	329071	50321	37987	27989	22332	20672	17315	24897	17566	18534	21993	3202	4350	3048	2530	4413	2754
"UXS1"	2245	45579	655	2948	352	303	1699	1249	802	1785	85	3550	509	626	779	904	842	758
"UXT"	715	7322	189	162	90	99	77	85	110	111	0	257	718	901	757	764	884	687
"V alpha immunoglobulin"	355	613	0	0	0	0	0	0	0	0	0	0	0	0	0	0	0	0
"V00539"	877	877	0	0	0	0	0	0	0	0	0	0	0	0	0	0	0	0
"VAC14"	3113	113719	26034	30979	13640	12394	16375	14604	8681	13876	20434	21083	2921	3993	3285	5686	4568	2655
"VAMP1"	3140	8439	1475	1660	808	667	893	767	638	220	666	746	90	1296	78	813	1048	205
"VAMP2"	2160	3830	493	153	265	228	100	53	116	79	204	136	1005	944	1061	809	1361	845
"VAMP3"	2209	10164	856	301	492	364	138	163	441	292	214	346	6681	6787	5975	5144	7471	4658
"VAMP4"	2695	41918	149	68	98	51	29	39	322	6	0	4	135	629	834	449	737	398
"VAMP5"	668	8982	85	0	46	39	0	0	162	26	0	0	19	114	344	95	451	102
"VAMP7"	2662	62487	0	0	0	0	0	0	0	0	0	0	0	0	2754	2405	2896	2050
"VAMP8"	744	4509	456	26	222	234	0	26	235	15	433	38	4729	449	5809	871	6657	5127
"VANGL1"	8699	56273	12	0	12	0	0	0	12	0	0	0	307	298	388	180	198	5
"VANGL2"	5353	28099	0	0	0	0	0	0	108	0	1	0	1	0	0	0	0	0
"VAP-B"	3788	57718	2390	250	1333	1057	154	96	1221	169	841	325	909	742	835	597	1269	681
"VAPA"	7000	46064	6402	3167	3497	2905	1673	1494	2503	1377	1493	2180	2818	3013	3658	2982	3941	2772
"VAPB"	3679	57718	2390	250	1333	1057	154	96	1221	169	841	325	909	742	835	597	1269	681
"VARS"	4322	18417	598	242	335	263	136	106	295	258	353	244	2518	2148	2471	2183	3405	2284
"VARS2"	4493	12647	109	29	61	48	19	10	172	54	71	13	312	347	465	341	584	360
"VASH1"	6037	21130	13102	3752	7159	5943	1988	1764	3927	1802	12202	4423	13018	10858	14109	10397	23363	14059
"VASH2"	4341	41040	0	0	0	0	0	0	11	14	0	0	0	0	0	0	0	0
"VASN"	2808	11682	1244	155	614	630	84	71	797	231	1869	364	1	52	0	259	431	118
"VASP"	2301	19552	4260	6646	2317	1943	3747	2899	1273	4986	4120	18530	6794	11948	5705	10416	8219	9111
"VAT1"	2764	7839	468	125	294	174	70	55	312	116	211	98	4744	3865	11599	2775	12448	2822
"VAT1L"	3775	191520	0	0	0	0	0	0	18	27	0	0	0	0	0	0	0	0
"VAV-3"	2506	294757	1017	565	584	433	353	212	1980	841	149	585	156	128	233	202	199	83
"VAV1"	2915	84651	3203	347	1804	1399	179	168	1468	437	1340	437	1558	1404	1783	1795	2075	1661
"VAV2"	4880	230431	16239	21694	8855	7384	11503	10191	7291	19606	7267	44487	1203	1203	1652	1353	2033	1568
"VAV3"	4881	393765	1083	661	637	446	426	235	2245	1120	149	720	445	383	695	626	662	316
"VAX1"	4498	9782	0	0	0	0	0	0	0	0	0	0	0	0	0	0	0	0
"VAX2"	1147	32855	0	0	0	0	0	0	45	30	0	0	6	0	0	0	0	0
"VBP1"	1632	23397	77	38	64	13	19	19	87	47	0	37	840	845	882	815	914	745
"VCAM1"	3109	19304	0	0	0	0	0	0	0	0	0	0	80	390	162	575	18	92
"VCAN"	12431	110631	3	16	0	3	9	7	14	24	0	0	196	271	6	7	12	25
"VCL"	8012	124963	29443	10510	14979	14464	5660	4850	13286	3424	19144	7420	16010	15392	11764	7054	20894	10414
"VCP"	3953	16676	2200	2933	1198	1002	1619	1314	796	1281	932	2275	6555	9558	9941	10154	11219	7923
"VCPIP1"	8177	36964	3397	6547	1818	1579	3594	2953	1079	2278	240	1835	3181	3011	3164	477	1169	850
"VCX"	969	1882	0	0	0	0	0	0	0	0	0	0	0	0	0	0	0	0
"VCX-2r"	787	1471	0	0	0	0	0	0	0	0	0	0	0	0	0	0	0	0
"VCX2"	817	1324	0	0	0	0	0	0	0	0	0	0	0	0	0	0	0	0
"VCX3A"	997	1501	0	0	0	0	0	0	0	0	0	0	0	0	0	0	0	0
"VCX3B"	1088	1681	0	0	0	0	0	0	0	0	0	0	0	0	0	0	0	0
"VCY"	550	741	0	0	0	0	0	0	0	0	0	0	0	0	0	0	0	0
"VCY1B"	550	741	0	0	0	0	0	0	0	0	0	0	0	0	0	0	0	0
"VCY2"	1065	20894	0	0	0	0	0	0	0	0	0	0	0	0	0	0	0	0
"VCY2IP-1"	1667	7595	866	44	467	399	15	29	307	95	913	170	2444	792	2671	900	3201	1231
"VDAC1"	1961	33219	1963	1454	1148	815	743	711	731	824	605	1547	4136	6131	5629	2644	6973	5199
"VDAC2"	1690	20643	1139	1484	701	438	836	648	448	867	274	1708	363	788	2184	2950	2686	2625
"VDAC3"	1438	14069	709	175	442	267	89	86	436	76	502	104	3045	2931	3224	2436	4002	2547
"VDR"	5024	63466	8739	7410	4905	3834	3942	3468	3020	6301	4298	13071	1070	1815	2833	3781	3281	2892
"VEGFA"	3660	16270	157	124	97	60	72	52	99	154	11	406	421	558	524	603	542	364
"VEGFB"	1124	3994	48	0	0	48	0	0	87	28	0	0	171	170	1490	414	631	363
"VEGFC"	2086	109206	0	0	0	0	0	0	0	0	0	0	0	0	0	0	0	0
"VEGFR1"	1127	28678	248	11267	149	99	7450	3817	49	3855	0	8958	10	295	153	155	105	189
"VEGFR3"	2390	28650	0	0	0	0	0	0	95	81	0	0	0	0	0	0	0	0
"VENTX"	2414	4027	8	0	8	0	0	0	45	32	0	0	38	41	8	13	178	114
"VENTXP7"	959	959	0	0	0	0	0	0	0	0	0	0	0	0	0	0	0	0
"VEPH1"	3160	238749	97	1249	75	22	699	550	19	720	0	361	59	5111	86	5239	65	1376
"VESPR"	1675	42929	35	62	26	9	40	22	125	52	0	18	190	200	261	294	334	270
"VEZF1"	4639	16707	1077	2573	591	486	1384	1189	397	1159	127	1527	1979	3435	1774	2294	2106	1630
"VEZT"	4574	85046	616	680	371	245	332	348	503	498	34	532	638	948	780	559	746	722
"VGCNL1"	2624	273719	0	0	0	0	0	0	0	9	0	0	0	0	0	0	0	0
"VGF"	2554	3063	0	0	0	0	0	0	0	0	0	0	0	0	0	0	0	0
"VGLL1"	1219	24656	0	0	0	0	0	0	0	0	0	0	0	0	0	0	0	0
"VGLL2"	2234	8008	0	0	0	0	0	0	0	0	0	0	0	0	0	0	0	0
"VGLL3"	10398	53134	0	0	0	0	0	0	0	0	0	0	0	0	0	0	0	0
"VGLL4"	3865	164678	3479	1390	1814	1665	798	592	2359	1867	316	1272	1257	83	161	184	256	89
"VHDJH"	117	117	0	0	0	0	0	0	0	0	0	0	0	0	0	0	0	0
"VHL"	2953	10427	1080	1721	610	470	927	794	383	791	177	2050	4264	5706	1906	2392	2284	1595
"VHLL"	1014	1014	0	0	0	0	0	0	0	1	0	0	0	0	0	0	0	0
"VIK"	1692	6283	1947	2040	1076	871	890	1150	1106	657	1603	2238	3576	1680	1453	1411	1820	1120
"VIL1"	2756	30410	0	0	0	0	0	0	106	14	0	0	0	0	0	0	0	0
"VILL"	3006	19147	15	0	15	0	0	0	164	120	5	88	23	37	53	159	86	72
"VIM"	2146	9336	9329	14216	5012	4317	7533	6683	2686	8061	3943	10452	154088	46222	137728	192985	213682	192561
"VIP"	1589	8967	0	0	0	0	0	0	0	0	0	0	0	0	0	0	0	0
"VIPL"	2365	34146	15	12	0	15	12	0	123	66	36	19	277	207	363	270	397	270
"VIPR1"	2803	34963	1	0	0	1	0	0	163	69	0	0	0	0	0	0	0	0
"VIPR2"	4290	116784	0	0	0	0	0	0	221	50	0	0	0	0	0	0	0	0
"VISA"	625	15613	705	39	376	329	27	12	873	45	166	9	86	73	161	99	238	115
"VIT"	2744	118017	0	0	0	0	0	0	19	0	0	0	0	0	0	0	0	0
"VKORC1"	1083	4102	29	0	26	3	0	0	115	11	38	0	159	160	446	168	189	224
"VKORC1L1"	1148	81544	1290	92	712	578	51	41	847	92	125	298	1090	1073	771	642	841	613
"VLCS-3"	2379	4866	5988	1685	3274	2714	888	797	1104	371	3263	532	13465	11114	9191	6118	23325	11990
"VLDLR"	3655	32694	0	0	0	0	0	0	0	0	0	0	5	4	4	0	0	0
"VLGR1"	5388	66075	0	0	0	0	0	0	0	0	0	0	0	0	0	0	0	0
"VMA21"	4690	12132	74	0	46	28	0	0	81	11	0	0	957	934	805	576	972	668
"VMAC"	1670	5411	20	9	20	0	5	4	61	67	0	70	215	121	178	121	209	113
"VMD2"	2897	14585	1146	3960	645	501	2122	1838	425	2437	208	6019	25386	35254	35333	55837	31750	42103
"VMO1"	806	1150	1	0	1	0	0	0	0	0	0	0	32	6	24	0	20	0
"VN1R1"	1314	1314	0	0	0	0	0	0	9	0	0	0	0	0	0	0	0	0
"VN1R2"	1312	1312	0	0	0	0	0	0	0	0	0	0	0	0	0	0	0	0
"VN1R4"	906	906	0	0	0	0	0	0	0	0	0	0	0	0	0	0	0	0
"VN1R5"	1072	1074	0	0	0	0	0	0	0	0	0	0	0	0	0	0	0	0
"VNN1"	3850	33198	0	0	0	0	0	0	0	0	0	0	0	0	0	0	0	0
"VNN2"	2010	14025	0	0	0	0	0	0	0	0	0	0	17	19	76	92	47	25
"VNN3"	1921	11977	0	0	0	0	0	0	0	0	0	0	0	0	0	3	3	0
"VOPP1"	2948	101895	28134	43209	15616	12518	23068	20141	9041	17160	12399	41132	319	6482	772	1084	874	559
"VPO2"	2397	89979	0	0	0	0	0	0	0	0	0	0	0	0	0	0	0	0
"VPRBP"	5850	100705	1271	576	711	560	318	258	782	469	281	985	952	1161	1306	844	1139	937
"VPREB1"	643	728	0	0	0	0	0	0	0	0	0	0	0	0	0	0	0	0
"VPREB3"	583	1698	0	0	0	0	0	0	0	0	0	0	3	0	0	0	0	0
"VPS11"	3232	14195	506	79	289	217	29	50	335	203	159	117	1619	1345	2354	1198	3004	1579
"VPS13A"	11332	240038	445	342	245	200	186	156	420	223	218	115	674	1199	747	646	870	438
"VPS13B"	14155	864315	26623	21965	15341	11282	11995	9970	16031	13307	3036	11980	2261	2542	2236	1961	2730	1649
"VPS13C"	13485	208057	16614	8831	9529	7085	4900	3931	9317	4255	4722	4940	6452	8218	8578	7948	8594	4481
"VPS13D"	16396	281985	6892	5883	3841	3051	3151	2732	4923	4183	2474	4794	2359	2726	3041	2729	3557	1978
"VPS16"	2751	26008	4450	2365	2541	1909	1288	1077	2134	1332	1260	2806	1265	1169	1230	1104	2073	889
"VPS18"	3899	9546	253	83	145	108	27	56	156	138	26	40	1297	636	1569	906	1925	992
"VPS24"	3380	217693	4651	2390	2883	1768	1336	1054	2351	940	1797	1832	1049	1476	2591	2415	2693	1955
"VPS25"	1106	6164	37	35	21	16	21	14	24	34	0	0	704	697	860	760	1121	782
"VPS26A"	2815	48708	1999	1523	1130	869	907	616	668	748	367	1876	2284	2035	2438	2133	2190	1802
"VPS26B"	3673	23125	1343	61	792	551	49	12	727	88	448	22	1596	1287	2128	1414	2785	1590
"VPS28"	1071	4929	346	20	183	163	7	13	124	92	155	34	754	858	1546	1051	2372	1046
"VPS29"	1160	8022	1759	1140	981	778	658	482	674	469	577	1056	2604	3068	1497	1748	1973	1548
"VPS33A"	2978	58860	842	1057	433	409	613	444	539	752	78	2034	1726	2069	1617	1675	2016	1096
"VPS33B"	2662	24061	128	20	91	37	14	6	172	56	120	0	510	428	528	311	659	334
"VPS35"	5030	20374	1106	153	670	436	69	84	337	65	195	0	3515	3759	4294	3378	4610	2785
"VPS36"	4573	37596	2211	453	1269	942	239	214	1278	230	1004	263	2639	2540	2265	1771	2330	1366
"VPS37A"	4596	51133	2702	3174	1601	1101	1752	1422	1671	1305	839	1208	904	1014	1285	1162	1402	1002
"VPS37B"	2749	30835	3167	9254	1801	1366	4911	4343	1054	3948	801	6778	819	2050	856	425	206	1133
"VPS37C"	2697	31190	6883	5128	3922	2961	2715	2413	2447	2585	4740	4775	1520	324	273	1851	411	1514
"VPS37D"	1608	4267	0	0	0	0	0	0	9	0	0	0	0	0	0	0	0	0
"VPS39"	4890	49604	2618	1331	1442	1176	713	618	1455	843	527	900	2410	2593	3586	2486	4263	2390
"VPS41"	4922	185258	6053	2570	3408	2645	1475	1095	3810	1464	1220	1582	1460	1940	3031	2584	3131	2113
"VPS45"	2851	78164	2121	220	1259	862	118	102	1634	84	272	219	1188	1115	1262	941	1351	928
"VPS4A"	2186	13660	722	277	414	308	157	120	344	211	443	450	3190	2600	2532	2151	3173	2171
"VPS4B"	3387	33327	1062	674	612	450	402	272	549	417	267	746	2084	2116	1891	1473	2200	1387
"VPS52"	2971	21615	1266	386	713	553	170	216	803	456	373	466	1247	815	1080	1130	1127	985
"VPS53"	10306	203368	5328	6888	3019	2309	3731	3157	3214	4698	1420	7190	1428	1683	1443	1431	1467	1087
"VPS54"	5152	44189	4191	2786	2335	1856	1871	915	2958	2688	749	1210	714	5895	646	661	649	703
"VPS72"	1404	12814	75	10	63	12	5	5	97	0	5	26	175	306	316	247	482	508
"VPS8"	5088	240473	7116	2744	4097	3019	1611	1133	5159	1890	2375	1544	1280	1468	1683	1569	1559	1192
"VRK1"	1715	84268	733	53	452	281	0	53	564	73	29	88	289	383	233	219	251	204
"VRK2"	2515	252271	4724	1269	2677	2047	694	575	2881	756	186	793	1759	697	1513	1031	1502	946
"VRK3"	2115	49083	839	392	459	380	198	194	709	688	376	1252	360	305	734	645	602	538
"VRL"	2177	21429	4767	1441	2688	2079	740	701	1700	861	3702	2061	5454	6357	8370	6333	9511	6266
"VSIG1"	3243	34215	0	0	0	0	0	0	0	0	0	0	0	0	0	0	0	0
"VSIG10"	5010	40412	46	0	15	31	0	0	97	6	0	0	296	311	253	167	278	187
"VSIG10L"	3683	10584	25	0	11	14	0	0	94	42	0	0	199	127	109	52	199	79
"VSIG2"	1215	4107	964	0	481	483	0	0	314	37	417	0	2011	1521	2169	2302	3114	2878
"VSIG4"	2197	18387	0	0	0	0	0	0	0	0	0	0	0	0	0	0	0	0
"VSIG8"	1824	8342	0	0	0	0	0	0	28	0	0	0	0	0	0	0	0	0
"VSNL1"	2008	115900	0	0	0	0	0	0	25	0	0	0	0	0	0	0	0	0
"VSTM1"	1026	23124	0	0	0	0	0	0	0	0	0	0	0	0	74	60	0	39
"VSTM2A"	2616	28170	0	0	0	0	0	0	0	0	0	0	0	0	0	0	0	0
"VSTM2B"	1248	37737	0	0	0	0	0	0	93	10	0	0	0	0	0	0	0	0
"VSTM2L"	1963	42248	0	0	0	0	0	0	275	102	66	28	68	50	118	83	26	83
"VSX1"	1935	6669	0	0	0	0	0	0	0	0	0	0	0	0	0	0	0	0
"VSX2"	2993	23261	0	0	0	0	0	0	38	65	0	0	0	0	0	0	0	0
"VTA1"	3250	73675	420	42	195	225	23	19	516	7	0	13	981	1047	1028	858	1060	830
"VTCN1"	2700	67341	0	0	0	0	0	0	0	0	0	0	0	0	0	0	0	0
"VTI1A"	4397	371747	27594	22968	15598	11996	12530	10438	13031	10677	8586	15565	1118	1445	1089	972	1215	815
"VTI1B"	1497	23735	1367	432	754	613	205	227	656	363	468	788	3636	3082	3385	2922	3647	1188
"VTN"	1683	3074	0	3	0	0	3	0	34	18	0	0	0	3	25	9	10	0
"VTRNA1-1"	99	99	0	0	0	0	0	0	0	0	0	0	0	0	0	0	0	0
"VTRNA1-2"	89	89	0	0	0	0	0	0	0	0	0	0	0	0	0	0	0	0
"VTRNA1-3"	89	89	0	0	0	0	0	0	0	0	0	0	0	0	0	0	0	0
"VTS20631"	3465	115985	0	0	0	0	0	0	318	150	0	0	0	0	0	0	0	0
"VWA1"	2539	5238	0	0	0	0	0	0	0	0	0	0	0	2	4	0	0	0
"VWA2"	3344	52721	0	0	0	0	0	0	0	14	0	0	0	0	0	0	0	0
"VWA3A"	4627	64419	0	0	0	0	0	0	12	10	0	0	0	0	0	0	0	0
"VWA3B"	4903	204951	0	0	0	0	0	0	23	0	0	0	0	0	0	0	0	0
"VWA5A"	3553	31507	0	19	0	0	11	8	13	0	0	0	482	503	607	834	463	303
"VWA5B1"	4497	63977	0	0	0	0	0	0	134	75	0	0	0	0	0	0	0	0
"VWA5B2"	4038	11801	6	4	6	0	4	0	1	21	0	0	1	0	0	0	0	0
"VWC2"	1895	138883	0	0	0	0	0	0	61	17	0	0	0	0	0	0	0	0
"VWC2L"	912	164194	0	0	0	0	0	0	0	0	0	0	0	0	0	0	0	0
"VWCE"	3612	37031	5	0	5	0	0	0	151	68	0	5	0	0	21	6	27	8
"VWDE"	6286	73345	0	0	0	0	0	0	0	0	0	0	0	0	0	0	0	0
"VWF"	8885	175798	0	0	0	0	0	0	209	64	0	0	15	13	47	37	46	22
"W"	4582	11676	748	380	406	342	203	177	524	108	470	72	5082	5571	4642	3730	5613	3031
"WA1"	889	13492	39	0	39	0	0	0	15	0	39	0	623	568	778	720	921	633
"WAC"	3813	88496	16678	14981	9309	7369	8155	6826	6920	6126	8057	10752	4430	4035	4043	2949	5151	3299
"WAPAL"	6320	86529	6053	5235	3478	2575	2813	2422	2732	2974	2175	5010	3375	3248	3804	2406	4082	2318
"WARS"	3224	42465	13679	69294	7692	5987	36997	32297	1948	27925	2710	23678	8008	19643	7543	13629	12973	12643
"WARS2"	2839	109456	159	231	99	60	127	104	102	347	0	283	94	32	252	231	178	142
"WAS"	1840	7631	690	119	383	307	92	27	141	30	152	20	1895	1224	2096	1377	2463	1550
"WASF1"	3231	80187	0	0	0	0	0	0	0	0	0	0	0	8	0	4	0	0
"WASF2"	4279	84545	10098	2240	5632	4466	1237	1003	4341	2049	6210	4365	7040	7306	8254	7059	9637	6573
"WASF3"	4842	131242	0	0	0	0	0	0	0	0	0	0	0	2	0	0	0	0
"WASH"	1693	16992	1555	498	826	729	286	212	970	412	1752	938	282	313	4377	2698	4152	1537
"WASH1"	1848	15230	89	16	39	50	5	11	200	75	0	0	285	222	5589	3162	6630	3084
"WASH2P"	2564	15793	434	141	250	184	88	53	368	177	338	368	103	78	4037	2570	5085	2154
"WASL"	4429	67117	5950	2764	3360	2590	1569	1195	2228	828	582	1163	536	417	538	245	557	307
"WAVE2"	3763	84545	10098	2240	5632	4466	1237	1003	4341	2049	6210	4365	7040	7306	8254	7059	9637	6573
"WBP1"	2051	2426	230	32	123	107	22	10	135	89	0	39	419	452	610	551	966	636
"WBP11"	2684	16989	298	725	228	70	435	290	221	488	37	268	1924	2310	2139	1743	2338	1903
"WBP11P1"	2972	2972	0	0	0	0	0	0	0	0	0	0	16	0	0	0	0	0
"WBP2"	2117	9722	755	468	309	446	277	191	508	183	664	424	3764	3330	2322	2009	6138	4363
"WBP2NL"	2320	29748	14308	13171	7932	6376	7033	6138	6107	6872	7385	15419	16750	8429	6765	6421	10448	13507
"WBP4"	2341	22442	399	370	247	152	183	187	226	287	4	143	515	824	500	520	518	423
"WBP5"	1090	2017	0	0	0	0	0	0	0	0	0	0	34	23	43	52	27	36
"WBSCR14"	3143	31348	1	0	1	0	0	0	95	43	0	0	0	0	72	95	15	30
"WBSCR16"	2387	33416	39	7	27	12	0	7	38	44	0	91	419	271	1196	1150	1540	1082
"WBSCR17"	3260	580796	0	0	0	0	0	0	33	0	0	0	0	0	0	0	0	0
"WBSCR20C"	1333	4003	171	39	93	78	20	19	50	77	0	25	276	185	1884	1365	2405	1169
"WBSCR22"	2545	21595	365	66	246	119	55	11	545	295	293	306	1034	864	812	658	1238	597
"WBSCR26"	477	933	0	0	0	0	0	0	31	0	0	0	0	0	0	0	0	0
"WBSCR27"	936	7936	0	0	0	0	0	0	0	0	0	0	0	0	0	0	0	0
"WBSCR28"	981	4736	0	0	0	0	0	0	10	11	0	0	0	0	0	0	0	0
"WBSCR5"	1957	20078	1230	297	608	622	154	143	425	525	1632	385	3075	3005	1904	1711	3454	2153
"WDF2"	1052	171113	15593	14425	8820	6773	8010	6415	6889	5196	1790	4813	539	724	434	483	610	436
"WDFY1"	4618	69988	2558	930	1432	1126	563	367	1749	874	1125	649	2752	2874	1034	2096	2848	497
"WDFY2"	3820	177688	17124	14425	9448	7676	8010	6415	7610	5196	2151	5919	1921	2481	1197	1047	1628	981
"WDFY3"	14381	296849	9097	3916	5012	4085	2047	1869	5904	2245	1337	1935	2011	2899	2909	3028	3031	1948
"WDFY4"	10074	297484	193390	141492	106711	86679	75600	65892	91101	70101	161347	133855	26985	32124	28748	24087	61107	33836
"WDHD1"	4760	86867	0	0	0	0	0	0	9	0	0	0	68	133	105	88	91	71
"WDR1"	3323	8838	17447	22439	9068	8379	12206	10233	4806	13849	9927	25103	14119	18856	12198	20680	16032	10979
"WDR10"	3786	80224	132	57	77	55	44	13	240	171	8	15	203	240	274	252	319	223
"WDR11"	9201	48699	5672	4497	3215	2457	2417	2080	2592	1427	872	1811	2798	3589	2988	2142	2697	1676
"WDR12"	2294	31627	50	0	38	12	0	0	106	0	0	0	292	431	598	445	355	315
"WDR13"	2105	7675	413	161	229	184	63	98	149	136	215	170	1040	700	1277	1156	1326	917
"WDR16"	2396	66832	0	0	0	0	0	0	0	0	0	0	0	0	0	0	0	0
"WDR17"	7391	116835	0	0	0	0	0	0	0	0	0	0	0	0	0	0	0	0
"WDR18"	1561	10243	55	13	15	40	4	9	31	110	0	0	349	231	520	414	500	358
"WDR19"	4556	103407	32	11	12	20	6	5	26	16	0	0	49	114	134	131	123	102
"WDR20"	3061	75129	6329	2616	3518	2811	1452	1164	2962	2009	4002	4434	591	427	673	383	745	368
"WDR23"	4295	10466	530	199	303	227	120	79	369	144	440	71	2732	2613	2583	2238	3014	2226
"WDR24"	3174	5700	281	54	192	89	21	33	207	144	0	87	152	126	372	227	529	304
"WDR25"	2126	153807	105	231	59	46	113	118	660	898	26	60	85	41	96	92	153	86
"WDR26"	6615	48887	8920	8562	4930	3990	4709	3853	4135	3811	3571	6175	5873	8232	6183	5883	6831	5063
"WDR27"	3614	244854	154	0	61	93	0	0	277	83	75	38	22	110	97	95	207	62
"WDR3"	3904	30679	36	0	5	31	0	0	46	16	0	0	481	475	640	361	691	332
"WDR31"	2464	24637	0	0	0	0	0	0	19	0	0	0	0	0	4	0	0	0
"WDR32"	6879	12888	669	139	406	263	81	58	377	107	56	42	940	865	802	507	792	462
"WDR33"	6305	106939	8970	3744	5098	3872	2106	1638	4008	1622	3183	3844	2528	1436	2163	1382	2926	1614
"WDR34"	1827	23191	320	49	120	200	47	2	255	70	81	4	23	35	28	13	1648	1033
"WDR35"	6970	79855	4	0	3	1	0	0	8	0	0	0	27	21	20	13	34	18
"WDR36"	6616	38333	770	99	441	329	66	33	441	101	149	40	1518	1258	1732	1057	1639	954
"WDR37"	4628	75463	11855	4301	6609	5246	2343	1958	5128	1600	6795	3645	3077	2287	2919	1598	3437	1914
"WDR38"	1260	4406	0	0	0	0	0	0	32	60	0	0	0	0	0	0	1220	0
"WDR4"	2146	30344	1840	2400	1031	809	1276	1124	1013	1071	1170	3499	482	644	470	734	524	402
"WDR41"	2571	60265	3923	586	2150	1773	322	264	2370	480	1052	490	2125	1068	860	706	1186	772
"WDR42A"	774	774	1790	755	1050	740	366	389	945	351	1649	814	311	142	453	407	1004	589
"WDR43"	3519	53549	1583	2204	934	649	1183	1021	947	1343	0	1472	891	996	1042	920	1089	826
"WDR44"	4158	103881	3872	469	2197	1675	265	204	2029	404	884	541	625	793	772	708	878	724
"WDR45"	2619	5666	294	0	147	147	0	0	120	96	97	49	596	430	895	940	892	682
"WDR45L"	2595	33973	654	429	427	227	285	144	635	576	38	1184	1116	1206	1331	1183	1536	1126
"WDR46"	2060	10112	457	148	305	152	67	81	188	209	50	173	694	640	784	617	848	558
"WDR47"	4387	72012	328	41	172	156	18	23	308	20	26	0	1093	1275	735	548	963	604
"WDR48"	3708	44374	954	605	518	436	368	237	726	294	98	697	2530	2522	2726	1083	3421	2241
"WDR49"	2606	174816	0	0	0	0	0	0	0	0	0	0	0	0	0	0	0	0
"WDR5"	3168	23885	1264	284	699	565	141	143	648	413	1018	195	885	706	1616	1012	1990	1007
"WDR51A"	2277	79458	28	24	13	15	11	13	350	143	0	0	22	61	71	32	68	49
"WDR51B"	3221	105841	687	199	398	289	126	73	571	342	90	351	868	801	728	895	789	559
"WDR52"	6531	78147	105	24	77	28	16	8	100	28	34	0	67	93	81	69	48	16
"WDR53"	1573	14354	24	0	13	11	0	0	0	0	0	0	126	26	173	41	221	89
"WDR54"	1128	3998	0	0	0	0	0	0	23	10	0	0	157	72	166	71	126	91
"WDR55"	2585	6169	244	50	113	131	24	26	136	25	81	49	1030	709	438	120	416	157
"WDR59"	3689	111548	545	1686	294	251	974	712	357	1074	291	1439	601	689	625	529	925	571
"WDR5B"	4184	4184	239	11	141	98	0	11	109	19	63	36	298	111	269	68	275	68
"WDR6"	4479	8751	995	960	91	904	521	439	887	563	909	410	147	111	2664	2147	7964	4725
"WDR60"	5442	61629	144	29	72	72	8	21	340	32	0	0	149	158	190	164	248	188
"WDR61"	1351	7838	173	18	104	69	18	0	175	21	66	0	832	803	770	566	834	495
"WDR62"	4777	50231	16	4	7	9	4	0	216	66	0	0	34	28	26	23	102	60
"WDR63"	3029	70829	0	0	0	0	0	0	0	0	0	0	2	0	0	0	0	0
"WDR64"	2608	118170	1	0	1	0	0	0	13	0	0	0	0	0	0	0	0	0
"WDR65"	3023	38525	0	0	0	0	0	0	0	0	0	0	0	0	0	0	0	0
"WDR66"	3774	85352	48	9	38	10	9	0	158	11	0	5	200	189	69	37	312	147
"WDR67"	3524	79472	787	0	458	329	0	0	767	5	75	0	397	322	368	224	438	227
"WDR68"	5754	43819	4009	997	2283	1726	547	450	1821	567	1280	991	7171	6648	8428	5873	8169	4806
"WDR69"	1899	52701	0	0	0	0	0	0	0	0	0	0	0	0	0	0	0	0
"WDR7"	7310	378422	11692	8315	6589	5103	4664	3651	7277	5143	1141	3602	1746	1641	2321	1793	2098	1464
"WDR70"	2138	373362	7164	6050	4000	3164	3344	2706	4836	4044	1084	3563	512	577	574	530	684	479
"WDR72"	7329	245923	0	0	0	0	0	0	0	0	0	0	0	0	0	0	0	0
"WDR73"	1850	11511	755	82	400	355	55	27	455	63	594	93	983	660	632	297	709	319
"WDR74"	1748	8899	10811	14864	5778	5033	7678	7186	2404	7993	25	2958	307	302	451	244	421	269
"WDR75"	4353	34107	346	308	162	184	177	131	426	309	25	155	626	1089	863	766	763	627
"WDR76"	2537	40004	0	0	0	0	0	0	0	0	0	0	59	23	11	3	16	5
"WDR77"	2417	9319	481	0	301	180	0	0	194	34	182	36	616	490	881	284	958	526
"WDR78"	3859	111998	0	0	0	0	0	0	37	21	0	0	0	0	0	3	0	0
"WDR8"	5729	18214	165	8	93	72	8	0	184	49	21	0	339	245	418	267	632	366
"WDR81"	6879	13770	2177	502	1262	915	258	244	858	309	1499	596	3614	2026	5024	2190	5900	2730
"WDR82"	4878	13718	2711	952	1493	1218	501	451	1156	664	2025	1596	5945	3903	5379	3017	6298	2880
"WDR85"	2139	24028	200	0	136	64	0	0	256	52	0	0	274	73	349	156	419	172
"WDR86"	2160	28687	153	5909	82	71	3278	2631	166	2630	0	4998	0	512	20	2653	0	4
"WDR87"	9070	21847	0	0	0	0	0	0	0	0	0	0	0	0	0	0	0	0
"WDR88"	1731	43705	0	0	0	0	0	0	41	17	0	24	101	16	23	0	0	0
"WDR89"	3152	44369	229	53	115	114	45	8	128	173	0	184	429	438	301	260	395	239
"WDR9"	6862	79543	5759	2026	3231	2528	1113	913	3127	878	1516	940	534	1874	820	1746	703	1364
"WDR90"	5582	18468	142	73	58	84	57	16	467	249	105	138	135	172	134	120	314	175
"WDR91"	4634	27728	233	88	152	81	39	49	213	81	23	23	472	419	599	517	540	412
"WDR92"	2252	27377	46	0	20	26	0	0	95	0	0	4	234	54	195	83	206	116
"WDR93"	2425	52842	0	0	0	0	0	0	25	0	0	0	2	0	0	0	0	0
"WDSOF1"	2649	28738	251	73	168	83	59	14	190	24	0	52	517	535	593	594	641	544
"WDSUB1"	1938	50800	623	37	393	230	37	0	527	9	87	3	305	279	431	250	308	181
"WDTC1"	4816	74103	874	284	480	394	130	154	525	355	396	287	1390	1510	1495	1387	2104	1503
"WDYHV1"	1354	25297	0	0	0	0	0	0	44	6	23	0	102	131	96	72	138	83
"WEE1"	5121	5929	0	0	0	0	0	0	11	0	0	0	22	42	8	20	0	4
"WEE2"	3073	22920	2	0	0	2	0	0	0	0	0	0	0	0	0	0	4	0
"WFDC1"	1381	35047	0	0	0	0	0	0	94	19	0	0	0	0	0	12	0	9
"WFDC10A"	483	1447	0	0	0	0	0	0	0	0	0	0	0	0	0	0	0	0
"WFDC10B"	635	20369	0	0	0	0	0	0	0	0	0	0	0	0	0	0	0	0
"WFDC11"	619	21677	0	0	0	0	0	0	0	0	0	0	0	0	0	0	0	0
"WFDC12"	777	1041	0	0	0	0	0	0	0	0	0	0	1	0	0	0	0	0
"WFDC13"	1374	6801	0	0	0	0	0	0	0	0	0	0	0	0	0	0	0	0
"WFDC2"	699	11779	0	0	0	0	0	0	0	0	0	0	0	0	0	0	0	0
"WFDC3"	1007	17702	0	0	0	0	0	0	8	0	0	0	16	0	0	0	0	0
"WFDC5"	1012	5712	0	0	0	0	0	0	9	0	0	0	0	0	0	0	0	0
"WFDC6"	622	5300	0	0	0	0	0	0	0	0	0	0	0	0	0	0	0	0
"WFDC8"	1275	28175	0	0	0	0	0	0	0	0	0	0	0	0	0	0	0	0
"WFDC9"	663	23330	0	0	0	0	0	0	0	0	0	0	0	0	0	0	0	0
"WFIKKN1"	1950	3106	0	0	0	0	0	0	25	0	0	0	1	0	0	0	0	0
"WFIKKN2"	3754	7104	0	0	0	0	0	0	39	32	0	0	0	0	0	0	0	0
"WFS1"	3659	14779	183	4	106	77	0	4	332	125	48	0	635	544	1650	1342	1432	1173
"WHAMM"	4269	25640	2562	1678	1049	1513	931	747	992	799	498	868	642	554	674	452	582	369
"WHAMML1"	3597	20628	0	0	0	0	0	0	0	0	0	0	0	3	28	21	21	10
"WHAMML2"	5254	20780	0	0	0	0	0	0	0	0	0	0	0	0	22	16	49	0
"WHSC1"	8575	49599	2681	716	1513	1168	392	324	1803	522	582	794	1198	1277	1423	1314	1707	1057
"WHSC1L1"	5452	107229	3073	601	1710	1363	334	267	1654	394	342	465	1165	1112	1295	1083	1392	911
"WHSC2"	2518	9529	675	216	374	301	132	84	756	189	586	261	269	146	516	267	670	343
"WI2-929E21.1-001"	2271	16693	1	20	0	1	20	0	7	0	0	0	5	20	212	182	197	145
"WIBG"	1232	25856	744	94	420	324	70	24	414	175	417	210	615	450	642	346	170	463
"WIF1"	2017	70711	0	0	0	0	0	0	0	0	0	0	0	0	0	0	0	0
"WINS1"	1288	28786	172	196	64	108	77	119	149	337	0	235	267	142	189	211	165	134
"WIPF1"	4825	38633	24530	5912	14115	10415	3224	2688	13810	1911	13212	2892	10758	10438	7510	9298	8290	4954
"WIPF2"	5533	62867	2073	1265	1199	874	699	566	821	844	423	2411	2014	1826	1689	1261	2226	1218
"WIPF3"	3248	71452	10	0	10	0	0	0	11	0	0	0	0	0	0	0	0	0
"WIPI1"	1940	36232	1378	572	833	545	284	288	711	353	421	460	917	1011	750	571	1041	538
"WIPI2"	4675	43652	2263	124	1294	969	39	85	1379	131	1085	199	2199	1811	2888	1754	3265	2019
"WIRE"	769	41677	1022	982	594	428	553	429	473	591	342	1961	46	40	95	87	119	70
"WISP1"	2801	38259	0	0	0	0	0	0	85	10	0	0	0	0	0	0	0	0
"WISP2"	1824	6269	0	0	0	0	0	0	18	13	0	0	0	0	0	0	0	0
"WISP3"	1322	15516	0	0	0	0	0	0	0	0	0	0	0	0	0	0	0	0
"WIT1"	3029	4035	0	0	0	0	0	0	0	0	0	0	0	0	0	0	0	0
"WIZ"	4506	9676	1255	611	623	632	337	274	587	472	1596	1150	686	646	1425	1265	2126	1223
"WNK1"	10343	158394	14261	10950	7986	6275	6069	4881	6934	6381	4404	5655	6905	5555	8861	8097	9998	6993
"WNK2"	7834	134276	0	3	0	0	3	0	672	400	0	0	0	5	0	0	0	0
"WNK3"	7768	161585	0	0	0	0	0	0	0	0	0	0	0	0	0	0	0	0
"WNK4"	4145	16385	0	0	0	0	0	0	112	53	0	0	0	0	0	0	0	0
"WNT1"	2287	4161	0	0	0	0	0	0	10	0	0	0	0	16	0	0	0	0
"WNT10A"	2379	13398	0	0	0	0	0	0	12	0	0	0	0	0	0	0	0	0
"WNT10B"	2275	6421	0	2	0	0	2	0	68	18	0	0	0	0	0	0	0	0
"WNT11"	1931	20205	0	0	0	0	0	0	82	74	0	0	0	0	0	0	0	0
"WNT16"	3117	12069	0	0	0	0	0	0	0	0	0	0	0	0	0	0	0	0
"WNT2"	2909	46657	0	0	0	0	0	0	0	0	0	0	0	0	0	0	0	0
"WNT2B"	2473	12540	2607	1000	1652	955	635	365	716	498	170	177	516	618	3	0	26	0
"WNT3"	1501	54397	0	0	0	0	0	0	126	23	0	0	1	0	0	0	0	0
"WNT3A"	2936	54211	0	0	0	0	0	0	133	114	0	0	0	0	0	0	0	0
"WNT4"	3908	25721	537	443	356	181	197	246	422	411	102	528	0	0	0	0	0	0
"WNT5A"	5842	21589	10668	20107	5981	4687	10792	9315	3202	8691	7476	24211	7796	19330	7151	15956	7275	10104
"WNT5B"	2586	16401	2375	57	1361	1014	51	6	1403	65	1396	0	2041	1097	2695	1416	3887	1937
"WNT6"	1704	14410	0	0	0	0	0	0	0	28	0	0	0	0	0	0	0	0
"WNT7A"	1718	61538	0	0	0	0	0	0	259	154	0	0	0	0	0	0	0	0
"WNT7B"	3916	56762	0	0	0	0	0	0	373	191	0	0	0	0	0	0	0	0
"WNT8A"	1788	7620	0	0	0	0	0	0	0	0	0	0	0	0	0	0	0	0
"WNT8B"	2000	20587	0	0	0	0	0	0	0	7	0	0	0	1	0	0	0	0
"WNT9A"	1244	26513	0	0	0	0	0	0	187	61	0	0	0	0	0	0	0	0
"WNT9B"	2643	35130	0	0	0	0	0	0	181	40	0	0	0	0	0	0	0	0
"WRAP53"	1972	15154	149	9	88	61	0	9	66	51	66	0	179	183	193	123	255	184
"WRB"	2080	10124	0	0	0	0	0	0	40	0	0	0	246	218	277	193	295	154
"WRN"	5780	140500	293	69	169	124	27	42	351	75	0	40	346	463	356	383	421	276
"WRNIP1"	2658	20314	2527	377	1373	1154	254	123	1199	246	1049	424	1693	1147	1604	1174	1659	866
"WSB1"	4197	19541	5116	5614	2857	2259	2868	2746	1852	2181	2694	4760	3816	5924	5008	6162	5326	4125
"WSB2"	2831	28461	1622	2099	943	679	1141	958	563	1080	580	2237	4976	6008	4649	5221	5426	4066
"WSCD1"	5880	55310	0	0	0	0	0	0	32	21	0	0	0	0	0	0	0	0
"WSCD2"	4688	118756	0	0	0	0	0	0	73	18	0	0	0	0	0	0	0	0
"WT1"	3192	47764	0	0	0	0	0	0	13	0	0	0	0	0	0	0	0	0
"WTAP"	3705	5117	5575	36724	3133	2442	19906	16818	1431	17944	545	22908	2644	16978	2853	21695	3222	8706
"WTIP"	2211	19206	0	0	0	0	0	0	2	0	0	1	1	1	2	4	0	0
"WWC1"	6760	180243	1	0	1	0	0	0	52	20	0	0	0	0	3	0	0	0
"WWC2"	8829	221466	790	110	453	337	88	22	1164	258	38	106	489	727	868	824	778	608
"WWC3"	6839	128724	1110	355	711	399	190	165	967	503	245	270	1024	1426	908	944	1157	769
"WWOX"	2249	1113014	6796	4536	3696	3100	2436	2100	5845	4622	907	6070	117	96	110	104	129	106
"WWP1"	4128	125184	1117	215	704	413	104	111	1324	322	0	203	366	214	925	999	872	796
"WWP2"	4527	179371	11513	7432	6407	5106	3950	3482	4334	2832	5566	7682	2864	2413	3155	2820	4151	2932
"WWTR1"	2082	183084	0	0	0	0	0	0	0	0	0	0	0	8	16	7	0	0
"X04930"	209	209	0	0	0	0	0	0	0	0	0	0	3	1	0	1	5	1
"X05128"	392	392	0	0	0	0	0	0	0	0	0	0	0	0	0	0	0	0
"X06774"	488	612	0	0	0	0	0	0	0	0	0	0	206	0	0	1	0	57
"X15673"	393	393	0	0	0	0	0	0	0	0	0	0	0	0	0	0	0	0
"X17676"	948	5202	0	0	0	0	0	0	39	8	0	0	0	0	0	0	61	0
"X58749"	277	277	0	0	0	0	0	0	0	0	0	0	0	0	0	0	0	0
"X60137"	333	333	0	0	0	0	0	0	0	0	0	0	0	0	0	0	0	0
"X60146"	227	227	0	0	0	0	0	0	0	0	0	0	0	0	0	0	0	0
"X61074"	330	1570	0	0	0	0	0	0	0	0	0	0	0	0	0	0	0	0
"X63945"	152	275	0	0	0	0	0	0	0	0	0	0	0	0	0	0	0	0
"X64709"	710	710	0	0	0	0	0	0	17	0	0	0	24	34	47115	51608	266135	50784
"X64983"	344	344	0	0	0	0	0	0	0	0	0	0	0	0	0	0	0	0
"X69637"	1317	10324	0	0	0	0	0	0	0	0	0	0	0	0	4	3	0	0
"XAB1"	1839	52210	1939	323	1109	830	182	141	891	342	979	659	2313	2082	1898	1123	2216	1091
"XAB2"	2673	10029	214	69	96	118	50	19	235	172	43	23	445	325	957	625	1122	752
"XAF1"	3629	19808	3901	1470	2109	1792	888	582	1842	872	1631	768	2264	2497	2913	610	2035	890
"XAGE1D"	791	4991	0	0	0	0	0	0	0	0	0	0	0	0	0	5	0	0
"XAGE1E"	790	4990	0	0	0	0	0	0	0	0	0	0	0	0	0	5	0	0
"XAGE2"	715	6744	0	0	0	0	0	0	0	0	0	0	0	0	0	0	0	0
"XAGE3"	519	5561	0	0	0	0	0	0	0	0	0	0	0	0	0	0	0	0
"XAGE5"	482	6096	0	0	0	0	0	0	0	0	0	0	0	0	0	0	0	0
"XAP8alpha"	2949	58787	2577	1147	1550	1027	612	535	1502	848	499	1615	22	74	27	70	44	14
"XB"	726	3850	0	0	0	0	0	0	0	0	0	0	0	0	0	0	0	0
"XB51"	2004	17372	454	42	244	210	7	35	272	113	370	110	246	334	265	333	580	373
"XBP1"	2173	2486	282	1229	116	166	661	568	157	135	40	781	3619	9087	1008	2863	986	1951
"XCL1"	1225	5461	0	0	0	0	0	0	3	0	0	0	9	7	0	7	23	17
"XCL2"	566	3232	27	0	10	17	0	0	12	11	0	0	9	14	9	17	38	19
"XCR1"	1375	6689	0	0	0	0	0	0	0	0	0	0	0	0	0	0	0	0
"XDH"	5753	80425	0	0	0	0	0	0	0	0	0	0	0	0	0	0	0	0
"XEDAR"	3339	43411	0	0	0	0	0	0	0	9	0	0	0	0	0	0	0	0
"XG"	2940	64448	0	0	0	0	0	0	27	0	0	0	0	0	0	0	0	0
"XGPY2"	684	35274	0	0	0	0	0	0	0	0	0	0	0	0	0	0	0	0
"XIAP"	8419	53775	2573	1545	1521	1052	917	628	1236	921	1512	3166	2448	2764	2100	1529	1667	806
"XIRP1"	6453	9372	0	0	0	0	0	0	50	10	0	0	0	0	0	0	0	0
"XIRP2"	12610	356286	0	0	0	0	0	0	0	0	0	0	0	0	0	0	0	0
"XIST"	19277	32095	33288	16561	18636	14652	9093	7468	15975	14591	56941	55532	0	0	0	0	30845	4060
"XK"	5087	46251	0	0	0	0	0	0	0	0	0	0	0	0	0	0	0	0
"XKR3"	1681	38273	241	0	113	128	0	0	47	0	0	0	101	105	60	38	99	58
"XKR4"	3910	423693	0	0	0	0	0	0	13	18	0	0	28	35	0	0	0	0
"XKR5"	4906	26996	0	0	0	0	0	0	53	16	0	0	0	0	0	0	0	0
"XKR6"	3761	305220	3385	2105	1897	1488	1176	929	1475	713	591	1227	62	45	5	6	60	0
"XKR7"	2912	30452	0	0	0	0	0	0	126	37	1	0	0	3	0	0	0	0
"XKR8"	2161	8102	12	0	12	0	0	0	60	15	0	0	297	115	258	117	373	165
"XKR9"	3297	66578	0	0	0	0	0	0	14	0	0	0	1	2	0	0	0	0
"XKRX"	2854	15469	0	0	0	0	0	0	0	0	0	0	0	0	0	0	0	0
"XKRY"	1580	1580	0	0	0	0	0	0	0	0	0	0	0	0	0	0	0	0
"XPA"	1706	22501	1389	282	617	772	131	151	986	279	284	318	304	1021	196	152	190	148
"XPC"	3734	33524	2168	899	1227	941	458	441	999	578	578	397	1348	1057	1783	853	2439	1167
"XPMC2H"	2188	11978	117	1	63	54	0	1	240	59	0	39	372	161	682	483	585	547
"XPNPEP1"	3606	47918	2696	1445	1555	1141	882	563	1580	1045	930	1493	1937	2029	2163	1973	3148	2103
"XPNPEP2"	3354	30581	0	0	0	0	0	0	64	47	0	0	238	205	277	292	375	302
"XPNPEP3"	3158	70786	1774	927	1003	771	486	441	781	344	820	1504	881	858	1221	947	1635	954
"XPO1"	6851	60350	7059	1733	4015	3044	976	757	3401	1129	5329	3062	5602	5791	4137	2823	3613	2265
"XPO4"	9907	125446	1535	346	909	626	235	111	1113	467	211	276	1057	1201	1254	1028	1209	861
"XPO5"	5395	53745	814	117	437	377	93	24	662	245	396	78	1445	956	1453	1171	1280	795
"XPO6"	4583	113876	9570	3386	5314	4256	1863	1523	4742	2420	3392	3616	2129	2991	4594	4055	5711	3458
"XPO7"	4917	86917	3158	175	1685	1473	117	58	2138	231	303	236	1985	2234	2254	1936	2814	1729
"XPOT"	3890	44230	166	58	88	78	17	41	216	25	0	0	1080	1009	1726	1411	2033	1333
"XPR1"	8509	258269	544	88	358	186	55	33	858	180	24	145	914	1181	1123	983	1055	788
"XPV"	2260	38582	210	0	124	86	0	0	147	39	0	47	352	197	278	154	310	130
"XRCC1"	2119	32268	195	60	92	103	35	25	330	163	157	100	522	474	680	592	915	592
"XRCC2"	3070	29663	0	0	0	0	0	0	0	0	0	0	0	0	0	0	0	0
"XRCC3"	2648	17870	7554	1813	2067	5487	1215	598	5278	989	1610	8178	3532	3729	908	1447	2647	1544
"XRCC4"	1710	276262	1341	534	727	614	250	284	1418	385	133	260	246	308	284	168	240	252
"XRCC5"	3848	89408	6989	3265	4025	2964	1810	1455	3518	1738	1277	2777	6523	7696	7083	6276	8146	5831
"XRCC6"	2146	42759	515	694	249	266	389	305	327	798	0	1648	1444	2283	4868	4693	4776	3563
"XRCC6BP1"	1165	15608	0	0	0	0	0	0	0	0	0	0	104	81	92	62	90	67
"XRN1"	10132	141404	2128	1051	1198	930	594	457	1695	730	288	443	1450	1904	1771	1549	1727	967
"XRN2"	3465	86523	7944	2901	4356	3588	1652	1249	3852	1877	2142	3243	3949	4302	4335	3579	5352	3412
"XRRA1"	5019	108278	8168	5020	4939	3229	2750	2270	2830	2509	1911	3532	2134	1672	737	298	1722	96
"XT-II"	3380	15120	570	51	358	212	23	28	304	90	79	140	442	266	360	265	696	359
"XTP2"	2151	47436	6760	10614	3672	3088	5664	4950	2824	4773	2406	7736	669	1344	827	864	985	404
"XTP6"	1354	446258	13731	21264	7731	6000	11786	9478	5608	10368	7167	15589	25	149	396	376	463	322
"XYLB"	3702	68218	79	9	61	18	4	5	163	13	0	6	44	58	42	40	62	29
"XYLT1"	9346	368557	33180	17735	18792	14388	9898	7837	13969	10075	20709	18317	3302	4293	3831	3699	3293	481
"XYLT2"	3577	15120	570	51	358	212	23	28	304	90	79	140	442	266	360	265	696	359
"Y09859"	225	403	0	0	0	0	0	0	0	0	0	0	0	0	0	0	0	0
"Y16709"	155	155	230	59	138	92	0	59	41	27	0	73	4290	4258	3719	2890	4327	3166
"YAF2"	4198	81143	5735	3757	3331	2404	2021	1736	2706	1437	1742	3278	427	505	300	263	399	313
"YAP1"	5377	122946	0	0	0	0	0	0	0	1	0	1	0	0	0	0	0	0
"YARS"	3130	42795	913	350	513	400	223	127	513	389	156	576	2216	2267	1915	1711	3084	2206
"YARS2"	2164	9397	128	42	87	41	25	17	78	0	0	0	285	143	317	153	457	321
"YBX1"	1551	19953	3047	4441	1700	1347	2402	2039	1439	2038	753	3585	5562	8118	16654	19915	7373	9772
"YBX2"	1592	6307	0	0	0	0	0	0	52	11	0	0	3	1	0	0	0	0
"YDJC"	1402	1964	107	0	70	37	0	0	19	40	0	44	320	300	114	291	455	334
"YEATS2"	6537	114809	4928	669	2918	2010	384	285	3043	280	2516	438	1270	1188	1542	1109	2272	1170
"YEATS4"	1391	31045	24	0	3	21	0	0	108	18	0	43	216	248	272	161	500	353
"YES1"	4695	90735	0	0	0	0	0	0	14	0	0	0	0	2	25	40	0	0
"YIF1A"	1128	4588	12	27	0	12	9	18	61	59	22	77	355	474	684	591	709	549
"YIF1B"	2912	6311	193	132	85	108	81	51	229	73	278	43	1518	1171	1496	1150	1719	1223
"YIPF1"	1866	38048	430	51	215	215	22	29	465	13	317	88	774	889	722	742	853	629
"YIPF2"	1512	5913	104	0	52	52	0	0	83	62	0	0	1659	1122	1556	1231	2345	1449
"YIPF3"	1577	5139	154	127	92	62	85	42	134	116	52	128	1247	1027	1965	1150	2206	1037
"YIPF4"	1970	28701	1577	123	929	648	60	63	777	57	700	27	1702	1611	1200	1067	1473	1047
"YIPF5"	3451	12549	0	0	0	0	0	0	0	9	0	0	804	816	916	698	731	684
"YIPF6"	1200	33416	574	375	282	292	256	119	442	336	190	384	1062	1344	706	763	775	590
"YIPF7"	940	29306	0	0	0	0	0	0	0	0	0	0	0	0	0	0	0	0
"YJEFN3"	2768	8675	354	202	199	155	111	91	284	303	163	406	21	100	166	132	133	5
"YKT6"	2772	13316	616	236	343	273	145	91	329	324	29	307	1831	1981	2843	2709	3467	2282
"YLPM1"	8157	73945	3970	987	2155	1815	581	406	1825	345	1097	792	2210	2461	2228	1774	2857	1587
"YME1L1"	4045	43938	1787	5061	965	822	2800	2261	908	2310	507	3679	2412	6551	3789	4172	4056	3456
"YOD1"	6295	9133	173	128	101	72	73	55	217	84	23	0	583	415	676	357	791	219
"YPEL1"	4671	38245	710	263	339	371	137	126	454	156	569	231	1135	1076	1040	793	1606	956
"YPEL2"	5237	70044	5085	494	2764	2321	254	240	3632	571	3221	170	1563	1056	2419	1133	2600	1266
"YPEL3"	2132	2440	50	34	29	21	17	17	44	0	45	53	553	408	590	478	745	427
"YPEL4"	1726	4858	435	6	198	237	0	6	233	55	180	0	868	386	542	166	433	279
"YPEL5"	2720	13018	1409	1688	836	573	877	811	740	637	174	899	3253	3529	3150	2517	3611	2324
"YQ028"	2633	2633	0	0	0	0	0	0	14	0	0	0	10	0	0	0	0	0
"YRDC"	1841	5253	139	67	79	60	36	31	68	90	0	92	619	234	596	1455	531	1055
"YSK4"	4358	42935	17	0	9	8	0	0	52	0	0	0	1	0	0	0	0	0
"YTHDC1"	6265	39720	2193	2824	1269	924	1556	1268	1176	1285	266	1441	1810	2485	1799	1717	2171	1402
"YTHDC2"	6314	81571	2417	1334	1313	1104	750	584	1340	711	622	1177	1288	1475	1406	942	1485	803
"YTHDF1"	3255	20756	896	694	458	438	353	341	642	559	42	1304	1385	715	1592	1360	1117	1295
"YTHDF2"	3247	32826	2322	2511	1305	1017	1390	1121	932	1375	799	3042	3047	2508	2879	2058	3621	2040
"YTHDF3"	5191	44226	4356	6407	2409	1947	3478	2929	1860	2965	674	4924	3357	3992	3802	3457	3807	2638
"YWHAB"	3111	22818	1615	1865	882	733	975	890	845	952	358	1876	11135	12587	11215	10381	12548	8442
"YWHAE"	1865	55722	4783	7321	2562	2221	4013	3308	1992	3843	3641	11359	3848	4848	4547	2062	1686	1765
"YWHAG"	3749	32236	5777	3756	3262	2515	2047	1709	2064	2220	3570	4695	11742	13726	11055	10016	12089	8393
"YWHAH"	1910	13112	1010	153	547	463	76	77	467	181	411	85	5842	5440	5410	3536	6564	3891
"YWHAQ"	2215	46640	2042	6628	1188	854	3544	3084	964	2708	532	5755	1112	5440	2179	2203	5911	1174
"YWHAZ"	3073	33555	7368	7243	4107	3261	3915	3328	2994	3016	4089	6474	18534	21501	13786	11938	13897	9757
"YY1"	2597	39704	3367	812	1742	1625	442	370	1504	422	1669	1874	5792	4379	4068	2504	5395	2875
"YY1AP1"	2902	29034	3925	3544	2397	1528	1987	1557	1856	1838	2454	4386	1905	2313	2762	2607	3084	2197
"YY2"	1961	18052	0	0	0	0	0	0	18	9	0	4	69	75	83	99	102	53
"Z11851"	142	58339	0	0	0	0	0	0	0	0	0	0	0	0	0	0	0	0
"Z22690"	83	83	0	0	0	0	0	0	0	0	0	0	0	0	0	0	0	0
"Z49973"	156	742	0	0	0	0	0	0	0	0	0	0	0	0	0	0	0	0
"Z49979"	448	448	0	0	0	0	0	0	0	0	0	0	0	0	0	0	0	0
"Z49982"	477	477	21	1629	0	21	844	785	94	1699	0	2668	715	1921	767	1596	855	994
"Z49985"	489	489	61	0	0	61	0	0	0	31	0	0	1242	1148	936	698	1172	767
"Z70701"	353	636	11	0	4	7	0	0	0	0	0	0	0	0	16	53	4	0
"ZACN"	1482	3624	181	231	162	19	72	159	70	0	0	0	0	1735	0	0	0	0
"ZADH1"	3539	80131	825	636	511	314	309	327	456	357	77	638	884	910	1017	1054	1208	990
"ZADH2"	5496	12004	1134	337	600	534	156	181	665	130	620	222	1231	846	1660	659	1819	782
"ZAK"	7193	151308	6297	1348	3588	2709	807	541	3481	1504	1164	2155	2523	3256	1658	1490	1752	1215
"ZAN"	8780	64171	0	0	0	0	0	0	168	108	0	0	3	0	0	3	0	0
"ZAP70"	3164	21890	111	15	89	22	7	8	257	85	0	73	28	49	60	57	130	76
"ZAR1"	1438	4113	0	0	0	0	0	0	0	0	0	0	0	0	0	0	0	0
"ZAR1L"	1107	8185	0	0	0	0	0	0	0	0	0	0	0	0	0	0	0	0
"ZBBX"	3327	139501	0	0	0	0	0	0	0	0	0	0	0	0	0	0	0	0
"ZBED1"	4577	14114	0	0	0	0	0	0	0	0	0	0	0	0	1548	1655	1844	1490
"ZBED2"	2188	2420	0	0	0	0	0	0	0	0	0	0	0	0	0	0	0	0
"ZBED3"	1422	10500	31	0	19	12	0	0	93	0	0	0	32	99	289	172	60	203
"ZBED4"	6888	36231	3802	1243	2154	1648	719	524	1794	1231	2297	2232	1188	879	1378	738	1834	783
"ZBED5"	4058	5114	1225	660	657	568	344	316	645	268	770	455	1655	1010	1134	360	1287	350
"ZBP1"	2304	16730	0	0	0	0	0	0	104	65	0	0	0	4	0	0	0	0
"ZBTB1"	4122	29118	10349	11983	5815	4534	6495	5488	4192	4293	5485	7700	5795	6713	5301	3976	6047	3141
"ZBTB10"	6065	36162	322	7468	201	121	4054	3414	207	3686	0	4200	531	5656	559	7513	493	3341
"ZBTB11"	5128	27705	1043	565	579	464	279	286	646	589	215	743	1567	1621	1621	1110	1855	1013
"ZBTB12"	1869	2379	92	10	56	36	3	7	61	46	170	118	115	70	221	44	312	36
"ZBTB16"	4447	130057	6	0	3	3	0	0	219	122	0	0	10	0	0	5	0	0
"ZBTB17"	2786	34263	1516	2864	862	654	1317	1547	743	1686	427	3260	533	329	590	634	704	341
"ZBTB2"	3088	27428	78	39	38	40	28	11	120	125	0	22	593	497	36	449	788	402
"ZBTB20"	3168	732699	9666	4276	5537	4129	2608	1668	10369	6261	967	3782	4	45	0	17	0	3
"ZBTB22"	2666	3333	124	2581	47	77	2570	11	91	94	0	0	3	658	670	636	991	663
"ZBTB24"	5604	20723	460	10	239	221	0	10	253	24	0	15	189	192	506	87	581	69
"ZBTB25"	2729	18376	4939	1578	3888	1051	845	733	1215	2832	973	5184	4032	4305	5354	2982	5836	2820
"ZBTB26"	2049	13167	446	66	275	171	34	32	312	51	0	45	456	1	0	156	0	99
"ZBTB3"	2974	3221	18	0	0	18	0	0	77	0	0	13	340	34	170	0	171	0
"ZBTB32"	1965	4111	12	0	0	12	0	0	66	35	0	0	0	0	0	0	0	0
"ZBTB33"	5314	7646	529	161	280	249	104	57	204	43	173	26	2555	1403	0	1110	3003	1186
"ZBTB34"	6563	25212	1070	12	633	437	0	12	563	68	452	104	757	263	1234	350	1304	308
"ZBTB37"	2327	18556	290	13	170	120	0	13	357	116	81	67	82	80	154	89	105	17
"ZBTB38"	8385	125572	3544	8454	1971	1573	4562	3892	1165	4330	476	7434	3014	4488	2335	4683	3222	2811
"ZBTB39"	6172	7614	190	102	123	67	57	45	275	162	0	126	384	645	411	385	537	150
"ZBTB4"	5945	24884	1154	112	656	498	88	24	747	384	218	187	1740	1601	2282	1595	2891	1518
"ZBTB40"	9011	79308	3336	1498	1902	1434	830	668	1740	783	809	616	1613	1546	2182	1682	2740	1389
"ZBTB41"	8569	46860	223	13	139	84	13	0	232	10	0	0	551	362	604	132	566	182
"ZBTB42"	3636	4115	66	0	18	48	0	0	150	51	56	0	313	159	322	130	455	175
"ZBTB43"	5973	33202	1805	2438	1008	797	1327	1111	757	1059	152	2529	854	935	1029	1049	1070	645
"ZBTB44"	9344	88033	1969	163	1188	781	99	64	1175	27	98	94	1414	1405	1378	945	1568	948
"ZBTB45"	2353	6024	198	0	116	82	0	0	129	78	0	42	339	190	405	227	563	267
"ZBTB46"	4381	60980	16197	13092	8975	7222	6968	6124	4956	9405	14618	25016	1893	2827	1675	2766	2569	1790
"ZBTB47"	4205	8200	263	1	140	123	1	0	127	17	174	0	422	244	455	278	612	452
"ZBTB48"	2348	9278	1557	307	859	698	191	116	613	285	892	298	1127	650	1330	615	1928	812
"ZBTB5"	4649	27307	504	562	266	238	300	262	288	450	24	494	327	1015	207	872	472	693
"ZBTB6"	4107	5275	23	25	12	11	15	10	53	0	0	0	828	377	664	208	540	165
"ZBTB7A"	4442	21600	4721	2053	2609	2112	1074	979	1150	1269	4956	4589	2316	1686	2655	2204	3011	1618
"ZBTB7B"	3833	15705	2542	185	1351	1191	125	60	1095	199	1259	134	3688	1660	4030	1572	6221	2171
"ZBTB7C"	4249	138191	46	0	20	26	0	0	882	152	0	0	167	101	0	3	170	185
"ZBTB8A"	7337	66771	11	0	11	0	0	0	29	0	0	0	129	91	62	22	111	15
"ZBTB8B"	8605	140885	11	0	11	0	0	0	29	0	0	0	129	91	62	22	111	15
"ZBTB8OS"	720	28878	269	20	140	129	0	20	175	0	0	61	164	167	178	242	251	271
"ZBTB9"	2711	2964	0	0	0	0	0	0	0	9	0	0	164	42	162	0	194	28
"ZC3H10"	2124	4250	134	0	87	47	0	0	150	85	0	43	343	144	368	187	493	140
"ZC3H11A"	5890	58458	3476	3183	1986	1490	1853	1330	1800	1653	1256	3300	3002	3550	4841	3753	5749	3648
"ZC3H12A"	2720	9859	3011	10795	1622	1389	5625	5170	544	7088	1793	18655	1212	21214	1314	32217	2116	23905
"ZC3H12B"	7169	19062	0	0	0	0	0	0	0	0	0	0	0	0	1	0	0	0
"ZC3H12C"	9547	35987	4579	103876	2529	2050	55979	47897	96	26839	0	29779	271	7917	523	8342	311	2504
"ZC3H12D"	2391	35154	2485	265	1418	1067	156	109	706	59	638	16	239	135	308	117	506	219
"ZC3H13"	6488	89845	2921	1864	1627	1294	978	886	1584	882	202	1155	2754	3034	2578	1877	3075	1786
"ZC3H14"	4210	50601	1233	42	819	414	20	22	757	34	127	30	1061	1105	1388	961	1483	929
"ZC3H15"	2141	23202	705	1202	410	295	643	559	469	645	139	776	1581	2008	1692	1663	1737	1372
"ZC3H18"	3817	61584	1535	4714	899	636	2513	2201	1204	4236	389	6911	932	1414	909	1783	1210	1145
"ZC3H3"	3289	103797	2710	864	1377	1333	496	368	2871	1950	1990	3290	472	313	664	469	682	496
"ZC3H4"	6129	49562	2690	2289	1443	1247	1282	1007	1204	1531	660	2762	1161	395	1336	1027	1752	1165
"ZC3H6"	11551	64464	1050	76	560	490	43	33	759	42	132	42	594	501	592	188	659	231
"ZC3H7A"	3866	31967	2486	1666	1397	1089	917	749	986	779	351	1748	1649	2327	2175	1715	2464	1527
"ZC3H7B"	5890	58585	1326	609	692	634	305	304	1166	933	252	1001	1610	1843	2501	2293	2599	1815
"ZC3H8"	1613	39227	879	42	544	335	16	26	381	33	117	0	459	220	275	134	226	121
"ZC3HAV1"	7182	66199	17123	79581	9044	8079	42533	37048	3062	41505	2539	31656	3938	15098	3556	6935	3390	1890
"ZC3HAV1L"	1758	10325	0	0	0	0	0	0	30	0	0	0	53	9	101	43	121	10
"ZC3HC1"	1923	33108	114	44	94	20	32	12	128	62	52	112	324	276	321	262	405	301
"ZC4H2"	4073	59970	0	0	0	0	0	0	0	0	0	0	0	9	3	5	0	0
"ZCCHC10"	2190	29562	488	715	301	187	372	343	195	351	0	940	604	830	562	551	102	518
"ZCCHC11"	5880	129816	265	120	176	89	57	63	223	44	50	26	392	494	452	436	608	356
"ZCCHC12"	2200	3145	0	0	0	0	0	0	0	0	0	0	0	0	0	0	0	0
"ZCCHC13"	845	845	0	0	0	0	0	0	2	0	0	0	0	0	0	0	0	0
"ZCCHC14"	6924	85610	1772	2200	948	824	1265	935	1334	997	279	1649	597	4188	867	748	818	520
"ZCCHC16"	2961	374222	0	0	0	0	0	0	0	0	0	0	0	0	0	0	0	0
"ZCCHC17"	1681	67940	1121	3385	644	477	1752	1633	810	1238	47	845	213	474	614	1522	686	1433
"ZCCHC18"	3048	3426	0	0	0	0	0	0	0	0	0	0	0	0	0	0	0	0
"ZCCHC2"	5909	63306	9651	816	5317	4334	461	355	5504	451	7250	457	3631	2013	6731	2811	6451	3435
"ZCCHC24"	5076	63300	398	39	237	161	3	36	901	302	778	59	661	556	795	599	690	450
"ZCCHC3"	2759	2759	14	0	14	0	0	0	0	0	0	0	593	418	658	408	747	371
"ZCCHC4"	2808	57609	180	9	115	65	0	9	147	0	5	6	149	200	194	172	161	90
"ZCCHC5"	2650	3261	0	0	0	0	0	0	0	0	0	0	0	0	0	0	0	0
"ZCCHC6"	5672	66721	7049	12656	4073	2976	6521	6135	3171	4485	1199	4581	3009	5612	3434	3757	3976	2250
"ZCCHC7"	2712	237543	24543	17914	13858	10685	9752	8162	13426	8442	11215	13680	748	886	546	399	836	437
"ZCCHC8"	2877	28084	1373	564	770	603	279	285	610	240	319	381	639	934	488	380	667	700
"ZCCHC9"	1794	11563	274	19	168	106	19	0	169	22	0	0	691	567	553	382	733	413
"ZCD1"	1838	6315	0	0	0	0	0	0	24	0	0	0	267	240	254	182	321	196
"ZCRB1"	1851	14045	0	0	0	0	0	0	0	7	0	0	151	357	376	300	642	258
"ZCWPW1"	2354	27808	258	192	179	79	119	73	293	306	0	102	87	829	510	112	107	65
"ZCWPW2"	1700	175972	72	230	37	35	115	115	84	56	0	86	18	48	10	26	48	26
"ZCYTOR7"	770	35846	0	0	0	0	0	0	0	0	0	0	0	0	0	0	0	0
"ZDBF2"	10151	39627	0	0	0	0	0	0	0	0	0	0	0	4	0	0	0	0
"ZDHHC1"	2019	22018	0	0	0	0	0	0	120	61	0	0	31	8	38	13	38	23
"ZDHHC11"	2619	55383	0	0	0	0	0	0	58	31	0	8	0	0	0	0	0	0
"ZDHHC12"	1313	3253	0	0	0	0	0	0	73	14	0	0	748	609	202	491	266	347
"ZDHHC13"	2450	59276	1231	174	754	477	85	89	526	155	112	89	385	377	316	259	432	294
"ZDHHC14"	2795	292421	31	11	15	16	11	0	424	78	0	0	29	37	21	12	46	31
"ZDHHC15"	6053	155075	14	13	0	14	13	0	0	0	0	0	0	0	0	0	0	0
"ZDHHC16"	1988	11196	526	101	307	219	52	49	257	83	213	26	280	387	391	381	445	375
"ZDHHC17"	4788	89622	4407	1553	2525	1882	847	706	2277	660	700	662	1409	1603	1255	838	1723	972
"ZDHHC18"	3143	29008	2330	614	1292	1038	289	325	1141	709	2131	1961	1539	1511	2546	2142	3044	2223
"ZDHHC19"	1863	13978	0	0	0	0	0	0	31	24	0	0	0	0	16	5	7	0
"ZDHHC2"	4024	66406	11	0	3	8	0	0	59	5	0	0	510	587	499	477	590	392
"ZDHHC20"	1852	82915	2831	333	1608	1223	186	147	2291	371	711	43	3844	98	785	655	695	396
"ZDHHC21"	3206	76438	1577	437	845	732	210	227	1424	280	186	417	434	553	401	318	568	238
"ZDHHC22"	3410	10522	0	0	0	0	0	0	37	0	0	0	0	0	0	0	0	0
"ZDHHC23"	3780	15079	0	0	0	0	0	0	0	4	0	0	29	41	0	0	4	0
"ZDHHC24"	1839	25565	140	0	102	38	0	0	324	81	24	0	811	572	929	616	914	540
"ZDHHC3"	12693	60922	1964	488	1096	868	305	183	1202	808	754	588	1769	1549	2398	1975	1825	1909
"ZDHHC4"	1642	6886	0	0	0	0	0	0	40	0	0	0	401	396	159	210	315	277
"ZDHHC5"	4572	33187	1827	1840	976	851	1073	767	659	1114	780	2068	3682	3906	4015	3951	5159	3436
"ZDHHC6"	2179	16614	329	92	181	148	92	0	248	174	31	33	870	975	980	743	1162	640
"ZDHHC7"	3282	37076	4287	865	2514	1773	460	405	1816	656	3479	1780	4214	2971	2012	2804	5417	2610
"ZDHHC8"	3450	14595	817	239	438	379	118	121	455	333	667	238	593	508	1330	1090	1443	1008
"ZDHHC8P"	2553	12008	0	0	0	0	0	0	28	0	0	0	0	0	0	0	0	0
"ZDHHC9"	2942	38960	0	0	0	0	0	0	0	0	0	0	177	198	179	210	170	164
"ZEB1"	6036	210705	30	22	12	18	9	13	20	45	0	29	16	66	8	11	23	3
"ZEB2"	5568	132333	152975	214623	85043	67932	115800	98823	68614	74553	72505	141832	8859	25497	16283	13375	10107	7777
"ZER1"	4299	42133	451	72	207	244	27	45	417	175	145	174	847	736	867	688	832	873
"ZF6"	1689	22395	2448	1112	1428	1020	604	508	1220	808	1720	1843	439	437	238	218	236	116
"ZFAND1"	1801	19574	67	0	57	10	0	0	87	0	0	0	142	129	168	94	271	117
"ZFAND2A"	922	7313	208	536	135	73	278	258	109	315	49	561	176	420	145	380	272	412
"ZFAND2B"	2003	2833	107	12	66	41	6	6	51	33	0	39	358	259	548	431	661	300
"ZFAND3"	3337	335092	54889	75400	30296	24593	40756	34644	21629	35244	24625	59360	1472	1439	1678	1477	1990	1246
"ZFAND5"	5875	13824	3989	5727	2194	1795	3119	2608	2393	2575	2301	3393	6718	9604	9792	8291	10508	7600
"ZFAND6"	1685	78691	8342	5852	4655	3687	3110	2742	3749	2492	2184	5236	2071	2050	1973	1760	2164	1571
"ZFAT"	5475	99008	694	475	390	304	248	227	1078	615	52	139	248	150	316	208	392	238
"ZFATAS"	941	2620	64	4	23	41	3	1	68	52	12	0	17	21	29	18	29	23
"ZFC3H1"	7193	54372	6735	8666	3697	3038	4669	3997	3033	4231	1582	5218	2255	2507	2482	2268	2830	1214
"ZFHX1B"	3766	93534	143979	188618	81289	62690	98569	90049	62871	65337	63277	130076	2069	4171	2911	3192	2496	2096
"ZFHX2"	5654	5914	0	0	0	0	0	0	126	35	0	0	0	0	0	0	0	0
"ZFHX3"	16070	265488	15471	5315	8766	6705	2806	2509	8429	4528	8788	4573	1354	1538	1521	1472	1944	1080
"ZFHX4"	13833	186007	0	0	0	0	0	0	0	0	0	0	0	0	0	0	0	0
"ZFP"	1853	15455	0	0	0	0	0	0	0	0	0	0	7	0	6	0	0	0
"ZFP1"	3308	23712	0	0	0	0	0	0	0	0	0	0	287	163	180	52	216	98
"ZFP106"	10478	44710	2889	916	1522	1367	531	385	1797	463	891	566	2280	7139	7474	4066	6599	4233
"ZFP112"	3795	40670	0	0	0	0	0	0	10	0	0	0	40	0	6	0	36	0
"ZFP14"	5684	42938	203	0	87	116	0	0	348	17	25	0	339	127	212	16	219	14
"ZFP161"	3531	7022	251	18	141	110	18	0	108	25	0	0	877	401	868	299	1015	412
"ZFP2"	2437	20627	0	0	0	0	0	0	0	0	0	0	41	56	0	0	0	0
"ZFP276"	4704	19939	2342	2340	1468	874	1230	1110	1126	1599	2131	2324	984	1060	1316	1233	2083	1143
"ZFP28"	4094	17854	0	0	0	0	0	0	14	0	0	0	115	113	86	24	141	48
"ZFP3"	4996	17916	299	23	200	99	0	23	261	66	0	0	546	310	464	127	561	172
"ZFP30"	4669	22925	84	0	49	35	0	0	106	0	14	0	454	115	126	0	233	0
"ZFP36"	1747	2560	777	2599	439	338	1324	1275	178	1087	518	1991	1592	18246	1795	15789	2296	26180
"ZFP36L1"	3024	5412	2268	2064	1257	1011	1095	969	649	989	1292	1385	4797	18864	5192	13157	5745	12632
"ZFP36L2"	3694	4205	441	786	223	218	422	364	206	466	275	82	4138	6032	5156	5322	5786	3269
"ZFP37"	2801	14824	0	0	0	0	0	0	0	2	0	0	0	0	0	0	0	0
"ZFP41"	4788	15767	758	173	375	383	73	100	719	296	574	383	331	191	436	241	779	278
"ZFP42"	2650	9276	0	0	0	0	0	0	0	0	0	0	0	0	0	0	0	0
"ZFP57"	2076	8754	14	0	0	14	0	0	14	0	0	0	208	130	314	187	439	225
"ZFP62"	4116	13075	120	0	64	56	0	0	178	48	0	0	233	149	217	61	272	184
"ZFP64"	3266	40706	300	32	181	119	23	9	365	43	0	40	358	217	286	84	398	180
"ZFP82"	2621	26691	28	0	6	22	0	0	72	0	0	0	26	48	157	6	194	11
"ZFP90"	4645	27924	121	0	84	37	0	0	152	16	0	0	369	284	496	246	488	226
"ZFP91"	5226	41928	3217	1482	1808	1409	770	712	1526	810	549	1082	3636	3796	3785	2779	4096	2633
"ZFP92"	1254	3306	0	0	0	0	0	0	14	0	26	0	149	4	3	0	28	0
"ZFP95"	4752	28569	150	17	100	50	0	17	232	22	0	22	607	517	560	265	762	356
"ZFPL1"	1394	4182	94	111	51	43	53	58	174	96	80	125	277	269	404	317	529	317
"ZFPM1"	3250	81561	22	32	13	9	25	7	855	523	0	50	4	2	0	5	8	3
"ZFPM2"	4486	485620	0	0	0	0	0	0	9	0	0	0	0	0	0	0	0	0
"ZFR"	4735	90390	5520	3678	3052	2468	1942	1736	2763	1652	1839	2384	2695	2532	2642	2291	3071	1068
"ZFR2"	4776	65007	0	1	0	0	1	0	294	165	0	0	2	3	0	0	0	0
"ZFS-3"	123	170	0	0	0	0	0	0	0	0	0	0	0	0	0	0	0	0
"ZFX"	5928	62821	5568	13402	3240	2328	7260	6142	1704	7102	1804	12315	1190	2059	1000	4318	1896	1547
"ZFY"	5247	47030	1269	2769	660	609	1472	1297	217	1616	0	0	840	1635	749	1618	0	0
"ZFYVE1"	4416	57681	510	251	273	237	160	91	358	154	262	325	755	471	920	489	1095	657
"ZFYVE16"	7242	71661	13886	6343	7864	6022	3588	2755	6390	1329	7228	3055	6619	8461	5555	4698	7110	4256
"ZFYVE19"	2284	7495	621	54	344	277	34	20	292	55	313	137	688	595	907	524	1195	670
"ZFYVE20"	6692	29077	1047	194	564	483	145	49	581	157	515	45	1151	770	1044	601	1102	590
"ZFYVE21"	2013	2232	608	9	309	299	0	9	518	170	302	92	679	461	786	496	1192	513
"ZFYVE26"	9717	70071	2977	880	1578	1399	413	467	1587	461	726	500	2022	1791	3029	2287	3714	2151
"ZFYVE27"	3059	23774	1718	1061	951	767	609	452	967	761	1168	1635	807	786	1161	1030	1493	908
"ZFYVE28"	4909	71485	6785	1332	3904	2881	690	642	3406	1197	2600	1096	402	448	400	333	569	317
"ZFYVE9"	4933	204313	0	0	0	0	0	0	22	16	0	0	0	2	0	0	0	0
"ZG16"	681	2280	0	0	0	0	0	0	11	10	0	0	0	1	0	0	0	0
"ZG16B"	831	2113	0	0	0	0	0	0	33	0	0	0	87	86	150	122	244	138
"ZGLP1"	1983	4755	22	0	10	12	0	0	6	25	0	5	0	1	170	141	221	58
"ZGPAT"	3444	30556	1611	977	899	712	532	445	674	1243	1406	3461	841	536	898	945	1585	1078
"ZHX1"	5034	27086	936	445	596	340	248	197	672	209	27	21	1306	1833	1449	1050	2075	1123
"ZHX2"	4363	192856	7451	38588	4158	3293	20533	18055	1596	22247	197	25747	320	338	329	365	365	145
"ZHX3"	10531	121652	1364	251	889	475	164	87	762	141	80	0	880	883	1056	657	1072	668
"ZIC1"	5232	7325	0	0	0	0	0	0	0	0	0	0	0	0	0	0	0	0
"ZIC2"	2684	4701	0	0	0	0	0	0	0	0	0	0	0	0	0	0	0	0
"ZIC3"	3940	5913	0	0	0	0	0	0	0	0	0	0	0	0	0	0	0	0
"ZIC4"	4464	11138	0	0	0	0	0	0	12	10	0	0	0	0	0	0	0	0
"ZIC5"	4599	8905	0	0	0	0	0	0	0	0	0	0	0	0	0	0	0	0
"ZIK1"	2862	8131	0	0	0	0	0	0	23	0	0	0	178	76	147	37	207	0
"ZIM2"	2272	66176	0	0	0	0	0	0	0	0	0	0	0	0	0	0	0	0
"ZIM3"	2632	11108	0	0	0	0	0	0	0	0	0	0	0	0	0	0	0	0
"ZIN"	1695	21664	1597	808	874	723	407	401	709	829	1482	1774	808	549	893	858	1108	683
"ZKSCAN1"	5531	22186	1388	1190	779	609	682	508	621	563	521	1146	3317	2898	2050	1330	2239	891
"ZKSCAN2"	7142	21533	0	0	0	0	0	0	8	0	0	0	222	146	174	25	293	4
"ZKSCAN3"	2418	16834	65	6	45	20	2	4	95	0	0	0	170	92	237	14	240	53
"ZKSCAN4"	2291	7514	23	0	0	23	0	0	118	0	0	0	88	14	117	9	147	7
"ZKSCAN5"	4350	28873	169	17	119	50	0	17	256	22	0	22	609	528	566	266	773	366
"ZMAT1"	6123	7932	452	358	235	217	216	142	306	263	0	123	351	573	526	459	537	65
"ZMAT2"	1518	6209	112	31	44	68	25	6	88	68	0	32	2071	2132	1654	1348	2071	1394
"ZMAT3"	2532	48059	236	16	105	131	8	8	341	10	70	26	320	349	262	287	346	137
"ZMAT4"	2469	367229	52	18	29	23	11	7	86	174	0	0	8	2	0	0	3	0
"ZMAT5"	1039	36025	32	0	16	16	0	0	307	75	0	0	311	164	377	213	394	302
"ZMIZ1"	7580	247495	35564	85073	19234	16330	44993	40080	13999	42148	19470	50436	6603	5839	7190	5097	8612	4787
"ZMIZ2"	5159	20948	3160	4626	1692	1468	2436	2190	1034	2708	2638	7154	1782	3056	2442	4549	3818	3248
"ZMPSTE24"	3163	36124	204	14	99	105	14	0	231	37	50	17	1865	2023	1891	1536	2180	1502
"ZMYM1"	4298	36484	520	26	295	225	13	13	419	41	113	87	493	387	284	123	417	207
"ZMYM2"	5651	62406	9940	3360	5454	4486	1707	1653	5310	1492	3269	1614	2089	2184	1925	1677	2075	1426
"ZMYM3"	6031	15463	350	6	142	208	6	0	353	0	120	0	1873	1300	1799	913	2899	1245
"ZMYM4"	7086	152978	4748	1089	2702	2046	687	402	2279	958	750	1369	1431	1954	1733	1498	2103	1330
"ZMYM5"	3276	40154	604	23	357	247	11	12	350	99	235	176	362	335	291	245	381	202
"ZMYM6"	5158	45802	5041	1241	2886	2155	664	577	2585	439	2277	971	3067	2455	2661	895	3474	1692
"ZMYND10"	1785	4621	13	0	0	13	0	0	116	48	0	0	18	7	13	11	19	20
"ZMYND11"	4418	120154	168	20	87	81	20	0	505	60	0	64	903	1058	1099	1054	1073	758
"ZMYND12"	1780	25937	0	0	0	0	0	0	0	0	0	0	0	0	3	0	0	8
"ZMYND15"	2425	6093	39	79	39	0	54	25	59	41	0	116	126	101	234	1130	164	190
"ZMYND17"	5694	12924	432	207	242	190	127	80	401	123	46	110	146	30	141	0	139	9
"ZMYND19"	1376	8408	131	27	72	59	0	27	139	73	0	57	270	195	407	217	337	242
"ZMYND8"	4862	146022	7630	1401	4253	3377	746	655	4205	1364	3105	2509	738	883	1070	852	1066	511
"ZNEUROK1"	1277	6541	0	0	0	0	0	0	0	0	0	0	0	0	0	0	0	0
"ZNF10"	4667	28836	42	10	29	13	10	0	0	0	0	21	79	79	88	26	55	9
"ZNF100"	4474	43588	2620	1272	1549	1071	672	600	1936	1021	1235	1850	33	88	545	351	635	392
"ZNF101"	1829	11702	269	112	153	116	57	55	135	124	0	142	799	472	357	216	352	198
"ZNF107"	5510	44890	688	183	449	239	91	92	714	172	263	190	486	484	211	7	451	175
"ZNF114"	2555	16705	0	0	0	0	0	0	11	0	0	0	0	0	0	0	0	0
"ZNF117"	6408	16586	1932	613	1069	863	287	326	645	182	561	320	953	715	790	536	876	401
"ZNF12"	5068	18504	624	378	390	234	171	207	474	333	67	356	899	738	1052	510	1194	366
"ZNF121"	1956	18919	360	355	189	171	223	132	121	303	118	771	25	40	284	177	261	149
"ZNF124"	2257	50042	11443	5390	6399	5044	2907	2483	4808	1934	6016	2354	1088	420	741	333	1006	389
"ZNF131"	2627	54838	1399	963	670	729	560	403	744	655	244	851	773	681	842	518	890	439
"ZNF132"	3033	7409	45	0	24	21	0	0	153	2	0	0	111	69	175	0	171	27
"ZNF133"	2706	28519	238	30	146	92	17	13	348	11	31	0	198	94	201	51	253	78
"ZNF134"	2251	7808	253	113	157	96	70	43	140	143	0	133	818	678	699	512	792	255
"ZNF135"	3393	10498	4	0	0	4	0	0	54	0	0	0	6	14	5	0	0	0
"ZNF136"	2974	26146	1183	3121	633	550	1664	1457	500	1309	72	3091	523	1014	480	574	480	464
"ZNF137"	2486	3469	81	0	27	54	0	0	52	10	0	13	165	139	0	1	98	0
"ZNF138"	2721	39254	287	0	193	94	0	0	338	0	63	0	96	85	96	45	95	34
"ZNF14"	2967	22642	73	27	50	23	13	14	145	72	0	22	209	109	156	100	189	0
"ZNF140"	3136	27221	928	1613	521	407	873	740	391	797	0	1509	470	1080	417	620	498	496
"ZNF141"	1646	36097	2279	557	1280	999	316	241	1122	247	1010	608	858	507	552	132	638	122
"ZNF142"	6146	21619	252	115	117	135	74	41	340	81	115	18	376	306	493	275	622	298
"ZNF143"	2961	67559	827	99	542	285	67	32	480	160	32	192	791	636	785	448	897	459
"ZNF146"	3858	24171	1565	1047	849	716	522	525	677	703	446	1644	2546	3101	2317	2115	2448	1638
"ZNF148"	9668	149685	10933	2246	5943	4990	1259	987	5244	1237	2137	1576	1889	1443	1612	878	1779	931
"ZNF154"	2749	8770	217	26	132	85	26	0	252	42	0	25	16	0	4	0	5	0
"ZNF155"	2691	14124	36	0	21	15	0	0	9	0	0	0	260	130	169	70	166	12
"ZNF157"	1699	43101	0	0	0	0	0	0	10	0	0	0	0	0	0	0	0	0
"ZNF16"	2618	20530	75	0	54	21	0	0	84	32	0	17	217	78	221	86	260	27
"ZNF160"	4342	36821	1805	540	1032	773	315	225	1045	281	474	727	145	66	757	320	884	321
"ZNF165"	2637	10768	0	0	0	0	0	0	15	0	0	0	0	1	0	4	5	0
"ZNF167"	3469	16938	101	10	50	51	0	10	214	33	0	64	493	421	220	135	141	176
"ZNF169"	3561	43715	1373	122	776	597	81	41	617	222	484	298	370	176	220	122	293	110
"ZNF17"	2723	10780	151	0	63	88	0	0	126	19	43	0	210	108	193	64	165	43
"ZNF174"	2485	8174	41	7	27	14	7	0	22	0	0	0	266	84	246	51	377	92
"ZNF175"	3789	18461	430	0	271	159	0	0	318	10	141	0	414	111	438	64	480	104
"ZNF177"	2422	57495	533	9	292	241	4	5	596	18	198	63	292	284	452	311	515	262
"ZNF18"	2776	19929	56	0	32	24	0	0	121	0	38	19	338	208	322	124	394	179
"ZNF180"	3298	24714	213	42	102	111	29	13	332	28	43	30	20	16	242	93	332	96
"ZNF181"	2955	8296	16	0	16	0	0	0	0	9	0	0	265	112	191	49	319	87
"ZNF182"	3593	29128	324	0	248	76	0	0	407	22	86	22	320	211	307	127	419	145
"ZNF184"	3632	22364	56	0	21	35	0	0	92	0	0	0	258	104	239	39	276	37
"ZNF185"	4338	59027	27	14	6	21	0	14	208	55	0	0	1555	1693	1439	1358	1443	1025
"ZNF187"	3147	11192	155	0	84	71	0	0	91	22	0	0	282	132	345	91	395	77
"ZNF189"	3266	11781	1710	5661	927	783	3147	2514	667	2473	284	3157	1022	5752	927	5053	1113	2178
"ZNF19"	2986	15243	0	0	0	0	0	0	35	0	0	0	37	6	28	8	9	0
"ZNF192"	5463	15522	354	46	209	145	33	13	472	68	13	0	864	617	1136	313	1393	366
"ZNF193"	1792	8189	374	16	177	197	0	16	265	33	42	0	488	334	453	165	671	219
"ZNF195"	2559	20439	914	310	503	411	152	158	410	182	37	227	251	251	135	85	162	53
"ZNF197"	4340	20241	165	15	102	63	8	7	152	35	61	0	592	359	340	85	476	121
"ZNF198"	1751	56152	5424	2115	3036	2388	1098	1017	2778	892	2374	933	633	717	590	574	679	411
"ZNF2"	3956	18881	15	0	15	0	0	0	32	14	0	0	194	72	150	4	180	6
"ZNF20"	2771	24728	45	0	24	21	0	0	35	0	0	0	138	20	131	17	199	6
"ZNF200"	3392	12863	103	216	69	34	141	75	80	63	35	22	380	547	438	298	458	263
"ZNF202"	4064	17368	154	35	79	75	15	20	128	71	8	113	263	288	355	267	401	189
"ZNF205"	2065	7955	4	0	0	4	0	0	142	27	0	0	119	43	142	19	186	72
"ZNF207"	4727	30820	14854	8372	7983	6871	4569	3803	7384	3167	8209	6445	6098	5534	8401	5948	10145	4786
"ZNF208"	8246	44848	0	0	0	0	0	0	0	0	0	0	0	0	0	0	0	0
"ZNF211"	3416	22355	296	100	151	145	63	37	310	101	40	132	1275	1073	1222	765	1419	492
"ZNF212"	2764	15909	394	108	245	149	64	44	235	144	122	180	373	209	383	227	472	259
"ZNF213"	3353	7749	47	0	17	30	0	0	47	19	0	0	409	231	516	263	707	318
"ZNF214"	2731	21039	0	0	0	0	0	0	0	0	0	0	0	0	0	0	0	0
"ZNF215"	3664	31625	0	0	0	0	0	0	0	0	0	0	0	0	0	0	0	0
"ZNF217"	5709	16097	7702	4017	4231	3471	2274	1743	3634	1994	5625	3143	7597	4300	7209	2770	8045	2635
"ZNF219"	3085	8605	524	0	293	231	0	0	224	26	366	0	1337	790	1599	1100	1957	1225
"ZNF22"	2470	69359	22	0	1	21	0	0	23	0	0	0	565	453	430	290	527	272
"ZNF221"	2432	16357	17	0	0	17	0	0	14	0	0	0	3	0	4	0	0	0
"ZNF222"	1824	7768	0	0	0	0	0	0	31	0	0	0	95	85	87	57	112	4
"ZNF223"	3941	62131	98	23	62	36	14	9	196	2	0	8	459	250	384	112	418	106
"ZNF224"	2472	13982	905	193	466	439	118	75	526	52	367	81	907	514	1141	350	1257	353
"ZNF225"	2794	19709	95	19	60	35	12	7	178	0	0	0	209	61	191	1	203	64
"ZNF226"	5284	12589	343	11	203	140	11	0	210	18	102	28	355	221	363	138	432	143
"ZNF227"	3051	24731	140	0	72	68	0	0	199	20	0	14	366	201	467	137	480	156
"ZNF229"	5425	22241	0	0	0	0	0	0	12	0	0	0	8	5	0	0	3	0
"ZNF23"	3682	41706	47	9	31	16	9	0	160	0	0	0	207	151	275	86	281	117
"ZNF230"	4137	10997	83	37	27	56	37	0	147	0	26	0	867	251	844	677	521	512
"ZNF232"	2121	6809	43	0	43	0	0	0	84	0	1	0	219	97	170	52	290	51
"ZNF233"	2949	15437	83	0	70	13	0	0	189	24	48	0	1	8	0	0	0	0
"ZNF234"	4604	18752	227	0	119	108	0	0	196	6	0	15	370	197	402	119	471	128
"ZNF235"	3194	18678	656	150	338	318	83	67	577	89	226	90	173	128	21	115	195	41
"ZNF236"	8235	146566	2817	588	1563	1254	361	227	1857	528	747	722	440	614	520	505	605	464
"ZNF238"	4196	4196	348	0	219	129	0	0	199	21	0	0	741	269	832	230	855	307
"ZNF239"	2388	12114	0	0	0	0	0	0	14	7	0	0	0	0	0	0	0	0
"ZNF24"	6315	12250	1010	578	551	459	288	290	506	341	196	308	3344	4482	3210	3137	3143	2102
"ZNF248"	4889	28589	320	0	200	120	0	0	424	0	105	46	230	167	237	41	219	37
"ZNF25"	3766	26660	549	15	296	253	15	0	470	41	68	0	657	61	597	404	601	343
"ZNF250"	6368	24510	325	56	211	114	39	17	251	85	30	151	222	117	168	53	227	67
"ZNF251"	3011	34677	493	0	270	223	0	0	573	51	244	32	208	96	187	90	276	110
"ZNF252"	5434	29311	170	0	83	87	0	0	268	0	0	0	944	939	675	469	631	404
"ZNF253"	3236	28746	52	0	41	11	0	0	206	0	1	0	313	75	105	2	143	7
"ZNF254"	3988	42678	7918	3724	4393	3525	2011	1713	3429	1719	4131	2921	631	631	470	166	496	145
"ZNF256"	2211	6876	37	0	21	16	0	0	63	0	0	17	149	115	85	71	104	0
"ZNF257"	3644	38637	0	0	0	0	0	0	0	0	0	0	13	20	4	0	0	0
"ZNF259"	1791	9464	152	326	72	80	182	144	90	179	0	263	560	325	664	970	811	760
"ZNF26"	3063	26099	1330	898	721	609	520	378	793	489	547	992	301	277	301	181	369	180
"ZNF260"	5395	17578	139	26	55	84	0	26	149	0	0	0	481	348	462	194	462	119
"ZNF263"	3458	12009	1246	460	676	570	289	171	838	283	352	607	1132	999	1308	944	1589	938
"ZNF264"	12164	31345	1041	125	589	452	60	65	760	392	122	439	1169	773	634	392	618	193
"ZNF266"	3611	22964	2127	1496	1102	1025	851	645	816	531	707	1173	597	2009	1120	914	2093	1195
"ZNF267"	3269	43549	10301	33928	5740	4561	18357	15571	3172	15528	3143	26172	2219	8717	1754	5021	2177	5047
"ZNF268"	3901	23737	160	20	104	56	17	3	150	26	0	66	641	662	591	374	612	283
"ZNF273"	5437	49084	49	0	28	21	0	0	41	17	0	0	46	50	59	6	56	4
"ZNF274"	2861	30533	2145	2706	1151	994	1459	1247	905	1327	644	2868	1423	2156	1239	1744	1567	1144
"ZNF275"	6955	8151	63	0	33	30	0	0	103	13	0	0	427	284	381	138	385	146
"ZNF276"	4629	19380	2550	2747	1669	881	1430	1317	1126	1599	2268	2626	1001	1137	1364	1245	2115	1158
"ZNF277"	2699	137348	1862	7636	1126	736	4178	3458	1394	69128	95	29171	432	401	398	452	608	343
"ZNF28"	4679	24225	65	21	65	0	0	21	125	48	0	38	728	773	776	426	635	363
"ZNF280A"	2147	6552	0	0	0	0	0	0	0	0	0	0	0	0	0	0	0	0
"ZNF280B"	5732	24735	0	0	0	0	0	0	0	0	0	0	0	0	0	0	0	0
"ZNF280C"	4656	66193	70	132	42	28	90	42	118	31	52	0	122	118	166	67	151	52
"ZNF280D"	4668	265680	2144	390	1229	915	219	171	1570	197	157	173	931	850	783	480	762	377
"ZNF281"	3517	3742	300	0	167	133	0	0	190	51	0	0	4	431	1	415	7	331
"ZNF282"	3727	30762	628	77	365	263	56	21	364	185	170	68	471	358	746	396	891	453
"ZNF283"	2570	21577	64	20	15	49	0	20	138	0	6	0	156	43	72	9	62	8
"ZNF284"	2213	15328	0	0	0	0	0	0	25	2	0	0	72	7	62	0	87	7
"ZNF285A"	2689	15970	0	0	0	0	0	0	0	0	0	0	0	0	0	0	0	0
"ZNF286A"	5549	21209	0	0	0	0	0	0	0	0	0	0	19	0	167	197	328	305
"ZNF286B"	5333	23832	0	0	0	0	0	0	0	0	0	0	21	0	230	252	210	88
"ZNF287"	4284	18891	0	0	0	0	0	0	0	0	0	0	0	2	15	0	31	0
"ZNF292"	10106	108137	7692	2034	4345	3347	1169	865	3544	893	1679	819	1395	1822	1423	865	1454	764
"ZNF295"	7636	23557	746	1227	420	326	655	572	431	701	0	913	1012	45	3	1343	1297	1110
"ZNF296"	1588	4931	9	0	8	1	0	0	10	29	0	0	114	70	110	110	173	133
"ZNF3"	3151	12766	556	71	313	243	56	15	334	158	121	89	612	362	635	322	752	272
"ZNF30"	2670	18271	0	0	0	0	0	0	9	0	0	0	27	0	0	0	4	0
"ZNF300"	3110	10429	0	0	0	0	0	0	0	0	0	0	0	31	0	0	0	0
"ZNF302"	2761	8737	366	64	197	169	44	20	215	16	68	31	668	402	620	233	622	190
"ZNF304"	4559	8620	48	0	34	14	0	0	39	0	0	24	353	213	380	145	406	6
"ZNF311"	3001	10501	0	0	0	0	0	0	0	0	0	0	0	0	0	0	0	3
"ZNF317"	4384	7490	2981	1799	1674	1307	941	858	1043	800	1184	1647	3038	2050	2899	1790	3541	1617
"ZNF318"	8015	33374	1429	229	822	607	103	126	595	109	441	78	2196	2037	2213	1378	2596	1329
"ZNF319"	4222	5191	51	0	22	29	0	0	80	11	0	0	509	96	625	47	845	168
"ZNF32"	1204	4846	15	0	15	0	0	0	57	0	78	0	448	400	457	310	506	287
"ZNF320"	6463	21389	630	89	352	278	48	41	264	41	67	85	707	530	240	103	375	126
"ZNF321"	2624	35728	180	38	83	97	21	17	338	13	0	29	314	149	338	112	436	67
"ZNF322A"	4803	25353	194	0	128	66	0	0	115	19	0	0	123	54	998	268	1061	330
"ZNF322B"	2375	2375	0	0	0	0	0	0	0	0	0	0	53	19	548	158	518	150
"ZNF323"	3559	31533	0	0	0	0	0	0	19	14	0	0	46	63	38	11	42	5
"ZNF324"	3816	6210	81	0	56	25	0	0	186	87	44	30	311	181	446	271	616	204
"ZNF324B"	3080	6230	21	0	7	14	0	0	33	0	0	9	88	9	171	63	183	35
"ZNF326"	2734	33418	907	763	482	425	420	343	756	380	169	388	501	641	674	567	654	363
"ZNF329"	3415	24453	16	0	16	0	0	0	68	0	0	0	297	135	156	71	167	54
"ZNF330"	1898	13801	565	414	307	258	227	187	393	154	242	165	1166	880	1526	748	1289	741
"ZNF331"	5150	59348	245	28	155	90	10	18	325	59	75	0	474	136	469	55	388	67
"ZNF333"	4119	31159	462	215	261	201	111	104	270	166	242	433	317	418	380	327	201	80
"ZNF334"	3481	12487	0	0	0	0	0	0	0	0	0	0	0	0	0	0	0	0
"ZNF335"	4479	23542	850	680	433	417	361	319	742	604	147	942	666	607	752	683	1172	797
"ZNF337"	4667	54027	941	491	509	432	269	222	507	256	256	267	684	709	638	329	793	335
"ZNF33A"	6125	49418	2084	4632	1139	945	2547	2085	972	2662	42	2620	932	1791	692	1067	805	468
"ZNF33B"	5963	49439	2094	4695	1149	945	2585	2110	1009	2750	42	2678	962	1987	692	1117	805	505
"ZNF34"	2032	7164	109	0	54	55	0	0	159	49	18	0	48	41	182	8	218	8
"ZNF341"	3353	60270	166	15	89	77	15	0	249	48	69	28	212	127	218	129	314	175
"ZNF343"	3634	27313	28	0	28	0	0	0	76	0	0	0	187	72	193	6	233	38
"ZNF345"	3113	29203	100	0	54	46	0	0	76	0	138	0	107	35	113	17	105	0
"ZNF346"	3078	44048	400	12	243	157	12	0	380	55	107	78	216	161	185	87	251	111
"ZNF347"	3868	19667	316	61	176	140	44	17	326	30	112	59	89	62	403	194	390	178
"ZNF35"	2652	12051	65	0	27	38	0	0	41	22	0	0	312	232	287	185	417	162
"ZNF350"	2344	22486	483	294	295	188	168	126	246	136	0	135	36	328	104	261	146	224
"ZNF354A"	2551	19174	78	0	42	36	0	0	41	0	0	0	305	227	358	199	73	161
"ZNF354B"	2335	23737	253	46	160	93	25	21	215	92	37	149	152	230	245	137	295	147
"ZNF354C"	2376	20084	0	0	0	0	0	0	39	0	0	0	582	65	61	11	4	0
"ZNF358"	1955	4909	1	2	1	0	1	1	0	11	0	0	179	83	228	215	329	172
"ZNF362"	3115	44148	2270	211	1235	1035	114	97	1149	194	1501	180	844	419	636	537	911	642
"ZNF364"	1804	77740	3395	3408	1892	1503	1939	1469	1492	2543	685	3430	1229	1494	617	571	749	391
"ZNF365"	4212	28302	16940	15412	9405	7535	8511	6901	5062	3938	8220	9410	292	575	181	170	144	69
"ZNF365C"	2285	28271	5312	3449	2977	2335	1947	1502	1686	987	3551	2614	106	126	111	129	45	21
"ZNF366"	2775	64017	42775	16699	23776	18999	9415	7284	14355	7553	23353	23026	2253	2425	2820	1564	4928	1137
"ZNF367"	3705	32444	0	0	0	0	0	0	9	0	0	0	1	37	0	0	0	0
"ZNF37A"	7024	29003	1224	425	654	570	256	169	599	603	0	274	816	1058	572	538	586	301
"ZNF37B"	10242	39295	258	64	150	108	24	40	365	84	0	22	178	259	109	76	141	35
"ZNF382"	3866	19850	64	0	43	21	0	0	42	0	0	0	147	92	154	36	149	46
"ZNF383"	2260	25748	183	0	143	40	0	0	117	0	0	0	290	91	185	54	217	68
"ZNF384"	3294	22183	896	227	507	389	126	101	489	276	352	465	1146	839	1008	761	1232	715
"ZNF385A"	2520	16634	2041	960	1121	920	487	473	832	370	1191	357	2262	2460	2792	1345	3454	4838
"ZNF385B"	3287	419514	0	0	0	0	0	0	17	0	0	0	0	0	0	0	0	0
"ZNF385C"	1991	3113	34	0	22	12	0	0	83	31	0	0	1196	1160	334	318	465	353
"ZNF385D"	1818	330326	0	0	0	0	0	0	8	12	0	0	0	0	0	0	0	0
"ZNF389"	1644	7826	0	0	0	0	0	0	0	0	0	0	0	0	0	0	0	0
"ZNF390"	3021	3689	0	0	0	0	0	0	0	0	0	0	0	0	0	0	0	0
"ZNF391"	1599	12705	0	0	0	0	0	0	0	0	0	0	0	0	0	0	0	0
"ZNF394"	2147	7024	987	537	534	453	281	256	477	149	755	604	1061	915	778	503	1106	615
"ZNF395"	5710	144682	51	0	25	26	0	0	181	56	0	0	208	176	201	86	268	90
"ZNF396"	2793	10642	0	0	0	0	0	0	0	17	0	0	30	0	3	0	21	5
"ZNF397"	2643	6156	607	80	373	234	29	51	375	64	0	43	899	725	841	261	964	245
"ZNF397OS"	2515	37353	84	0	61	23	0	0	126	25	0	0	221	201	25	28	87	5
"ZNF398"	5497	56610	422	0	207	215	0	0	320	30	25	15	781	245	682	96	896	234
"ZNF404"	1843	7774	0	1	0	0	0	1	0	0	0	0	23	30	0	0	0	0
"ZNF407"	8012	434707	15259	15315	8681	6578	8539	6776	8399	8812	1919	8489	706	598	735	544	858	442
"ZNF408"	2446	5095	0	0	0	0	0	0	81	17	0	0	198	69	228	145	295	88
"ZNF409"	2918	19084	0	0	0	0	0	0	88	83	0	0	3	0	4	0	0	0
"ZNF41"	4379	36785	809	198	454	355	88	110	540	188	71	341	56	43	475	362	91	41
"ZNF410"	2361	45219	818	636	504	314	309	327	456	357	77	638	566	601	747	798	961	774
"ZNF414"	1411	3587	11	0	10	1	0	0	33	16	0	0	98	68	189	110	143	49
"ZNF415"	2665	25042	0	0	0	0	0	0	12	0	0	0	14	3	0	0	0	0
"ZNF416"	2512	7310	0	0	0	0	0	0	72	0	0	0	168	77	148	32	173	0
"ZNF417"	4705	10837	931	538	517	414	276	262	459	456	275	559	887	418	723	589	769	296
"ZNF418"	3921	13490	45	0	26	19	0	0	85	0	13	0	57	25	70	0	58	0
"ZNF419"	2371	6971	0	0	0	0	0	0	45	0	0	15	220	143	164	17	220	33
"ZNF420"	2976	51269	198	0	107	91	0	0	283	8	0	0	186	111	191	0	213	18
"ZNF423"	4826	336398	0	0	0	0	0	0	986	245	0	0	0	0	0	0	0	0
"ZNF425"	3160	23500	0	0	0	0	0	0	20	12	0	0	1	0	10	0	26	0
"ZNF426"	2408	10585	6	0	6	0	0	0	30	8	23	0	27	67	167	136	189	93
"ZNF428"	1397	12639	10	0	0	10	0	0	30	93	0	0	249	347	344	319	405	309
"ZNF429"	2365	32644	119	0	54	65	0	0	61	0	0	0	123	122	121	11	14	0
"ZNF43"	5736	47079	1412	771	826	586	411	360	646	440	125	625	415	241	307	110	255	32
"ZNF430"	2653	38157	1802	1782	1008	794	1033	749	718	876	350	1476	624	671	453	471	423	280
"ZNF431"	3874	43967	2337	1175	1394	943	659	516	1110	413	86	263	535	561	433	282	402	180
"ZNF432"	2577	15397	53	72	24	29	39	33	58	60	0	0	57	37	199	113	37	31
"ZNF433"	2364	20995	1664	288	942	722	159	129	866	200	661	141	88	48	103	27	106	19
"ZNF434"	3123	18929	166	0	127	39	0	0	144	19	0	19	444	281	531	202	582	158
"ZNF436"	4496	10417	34	0	20	14	0	0	54	0	0	0	11	156	362	90	457	98
"ZNF438"	3426	154881	4522	1411	2475	2047	831	580	4052	1252	663	702	564	450	693	584	730	505
"ZNF439"	2552	3463	222	34	113	109	21	13	100	0	0	0	152	101	127	50	110	0
"ZNF44"	2797	23089	2156	1327	1243	913	704	623	771	627	1122	1912	319	512	277	330	329	210
"ZNF440"	4185	20911	477	56	259	218	20	36	501	43	167	29	371	226	335	105	503	204
"ZNF441"	4510	17073	0	0	0	0	0	0	56	0	0	0	286	27	186	0	120	0
"ZNF442"	2831	16292	0	0	0	0	0	0	0	0	0	0	29	4	14	0	29	0
"ZNF443"	2667	11407	53	0	53	0	0	0	0	0	0	0	75	29	135	35	114	14
"ZNF444"	2047	19707	97	0	47	50	0	0	169	12	61	0	267	153	214	141	385	172
"ZNF445"	10257	37902	1114	132	623	491	71	61	787	141	257	94	686	643	1090	373	1192	352
"ZNF446"	2181	4803	34	0	25	9	0	0	109	40	0	0	96	53	126	67	190	108
"ZNF449"	4819	5005	81	0	42	39	0	0	197	70	87	24	138	64	85	7	265	4
"ZNF45"	3908	22632	209	0	67	142	0	0	114	9	49	0	524	448	499	257	591	274
"ZNF451"	5256	80272	3010	1047	1634	1376	538	509	1891	579	187	531	1494	1349	1299	815	1584	620
"ZNF454"	2363	25212	0	0	0	0	0	0	23	0	0	0	0	0	0	0	0	0
"ZNF460"	3852	13585	1910	2145	1254	656	1245	900	804	927	543	1392	27	139	68	128	46	64
"ZNF461"	3197	29457	6	0	6	0	0	0	74	16	0	0	99	47	104	5	105	0
"ZNF462"	8301	148413	0	0	0	0	0	0	0	0	0	0	0	0	0	0	0	0
"ZNF467"	2284	8844	6	0	6	0	0	0	75	30	0	0	256	99	173	52	413	146
"ZNF468"	4035	19118	36	38	36	0	12	26	26	20	41	104	34	700	746	468	707	408
"ZNF469"	13205	13288	15	0	15	0	0	0	60	15	0	0	0	0	53	0	0	0
"ZNF470"	7146	15373	0	0	0	0	0	0	85	13	0	0	278	184	197	74	207	51
"ZNF471"	4969	21057	11	0	0	11	0	0	0	14	0	0	11	46	0	8	4	0
"ZNF473"	4693	22819	13	1	0	13	0	1	305	57	0	25	242	101	249	96	334	96
"ZNF474"	1950	24044	0	0	0	0	0	0	0	0	0	0	0	0	0	0	0	0
"ZNF479"	2070	20245	0	0	0	0	0	0	0	0	0	0	0	0	0	0	0	0
"ZNF48"	2205	3660	0	0	0	0	0	0	17	0	0	0	100	20	35	86	105	0
"ZNF480"	4744	28748	0	0	0	0	0	0	10	0	0	0	304	263	61	60	32	15
"ZNF483"	3727	19267	25	0	13	12	0	0	17	0	0	0	175	167	145	113	221	174
"ZNF484"	2958	31941	39	0	29	10	0	0	100	0	0	12	8	50	43	0	90	7
"ZNF485"	2059	11498	0	0	0	0	0	0	10	0	0	0	55	0	68	0	15	6
"ZNF486"	1526	30903	0	20	0	0	11	9	8	0	0	0	115	26	55	7	49	0
"ZNF487"	1495	45435	12	0	12	0	0	0	31	24	0	0	33	29	0	0	13	8
"ZNF488"	3496	18777	0	0	0	0	0	0	35	13	0	0	0	0	0	0	0	0
"ZNF490"	6103	34705	121	9	65	56	0	9	169	55	0	3	244	27	258	6	284	3
"ZNF491"	2826	9917	20	0	20	0	0	0	11	4	0	0	22	0	0	0	0	0
"ZNF492"	4249	33348	0	0	0	0	0	0	0	0	0	0	0	0	0	0	0	0
"ZNF493"	5003	30375	687	40	389	298	28	12	310	13	0	0	136	68	142	0	21	0
"ZNF496"	2436	31424	346	81	159	187	39	42	331	346	26	499	133	163	517	217	273	161
"ZNF497"	3469	8397	90	58	38	52	23	35	90	27	0	0	121	194	157	164	280	214
"ZNF498"	4924	11348	1148	299	656	492	159	140	467	68	184	306	384	260	584	202	580	242
"ZNF500"	3258	16353	245	0	122	123	0	0	151	80	148	0	53	12	212	3	280	17
"ZNF501"	3066	7453	0	0	0	0	0	0	0	0	0	0	89	14	12	0	0	0
"ZNF502"	3275	11188	0	0	0	0	0	0	28	0	0	0	139	85	7	0	75	0
"ZNF503"	3181	3910	0	0	0	0	0	0	0	15	0	0	10	156	9	215	119	7
"ZNF506"	3328	29042	1396	668	815	581	349	319	684	292	221	237	596	393	361	292	332	216
"ZNF507"	7723	42059	0	0	0	0	0	0	11	0	0	13	4	0	0	0	12	0
"ZNF509"	2950	31590	158	39	89	69	0	39	140	246	12	72	152	158	205	287	188	128
"ZNF510"	5622	22193	228	0	126	102	0	0	149	10	14	6	59	250	201	26	352	57
"ZNF511"	2031	4245	31	17	30	1	6	11	41	14	0	0	358	384	432	372	422	258
"ZNF512"	3664	40067	1708	269	963	745	150	119	723	244	840	568	744	486	857	405	977	372
"ZNF512B"	5936	13165	132	34	60	72	15	19	166	80	0	0	180	207	391	189	507	190
"ZNF513"	2140	3493	467	143	290	177	71	72	186	191	299	166	3025	1813	1920	1793	2364	1686
"ZNF514"	3425	11701	289	0	183	106	0	0	248	24	0	0	144	56	161	23	450	144
"ZNF516"	6652	135529	38731	21618	21252	17479	11608	10010	15677	9233	22809	15827	1546	1599	2543	1763	4961	1857
"ZNF517"	3388	10270	43	0	28	15	0	0	78	35	0	0	95	35	28	5	134	0
"ZNF518A"	8341	34040	5551	3142	3208	2343	1706	1436	2531	1094	1504	1815	2410	2364	1628	1036	1844	933
"ZNF518B"	6938	17529	238	65	127	111	40	25	205	42	0	48	872	740	931	541	772	334
"ZNF519"	2227	56442	19	8	19	0	8	0	83	20	0	8	13	0	0	0	0	0
"ZNF521"	5060	290328	0	0	0	0	0	0	12	0	0	0	0	2	3	0	0	0
"ZNF524"	1111	2776	134	9	81	53	9	0	95	0	79	24	445	271	510	231	659	321
"ZNF525"	6091	20868	13	8	6	7	8	0	217	9	0	0	412	242	254	120	180	72
"ZNF526"	3957	7863	174	14	99	75	14	0	183	48	83	0	388	95	392	187	487	136
"ZNF527"	5131	21909	0	0	0	0	0	0	23	0	0	0	95	52	63	6	78	6
"ZNF528"	4198	20537	182	37	97	85	12	25	157	11	30	32	362	382	227	205	179	120
"ZNF529"	5251	29681	703	513	396	307	245	268	606	333	118	189	660	739	519	422	408	183
"ZNF530"	2967	8386	22	0	22	0	0	0	33	0	0	0	75	15	44	0	73	3
"ZNF532"	6810	121849	17	0	3	14	0	0	91	13	0	7	73	108	71	96	258	83
"ZNF534"	2094	8038	0	0	0	0	0	0	0	2	0	0	0	0	0	0	0	0
"ZNF536"	4940	185639	0	0	0	0	0	0	108	0	0	0	0	0	0	0	0	0
"ZNF540"	3150	62688	42	0	25	17	0	0	12	0	0	0	36	0	16	3	6	0
"ZNF541"	4646	35167	0	0	0	0	0	0	40	12	0	0	0	1	0	0	0	0
"ZNF542"	3561	11531	131	23	107	24	8	15	45	24	0	47	555	446	256	132	311	171
"ZNF543"	3663	10269	15	0	15	0	0	0	14	0	0	0	118	78	133	43	91	0
"ZNF544"	3519	34667	833	127	490	343	68	59	652	86	340	18	452	430	314	199	344	192
"ZNF546"	4600	20573	52	0	24	28	0	0	112	18	0	0	71	46	87	0	58	0
"ZNF547"	2788	16046	555	90	300	255	29	61	915	260	79	259	2179	1300	1765	684	1877	269
"ZNF548"	3420	11569	165	90	91	74	29	61	109	172	0	150	310	375	221	284	237	75
"ZNF549"	5609	30218	134	0	72	62	0	0	250	23	0	78	386	137	300	39	299	29
"ZNF550"	4308	18022	0	0	0	0	0	0	114	8	0	0	89	6	58	0	51	0
"ZNF551"	3702	7812	716	253	423	293	121	132	320	163	141	149	432	298	320	175	330	114
"ZNF552"	2531	7831	1180	574	646	534	336	238	588	268	1218	812	180	123	138	22	233	56
"ZNF554"	3801	16863	0	0	0	0	0	0	62	0	0	0	58	22	55	5	75	0
"ZNF555"	2233	12726	17	0	0	17	0	0	127	0	0	0	252	15	264	10	291	4
"ZNF556"	1636	11170	0	0	0	0	0	0	0	0	0	0	0	0	0	0	0	0
"ZNF557"	6007	18507	184	79	64	120	48	31	169	12	45	62	376	175	307	108	257	91
"ZNF558"	3477	22595	21	0	16	5	0	0	10	22	0	0	405	370	282	182	400	202
"ZNF559"	3163	19666	533	9	292	241	4	5	554	18	198	63	290	281	440	311	509	262
"ZNF560"	2812	32250	0	0	0	0	0	0	0	0	0	0	0	0	0	0	0	0
"ZNF561"	4545	13915	289	102	164	125	63	39	180	73	0	51	1101	669	712	359	762	296
"ZNF562"	5777	26427	2246	1343	1261	985	779	564	1115	680	1942	1863	94	86	596	340	628	312
"ZNF563"	2775	16230	40	0	13	27	0	0	48	0	0	0	87	70	71	28	57	23
"ZNF564"	2951	26173	1169	33	635	534	18	15	616	35	413	0	377	78	258	7	328	38
"ZNF565"	1947	32800	277	11	263	14	0	11	194	128	0	0	66	35	96	68	131	8
"ZNF566"	5266	44443	121	16	112	9	16	0	114	0	0	23	183	103	168	57	141	47
"ZNF567"	2825	33695	118	0	84	34	0	0	196	0	33	36	152	90	184	17	187	7
"ZNF568"	2916	35217	7	0	7	0	0	0	10	11	0	0	72	38	52	13	54	5
"ZNF569"	4511	58109	20	0	11	9	0	0	73	9	0	0	147	126	63	10	105	20
"ZNF57"	2000	17573	27	0	14	13	0	0	69	0	0	0	74	24	109	0	111	3
"ZNF570"	2252	16262	7	0	7	0	0	0	0	9	0	0	84	53	90	4	87	3
"ZNF571"	2380	30519	42	0	25	17	0	0	12	0	0	0	28	0	6	0	6	0
"ZNF572"	3276	6091	0	0	0	0	0	0	0	0	0	0	0	0	0	0	0	0
"ZNF573"	2494	40999	280	104	171	109	57	47	234	61	0	50	923	1097	220	16	54	7
"ZNF574"	3466	13090	42	0	26	16	0	0	61	63	0	20	441	269	488	314	624	259
"ZNF575"	2290	10635	342	95	158	184	32	63	19	116	283	862	330	415	219	178	613	330
"ZNF576"	1902	4045	105	12	87	18	0	12	183	35	0	0	210	127	270	115	314	148
"ZNF577"	4045	16653	423	38	270	153	26	12	441	61	143	0	627	327	270	124	317	101
"ZNF578"	6746	63303	2	0	0	2	0	0	8	0	2	0	0	0	8	0	1	0
"ZNF579"	2169	3321	0	0	0	0	0	0	31	0	0	43	68	0	151	21	189	38
"ZNF580"	1672	8455	2335	1065	1263	1072	563	502	593	465	1505	1206	671	589	935	528	1234	626
"ZNF581"	1769	10608	2355	1065	1263	1092	563	502	654	502	1505	1206	918	657	1238	625	1645	746
"ZNF582"	2549	10268	26	0	13	13	0	0	13	0	0	0	36	80	118	10	83	40
"ZNF583"	2595	20708	0	0	0	0	0	0	0	0	0	0	82	83	79	3	86	7
"ZNF584"	2360	9629	72	0	47	25	0	0	62	9	0	0	220	139	279	110	342	130
"ZNF585A"	4139	22616	25	0	11	14	0	0	36	0	8	0	276	152	317	157	349	84
"ZNF585B"	2972	25729	479	11	237	242	11	0	157	34	1	125	155	176	42	154	59	157
"ZNF586"	2267	10959	4510	1964	2609	1901	1075	889	1635	968	3611	2597	496	457	392	354	470	198
"ZNF587"	6847	15219	12693	6429	7246	5447	3430	2999	5613	3715	10292	9236	3884	3374	2641	2026	2782	1078
"ZNF589"	4727	46519	4298	1478	2400	1898	790	688	1674	449	3181	1749	2361	1853	2420	1194	2807	1232
"ZNF592"	8188	57845	4929	404	2789	2140	159	245	2096	280	2086	629	2387	1383	3037	1526	3619	1727
"ZNF593"	650	976	0	0	0	0	0	0	0	0	0	0	115	121	135	157	172	160
"ZNF594"	4879	12349	217	57	115	102	36	21	211	60	109	79	110	46	160	8	182	10
"ZNF595"	2813	34874	3692	512	2079	1613	313	199	1856	230	2074	673	249	164	131	97	186	24
"ZNF596"	2874	14950	24	0	24	0	0	0	31	0	0	0	76	8	46	5	92	0
"ZNF597"	1776	7381	0	0	0	0	0	0	67	0	0	0	13	273	24	11	20	11
"ZNF598"	3209	11997	342	147	171	171	82	65	263	413	260	556	316	361	569	645	591	536
"ZNF599"	3856	10324	0	0	0	0	0	0	0	5	0	0	0	0	14	0	14	4
"ZNF600"	2548	21286	123	19	61	62	13	6	63	27	0	0	34	292	381	220	514	212
"ZNF605"	6167	34822	755	47	376	379	31	16	577	69	220	26	627	474	335	114	497	181
"ZNF606"	4226	26269	164	0	82	82	0	0	168	23	48	0	295	73	197	13	313	0
"ZNF607"	4357	23417	0	0	0	0	0	0	23	0	0	0	30	1	0	0	26	0
"ZNF608"	5714	108257	0	0	0	0	0	0	0	0	0	0	0	0	0	6	0	0
"ZNF609"	8624	186647	22334	16869	12806	9528	9251	7618	10128	9049	13698	19063	2742	2671	3074	2729	3883	2384
"ZNF610"	2269	30879	0	0	0	0	0	0	14	9	0	0	3	17	6	0	3	0
"ZNF611"	4820	32242	851	244	472	379	150	94	438	269	473	383	476	44	315	207	319	194
"ZNF613"	2339	18319	26	0	14	12	0	0	58	0	0	0	216	65	170	40	238	59
"ZNF614"	4803	15104	13	0	13	0	0	0	22	31	0	78	384	378	245	229	241	126
"ZNF615"	4121	16872	41	0	16	25	0	0	88	41	0	21	65	200	200	100	188	44
"ZNF616"	3050	25539	74	0	42	32	0	0	81	0	36	0	300	9	279	71	325	115
"ZNF618"	9406	180314	556	27	326	230	22	5	1178	204	6	55	525	603	579	419	709	395
"ZNF619"	2547	11483	90	0	50	40	0	0	123	25	20	0	189	78	186	58	182	29
"ZNF620"	2266	11669	0	0	0	0	0	0	25	10	0	0	43	41	51	51	35	28
"ZNF621"	8239	14669	806	347	466	340	181	166	352	186	21	227	733	920	455	309	419	215
"ZNF622"	1697	14267	252	770	136	116	418	352	194	280	0	153	281	115	436	484	593	337
"ZNF623"	4048	17529	755	28	439	316	0	28	393	90	350	61	807	352	614	118	690	182
"ZNF624"	4241	33112	116	0	77	39	0	0	133	0	0	0	271	25	173	8	235	6
"ZNF625"	1676	11820	9	0	9	0	0	0	0	0	0	0	14	0	14	7	30	2
"ZNF626"	6092	41659	83	3	53	30	3	0	135	16	1	34	185	175	42	29	53	7
"ZNF627"	2868	21741	236	0	131	105	0	0	202	24	49	70	386	110	372	42	380	56
"ZNF628"	3850	8157	23	0	11	12	0	0	77	30	0	0	181	10	123	31	211	30
"ZNF629"	6090	8755	372	1	205	167	1	0	138	122	65	26	902	471	871	442	1179	367
"ZNF630"	2565	13193	33	0	24	9	0	0	25	0	0	0	35	38	9	4	57	8
"ZNF638"	6850	103300	17750	15470	9903	7847	8489	6981	8329	7104	7682	11667	3173	4144	3283	2852	3673	2507
"ZNF639"	3020	11771	0	0	0	0	0	0	26	0	0	0	441	327	417	205	367	179
"ZNF641"	2323	8091	2840	643	1591	1249	322	321	1205	107	1257	156	335	211	1993	849	514	133
"ZNF642"	2461	18714	595	0	348	247	0	0	330	10	17	8	907	366	823	188	1102	318
"ZNF643"	2348	13575	12	0	6	6	0	0	40	0	1	0	187	44	75	0	66	29
"ZNF644"	5627	106813	12598	11946	7103	5495	6443	5503	5704	5430	4243	8207	1077	1557	1473	1066	1563	922
"ZNF645"	1516	1516	0	0	0	0	0	0	0	0	0	0	0	0	0	0	0	0
"ZNF646"	6204	9085	842	124	448	394	50	74	479	245	434	218	0	652	1878	779	2275	951
"ZNF648"	3649	7142	0	0	0	0	0	0	12	0	0	0	0	0	0	0	0	0
"ZNF649"	3173	15760	140	49	55	85	16	33	157	39	0	62	359	280	316	193	311	132
"ZNF652"	11497	72909	6294	1152	3512	2782	663	489	2766	563	3006	899	2391	1761	1577	780	2551	1102
"ZNF653"	2161	22410	38	0	38	0	0	0	163	14	0	0	95	47	66	30	128	81
"ZNF654"	4957	5552	371	711	200	171	391	320	241	161	0	94	978	949	952	288	1041	560
"ZNF655"	5803	6254	5231	4599	2965	2266	2468	2131	2533	1799	4082	4085	3576	4472	4059	3281	4575	2675
"ZNF658"	4187	20712	0	0	0	0	0	0	0	0	0	0	3	0	22	0	0	0
"ZNF658B"	4117	65075	0	0	0	0	0	0	0	0	0	0	0	0	32	0	9	0
"ZNF66"	1120	18292	26	0	0	26	0	0	39	0	0	0	0	0	4	13	7	4
"ZNF660"	2208	11103	0	0	0	0	0	0	0	0	0	0	0	0	0	0	1	0
"ZNF662"	6174	13169	0	0	0	0	0	0	0	0	0	0	0	0	0	0	0	0
"ZNF664"	5112	42299	919	222	532	387	113	109	625	321	272	287	1159	1318	1500	1097	2030	1285
"ZNF665"	3295	30069	0	0	0	0	0	0	0	0	0	0	0	0	0	0	4	0
"ZNF667"	4746	33235	0	0	0	0	0	0	0	0	0	0	11	10	0	0	0	4
"ZNF668"	2627	13334	198	16	102	96	16	0	190	81	0	82	109	206	283	167	119	193
"ZNF669"	1984	4412	15	0	0	15	0	0	18	0	0	0	255	75	114	44	119	4
"ZNF670"	2713	111107	0	0	0	0	0	0	168	0	0	0	69	28	60	4	84	0
"ZNF671"	2476	7877	507	28	248	259	28	0	275	42	89	83	438	140	375	132	488	126
"ZNF672"	2939	11185	1248	894	614	634	538	356	595	764	497	1487	2041	2341	2254	2453	3078	2603
"ZNF673"	2492	27451	12	0	7	5	0	0	15	0	0	0	52	80	85	60	77	55
"ZNF674"	4096	47733	0	0	0	0	0	0	11	0	0	0	19	73	15	40	75	3
"ZNF675"	2212	34310	1047	87	647	400	55	32	596	84	106	94	56	33	81	133	57	25
"ZNF676"	2937	17852	0	0	0	0	0	0	0	0	0	0	0	0	0	0	0	0
"ZNF677"	3532	19305	18	0	18	0	0	0	17	0	0	0	243	279	203	127	70	14
"ZNF678"	2523	92883	976	208	607	369	98	110	1112	151	59	168	279	255	98	21	40	6
"ZNF679"	1563	38450	0	0	0	0	0	0	0	0	0	0	0	0	0	0	0	0
"ZNF680"	3054	43252	1661	120	962	699	81	39	765	70	103	100	211	138	145	81	201	57
"ZNF681"	6499	19696	0	0	0	0	0	0	0	0	0	0	0	0	0	0	0	0
"ZNF682"	3464	34837	0	0	0	0	0	0	0	14	0	0	20	0	7	0	0	0
"ZNF683"	1717	11143	0	0	0	0	0	0	32	16	0	0	1	0	0	8	37	30
"ZNF684"	2100	16608	35	0	18	17	0	0	26	0	0	0	115	9	96	14	105	3
"ZNF687"	5386	9591	605	414	312	293	176	238	467	393	199	742	1836	1370	1943	1511	2432	1368
"ZNF688"	1830	2711	31	0	0	31	0	0	18	23	0	29	174	78	190	137	210	144
"ZNF689"	2710	6983	99	8	45	54	0	8	102	0	0	0	32	10	475	136	850	156
"ZNF69"	1662	26695	351	23	210	141	9	14	416	0	0	17	289	194	95	12	126	54
"ZNF691"	2028	5866	129	11	81	48	0	11	168	0	0	0	168	34	213	58	263	71
"ZNF692"	2137	8856	1289	513	751	538	297	216	511	414	263	785	162	202	409	208	488	252
"ZNF695"	3341	22732	0	0	0	0	0	0	0	0	0	0	0	0	0	0	0	0
"ZNF696"	4685	8561	149	0	76	73	0	0	70	12	0	29	165	19	116	6	153	0
"ZNF697"	5083	28392	6565	61516	3633	2932	33031	28485	1203	19094	624	42078	1045	18882	1246	12447	1145	5521
"ZNF699"	2099	9811	44	20	44	0	20	0	68	8	0	69	26	11	28	45	36	4
"ZNF7"	5643	9489	1618	1325	900	718	663	662	1027	672	1298	1635	619	363	723	312	941	329
"ZNF70"	4018	9508	25	0	12	13	0	0	75	0	0	0	40	31	51	3	9	0
"ZNF700"	2988	25679	6857	3707	3845	3012	2000	1707	3427	1645	6281	3410	1767	1455	826	432	1035	517
"ZNF701"	3001	14523	236	0	116	120	0	0	280	34	121	128	512	299	462	214	481	175
"ZNF702"	3000	25281	0	0	0	0	0	0	8	2	0	0	104	123	160	104	1	0
"ZNF703"	2176	3097	0	0	0	0	0	0	27	0	0	0	287	64	315	54	386	120
"ZNF704"	4312	236249	6675	5913	3885	2790	3322	2591	1101	665	0	931	211	187	558	444	212	0
"ZNF705A"	3443	7494	4	0	1	3	0	0	0	0	0	0	0	0	0	0	0	0
"ZNF705D"	3688	26178	0	0	0	0	0	0	0	0	0	0	0	0	0	0	0	0
"ZNF706"	2863	8694	869	369	425	444	240	129	387	265	309	346	1680	2044	2308	2520	2548	2113
"ZNF707"	3066	10934	413	40	277	136	24	16	204	102	166	20	418	270	426	202	767	243
"ZNF708"	4062	38251	1678	549	984	694	370	179	706	208	117	186	433	289	306	202	266	52
"ZNF709"	4951	90359	1274	33	697	577	18	15	771	48	458	0	377	78	264	7	328	38
"ZNF71"	3128	28880	15	0	15	0	0	0	132	0	0	0	156	50	152	7	215	84
"ZNF710"	3087	79275	34494	9397	19437	15057	4958	4439	12002	3645	27589	8716	3628	1078	3123	1368	4763	2163
"ZNF711"	4852	28597	0	0	0	0	0	0	0	0	0	0	43	69	28	53	21	0
"ZNF713"	2867	53273	19	3	19	0	0	3	83	28	0	47	187	168	80	77	100	40
"ZNF714"	8776	42912	1248	171	688	560	94	77	513	89	42	20	459	490	318	128	229	61
"ZNF716"	5214	23384	0	0	0	0	0	0	0	0	0	0	0	0	0	0	0	0
"ZNF717"	3072	48227	155	0	101	54	0	0	347	8	0	6	149	60	82	0	6	9
"ZNF718"	2173	103263	3135	374	1771	1364	247	127	1490	210	1786	641	240	164	127	94	186	24
"ZNF720"	6119	46658	1009	1351	656	353	797	554	703	518	30	1089	410	504	378	434	378	247
"ZNF721"	5169	59663	4027	1588	2225	1802	889	699	1798	759	1170	1310	863	825	736	381	877	333
"ZNF726"	1780	6640	1	0	0	1	0	0	0	0	0	0	5	0	0	0	4	0
"ZNF727"	1681	33106	0	0	0	0	0	0	0	0	0	0	0	0	0	0	8	0
"ZNF732"	2182	25482	0	0	0	0	0	0	0	0	0	0	0	0	0	0	0	0
"ZNF735"	1241	13087	0	0	0	0	0	0	0	0	0	0	0	0	0	0	0	0
"ZNF737"	8394	27829	93	0	36	57	0	0	81	0	0	0	210	77	145	6	125	0
"ZNF738"	11725	29650	225	79	126	99	42	37	199	39	14	32	157	132	154	53	63	32
"ZNF74"	3969	14273	0	0	0	0	0	0	0	0	0	0	54	29	86	19	143	16
"ZNF740"	4262	10120	752	35	431	321	14	21	478	37	206	0	1073	586	1347	451	1662	660
"ZNF746"	3807	25016	2229	251	1271	958	139	112	1065	353	892	605	1325	545	1357	548	1575	630
"ZNF747"	2372	3416	0	0	0	0	0	0	102	11	49	0	1	6	209	50	148	39
"ZNF749"	2932	10500	43	0	28	15	0	0	33	0	0	16	83	0	62	0	54	0
"ZNF750"	3193	10622	194	33	124	70	19	14	204	56	0	0	2	0	0	0	0	0
"ZNF75A"	2266	10216	596	224	351	245	128	96	265	108	127	119	533	516	421	267	533	252
"ZNF75D"	5544	58239	3250	491	1892	1358	342	149	1694	427	806	632	538	449	612	385	789	304
"ZNF76"	2667	36252	330	105	188	142	63	42	494	140	141	77	360	464	712	633	788	593
"ZNF761"	4218	26289	1049	425	613	436	217	208	760	422	285	675	798	816	677	476	758	373
"ZNF763"	2647	55298	7579	3727	4285	3294	2020	1707	3853	1679	6540	3491	1967	1558	996	463	1231	585
"ZNF764"	2740	4500	125	0	83	42	0	0	161	26	119	0	3	76	226	52	281	26
"ZNF765"	4786	46295	387	150	222	165	98	52	594	101	51	109	1387	966	910	450	965	324
"ZNF766"	3054	23154	142	14	54	88	0	14	255	93	53	24	493	249	446	118	493	139
"ZNF768"	3486	10898	216	22	105	111	22	0	182	37	179	0	1413	694	1535	570	2116	750
"ZNF77"	2043	11754	21	0	2	19	0	0	30	16	0	0	81	10	74	0	102	0
"ZNF770"	5405	9911	268	46	174	94	37	9	135	11	0	14	1534	1124	1333	604	1441	568
"ZNF771"	1457	11182	10	3	10	0	0	3	145	21	0	0	909	790	803	593	1256	748
"ZNF772"	5423	7985	9	0	9	0	0	0	52	11	36	0	219	108	220	35	167	0
"ZNF773"	2189	8201	0	0	0	0	0	0	27	0	0	0	157	70	135	45	150	4
"ZNF774"	1841	9239	1	0	1	0	0	0	13	0	8	0	0	0	0	0	0	0
"ZNF775"	2278	19315	38	0	30	8	0	0	94	14	0	0	37	11	84	21	109	35
"ZNF776"	5293	11363	1902	466	1106	796	261	205	1279	399	288	332	1548	931	1276	656	1348	370
"ZNF777"	3071	29594	157	8	59	98	8	0	152	9	0	0	292	112	353	143	442	205
"ZNF778"	2928	11254	319	32	171	148	20	12	232	132	0	98	182	154	246	266	276	146
"ZNF780A"	4258	21787	1249	49	674	575	27	22	728	11	625	176	854	332	828	68	1025	192
"ZNF780B"	8862	27946	2199	363	1218	981	202	161	1243	266	1025	339	833	719	624	301	768	269
"ZNF781"	3273	24568	0	0	0	0	0	0	0	0	0	0	0	0	0	0	0	0
"ZNF782"	3319	37118	928	317	511	417	155	162	774	315	103	110	60	20	24	18	51	29
"ZNF783"	2937	9738	1386	383	703	683	236	147	712	397	349	371	606	455	1032	644	1364	621
"ZNF784"	2026	3827	134	0	63	71	0	0	61	27	115	0	49	82	173	55	4	80
"ZNF785"	3212	5018	277	0	142	135	0	0	209	47	400	81	312	36	157	47	293	86
"ZNF786"	3596	21138	180	30	106	74	14	16	199	42	0	0	294	89	360	84	339	28
"ZNF787"	1931	33919	3473	2039	1869	1604	1075	964	1207	1152	2094	3252	889	528	590	483	1275	857
"ZNF788"	3769	22415	0	0	0	0	0	0	38	0	0	0	196	96	135	45	186	55
"ZNF789"	1854	14704	3002	1796	1659	1343	982	814	1096	812	2921	2442	1217	1396	795	596	1095	422
"ZNF79"	2200	20999	125	235	72	53	87	148	156	209	30	155	182	135	222	167	314	132
"ZNF790"	3037	20953	140	0	66	74	0	0	231	34	0	0	150	97	119	31	71	25
"ZNF791"	2640	18946	543	1032	315	228	469	563	233	987	132	1691	682	503	384	156	386	127
"ZNF792"	3892	7697	53	0	41	12	0	0	67	0	0	0	132	48	99	45	194	0
"ZNF793"	7127	36398	0	0	0	0	0	0	0	0	0	0	0	0	2	0	0	0
"ZNF799"	2535	22025	30	18	20	10	18	0	128	38	6	31	219	154	196	95	239	69
"ZNF8"	4682	36681	1515	873	824	691	435	438	827	498	384	650	1489	1408	329	55	459	88
"ZNF80"	2946	2946	0	0	0	0	0	0	0	0	0	0	0	0	0	0	0	0
"ZNF800"	4227	22415	3647	6572	2042	1605	1885	4687	3323	3572	1166	1911	112	169	1007	1662	1050	836
"ZNF804A"	4687	341121	52610	51749	29362	23248	28124	23625	17171	13005	14645	22063	565	654	537	450	435	386
"ZNF804B"	4590	577593	0	0	0	0	0	0	0	0	0	0	0	0	0	0	0	0
"ZNF805"	10129	22054	27	59	26	1	29	30	182	38	27	46	335	203	242	91	231	49
"ZNF808"	4233	36810	3302	1268	1873	1429	749	519	1863	605	3111	1246	1418	1539	800	412	601	343
"ZNF81"	7939	85311	717	349	323	394	182	167	492	172	70	224	546	457	268	151	340	215
"ZNF813"	4192	26559	39	10	25	14	10	0	140	63	0	15	484	172	257	82	309	86
"ZNF814"	6286	19697	3712	2205	2125	1587	1166	1039	1617	1116	2861	3076	1606	1721	1209	988	1306	605
"ZNF815"	2828	31277	10	0	0	10	0	0	89	0	0	0	35	49	50	25	55	51
"ZNF816A"	2702	13484	39	0	13	26	0	0	182	0	0	0	277	58	35	66	363	46
"ZNF821"	1956	24488	209	18	111	98	18	0	146	104	0	21	100	121	150	94	233	132
"ZNF823"	2399	17682	0	0	0	0	0	0	26	0	0	0	43	7	62	0	111	0
"ZNF826"	4735	33243	0	0	0	0	0	0	16	0	0	0	0	0	0	0	7	0
"ZNF827"	4194	177717	0	7	0	0	7	0	25	17	0	57	0	4	9	11	0	0
"ZNF828"	3820	12839	644	69	336	308	35	34	348	26	77	0	1573	565	1698	282	1894	504
"ZNF829"	3162	10837	0	0	0	0	0	0	0	0	0	0	18	11	8	6	5	0
"ZNF83"	3444	5363	1129	383	622	507	238	145	728	304	402	222	730	1475	184	615	216	672
"ZNF830"	1656	1656	74	18	46	28	18	0	32	17	0	0	322	295	420	303	497	269
"ZNF831"	9406	68092	0	21	0	0	13	8	41	29	0	0	0	3	0	0	0	0
"ZNF833"	3391	46793	0	0	0	0	0	0	48	0	0	0	112	114	5647	6026	7192	5447
"ZNF835"	1841	8170	0	0	0	0	0	0	0	11	0	0	0	0	0	0	4	0
"ZNF836"	3336	16771	24	2	1	23	0	2	25	0	0	0	118	69	92	13	84	4
"ZNF837"	2035	13400	9	0	0	9	0	0	98	15	0	0	42	4	9	0	22	3
"ZNF839"	3327	22950	267	107	129	138	79	28	296	117	137	280	304	268	403	245	504	245
"ZNF84"	7033	26009	1439	792	770	669	407	385	1012	481	349	650	973	965	912	620	1104	435
"ZNF841"	3883	31301	1041	447	594	447	268	179	451	284	456	399	321	131	427	298	414	197
"ZNF843"	2015	7465	1	1	0	1	0	1	18	1	1	2	0	1	0	0	0	0
"ZNF844"	2838	13082	36	0	36	0	0	0	78	0	0	0	323	94	327	43	323	28
"ZNF845"	4418	21122	90	0	52	38	0	0	146	32	0	0	600	329	568	228	606	84
"ZNF846"	2139	11261	1228	394	742	486	206	188	662	285	193	315	417	533	311	225	347	182
"ZNF85"	2653	14034	0	0	0	0	0	0	13	0	0	0	128	68	98	12	102	0
"ZNF853"	3579	8394	0	0	0	0	0	0	0	0	0	0	0	0	0	0	0	0
"ZNF860"	3100	9856	0	0	0	0	0	0	0	0	0	0	0	0	0	0	0	0
"ZNF862"	6904	29060	557	17	257	300	17	0	642	184	38	48	545	414	735	331	997	316
"ZNF876P"	2607	43384	0	0	0	0	0	0	38	0	0	0	1	0	0	0	0	0
"ZNF878"	1742	12509	0	0	0	0	0	0	54	0	0	0	10	8	0	0	0	0
"ZNF879"	2608	10613	0	21	0	0	8	13	34	0	0	12	135	75	82	20	149	53
"ZNF880"	2264	15876	0	0	0	0	0	0	27	0	0	0	164	176	228	169	160	132
"ZNF90"	3757	43176	0	0	0	0	0	0	0	0	0	0	0	0	3	0	0	0
"ZNF91"	5399	37772	1574	1416	894	680	790	626	1217	788	259	1015	484	593	645	561	538	275
"ZNF92"	3117	27231	285	158	179	106	95	63	253	88	0	47	467	253	411	175	366	120
"ZNF93"	2116	33980	34	14	20	14	14	0	174	16	4	49	137	9	138	13	174	0
"ZNF98"	2264	31251	0	0	0	0	0	0	0	0	0	0	0	0	0	0	0	0
"ZNF99"	3117	13777	0	0	0	0	0	0	0	0	0	0	0	0	0	0	0	0
"ZNFN1A2"	9454	148957	16	0	9	7	0	0	24	0	38	72	120	196	33	4	0	0
"ZNFN1A3"	1775	99242	95	14	53	42	6	8	27	25	102	31	134	4	9	0	69	18
"ZNFPHEX133"	5641	20383	318	11	178	140	0	11	257	61	27	60	644	649	560	504	656	365
"ZNFX1"	7381	32317	4636	12485	2591	2045	6666	5819	1447	5998	1656	7924	6096	10102	5888	9163	8143	5424
"ZNHIT1"	4671	6486	93	12	53	40	0	12	119	74	0	0	930	556	46	0	326	30
"ZNHIT2"	1296	1296	17	0	0	17	0	0	80	32	0	0	121	26	127	25	177	28
"ZNHIT3"	2034	12683	128	31	80	48	31	0	78	16	69	67	380	542	613	473	616	491
"ZNHIT6"	2806	55611	214	78	136	78	58	20	181	46	0	28	356	335	322	171	340	202
"ZNRD1"	863	3630	0	0	0	0	0	0	0	0	0	0	125	181	190	214	200	162
"ZNRF1"	4792	111979	288	713	130	158	405	308	473	959	57	854	632	525	172	139	135	258
"ZNRF2"	3464	83386	9637	18340	5826	3811	9966	8374	3743	7015	1075	2634	1906	2258	1538	1636	1860	1433
"ZNRF3"	6550	173587	8	0	8	0	0	0	103	30	0	36	8	12	16	13	4	0
"ZNRF4"	1442	1442	0	0	0	0	0	0	0	0	0	0	0	0	0	0	0	0
"ZNT5"	1195	10749	178	79	73	105	49	30	179	89	73	229	256	310	150	132	293	172
"ZP1"	1983	8150	0	0	0	0	0	0	51	23	0	0	0	0	0	0	0	0
"ZP2"	2484	14296	0	0	0	0	0	0	0	0	0	0	0	0	0	0	0	0
"ZP3"	1861	13434	0	0	0	0	0	0	187	10	116	30	44	25	105	129	169	104
"ZP4"	1646	8226	0	0	0	0	0	0	0	0	0	0	0	0	0	0	0	0
"ZPBP"	1232	155836	0	0	0	0	0	0	0	0	0	0	0	0	0	0	0	0
"ZPBP2"	2260	9691	0	0	0	0	0	0	0	0	0	0	0	0	0	0	0	0
"ZPLD1"	4371	380599	0	0	0	0	0	0	0	0	0	0	0	0	0	0	0	0
"ZRANB1"	4950	45314	1662	1311	976	686	709	602	1000	795	368	1631	1636	1597	1767	873	2080	716
"ZRANB2"	2928	17772	1323	1672	438	885	876	796	1104	782	384	846	1963	2302	746	1844	2567	1367
"ZRANB3"	3815	330608	66	0	28	38	0	0	79	23	2	28	452	587	22	30	17	0
"ZRSR2"	1862	31783	6531	1671	3618	2913	820	851	2301	652	3014	1451	9916	8817	7812	6682	11962	7813
"ZSCAN1"	2060	20567	0	0	0	0	0	0	55	15	0	0	24	16	0	0	0	0
"ZSCAN10"	3068	4344	0	0	0	0	0	0	28	0	0	0	0	0	0	0	0	0
"ZSCAN12"	4348	20947	50	0	15	35	0	0	46	0	0	0	77	19	86	0	84	4
"ZSCAN12L1"	3712	4565	0	0	0	0	0	0	0	0	0	0	0	0	0	0	5	0
"ZSCAN16"	1277	5469	93	31	57	36	16	15	105	15	0	0	93	19	120	11	158	47
"ZSCAN18"	2936	14523	34	0	29	5	0	0	108	56	0	22	188	78	163	119	176	100
"ZSCAN2"	3751	22701	29	0	0	29	0	0	111	9	0	0	161	56	155	25	222	20
"ZSCAN20"	4224	23763	40	0	16	24	0	0	91	0	0	0	91	5	90	4	169	0
"ZSCAN21"	1991	15246	140	25	97	43	25	0	121	26	0	0	187	144	208	119	231	101
"ZSCAN22"	4646	15329	110	0	52	58	0	0	130	47	0	31	183	93	162	41	309	47
"ZSCAN23"	3164	10848	0	0	0	0	0	0	0	0	0	0	0	0	0	0	0	0
"ZSCAN29"	5683	11890	271	76	173	98	41	35	132	0	20	25	756	567	695	406	858	388
"ZSCAN4"	2250	10218	0	0	0	0	0	0	0	0	0	0	0	0	0	0	0	0
"ZSCAN5A"	2457	147073	3021	905	1677	1344	466	439	1541	637	693	765	159	213	100	127	114	141
"ZSCAN5B"	1629	3364	0	0	0	0	0	0	0	0	0	0	0	0	0	0	0	0
"ZSIG13"	2249	152341	0	0	0	0	0	0	11	8	0	0	14	50	7	0	0	0
"ZSWIM1"	2788	4058	38	0	38	0	0	0	30	23	0	7	377	188	297	143	330	147
"ZSWIM2"	2455	21692	0	0	0	0	0	0	0	0	0	0	0	0	0	0	0	0
"ZSWIM3"	2931	21507	2	0	2	0	0	0	41	9	0	20	167	39	223	8	253	31
"ZSWIM4"	4352	36772	19	133	3	16	85	48	124	225	6	469	102	233	88	155	164	163
"ZSWIM5"	5850	190176	1	0	1	0	0	0	11	0	0	0	2	5	0	0	0	0
"ZSWIM6"	5516	213900	38353	34206	21438	16915	18530	15676	18855	15995	19323	22393	1782	1976	1669	1710	2063	1331
"ZSWIM7"	2010	23131	229	29	112	117	18	11	151	24	171	0	418	233	263	185	198	218
"ZTL1"	1905	14128	159	67	76	83	35	32	79	25	18	0	1033	1084	1575	1248	1479	1109
"ZUFSP"	2202	33175	277	144	184	93	67	77	171	52	9	116	366	356	417	260	428	375
"ZW10"	2898	40516	94	23	55	39	16	7	67	11	0	26	454	479	621	366	726	480
"ZWILCH"	3290	44387	5	72	0	5	29	43	44	64	0	37	278	417	305	368	324	228
"ZWINT"	1859	3837	0	0	0	0	0	0	0	11	0	0	67	64	141	122	88	40
"ZXDA"	2871	2871	0	0	0	0	0	0	0	15	0	0	64	371	164	366	99	93
"ZXDB"	5639	5639	30	0	22	8	0	0	0	9	0	0	348	272	388	354	403	175
"ZXDC"	12606	24805	6613	3416	3641	2972	1866	1550	2192	1321	3679	2992	2110	1918	2215	1479	2648	1176
"ZYG11A"	4285	52066	0	0	0	0	0	0	0	0	0	0	0	0	0	0	0	0
"ZYG11B"	8154	100882	764	123	352	412	65	58	738	26	240	64	4841	5092	1583	859	1676	800
"ZYX"	2314	9844	4795	3340	2607	2188	1815	1525	1284	2225	3706	5670	11769	10092	17323	14914	17992	12416
"ZZEF1"	11449	138515	5655	2129	3167	2488	1151	978	3049	1550	1499	2507	1963	2863	4282	3679	4948	3197
"ZZZ3"	4337	118154	6009	2022	3203	2806	1063	959	2897	862	644	1886	756	661	667	563	648	459
"Zep-1"	9073	110460	27695	6228	15274	12421	3200	3028	11572	2542	17299	3617	460	456	476	351	511	234
"ZnF20"	3095	23453	165	15	102	63	8	7	152	35	61	0	592	359	340	85	476	121
"[epsilon] IgE"	208	291	0	0	0	0	0	0	0	0	0	0	0	0	0	0	0	1
"aat-1"	4212	64080	0	0	0	0	0	0	0	0	0	0	0	0	0	0	0	0
"abParts"	66622	1288833	1517	315	804	713	166	149	3737	1162	482	277	1336	1344	1497	1406	2026	1457
"abp620"	1571	78319	2223	1216	1249	974	735	481	1115	1124	476	409	67	71	135	152	87	33
"ad24"	2238	16503	93	81	46	47	42	39	37	35	0	71	160	191	190	165	143	89
"adam23"	2473	172648	239	310	162	77	178	132	159	85	20	41	481	662	256	292	64	8
"aie-75"	2182	50522	0	0	0	0	0	0	149	101	0	0	0	0	0	0	0	0
"aik2"	1254	5835	0	0	0	0	0	0	82	48	0	0	10	5	20	5	11	0
"airm-1"	1066	11227	371	21	196	175	13	8	333	291	328	239	1368	1231	1191	1174	1500	1394
"alcan-gamma"	565	3751	0	0	0	0	0	0	0	10	0	0	0	0	0	0	0	0
"alpha-1,3-galactosyltransferase type 1"	3756	55039	13589	11833	7518	6071	6386	5447	5879	4678	11850	14516	6722	7422	5691	5490	6181	4439
"amap-1"	3370	23118	1	0	1	0	0	0	51	22	0	0	0	0	0	0	0	0
"ape"	3780	16535	7326	5669	3996	3330	3049	2620	2241	2344	3675	4624	519	46	853	901	638	363
"argBPIB"	5737	41124	785	82	458	327	62	20	560	88	124	30	746	675	800	460	998	630
"asnS"	2468	21285	1063	379	620	443	235	144	331	143	437	297	3168	4787	4008	3484	4228	2007
"av27s1"	396	564	0	0	0	0	0	0	0	0	0	0	0	0	0	0	0	0
"b9"	1472	35127	0	0	0	0	0	0	167	54	0	0	1	5	11	9	9	14
"bA251O17.3"	1083	17568	0	0	0	0	0	0	94	17	0	0	4	5	0	0	18	7
"bK150C2.9"	2112	12139	17	0	15	2	0	0	288	175	0	0	1666	1557	755	354	791	586
"bK250D10.8"	331	234187	12377	13084	6872	5505	6987	6097	5161	6632	5956	15419	6833	8015	6646	6334	10349	7288
"bMRP64"	765	1643	0	0	0	0	0	0	26	18	0	0	790	1273	976	943	497	456
"beta1,3-GalT 5"	594	29623	0	0	0	0	0	0	30	8	0	0	0	0	0	0	0	0
"beta3GalNAcT-1"	1174	16242	0	0	0	0	0	0	26	0	0	15	152	166	216	96	1	105
"bim-alpha1"	4774	44714	10602	6780	5908	4694	3637	3143	4832	3432	7277	7306	5801	4964	6623	4340	6515	3972
"bk125H2.1"	2305	75864	0	0	0	0	0	0	9	0	0	0	0	0	0	0	0	0
"bpl 41-16"	1435	28555	0	0	0	0	0	0	64	31	0	0	0	0	0	0	0	0
"c-ERBB-2"	2522	29518	1	0	0	1	0	0	162	80	0	0	0	0	3	7	7	8
"c-erbB-3"	436	648	0	0	0	0	0	0	11	0	0	0	0	0	0	0	0	0
"c-lbc"	1511	101961	5850	6207	3374	2476	3433	2774	2642	2060	1133	4835	365	469	516	460	630	297
"cBGL1"	2064	105481	0	57	0	0	29	28	35	37	0	0	1767	2344	2381	2376	2875	2190
"cN5H6.4"	1518	1518	0	0	0	0	0	0	12	18	0	0	0	0	0	0	0	0
"cPLA2 beta"	3203	20064	1244	651	715	529	346	305	732	589	379	418	341	460	751	607	800	408
"cPLA2 gamma"	881	7217	0	0	0	0	0	0	10	0	76	38	0	0	32	30	46	11
"caspace"	1467	5746	21	0	21	0	0	0	77	26	0	15	0	0	0	0	0	0
"cega"	1644	6031	70	56	39	31	31	25	66	31	28	0	756	702	819	715	991	697
"cent-b"	2677	37457	1975	330	1105	870	135	195	981	166	881	261	1685	1641	1331	951	1826	1020
"chromosome 10 open reading frame 139"	732	1520	0	0	0	0	0	0	0	12	0	0	0	0	0	0	0	0
"coagulation factor II"	2027	20314	0	0	0	0	0	0	28	0	0	0	5	6	0	0	0	0
"cog4"	3521	42986	539	130	321	218	66	64	446	102	173	91	941	826	1132	1008	1449	926
"contactin 1"	139	139	0	0	0	0	0	0	0	0	0	0	0	0	0	0	0	0
"cytochrome b"	1128	1128	0	0	0	0	0	0	0	0	0	0	0	0	0	0	0	0
"dJ1198O21.1"	7161	9745	3445	2912	1897	1548	1517	1395	1664	1272	2167	2011	3913	5384	4858	4695	5335	3451
"dJ402G11.5"	1758	11300	1293	193	804	489	108	85	851	253	1310	669	650	677	1128	680	1383	578
"ddb2"	1741	22362	3794	975	2081	1713	529	446	1533	315	3048	648	2330	2123	1568	2434	3040	801
"derp10"	1832	7891	289	177	164	125	103	74	203	102	74	102	1341	1055	1475	1164	1843	1229
"derp13"	490	67303	0	0	0	0	0	0	0	0	0	0	0	0	0	0	0	0
"derp7"	4717	8621	0	0	0	0	0	0	0	0	0	0	0	0	0	0	0	0
"dgkd-2"	1449	8213	152	40	78	74	22	18	222	49	94	94	99	122	99	88	135	85
"diap3"	1360	85351	0	0	0	0	0	0	0	0	0	0	0	0	0	0	0	0
"dickkopf-2"	467	359146	0	0	0	0	0	0	8	0	0	0	0	0	0	0	0	0
"doc-1"	1293	10148	86	0	43	43	0	0	169	36	0	0	1545	1680	510	482	523	1269
"drim"	1594	11302	6	34	6	0	11	23	9	13	12	0	29	52	76	55	37	28
"eIF2B delta subunit"	3629	4103	301	13	148	153	5	8	127	30	38	60	538	505	657	436	849	279
"eIF4B"	1270	21643	1103	484	655	448	291	193	640	353	215	936	238	604	1827	1275	2409	1363
"elys"	7097	60414	1010	767	566	444	409	358	666	903	58	796	815	1087	2017	2241	1976	1547
"endogenous retrovirus ERV9"	998	998	0	0	0	0	0	0	0	0	0	0	0	0	0	0	0	0
"ent2"	2348	9654	18	0	18	0	0	0	110	74	0	0	1	11	0	0	42	9
"env"	1553	1553	0	0	0	0	0	0	0	0	0	0	0	0	0	0	0	0
"eps15R"	3084	116703	2934	585	1611	1323	375	210	2518	673	1375	955	754	657	816	733	989	695
"epsilon-cop"	758	27452	763	730	413	350	410	320	836	494	1352	1422	1311	1544	1554	1738	2114	1807
"fad104"	940	147662	19303	75703	10892	8411	40528	35175	8833	44903	4155	47680	133	230	133	312	119	105
"fad49"	1552	73464	33	0	33	0	0	0	107	31	0	0	5	20	15	17	24	0
"ferritin light chain-like"	1504	30180	0	0	0	0	0	0	0	0	0	0	0	0	0	0	0	0
"fgf-20"	914	9342	0	0	0	0	0	0	0	0	0	0	0	0	0	0	0	0
"fln29"	1130	24328	866	199	517	349	103	96	636	122	289	241	1712	1049	1604	1045	2198	741
"fls485"	3184	57775	0	0	0	0	0	0	23	33	0	0	0	0	0	0	0	0
"foap-13"	1655	36699	253	1908	122	131	1076	832	197	1030	44	2403	1174	2158	1856	4025	1777	2663
"foap-2"	1596	77538	28241	59543	15657	12584	32270	27273	8411	36674	12042	51460	751	2938	1296	3530	1324	1437
"foap-4"	1663	13890	0	0	0	0	0	0	0	0	0	0	17	16	73	86	45	25
"foap-7"	1978	20019	1377	264	663	714	166	98	673	118	303	131	7994	9337	6771	3784	7703	3320
"gcp16"	1918	20418	284	174	159	125	111	63	245	282	0	192	2291	2589	1978	1963	2488	1928
"gis5"	1177	4477	0	0	0	0	0	0	24	0	0	0	0	0	0	4	0	0
"gp130"	1117	35428	5234	6964	2923	2311	3760	3204	2323	3636	1874	5768	5376	10344	1096	1919	1500	892
"graf-2"	1360	49530	127963	115547	78046	49917	66226	49321	43983	48883	68033	97350	3096	3107	2840	3020	4051	2639
"h4F2hc"	255	1816	327	393	212	115	197	196	54	107	212	307	515	1078	995	924	150	965
"hADV14S1"	426	589	0	0	0	0	0	0	0	0	0	0	0	0	0	0	0	0
"hADV23S1"	426	571	0	0	0	0	0	0	0	0	0	0	0	0	0	0	0	0
"hADV29S1"	479	368899	313	373	135	178	239	134	71	15	0	129	236	347	109	114	159	108
"hADV36S1"	713	322109	313	373	135	178	239	134	71	15	0	129	255	373	127	129	186	131
"hADV38S2"	378	620	0	0	0	0	0	0	0	0	0	0	0	0	0	0	0	0
"hAG-2/R"	1132	4262	0	0	0	0	0	0	0	0	0	0	0	0	0	0	0	0
"hAK3alpha"	3925	16495	236	35	114	122	17	18	114	82	34	0	1011	1063	712	615	863	655
"hAO"	3785	62274	0	0	0	0	0	0	0	11	0	0	0	0	0	0	0	0
"hAPG12"	2953	11704	1062	526	623	439	321	205	532	256	265	289	1890	1734	1249	726	1288	565
"hAPG4A"	2051	62963	88	8	50	38	8	0	65	0	0	0	404	433	386	362	467	343
"hArpX"	1106	41053	71	0	50	21	0	0	62	0	10	0	318	484	367	302	437	332
"hCAP-C"	2066	25379	291	104	183	108	50	54	204	42	25	130	299	177	410	353	479	228
"hCAP-E"	3296	14128	0	5	0	0	5	0	0	0	0	0	310	315	312	234	407	224
"hCCC6"	635	4442	3145	836	1401	1744	405	431	610	377	2658	1187	3884	1990	1280	1010	2222	1071
"hCG_1642047"	1990	2965	0	0	0	0	0	0	0	0	0	0	112	120	37	0	0	0
"hCG_1646325"	1503	1503	0	0	0	0	0	0	0	0	0	0	0	0	0	0	0	0
"hCG_1657684"	3034	5933	0	0	0	0	0	0	122	15	0	0	60	55	47	66	82	52
"hCG_1685787"	857	13922	828	1023	570	258	617	406	641	986	155	1554	1834	3087	1326	1353	1656	1294
"hCG_1770745"	1255	2083	0	0	0	0	0	0	87	16	0	0	0	0	0	0	0	0
"hCG_1779191"	915	915	1160	1106	638	522	592	514	611	557	0	995	695	699	734	739	895	712
"hCG_1780060"	1015	5067	0	0	0	0	0	0	18	0	0	0	8	11	0	0	5	4
"hCG_1787779"	3483	61356	6490	1370	3402	3088	747	623	3037	1484	5283	2442	2847	2809	3344	3366	5067	4554
"hCG_1803240"	2248	12572	0	0	0	0	0	0	0	0	0	0	0	0	0	0	0	0
"hCG_1811060"	757	16671	364	88	214	150	48	40	162	131	0	19	126	128	95	83	123	84
"hCG_1818547"	1333	1333	296	74	75	221	49	25	156	42	120	71	0	0	0	0	0	0
"hCG_1820408"	3301	7376	0	0	0	0	0	0	0	0	0	0	0	0	0	0	0	0
"hCG_1986256"	1439	1439	2	9	2	0	4	5	0	0	0	0	0	0	64	50	48	43
"hCG_1993022"	2291	2633	0	0	0	0	0	0	0	0	0	0	0	0	0	0	0	0
"hCG_1994130"	2201	7368	299	310	151	148	179	131	191	223	229	431	2574	2978	3991	3884	8010	4311
"hCG_1995134"	3522	3522	0	0	0	0	0	0	22	0	0	0	0	0	0	0	0	0
"hCG_1997999"	2849	2849	0	0	0	0	0	0	0	0	0	0	0	0	0	0	0	0
"hCG_1998535"	2186	18146	3351	2770	1521	1830	1296	1474	1170	2557	1104	1494	333	307	499	479	581	397
"hCG_2001537"	1441	2141	500	168	245	255	94	74	101	141	299	806	2233	1907	2453	2243	3100	255
"hCG_2008157"	1700	2596	0	0	0	0	0	0	33	15	0	0	19	0	0	0	0	0
"hCG_2009575"	3022	319009	0	0	0	0	0	0	36	0	0	0	0	0	0	0	0	0
"hCG_2013121"	1392	13114	0	0	0	0	0	0	0	7	0	0	4	26	6	14	15	21
"hCG_2014417"	1532	2117	13	15	0	13	6	9	21	11	0	0	103	88	97	73	175	111
"hCG_2018772"	2253	2253	149	30	107	42	14	16	130	33	88	50	0	12	4	3	3	2
"hCG_2022580"	4545	34203	2952	910	1677	1275	548	362	1639	616	2066	1402	520	352	3103	2138	4598	2773
"hCG_2023280"	1010	1010	53	25	28	25	0	25	45	0	0	0	67	28	97	78	57	40
"hCG_2028511"	2024	2024	0	0	0	0	0	0	0	0	0	0	0	0	0	0	0	0
"hCG_2031650"	4618	24302	1066	1800	648	418	914	886	600	1004	532	2457	593	1217	619	829	760	548
"hCG_2032453"	975	1480	0	0	0	0	0	0	0	0	0	0	0	0	0	0	0	0
"hCG_2039358"	1714	22684	0	1	0	0	1	0	10	0	0	0	0	0	0	0	0	0
"hCG_20425"	1750	2517	451	140	267	184	79	61	131	167	253	219	1643	1485	21	854	1310	830
"hCG_20426"	1478	2850	0	0	0	0	0	0	0	0	0	0	0	0	0	0	0	0
"hCG_25025"	790	29612	0	0	0	0	0	0	108	38	0	0	0	0	0	0	0	0
"hCG_28338"	2734	7788	0	0	0	0	0	0	15	0	0	0	0	0	0	0	0	1
"hCG_30195"	5441	9423	942	356	496	446	175	181	481	300	122	339	1313	1273	1658	1323	2128	1405
"hCG_31249"	1348	3841	0	0	0	0	0	0	34	26	0	0	0	0	0	0	0	0
"hCG_38438"	1089	5143	152	15	86	66	0	15	175	41	36	0	3224	3999	3014	3155	369	3104
"hCG_41425"	2180	14063	0	0	0	0	0	0	24	0	0	0	3	0	9	0	19	0
"hCPE-R"	4165	4942	0	0	0	0	0	0	30	0	0	0	0	0	0	0	0	0
"hDNp73A"	1900	6427	0	0	0	0	0	0	66	33	0	0	0	0	0	0	0	0
"hDV102S1"	412	563	0	0	0	0	0	0	0	0	0	0	0	0	0	0	0	0
"hDV103S1"	393	625	0	0	0	0	0	0	0	0	0	0	0	0	0	0	0	0
"hDaxx"	1836	2865	58	246	9	49	147	99	60	6	12	537	128	3045	95	2830	175	33
"hEMMPRIN"	1654	10957	657	157	362	295	81	76	280	301	488	226	5008	2949	9280	8140	7229	6332
"hFKHLB"	9312	537971	12874	8299	7363	5511	4719	3580	9630	8445	3518	12404	273	776	547	417	715	409
"hGli2"	868	216142	0	0	0	0	0	0	917	391	0	0	0	0	0	0	0	0
"hHAVcr-1"	900	23136	0	0	0	0	0	0	0	0	0	0	0	0	5	6	6	0
"hINADL"	5083	358056	0	0	0	0	0	0	8	0	0	0	0	0	0	0	0	0
"hJAL"	1507	6455	17	0	0	17	0	0	31	13	14	0	1073	1147	1080	968	1197	946
"hLAT2"	3567	58345	6826	522	3829	2997	252	270	2388	103	4742	278	7010	5731	5981	3706	6830	4840
"hLRp105"	2286	10005	1	0	0	1	0	0	89	18	0	0	387	303	517	396	778	423
"hMAST205"	1224	142019	721	190	388	333	122	68	676	124	45	66	82	71	87	107	113	76
"hMBLR"	2261	48339	10	0	0	10	0	0	0	0	0	4	122	99	208	103	213	128
"hMLH1"	2475	57070	1555	1997	812	743	1157	840	713	875	368	2004	1203	1669	1064	2439	3065	1012
"hMYH"	979	11229	33	21	13	20	12	9	34	35	0	30	136	78	209	184	242	161
"hMmTRA1b"	1999	29662	13	7	13	0	0	7	42	126	0	0	105	315	243	346	92	121
"hMtCCA"	1288	3011	130	150	66	64	91	59	60	102	0	144	76	75	26	47	78	33
"hNAACTE"	2971	15375	386	22	213	173	10	12	251	11	104	0	249	101	395	326	528	305
"hNB-2"	2134	165616	0	0	0	0	0	0	0	0	0	0	0	0	0	0	0	0
"hNB-3"	1529	205435	0	0	0	0	0	0	0	0	0	0	0	0	0	0	0	0
"hNBL4"	2718	7659	28	0	0	28	0	0	16	18	0	0	26	26	21	0	23	0
"hNap1BP"	3136	114434	12131	20588	6801	5330	10894	9694	4751	18233	3240	54283	1925	2544	4573	2483	5240	4174
"hNedd5"	1196	9380	2256	1253	1373	883	707	546	811	608	970	1177	431	556	176	247	292	145
"hNp95"	3825	51974	1256	144	720	536	93	51	632	224	1424	604	302	164	142	92	411	61
"hOAT4"	2573	11075	0	0	0	0	0	0	75	0	0	0	0	0	0	0	0	0
"hOBDPF"	1963	9552	0	0	0	0	0	0	0	14	0	0	0	0	0	0	0	0
"hOGG1"	745	5635	246	0	246	0	0	0	91	35	0	43	1373	945	27	593	865	613
"hPAD-colony10"	2479	12727	0	0	0	0	0	0	59	50	0	0	0	0	0	0	0	0
"hPARG"	2347	345006	152	0	67	85	0	0	284	3	0	42	387	375	526	432	494	425
"hPGAP1"	8747	13014	13	27	4	9	5	22	0	44	0	24	47	100	5	0	0	0
"hPMS6"	1022	109661	171	99	99	72	70	29	205	123	9	67	218	196	296	256	412	263
"hPMS8"	931	2822	6	0	1	5	0	0	0	0	0	0	38	48	30	30	27	20
"hPRL-3"	1077	9615	0	358	0	0	143	215	52	659	0	1159	20	149	0	350	24	140
"hPer"	4019	10376	220	333	116	104	153	180	381	466	54	1349	593	1797	554	1430	533	1082
"hRAB-23"	2234	33512	0	0	0	0	0	0	0	0	0	0	69	21	22	10	48	9
"hRAD18"	2980	83587	447	1448	245	202	795	653	324	1377	0	373	145	1198	265	129	149	199
"hREV3"	3180	56961	1269	548	748	521	302	246	761	323	220	48	316	348	419	329	436	332
"hSF21"	1721	42330	1325	446	747	578	220	226	852	432	253	640	111	232	173	203	153	96
"hSIPL1A"	1697	5604	433	55	250	183	42	13	218	90	320	30	1308	461	1367	1061	1842	1226
"hSK4"	1135	7067	467	63	251	216	39	24	129	320	623	1436	455	135	310	489	850	525
"hSKRP1"	5319	21435	0	0	0	0	0	0	0	0	0	0	0	0	3	0	0	0
"hSSH-3"	2792	9159	238	32	126	112	16	16	161	14	97	1	523	479	518	460	879	521
"hShrmL"	3883	52674	0	0	0	0	0	0	0	0	0	0	0	0	0	23	0	0
"hTERT"	3655	41877	0	0	0	0	0	0	218	97	0	0	0	1	0	0	0	0
"hTIM44"	1249	15578	464	50	284	180	26	24	256	163	123	164	453	423	445	389	696	384
"hTPK1"	2818	286974	11543	7593	6547	4996	4216	3377	7247	5029	935	3599	1139	246	245	778	1192	781
"hTRF1-AS"	642	11945	39	0	25	14	0	0	21	0	0	0	0	0	62	57	114	54
"hTTY1s"	1595	20718	784	77	478	306	59	18	428	204	453	220	0	0	0	0	20	0
"hTroy"	1671	16060	0	0	0	0	0	0	0	0	0	0	0	0	0	0	0	0
"hVPS11"	3412	14156	506	79	289	217	29	50	335	203	159	117	1619	1345	2354	1198	3004	1579
"hWAPL"	1027	4215	470	134	268	202	24	110	209	228	0	486	419	76	543	306	430	262
"hXllL"	1960	32103	0	0	0	0	0	0	129	19	0	0	0	4	0	0	2	0
"hairless"	1752	2968	126	0	71	55	0	0	57	0	139	27	155	144	107	95	332	171
"hasc-1"	1578	3027	0	0	0	0	0	0	14	45	0	0	0	0	0	0	0	0
"hbet1"	3605	41607	47	0	29	18	0	0	92	0	0	0	526	538	298	253	414	310
"hboct"	2028	6554	0	0	0	0	0	0	21	9	0	0	0	0	0	0	0	0
"hdim1+"	1609	15665	1671	128	930	741	55	73	729	177	746	476	1236	804	1224	780	1347	747
"hfb101"	1952	27681	1864	2429	1013	851	1305	1124	796	1165	555	2654	557	2156	508	784	616	400
"hfzo2"	3401	45528	1657	83	921	736	63	20	1056	117	282	143	1106	1423	1002	859	1003	738
"hla-b"	910	1054	2515	5673	1406	1109	2911	2762	1274	3360	1521	3099	51037	46567	35125	64070	30925	28134
"hoip"	1563	5737	1199	262	599	600	168	94	545	332	909	369	1363	927	1821	947	2171	854
"hork3"	1352	47308	0	0	0	0	0	0	0	0	0	0	25	12	3	17	28	0
"hp28"	2483	9939	14	0	0	14	0	0	37	42	0	0	0	2	0	0	0	0
"hucep-13"	2291	2885	708	397	178	530	199	198	172	49	452	279	1317	967	802	1037	1014	897
"iNAT"	2872	29806	0	0	0	0	0	0	0	0	0	0	0	0	0	0	0	0
"iPLA2"	3386	54569	613	777	377	236	509	268	372	534	40	484	1059	1830	910	1139	1058	706
"ifp1"	2699	7623	0	0	0	0	0	0	15	0	0	0	0	0	0	0	0	1
"il-xr"	962	16645	0	0	0	0	0	0	0	0	0	0	0	0	0	20	0	0
"immunoglobulin epsilon chain constant..."	232	2324	0	0	0	0	0	0	22	15	0	0	0	0	0	0	0	2
"immunoglobulin epsilon chain membrane..."	359	2154	0	0	0	0	0	0	22	15	0	0	0	0	0	0	0	2
"insl7"	567	2768	0	0	0	0	0	0	31	18	0	0	0	0	0	0	0	0
"kIAA0367"	4465	80822	2558	720	1364	1194	386	334	703	232	0	30	114	226	0	0	16	0
"kenae1"	3929	16181	17	0	7	10	0	0	105	0	0	0	233	101	178	110	172	117
"keratin 19"	632	632	0	0	0	0	0	0	0	0	0	0	0	0	0	0	0	0
"klotho"	2187	45718	0	0	0	0	0	0	0	0	0	0	6	0	0	0	5	0
"l-rap"	5802	43756	519	47	282	237	24	23	538	11	41	26	1697	1902	1486	1194	3945	2592
"lhpp"	1194	8941	140	19	66	74	19	0	196	89	35	0	209	191	158	178	203	170
"limkain"	3683	9155	325	93	153	172	68	25	191	112	196	32	114	592	803	628	1333	119
"lsm6"	1370	14333	461	11	260	201	11	0	205	29	63	62	361	377	379	312	580	362
"mGluR6"	1121	3277	0	0	0	0	0	0	0	0	0	0	0	0	0	0	0	0
"mGluR8b"	3766	804919	0	0	0	0	0	0	0	0	0	0	0	0	0	0	0	0
"mawbp"	2380	19877	4	0	4	0	0	0	8	2	0	0	48	48	15	29	39	32
"mccb"	3629	71415	500	211	280	220	101	110	371	267	34	252	1257	1384	1367	1275	1533	1018
"mdr1"	343	113133	0	0	0	0	0	0	0	0	0	0	0	0	0	0	0	0
"mifr-1"	911	1869	0	0	0	0	0	0	0	0	0	0	1	4	10	3	13	10
"mifr-2"	1313	2471	0	0	0	0	0	0	0	0	0	0	1	4	10	3	13	10
"mih1/Tx"	1278	23852	695	1016	356	339	608	408	476	885	51	970	1060	2513	1137	1357	1308	1521
"mimitin"	599	207831	207	209	115	92	109	100	268	122	0	103	98	0	83	62	56	49
"mina53"	1297	20273	426	19	264	162	11	8	258	11	101	0	167	126	109	95	216	176
"mir-223"	1818	4963	0	0	0	0	0	0	25	0	0	0	20	78	125	91	102	39
"mm-1"	2078	3999	544	433	326	218	231	202	245	261	240	418	3125	3432	4489	3894	4235	3380
"mop-3"	1496	54534	914	641	507	407	469	172	645	340	402	841	2448	2351	2050	1772	2109	1222
"mop-4"	1313	15261	768	545	253	515	335	210	499	224	55	100	294	378	274	271	143	91
"mop-5"	1200	13263	4831	516	2645	2186	383	133	1758	134	3215	83	16708	1673	6359	4477	6074	3801
"nNOSmu"	281	4819	0	0	0	0	0	0	0	0	0	0	0	0	0	0	0	0
"naaladase II"	2105	24689	0	0	0	0	0	0	0	0	0	0	0	0	0	0	0	0
"naaladase L"	2813	13719	0	0	0	0	0	0	59	15	0	0	161	8	174	0	47	114
"nap1"	5814	82105	5763	1537	3232	2531	860	677	2702	928	2654	1715	1401	1580	1933	1163	1035	600
"nek11L"	2974	323616	7402	2610	4237	3165	1447	1163	2675	1021	1929	1696	119	83	0	0	40	0
"nesca"	2672	9432	177	63	88	89	55	8	471	81	0	31	429	442	437	313	659	454
"nifS"	2507	30665	45	0	23	22	0	0	127	0	0	19	469	455	559	478	572	465
"odf2"	1006	27903	84	12	52	32	0	12	116	62	28	44	241	192	380	361	318	286
"p18"	453	675	13	0	0	13	0	0	0	7	0	13	149	487	631	225	714	229
"p42"	899	1037	229	40	194	35	26	14	71	26	137	63	7619	708	439	491	616	516
"p53"	1365	5208	173	174	108	65	91	83	190	53	313	93	1725	1693	1316	1197	1539	1133
"p53AIP1"	1322	6391	0	0	0	0	0	0	0	14	0	0	0	0	0	0	0	0
"p53R2"	1444	31794	872	168	533	339	95	73	517	44	113	82	274	232	2021	265	370	1094
"p70 S6Kb"	1762	6945	410	76	209	201	28	48	201	169	321	155	665	615	784	652	1094	632
"pKBF-2"	1928	1928	3874	2226	1962	1912	1200	1026	3751	837	1061	1045	9895	10361	11844	9345	13455	7667
"parkin"	3444	915208	0	0	0	0	0	0	82	12	0	0	0	0	0	0	0	0
"parn"	899	30365	193	73	112	81	23	50	192	64	45	56	361	455	220	198	389	179
"patched a isoform"	784	26211	2	0	2	0	0	0	22	0	0	0	0	0	0	0	0	4
"pcap"	2217	22959	1136	632	641	495	383	249	519	338	1040	761	559	719	617	460	804	422
"pcnp"	2190	20239	1421	1000	877	544	562	438	574	530	172	1038	6687	7037	8596	8805	11760	8560
"peptidylglycine alpha-amidating monoo..."	377	13457	0	0	0	0	0	0	35	0	0	0	9	12	32	64	21	21
"pfkfb2"	3781	46608	228	128	115	113	73	55	247	88	23	10	898	778	1196	671	1459	533
"pknbeta"	2987	15626	2	0	0	2	0	0	142	57	0	9	711	550	4	0	7	3
"pp10122"	1170	1259	1300	917	676	624	488	429	782	542	2632	1716	927	877	527	532	875	462
"pp12613"	2224	2224	0	0	0	0	0	0	0	0	0	0	0	0	0	0	0	0
"pp13479"	2590	21401	2976	1119	1620	1356	616	503	1203	511	2148	1056	588	694	789	610	1247	542
"pp13624"	2272	188889	4795	6649	2721	2074	3588	3061	2855	4464	1157	6996	524	622	589	616	690	431
"pp13759"	2037	49970	1496	357	850	646	180	177	819	313	566	920	216	199	296	346	297	214
"pp14450"	2001	3103	138	28	40	98	8	20	24	53	63	0	370	307	579	498	513	495
"pp14737"	2330	33035	809	138	444	365	85	53	403	111	374	368	190	290	189	141	164	149
"pp14762"	3593	3593	0	0	0	0	0	0	0	0	0	0	0	0	0	0	0	0
"pp6037"	1388	40250	1313	209	651	662	107	102	869	251	595	208	285	262	311	145	575	232
"pp6318"	1623	4055	1024	326	241	783	176	150	923	380	280	190	1068	1015	462	358	982	443
"pp7201"	2942	62581	9967	6765	5541	4426	3752	3013	7576	3421	4951	4126	6505	7899	10843	7469	12523	7522
"pp7704"	984	4851	506	421	278	228	227	194	374	157	222	300	2226	1969	706	539	696	404
"pp8875"	3410	16537	2325	501	1293	1032	281	220	1408	665	2179	809	3285	2826	3082	3375	5340	3620
"pp9286"	2116	24264	5926	3132	3409	2517	1655	1477	2392	1519	4818	3664	2280	2749	4213	3397	2128	2720
"pp9320"	2572	3431	214	126	122	92	76	50	115	73	153	123	238	33	207	108	348	146
"pp9943"	4619	13107	762	432	420	342	254	178	456	305	367	614	1043	1390	874	1152	1488	1231
"pp9974"	4266	4558	0	0	0	0	0	0	96	38	0	0	0	0	0	0	0	0
"prtphn1"	574	2347	2	3	2	0	0	3	0	20	0	19	26	8	50	46	50	23
"pt-wd"	1771	21117	128	316	92	36	166	150	193	313	0	335	887	930	2007	2261	2239	1925
"rap1GAP"	494	5214	839	184	440	399	94	90	166	117	604	69	277	333	119	126	245	140
"rapa"	1089	182630	34219	7581	19281	14938	4107	3474	15428	3705	30731	9971	569	153	107	99	168	52
"raptor"	2800	16939	1366	274	758	608	149	125	1217	528	588	610	603	576	651	685	840	642
"rfg5"	929	6839	66	0	39	27	0	0	70	10	0	0	208	316	329	205	368	293
"rfpl1ant"	5114	5114	0	0	0	0	0	0	0	0	0	0	25	0	0	0	0	0
"rfpl3ant"	1298	11170	0	0	0	0	0	0	0	0	0	0	7	0	0	0	0	0
"rnh1"	1818	13188	87	114	40	47	88	26	176	196	76	158	70	932	312	367	349	206
"rpl10a"	1241	2188	234	202	125	109	111	91	112	144	80	179	3183	4544	4032	5081	6946	5315
"sema W"	1599	20319	0	0	0	0	0	0	0	0	0	0	4	0	0	0	0	8
"semaY"	3426	14659	0	0	0	0	0	0	36	38	0	0	0	3	0	0	0	0
"septin 9/TNRC6C fusion"	42	42	3	0	3	0	0	0	0	3	0	0	0	0	0	0	0	0
"skp2-alpha"	1355	30089	371	0	169	202	0	0	376	8	59	0	351	265	354	115	430	140
"slac2-c"	4842	450503	81	95	47	34	54	41	437	143	0	263	1	0	1	0	2	0
"smap-1"	1532	7975	131	28	72	59	28	0	172	48	60	0	293	205	451	175	763	228
"smap-4"	2188	27594	2926	1526	1584	1342	817	709	1743	841	702	954	7525	8225	11018	10576	10395	7391
"smap-8"	1717	7180	0	23	0	0	12	11	52	23	0	0	0	0	0	0	0	0
"sp32"	508	777	0	0	0	0	0	0	23	0	0	0	0	7	1	0	1	0
"surfactant associated protein F"	697	10477	0	0	0	0	0	0	0	0	0	0	0	0	0	0	0	0
"surfactant associated protein H"	1862	40496	0	0	0	0	0	0	12	0	0	0	0	0	0	0	0	0
"surfactant associated protein J"	3245	23490	72	0	40	32	0	0	355	11	0	0	0	0	1	0	64	6
"survivin-3B"	2800	11440	0	0	0	0	0	0	28	0	0	0	0	0	0	0	4	0
"syndecan 4"	468	468	0	0	0	0	0	0	0	0	0	0	0	0	0	0	0	0
"syt14r"	2026	94191	0	0	0	0	0	0	0	0	0	0	0	0	0	0	0	0
"sytXIV"	4927	226095	0	0	0	0	0	0	0	0	0	0	0	0	0	0	0	0
"tMDC"	2751	71907	0	0	0	0	0	0	0	0	0	0	0	0	0	0	0	0
"tMDC II"	1953	102715	0	0	0	0	0	0	0	0	0	0	0	0	0	0	0	0
"tMDC III"	1902	145345	0	0	0	0	0	0	0	0	0	0	0	0	0	0	0	0
"tgat"	9746	365623	24188	14889	13522	10666	8058	6831	12737	8380	8772	10516	1867	2563	3987	3335	4134	2360
"tgr"	1347	1864	185	137	105	80	78	59	70	60	17	10	4211	4720	3223	3078	4488	3291
"tiga1"	677	1457	26	0	16	10	0	0	40	161	0	68	118	114	105	75	149	96
"tl132"	4779	9991	847	576	528	319	350	226	106	137	0	81	550	895	367	438	606	106
"tmp_locus_39"	2154	2154	0	0	0	0	0	0	0	0	0	0	0	0	0	0	0	0
"tollip"	3458	35239	4571	2394	2479	2092	1271	1123	1773	1413	3864	3263	468	344	2801	2739	3946	670
"tom1-like"	2270	61278	45	0	27	18	0	0	127	7	0	0	495	374	423	19	309	0
"trp7"	2614	143952	0	0	0	0	0	0	11	0	0	0	0	0	0	0	0	0
"trpc2"	1196	11077	0	0	0	0	0	0	0	14	0	0	0	0	0	0	8	0
"truncated AKR"	1406	44606	0	0	0	0	0	0	29	0	0	0	11	9	0	0	0	0
"tsal1"	628	8109	603	83	288	315	39	44	259	74	445	0	65	26	41	33	90	22
"tumor antigen NA88-A"	2716	2716	0	0	0	0	0	0	0	0	0	0	0	0	0	0	0	0
"unknown"	1742	1742	34	475	22	12	343	132	59	3801	0	17	1026	4849	339	346	360	293
"usp11"	3308	9259	14	10	6	8	10	0	52	74	0	0	343	446	355	377	325	243
"ust3"	1845	40451	83	22	69	14	10	12	34	0	0	0	0	0	0	0	0	0
"vWF-CP"	2989	45050	32	0	20	12	0	0	199	182	0	39	12	92	225	157	39	184
"ve-statin"	1919	9754	0	0	0	0	0	0	79	62	0	0	3	2	26	31	22	26
"white"	1766	9455	820	35	228	592	18	17	599	123	126	0	1913	450	658	486	1022	565
"wisp3 varinat"	1308	15609	0	0	0	0	0	0	0	0	0	0	0	0	0	0	0	0
"xpct"	3183	9560	0	0	0	0	0	0	0	0	0	0	0	0	0	0	0	0
"znfp104"	840	840	35	0	0	35	0	0	15	0	0	12	0	0	0	0	0	0
